flow_duration,protocol,TotPackets,TotBytes,tot_fwd_pkts,totlen_fwd_pkts,fwd_iat_mean,fwd_pkt_len_max,fwd_pkt_len_mean,tot_bwd_pkts,totlen_bwd_pkts,bwd_iat_mean,bwd_pkt_len_max,bwd_pkt_len_mean
7.894,6,68,21123,34,575,239,1152,16336,34,427,231,1152,4787
21.261,6,3176,3103713,2061,1429,10,1448,3041057,1115,776,18,1448,62656
0.014,6,16,6004,8,88,2,88,452,8,1305,2,1880,5552
0.113,17,2,672,2,308,113,308,672,0,0,0,0,0
1639.781,6,154,13543,100,71,16563,138,7726,54,69,27940,69,5817
0.335,17,2,304,1,60,0,60,88,1,188,0,188,216
1756.847,6,126,8086,68,27,26220,27,4082,58,47,30821,427,4004
19.278,17,25,11400,14,617,1480,1350,9037,11,186,1924,1350,2363
124.562,6,40,8877,15,123,8896,267,1593,25,313,5189,1452,7284
0.301,17,2,198,1,39,0,39,67,1,103,0,103,131
0.751,6,119,87628,52,131,14,232,2609,67,1349,11,1430,85019
253.026,6,95,34458,43,686,2240,1152,26432,52,424,4956,1179,8026
3.91,17,4,240,4,32,1303,32,240,0,0,0,0,0
5.841,1,7,3609,7,487,973,548,3609,0,0,0,0,0
1.417,6,24,8004,12,164,108,267,1288,12,1014,110,2491,6716
4.066,17,5,335,5,39,1016,39,335,0,0,0,0,0
0.026,17,4,344,2,47,17,47,150,2,69,16,75,194
11.824,6,627,490135,329,1418,36,1448,468113,298,899,15,1448,22022
16.832,6,21,4515,9,341,2104,722,1488,12,299,1490,1408,3027
0.091,17,2,180,1,30,0,30,58,1,94,0,94,122
1.129,6,5,260,5,0,0,0,260,0,0,0,0,0
280.427,6,30,7432,13,158,23368,267,1317,17,603,17523,2076,6115
0.011,17,2,339,1,49,0,49,77,1,234,0,234,262
0.023,17,2,558,1,32,0,32,60,1,470,0,470,498
280.03,6,29,7392,13,158,23335,267,1317,16,678,18666,3456,6075
193.048,6,11,854,4,112,64349,112,280,7,90,32155,90,574
9.245,6,37,11305,19,784,513,1408,4168,18,476,504,4044,7137
1788.957,17,142,11360,71,48,25556,48,5396,71,56,25556,56,5964
1781.486,17,83,3480,82,14,21993,14,3444,1,8,0,8,36
12.437,6,14,3283,5,83,2987,92,435,9,394,1486,1448,2848
3.857,6,133,181419,53,279,74,859,4513,80,2303,48,7040,176906
127.217,6,14,5625,4,106,42400,106,274,10,823,14134,1460,5351
0.51,17,2,167,1,39,0,39,67,1,72,0,72,100
300.88,6,42,13568,23,881,13676,1460,8006,19,399,481,1460,5562
98.78,6,11,719,11,31,9878,31,719,0,0,0,0,0
1794.085,17,83,3480,82,14,22149,14,3444,1,8,0,8,36
0.401,6,27,8977,14,239,30,597,1694,13,942,31,1438,7283
0.021,17,2,503,1,40,0,40,68,1,407,0,407,435
280.227,6,29,7392,13,158,23352,267,1317,16,603,18680,2036,6075
1.741,6,20,3833,11,234,174,564,1504,9,463,193,1343,2329
64.267,6,15,7169,6,98,12853,106,445,9,908,44,1420,6724
61.043,6,49,9020,23,345,705,720,2071,26,327,2436,1460,6949
28.32,6,8,460,3,0,14160,0,160,5,0,2000,0,300
1797.416,17,449,39928,404,35,4460,288,25708,45,288,40024,288,14220
0.49,6,328,324244,214,183,2,230,12033,114,2734,3,8448,312211
1757.415,6,97,7307,63,38,28345,205,4476,34,33,53245,98,2831
23.549,6,31,8047,14,188,1811,721,1883,17,685,1460,1440,6164
1704.182,6,24,3624,16,241,113612,241,2568,8,92,243426,92,1056
22.514,6,60,23728,31,1164,401,1360,17642,29,307,797,1360,6086
0.15,17,2,489,1,34,0,34,62,1,399,0,399,427
0.162,6,46,21318,26,1088,6,1420,16297,20,467,8,1883,5021
2.09,6,32,12101,19,517,116,1360,3404,13,907,159,2720,8697
0.067,17,2,138,1,33,0,33,61,1,49,0,49,77
16.644,17,24,14931,11,606,1657,1350,6982,13,583,1380,1350,7949
602.051,2,6,192,6,8,120410,8,192,0,0,0,0,0
6.372,6,47,8489,25,227,265,314,4182,22,489,290,1179,4307
0.084,17,2,245,1,32,0,32,60,1,157,0,157,185
72.203,6,15,3201,6,92,14440,92,400,9,1164,8974,1408,2801
1798.624,6,374,26413,213,98,8484,469,15143,161,69,11241,69,11270
839.435,6,149,11319,50,50,17131,148,3449,99,50,8564,368,7870
0.14,6,2,112,1,0,0,0,60,1,0,0,0,52
75.372,6,18,740,8,0,7128,0,324,10,0,8373,0,416
1786.702,1,58,4872,0,0,0,0,0,58,56,31345,56,4872
280.245,6,29,7392,13,158,23353,267,1317,16,543,18680,1400,6075
1699.464,17,12,498,11,14,169946,14,462,1,8,0,8,36
302.885,6,8679,9246124,3171,162,95,295,165584,5508,1598,44,14020,9080540
280.454,6,29,7392,12,158,25495,267,1277,17,603,17524,1380,6115
110.086,17,4,352,2,60,110084,60,176,2,60,110084,60,176
1630.027,1,8,448,8,28,232861,28,448,0,0,0,0,0
1785.019,1,62,5208,62,56,29262,56,5208,0,0,0,0,0
0.648,17,6,660,3,78,324,84,320,3,85,219,104,340
1799.784,17,450,39960,405,35,4454,288,25740,45,288,40019,288,14220
2.96,17,4,240,4,32,986,32,240,0,0,0,0,0
1781.761,6,362,22898,210,69,8525,69,12678,152,69,11799,69,10220
0.24,6,24,5980,12,164,21,453,1442,12,781,21,2224,4538
70.983,6,132,128457,82,430,876,647,5670,50,2612,1397,8448,122787
183.298,17,4,240,2,32,183297,32,120,2,32,183297,32,120
3.792,17,8,1784,4,30,1262,30,232,4,360,1262,484,1552
0.375,17,8,2766,8,317,53,356,2766,0,0,0,0,0
10.046,6,22,4518,12,267,905,501,1285,10,565,1106,1420,3233
280.483,6,29,7392,13,158,23373,267,1317,16,603,18691,1400,6075
2.175,17,3,1232,3,382,1087,548,1232,0,0,0,0,0
377.254,6,18,1242,14,180,29019,180,916,4,110,20065,110,326
280.462,6,28,7352,13,158,23371,267,1317,15,775,20029,3465,6035
0.664,6,118,87088,52,131,13,232,2609,66,1341,10,1430,84479
1787.239,6,115,13683,75,81,24151,504,5920,40,162,45823,1452,7763
1781.595,17,120,9600,60,48,30196,48,4560,60,56,30196,56,5040
1.38,6,38,8266,19,321,76,1164,2730,19,433,66,1360,5536
1787.148,6,4168,3996020,1499,129,1193,349,94716,2669,1449,669,5672,3901304
1.121,17,4,240,2,32,1120,32,120,2,32,1120,32,120
0.141,17,2,192,1,60,0,60,88,1,76,0,76,104
1772.218,6,180,15480,120,69,14892,69,8940,60,69,30036,69,6540
1744.624,6,95,7203,63,38,28139,205,4476,32,33,56269,98,2727
0.26,6,15,4947,8,134,37,137,693,7,973,43,1448,4254
19.868,6,2397,2266079,1576,1361,12,1408,2218723,821,776,24,1408,47356
1793.521,17,66,2766,65,14,28023,14,2730,1,8,0,8,36
1786.112,6,117,13663,75,80,24136,503,5886,42,160,43561,1420,7777
1788.956,6,360,22818,209,69,8600,69,12569,151,69,11926,69,10249
5.396,6,549,464145,332,1330,15,1368,448197,217,776,23,1473,15948
1.437,6,47,18866,26,936,57,1460,13250,21,433,63,1460,5616
1.24,6,10,1102,6,483,248,483,803,4,83,410,83,299
1690.485,17,14,3843,7,30,281745,30,406,7,463,281745,463,3437
0.302,17,2,167,1,39,0,39,67,1,72,0,72,100
41.965,17,44,11396,44,231,975,388,11396,0,0,0,0,0
192.716,6,30,7432,13,158,16059,267,1317,17,543,12033,1400,6115
92.572,6,23,9877,11,295,68,579,1359,12,1146,8403,1460,8518
366.361,6,27,1767,18,177,21550,177,1181,9,110,8815,110,586
0.865,6,2,1235,1,0,0,0,40,1,1155,0,1155,1195
0.012,6,2,171,1,91,0,91,131,1,0,0,0,40
33.911,6,28,4939,14,154,2608,722,1807,14,480,2593,1448,3132
6.949,6,16,2370,10,210,771,210,972,6,545,1382,904,1398
16.698,6,20,2994,12,210,1508,210,1472,8,545,2309,904,1522
6.666,6,25,7097,12,155,606,267,1266,13,589,554,3426,5831
10.401,6,751,628252,455,1307,22,1368,608184,296,931,34,2736,20068
7.997,17,4,240,2,32,7997,32,120,2,32,7997,32,120
1791.796,6,404,32630,227,90,7928,1189,15678,177,138,10180,3457,16952
2.684,6,13,2311,8,188,383,245,700,5,1407,600,1407,1611
220.548,17,4,240,2,32,220547,32,120,2,32,220547,32,120
1794.084,17,144,11520,72,48,25268,48,5472,72,56,25268,56,6048
1798.977,17,449,39928,404,35,4463,288,25708,45,288,40022,288,14220
39.102,17,23,2012,12,48,3549,48,912,11,72,3513,72,1100
0.449,6,24,7956,13,335,36,668,2038,11,1067,44,1906,5918
125.547,2,2,64,2,8,125547,8,64,0,0,0,0,0
1797.496,1,342,28728,342,56,5271,56,28728,0,0,0,0,0
280.971,6,20,1443,11,31,28097,31,727,9,31,26888,31,716
2.02,17,2,134,2,39,2020,39,134,0,0,0,0,0
0.008,17,2,543,1,45,0,45,73,1,442,0,442,470
357.927,6,75,49600,46,1180,7953,1448,41362,29,746,2199,1448,8238
1787.907,6,354,22440,206,69,8721,69,12380,148,69,12162,69,10060
366.313,6,20,1355,15,177,26165,177,977,5,110,15160,110,378
0.148,17,4,284,2,32,79,32,120,2,54,70,60,164
34.518,6,38,8387,18,360,536,734,1834,20,441,1809,1440,6553
67.746,6,23,932,12,0,6157,0,484,11,0,6773,0,448
295.134,6,52,4334,21,97,14750,337,2298,31,53,9837,143,2036
15.9,1,4,426,4,78,5300,112,426,0,0,0,0,0
32.136,6,217,203842,75,125,434,299,4277,142,1392,227,1418,199565
5.529,6,42,7389,22,218,263,314,3503,20,440,277,1152,3886
72.243,6,32,10424,12,152,6567,267,1404,20,547,3791,1420,9020
55.653,17,4,304,4,48,18551,48,304,0,0,0,0,0
1789.118,17,142,11360,71,48,25558,48,5396,71,56,25558,56,5964
1773.206,6,183,15738,121,69,14776,69,8980,62,69,29065,69,6758
5.879,6,35,14650,18,480,345,928,4115,17,894,346,1460,10535
75.353,6,44,8863,20,367,806,787,1994,24,327,3268,1360,6869
0.346,6,24,4571,12,165,31,456,1446,12,415,29,888,3125
1797.763,6,363,25490,212,99,8520,469,14965,151,69,11984,69,10525
1.258,6,47,18275,26,891,50,1360,12659,21,476,54,2715,5616
280.636,6,34,8992,16,158,18709,267,1437,18,621,16505,1400,7555
8.69,6,1360,1157281,763,1427,11,1448,1119249,597,776,14,1448,38032
0.073,6,3,168,1,0,0,0,52,2,0,48,0,116
11.638,6,900,788386,565,1320,20,1368,764858,335,776,34,1473,23528
2.271,17,2,204,1,34,0,34,62,1,114,0,114,142
0.073,17,2,180,1,30,0,30,58,1,94,0,94,122
12.317,6,1889,1685292,1185,1368,10,1380,1650850,704,421,17,1923,34442
1792.685,17,72,3018,71,14,25609,14,2982,1,8,0,8,36
1772.209,6,102,9467,67,65,26851,65,5641,35,59,52120,59,3826
859.232,1,8,848,8,78,122747,78,848,0,0,0,0,0
163.024,6,23,9001,11,514,100,1236,2014,12,927,14803,1460,6987
292.31,6,36,7138,17,262,18266,517,1680,19,744,16236,1418,5458
0.011,17,2,399,1,39,0,39,67,1,304,0,304,332
0.486,6,26,6084,12,164,44,453,1442,14,558,34,1448,4642
0.011,17,2,243,1,37,0,37,65,1,150,0,150,178
31.996,6,392,388271,131,126,246,300,7190,261,1429,122,2836,381081
3.132,6,14,2355,7,188,522,245,660,7,703,480,1152,1695
281.053,6,30,7432,13,158,23421,267,1317,17,543,17562,1400,6115
1672.036,1,7,392,7,28,278672,28,392,0,0,0,0,0
1759.525,6,100,7866,66,45,27069,205,4902,34,35,53309,98,2964
10.335,6,81,24978,41,567,258,1152,19237,40,459,258,1179,5741
1.686,6,29,10365,17,367,105,833,1785,12,1012,145,1420,8580
11.0,6,20,4402,11,275,1100,275,998,9,758,777,1420,3404
5.294,6,24,9156,13,422,441,1205,2374,11,1240,509,2491,6782
0.422,6,32,17042,16,129,28,129,969,16,1269,28,1448,16073
75.982,17,4,240,2,32,75981,32,120,2,32,75980,32,120
0.05,17,2,172,1,50,0,50,78,1,66,0,66,94
1770.953,6,104,9883,68,70,26432,234,5948,36,60,50595,83,3935
667.35,6,36,2647,27,31,25667,31,1900,9,31,60185,31,747
798.945,1,34,1904,34,28,24210,28,1904,0,0,0,0,0
10.965,6,6,328,4,0,3655,0,216,2,0,10821,0,112
257.893,6,66,10048,31,102,7079,267,2578,35,263,7584,1420,7470
18.943,6,1168,1043094,763,1294,24,1368,1017370,405,776,46,2736,25724
126.864,6,22,8758,11,316,66,640,1421,11,983,12673,1360,7337
61.351,6,37,15935,22,800,2921,1440,9157,15,665,4363,1440,6778
280.211,6,30,7432,13,158,23350,267,1317,17,543,17509,1400,6115
560.604,17,6,444,3,30,280295,30,174,3,62,280294,62,270
10.5,6,1977,1854462,1275,1377,8,1408,1813294,702,931,14,2816,41168
1786.931,17,73,3060,72,14,25168,14,3024,1,8,0,8,36
1716.603,1,8,448,8,28,245229,28,448,0,0,0,0,0
3.829,17,24,16665,10,434,425,1350,4628,14,831,292,1350,12037
257.847,6,32,8952,14,158,19834,267,1357,18,624,15163,1400,7595
277.011,6,30,7432,13,158,23084,267,1317,17,543,17307,1400,6115
3.523,6,34,6169,17,206,220,314,2744,17,456,204,1152,3425
1743.953,6,95,7203,63,38,28128,205,4476,32,33,56246,98,2727
9.392,6,15,1339,8,182,1341,182,788,7,77,1530,134,551
1772.51,6,180,15480,120,69,14895,69,8940,60,69,30039,69,6540
1783.22,17,83,3480,82,14,22015,14,3444,1,8,0,8,36
1775.943,17,73,3060,72,14,25013,14,3024,1,8,0,8,36
1.305,6,48,18273,28,882,48,1360,12652,20,437,59,2715,5621
4.271,6,38,7229,19,218,237,314,3383,19,513,222,1179,3846
0.17,17,2,152,1,48,0,48,76,1,48,0,48,76
6.101,6,1601,1489648,1021,1382,5,1408,1454824,580,931,10,2801,34824
1790.161,17,179,11456,179,36,10057,36,11456,0,0,0,0,0
1.05,17,4,804,2,36,1046,36,128,2,310,1045,318,676
5.734,6,2,120,2,0,0,0,120,0,0,0,0,0
1795.263,17,80,3354,79,14,23016,14,3318,1,8,0,8,36
24.06,6,37,8288,16,188,1604,722,1964,21,498,1182,1380,6324
0.198,17,2,152,1,48,0,48,76,1,48,0,48,76
2.314,6,6,340,3,0,1157,0,160,3,0,520,0,180
1786.565,6,102,8296,68,65,26665,65,4930,34,59,54135,59,3366
56.804,17,2867,571640,2842,172,19,172,568400,25,101,2085,172,3240
0.967,17,4,240,2,32,966,32,120,2,32,966,32,120
129.715,6,23,8008,12,377,64,796,1667,11,841,12957,2720,6341
180.52,2,2,64,2,8,180520,8,64,0,0,0,0,0
0.713,17,11,9886,5,821,178,1350,4246,6,912,73,1350,5640
1785.921,6,102,8296,68,65,26655,65,4930,34,59,54116,59,3366
91.279,6,11,806,11,26,9127,26,806,0,0,0,0,0
81.027,17,4,240,2,32,81025,32,120,2,32,81026,32,120
1.243,6,39,9888,21,440,62,1360,4392,18,476,63,2715,5496
267.882,17,4,352,2,60,267881,60,176,2,60,267880,60,176
91.52,6,2,104,2,0,0,0,104,0,0,0,0,0
16.423,6,11,5489,4,106,5455,106,274,7,1231,2728,2077,5215
1786.014,6,107,8690,70,66,25884,66,5110,37,60,49608,60,3580
10.774,6,20,4442,11,275,1077,275,998,9,768,752,1440,3444
12.396,6,9,2235,8,258,1770,365,2131,1,64,0,64,104
1740.479,17,29,6699,29,203,62159,203,6699,0,0,0,0,0
240.48,6,60,24855,27,548,9248,1418,6351,33,839,7514,1418,18504
104.876,17,4,352,2,60,104874,60,176,2,60,104874,60,176
10.431,6,1645,1443057,1002,1388,10,1420,1413116,643,420,16,1420,29941
11.271,6,108,37156,56,616,204,1152,30594,52,407,215,1152,6562
0.567,6,4,220,3,0,283,0,160,1,0,0,0,60
41.299,1,44,4576,0,0,0,0,0,44,76,960,76,4576
0.087,17,2,188,1,52,0,52,80,1,80,0,80,108
121.202,6,22,9126,12,304,79,597,1425,10,1214,13445,2720,7701
1795.533,1,200,21200,200,78,9022,78,21200,0,0,0,0,0
0.779,6,10,1687,7,100,129,100,384,3,1179,263,1179,1303
26.508,6,3884,3426958,2241,1434,11,1448,3320938,1643,776,16,1448,106020
0.141,17,2,657,2,300,141,301,657,0,0,0,0,0
141.493,17,4,352,2,60,141492,60,176,2,60,141492,60,176
60.193,6,835,789714,313,528,192,1254,17881,522,1434,115,2896,771833
1680.434,1,15,840,15,28,120031,28,840,0,0,0,0,0
1591.137,1,8,448,8,28,227305,28,448,0,0,0,0,0
45.359,6,22,4568,9,341,5669,722,1489,13,299,3758,1448,3079
58.92,6,10,648,10,31,6546,31,648,0,0,0,0,0
4.985,17,2,628,2,286,4985,286,628,0,0,0,0,0
240.409,6,59,24762,27,548,9246,1418,6361,32,880,7754,1418,18401
1772.271,6,181,15589,120,69,14893,69,8940,61,69,29530,69,6649
1740.466,17,28,6580,28,207,64461,207,6580,0,0,0,0,0
1790.872,6,499,83346,242,216,7430,1360,52699,257,185,6995,2720,30647
60.166,2,2,64,2,8,60166,8,64,0,0,0,0,0
0.433,6,21,7203,12,318,38,600,1906,9,964,52,1471,5297
9.034,6,610,528781,280,1059,32,1460,30736,330,1558,26,7300,498045
1791.864,6,359,22709,209,69,8614,69,12569,150,69,12023,69,10140
424.737,6,540,148436,321,475,1327,1440,69493,219,329,1948,1328,78943
3.012,17,4,338,2,34,3003,34,124,2,79,3000,79,214
1796.07,17,377,102095,377,242,4776,422,102095,0,0,0,0,0
1786.902,6,3769,3672037,1243,127,1438,339,70362,2526,1415,707,2836,3601675
1741.409,17,28,6580,28,207,64496,207,6580,0,0,0,0,0
1778.774,17,140,11200,70,48,25779,48,5320,70,56,25779,56,5880
384.952,6,18,1242,14,180,29611,180,916,4,110,20065,110,326
10.808,6,20,4402,11,275,1080,275,998,9,758,748,1420,3404
21.93,6,51,23192,27,1255,355,1460,17430,24,399,945,1460,5762
125.85,2,2,64,2,8,125850,8,64,0,0,0,0,0
31.632,17,4,352,2,60,31631,60,176,2,60,31631,60,176
1787.902,6,377,26188,216,98,8315,469,15332,161,69,11174,69,10856
1323.48,2,14,448,14,8,101806,8,448,0,0,0,0,0
8.039,6,1263,1098318,779,1361,10,1380,1072744,484,613,16,1924,25574
1797.547,6,374,25130,216,87,8360,469,14394,158,69,11448,69,10736
281.089,6,29,7392,13,158,23424,267,1317,16,603,18730,2036,6075
4.11,17,2,122,2,33,4110,33,122,0,0,0,0,0
4.569,6,34,6169,18,206,268,314,2784,16,548,288,1179,3385
280.344,6,30,7432,13,158,23362,267,1317,17,543,17513,1300,6115
73.403,6,25,7833,12,261,6673,467,1405,13,522,5356,1368,6428
0.477,6,14,1733,7,288,75,288,588,7,426,45,434,1145
1.624,6,47,19182,27,892,62,1360,13606,20,476,74,2720,5576
9.362,6,41,9610,22,450,445,766,2737,19,406,462,1360,6873
305.423,17,11,836,11,48,30542,48,836,0,0,0,0,0
369.589,6,25,1651,17,177,23099,177,1117,8,110,9206,110,534
1797.923,2,29,928,29,8,64211,8,928,0,0,0,0,0
1751.005,6,186,11385,93,47,19032,208,6766,93,31,19029,31,4619
1773.953,6,192,16374,125,69,14306,69,9278,67,69,26875,69,7096
0.163,6,3,132,2,0,13,0,92,1,0,0,0,40
9.962,17,4,4260,4,1037,3320,1055,4260,0,0,0,0,0
12.576,6,1854,1730327,1221,1368,10,1380,1696533,633,515,19,1923,33794
19.604,17,34,5734,16,168,1304,1350,3141,18,116,1151,1350,2593
1765.468,2,13,416,13,8,147122,8,416,0,0,0,0,0
3.875,17,5,556,4,64,1285,64,368,1,160,0,160,188
368.623,6,25,1651,17,177,23038,177,1117,8,110,9204,110,534
1760.937,17,174,37408,174,186,10178,422,37408,0,0,0,0,0
1773.067,6,181,15589,120,69,14899,69,8940,61,69,29544,69,6649
20.785,17,31,19269,13,408,1729,1350,5677,18,727,1220,1350,13592
0.734,6,23,6199,13,268,60,679,1865,10,982,79,1691,4334
1.719,6,25,8719,15,277,122,565,1437,10,982,171,1420,7282
62.13,6,20,9097,11,500,88,1194,1972,9,1350,7743,2720,7125
1795.124,17,80,3354,79,14,23014,14,3318,1,8,0,8,36
1795.167,17,80,3354,79,14,23014,14,3318,1,8,0,8,36
1763.772,1,72,6048,72,56,24841,56,6048,0,0,0,0,0
280.2,6,28,7352,12,158,25472,267,1277,16,603,18679,1400,6075
7.248,6,1469,1363387,935,1381,7,1408,1330955,534,931,13,2801,32432
7.996,6,19,4338,9,35,999,92,582,10,1069,862,1448,3756
1681.273,17,14,3843,7,30,280211,30,406,7,463,280211,463,3437
0.552,17,4,950,2,40,541,40,136,2,379,537,379,814
0.18,17,3,1063,3,326,90,354,1063,0,0,0,0,0
0.143,6,10,767,5,186,25,186,454,5,45,34,45,313
1752.19,6,183,11234,92,47,19254,208,6695,91,31,19466,31,4539
1798.539,1,16,928,16,30,119902,30,928,0,0,0,0,0
1777.668,17,140,11200,70,48,25763,48,5320,70,56,25763,56,5880
1770.788,6,109,10103,69,65,26041,65,5875,40,59,45402,59,4228
0.423,6,15,2237,7,324,70,585,1009,8,396,49,580,1228
0.05,17,2,180,1,30,0,30,58,1,94,0,94,122
321.644,6,24,1735,18,43,18920,43,1375,6,0,63749,0,360
125.368,6,15,3196,8,92,17909,92,504,7,464,20863,2026,2692
0.937,17,3,634,2,32,930,32,120,1,486,0,486,514
1.853,17,4,334,2,39,1822,39,134,2,72,1817,72,200
28.437,6,10,4827,4,171,1146,171,387,6,1030,5687,1448,4440
1776.827,17,142,11360,71,48,25382,48,5396,71,56,25382,56,5964
1.244,6,50,18899,27,863,47,1360,13203,23,433,49,1360,5696
115.992,6,30,7432,13,158,9666,267,1317,17,603,7247,2076,6115
12.285,6,1941,1696433,1177,1387,10,1420,1661652,764,526,16,3303,34781
0.873,6,11,1727,7,100,145,100,384,4,589,205,1152,1343
53.427,6,18,740,10,0,5936,0,404,8,0,5149,0,336
0.236,17,2,384,1,39,0,39,67,1,289,0,289,317
1788.713,6,362,22898,210,69,8558,69,12678,152,69,11844,69,10220
2.058,17,3,174,3,30,1029,30,174,0,0,0,0,0
64.38,6,23,6778,10,179,32,318,1257,13,967,5361,2736,5521
2.969,17,4,928,4,204,989,204,928,0,0,0,0,0
15.017,6,24,1742,13,275,1251,275,1086,11,96,1376,96,656
1772.694,6,180,15480,120,69,14896,69,8940,60,69,30044,69,6540
1.412,6,46,19130,27,891,54,1360,13594,19,529,67,4075,5536
13.363,17,4,352,2,48,13355,48,152,2,72,13355,72,200
0.626,6,21,5975,12,282,56,517,1760,9,931,73,1946,4215
0.007,6,2,218,1,138,0,138,178,1,0,0,0,40
1.298,6,51,23816,30,998,44,1360,18200,21,476,55,2715,5616
0.296,6,27,8932,13,227,24,547,1604,14,941,22,1408,7328
19.451,17,24,11695,14,651,1493,1350,9517,10,189,2157,1350,2178
5.161,6,6,468,5,106,1290,106,420,1,0,0,0,48
0.547,6,14,1745,7,288,65,288,600,7,426,64,434,1145
1799.696,17,179,13962,179,50,10110,50,13962,0,0,0,0,0
1776.079,6,181,15589,120,69,14925,69,8940,61,69,29592,69,6649
0.5,17,3,543,2,39,421,39,134,1,381,0,381,409
17.042,17,25,7304,12,351,1546,1350,4557,13,183,1417,1350,2747
1774.242,6,180,15480,120,69,14909,69,8940,60,69,30064,69,6540
1696.972,1,8,848,8,78,242424,78,848,0,0,0,0,0
31.284,6,4759,4596383,3183,1367,9,1408,4509767,1576,776,19,1408,86616
138.689,17,6,2016,6,308,27737,308,2016,0,0,0,0,0
7.163,6,4,240,4,0,0,0,240,0,0,0,0,0
62.292,6,85,56655,50,1197,1271,1368,48100,35,840,1824,2519,8555
1783.485,17,83,3480,82,14,22018,14,3444,1,8,0,8,36
102.213,6,77,52194,47,1219,2222,1448,43909,30,746,2130,1448,8285
0.573,17,4,566,2,31,563,31,118,2,196,236,196,448
6.794,6,675,577717,410,1334,16,1368,557789,265,776,24,1473,19928
11.49,6,5,260,2,0,3321,0,104,3,0,5745,0,156
248.842,6,400,386077,259,240,964,256,18232,141,2816,1777,12672,367845
0.362,17,8,2766,8,317,51,356,2766,0,0,0,0,0
0.012,6,13,3987,8,114,1,114,454,5,1660,1,2920,3533
4.539,6,37,7205,19,218,252,314,3383,18,516,251,1179,3822
1.597,6,39,12658,20,451,84,1440,3577,19,755,73,1440,9081
0.401,6,2,149,1,0,0,0,40,1,69,0,69,109
0.751,6,3,156,1,0,0,0,40,2,0,593,0,116
8.284,6,11,1729,4,279,2761,279,483,7,174,759,272,1246
0.052,17,2,672,2,308,52,308,672,0,0,0,0,0
0.336,6,21,7290,13,335,27,668,2026,8,1210,47,1906,5264
1781.762,6,363,23007,210,69,8525,69,12678,153,69,11722,69,10329
1786.122,6,150,19350,90,302,20068,302,13740,60,83,30273,83,5610
473.063,6,37,7247,17,151,13789,501,1745,20,276,24890,1420,5502
0.072,17,4,368,2,32,40,32,120,2,96,41,96,248
0.221,6,3,453,2,241,221,241,321,1,92,0,92,132
750.725,17,148,11248,148,48,5106,48,11248,0,0,0,0,0
0.012,6,9,1547,5,515,2,515,783,4,548,3,548,764
1.869,6,14,2351,8,188,267,245,700,6,703,322,1152,1651
2.011,17,3,1167,3,361,1005,361,1167,0,0,0,0,0
240.332,6,48,12273,23,523,10923,1418,5955,25,417,10013,1364,6318
0.106,17,2,588,1,39,0,39,67,1,493,0,493,521
178.891,6,38,24025,24,840,23,1360,6035,14,2177,13752,5432,17990
84.747,6,123,92015,77,1249,1115,1408,81500,46,811,1878,3847,10515
1770.41,6,100,9226,66,64,27237,64,5544,34,58,53646,58,3682
7.805,17,6,528,3,48,3896,48,228,3,72,3896,72,300
291.746,17,4,240,2,32,291745,32,120,2,32,291745,32,120
1799.792,17,4192,201216,2096,20,859,20,100608,2096,20,859,20,100608
1440.353,17,25,5875,25,207,60014,207,5875,0,0,0,0,0
6.47,6,39,7269,19,218,359,314,3383,20,513,326,1179,3886
1789.356,6,356,22520,208,69,8644,69,12460,148,69,12172,69,10060
1746.188,1,8,448,8,28,249455,28,448,0,0,0,0,0
104.944,6,34,17738,16,708,42,1360,4214,18,984,6164,1360,13524
1785.903,17,140,11200,70,48,25882,48,5320,70,56,25882,56,5880
0.737,6,6,1527,4,100,245,100,264,2,1179,397,1179,1263
0.35,6,22,7342,12,335,31,668,1974,10,1210,38,1906,5368
5.884,17,31,13366,14,483,452,1350,7163,17,336,214,1350,6203
1796.538,17,428,38120,385,35,4678,288,24532,43,288,41924,288,13588
61.609,6,37,15791,22,786,2933,1408,9013,15,665,4376,1408,6778
1740.21,17,30,2490,30,55,60007,55,2490,0,0,0,0,0
2.804,17,4,240,2,32,2803,32,120,2,32,2803,32,120
1740.792,17,30,31680,30,1028,60027,1028,31680,0,0,0,0,0
1104.125,17,305,32714,130,142,8557,1350,22213,175,32,6345,60,10501
5.109,6,39,7285,20,218,268,314,3423,19,516,269,1179,3862
1.879,17,411,370163,141,94,13,1350,17285,270,1278,6,1350,352878
1799.622,17,448,39896,403,35,4476,288,25676,45,288,40022,288,14220
2.465,6,5,288,2,0,2278,0,112,3,0,1140,0,176
65.049,6,42,17355,23,826,2956,1368,10303,19,671,3601,2736,7052
1786.951,6,123,14321,76,80,23826,500,6020,47,149,38844,1420,8301
0.098,6,10,1495,5,507,24,507,727,5,556,24,556,768
0.79,6,28,5967,14,156,60,267,1502,14,650,55,1420,4465
3.355,6,100,80088,64,779,53,1360,8962,36,2488,90,6800,71126
251.674,2,2,64,2,8,251674,8,64,0,0,0,0,0
0.569,6,21,7290,13,335,47,668,2026,8,968,71,1946,5264
1795.131,17,80,3354,79,14,23014,14,3318,1,8,0,8,36
1785.286,17,87,3648,86,14,21003,14,3612,1,8,0,8,36
22.202,6,14,2245,8,211,3171,211,846,6,545,4440,904,1399
6.142,6,1515,1374158,937,1387,6,1408,1339438,578,931,10,2801,34720
1.609,6,30,8343,15,225,102,561,1985,15,820,102,1440,6358
280.047,6,28,7352,12,158,25458,267,1277,16,603,18666,1400,6075
102.107,17,10,800,5,48,25523,48,380,5,56,25523,56,420
8.207,6,19,9695,9,275,1025,275,643,10,1440,878,1440,9052
310.201,17,9,3038,9,309,38775,322,3038,0,0,0,0,0
280.93,6,30,8137,13,158,23410,267,1317,17,681,17551,2085,6820
1796.659,6,400,28252,216,104,8356,469,15732,184,56,9817,69,12520
1699.431,17,12,498,11,14,169943,14,462,1,8,0,8,36
0.081,17,2,2380,2,1162,81,1162,2380,0,0,0,0,0
0.499,6,7,295,4,0,166,0,164,3,7,96,7,131
7.834,6,576,491857,357,1310,21,1368,475793,219,776,35,2736,16064
1681.155,1,14,784,14,28,129319,28,784,0,0,0,0,0
19.181,6,33,16503,19,960,1065,1360,8473,14,1065,1461,4961,8030
1.144,6,24,8004,12,164,88,267,1288,12,1014,88,2816,6716
0.031,17,2,588,1,39,0,39,67,1,493,0,493,521
1784.38,6,183,15738,122,69,14746,69,9089,61,69,29731,69,6649
1763.195,2,14,448,14,8,135630,8,448,0,0,0,0,0
245.85,6,43,8231,21,140,12292,501,1970,22,283,11569,1420,6261
1785.084,17,70,2934,69,14,26251,14,2898,1,8,0,8,36
18.877,17,30,6089,15,209,1346,1350,3569,15,140,1346,1350,2520
0.996,17,28,14894,14,788,76,1350,11430,14,219,60,1350,3464
11.228,6,20,4402,11,275,1122,275,998,9,758,780,1420,3404
251.735,2,2,64,2,8,251735,8,64,0,0,0,0,0
279.399,6,29,7392,13,158,23283,267,1317,16,603,18624,1400,6075
0.18,6,2,891,1,811,0,811,851,1,0,0,0,40
0.942,17,2,238,1,59,0,59,87,1,123,0,123,151
11.437,6,2336,2188013,1497,1383,7,1408,2139721,839,776,13,1408,48292
240.265,6,39,5345,19,235,13345,751,2646,20,206,12644,695,2699
5.852,6,64,40223,40,1070,150,1360,21988,24,1438,246,2720,18235
11.027,6,19,4362,11,275,1102,275,998,8,1010,893,2840,3364
11.949,6,1927,1647716,1164,1363,10,1380,1610986,763,515,15,1923,36730
300.982,6,53,23283,30,1088,10378,1360,17561,23,399,399,1360,5722
126.608,6,22,8124,12,429,61,952,1823,10,981,14051,2720,6301
53.667,6,10,3238,10,302,5963,302,3238,0,0,0,0,0
8.98,6,54,13775,26,329,358,469,6654,28,272,332,1460,7121
1788.429,1,99,5544,99,28,18249,28,5544,0,0,0,0,0
126.514,2,2,64,2,8,126514,8,64,0,0,0,0,0
61.831,6,46,5738,29,132,2208,174,2098,17,368,2687,1452,3640
1796.85,17,448,39896,403,35,4469,288,25676,45,288,40021,288,14220
1756.134,6,4307,3971141,1591,149,1104,960,95976,2716,1414,646,4254,3875165
3.994,17,4,248,4,34,1331,34,248,0,0,0,0,0
367.223,6,27,1767,18,177,21601,177,1181,9,110,8545,110,586
1617.669,1,7,392,7,28,269611,28,392,0,0,0,0,0
0.045,17,4,398,2,46,0,46,148,2,97,39,103,250
1792.803,17,175,11200,175,36,10303,36,11200,0,0,0,0,0
1584.299,6,212,18546,80,81,20052,339,8442,132,72,12092,1062,10104
1797.816,6,394,27751,223,101,8098,469,16426,171,69,10575,69,11325
4.615,17,16,9856,7,426,769,1350,3178,9,714,562,1350,6678
1.298,6,41,9968,21,440,64,1360,4392,20,433,57,1360,5576
0.131,17,2,602,1,46,0,46,74,1,500,0,500,528
0.016,17,2,187,1,45,0,45,73,1,86,0,86,114
373.414,6,18,1242,14,180,28724,180,916,4,110,20067,110,326
12.28,6,19,2541,10,211,1364,211,986,9,545,1533,904,1555
1.347,6,47,18895,26,939,53,1460,13279,21,433,57,1460,5616
240.645,6,413,386466,136,460,1782,1418,10763,277,1373,871,1827,375703
300.694,6,37,8265,20,241,15826,618,1833,17,478,534,1928,6432
1796.441,17,449,39928,404,35,4457,288,25708,45,288,40020,288,14220
3.93,6,27,8827,16,282,262,578,1490,11,984,350,1452,7337
0.033,17,4,368,2,32,29,32,120,2,96,14,96,248
280.365,6,30,7432,13,158,23363,267,1317,17,543,17513,1400,6115
20.458,17,42,8138,19,171,1134,1350,3792,23,160,928,1350,4346
4.781,6,44,8369,22,227,227,314,4062,22,489,215,1179,4307
0.118,17,2,199,1,42,0,42,70,1,101,0,101,129
596.902,17,17,6632,17,362,37306,548,6632,0,0,0,0,0
1789.968,6,358,22669,209,69,8605,69,12500,149,69,12094,69,10169
1796.547,17,448,39896,403,35,4469,288,25676,45,288,40020,288,14220
1.376,6,44,13602,23,703,62,1460,7986,21,433,59,1460,5616
1780.459,17,142,11360,71,48,25434,48,5396,71,56,25434,56,5964
1743.154,6,120,10946,70,89,25263,205,7111,50,32,35570,64,3835
1786.549,6,102,8364,68,66,26664,66,4964,34,60,54133,60,3400
0.076,17,4,336,2,34,1,34,124,2,78,19,84,212
0.02,6,3,182,2,31,20,31,111,1,31,0,31,71
0.75,17,2,152,1,48,0,48,76,1,48,0,48,76
1785.325,6,356,22520,208,69,8624,69,12460,148,69,12145,69,10060
0.021,17,4,368,2,32,20,32,120,2,96,7,96,248
1683.005,2,15,480,15,8,120214,8,480,0,0,0,0,0
0.518,17,3,451,2,39,492,39,134,1,289,0,289,317
1796.474,17,448,39612,404,35,4457,288,25708,44,288,40944,288,13904
0.835,6,3,127,1,0,0,0,40,2,7,0,7,87
1778.48,17,142,11360,71,48,25381,48,5396,71,56,25377,56,5964
28.631,6,47,12926,22,179,1363,721,2495,25,673,1150,1440,10431
1772.118,6,184,15778,122,69,14645,69,9158,62,69,29049,69,6620
1750.601,17,12,498,11,14,175060,14,462,1,8,0,8,36
204.364,17,4,352,2,60,204363,60,176,2,60,204363,60,176
1783.233,17,140,11200,70,48,25843,48,5320,70,56,25843,56,5880
280.429,6,29,7392,13,158,23369,267,1317,16,603,18692,2760,6075
120.013,17,5,1694,5,310,30003,318,1694,0,0,0,0,0
300.81,6,36,8201,20,241,15832,618,1809,16,521,571,3488,6392
1741.418,6,87,6322,58,31,30551,31,3915,29,31,62184,31,2407
1798.43,1,58,4872,0,0,0,0,0,58,56,31551,56,4872
4.049,17,5,295,5,31,1012,31,295,0,0,0,0,0
1796.153,6,361,22858,210,69,8594,69,12678,151,69,11974,69,10180
1797.969,17,449,39928,404,35,4461,288,25708,45,288,40018,288,14220
947.563,17,14,3557,7,32,157925,37,420,7,420,157925,463,3137
300.297,6,31,11832,17,592,18768,1402,4457,14,948,18485,2804,7375
156.352,6,169,130420,106,1288,1489,1408,117629,63,731,2172,3847,12791
0.343,6,4,220,2,0,343,0,100,2,0,302,0,120
60.19,6,8,444,4,31,19263,31,222,4,31,20063,31,222
0.435,6,12,1653,6,288,81,288,548,6,426,48,434,1105
1795.872,17,87,3648,86,14,21127,14,3612,1,8,0,8,36
6.917,6,656,529387,380,1322,17,1368,510371,276,776,24,1473,19016
4.891,17,2,1364,2,654,4891,654,1364,0,0,0,0,0
0.016,6,13,3980,7,88,2,88,388,6,1670,3,1880,3592
421.087,2,3,96,3,8,210543,8,96,0,0,0,0,0
220.134,6,29,8832,14,158,16933,267,1357,15,858,15723,2800,7475
1741.38,6,87,6322,58,31,30550,31,3915,29,31,62190,31,2407
1.388,6,54,21349,30,954,47,1360,15568,24,400,52,1360,5781
366.941,6,25,1651,17,177,22933,177,1117,8,110,9170,110,534
0.427,17,2,152,1,48,0,48,76,1,48,0,48,76
2.349,6,53,19321,30,927,81,1460,13329,23,389,93,2920,5992
371.013,6,27,1767,18,177,21824,177,1181,9,110,8835,110,586
1772.346,6,180,15480,120,69,14893,69,8940,60,69,30033,69,6540
0.578,6,27,9135,13,268,48,711,1768,14,945,38,1368,7367
315.915,1,10,1060,10,78,35101,78,1060,0,0,0,0,0
13.406,6,44,9222,21,250,670,335,4102,23,419,597,1179,5120
34.72,1,6,336,6,28,6944,28,336,0,0,0,0,0
1744.174,6,95,7203,63,38,28131,205,4476,32,33,56256,98,2727
1764.257,2,15,480,15,8,126018,8,480,0,0,0,0,0
4.194,17,3,2948,3,954,2097,1139,2948,0,0,0,0,0
1.796,6,54,13821,27,533,69,1301,4832,27,464,68,2186,8989
174.493,17,110,32233,43,623,4154,1350,28029,67,34,2635,60,4204
3.712,6,14,3143,8,49,530,92,511,6,579,56,1408,2632
1772.004,6,180,15480,120,69,14890,69,8940,60,69,30032,69,6540
1784.167,6,102,8160,68,63,26629,63,4862,34,57,54063,57,3298
4.15,17,4,963,2,33,4055,37,123,2,392,4107,463,840
1781.765,6,365,25501,212,100,8444,469,14896,153,69,11722,69,10605
380.32,6,8,442,6,106,76062,106,354,2,0,380310,0,88
280.353,6,28,7352,12,158,25486,267,1277,16,603,18688,1400,6075
1.218,6,28,8631,15,236,74,625,2049,13,1008,84,2720,6582
1680.652,1,15,870,15,30,120046,30,870,0,0,0,0,0
1746.91,1,63,5292,0,0,0,0,0,63,56,28175,56,5292
110.069,6,32,12232,15,542,81,1287,2294,17,770,6868,1460,9938
0.171,6,26,7256,14,155,13,267,1341,12,678,14,3436,5915
154.322,6,17,692,6,0,7370,0,244,11,0,15431,0,448
1795.864,6,356,22520,208,69,8675,69,12460,148,69,12214,69,10060
280.18,6,29,7392,14,158,21552,267,1357,15,678,20010,2800,6035
125.424,6,15,3232,8,92,17917,92,540,7,464,20875,2026,2692
1743.358,6,95,7203,63,38,28118,205,4476,32,33,56226,98,2727
0.926,6,23,6397,13,310,76,891,2077,10,979,102,1731,4320
1792.788,6,357,22629,208,69,8660,69,12460,149,69,12113,69,10169
0.304,17,3,1164,3,360,152,360,1164,0,0,0,0,0
31.621,6,8,376,2,0,31621,0,88,6,0,6287,0,288
126.355,2,2,64,2,8,126355,8,64,0,0,0,0,0
1.007,17,8,700,4,34,333,34,248,4,85,332,91,452
1793.345,17,65,2730,65,14,28021,14,2730,0,0,0,0,0
1.326,6,33,12202,19,525,73,1360,3430,14,820,85,1379,8772
1765.021,2,15,480,15,8,126072,8,480,0,0,0,0,0
10.915,6,26,9137,14,666,839,1360,3271,12,895,976,1747,5866
1783.006,6,105,8365,69,47,26220,205,5156,36,37,50930,108,3209
1795.473,6,428,132718,227,816,7944,1303,100569,201,211,8976,1452,32149
0.044,6,10,1514,5,503,11,503,771,5,475,10,475,743
0.035,17,2,180,1,30,0,30,58,1,94,0,94,122
194.012,17,4,352,2,60,194011,60,176,2,60,194011,60,176
0.407,6,23,6001,13,108,33,147,959,10,927,44,2601,5042
1783.001,6,306,54242,194,304,9238,304,40204,112,83,16063,83,14038
1.229,6,40,9928,21,440,61,1360,4392,19,476,59,2715,5536
1793.888,6,356,22520,208,69,8666,69,12460,148,69,12202,69,10060
11.688,6,1720,1593816,1126,1364,10,1432,1565616,594,389,19,1432,28200
0.002,6,2,1440,1,0,0,0,40,1,1348,0,1348,1400
292.118,1,4,224,4,28,97372,28,224,0,0,0,0,0
300.937,6,60,28980,32,1087,9707,1448,15851,28,648,323,1448,13129
1740.625,17,30,31680,30,1028,60021,1028,31680,0,0,0,0,0
280.239,6,28,7352,13,158,23353,267,1317,15,678,20014,4200,6035
252.413,2,2,64,2,8,252413,8,64,0,0,0,0,0
300.723,6,51,21430,30,488,10369,1050,4155,21,1078,3259,7695,17275
280.165,6,28,7352,12,158,25469,267,1277,16,603,18677,1400,6075
1787.833,17,86,3609,85,13,21283,14,3565,1,16,0,16,44
1790.688,6,104,8506,70,65,25952,65,5140,34,59,54259,59,3366
1.494,6,53,21690,30,977,51,1460,15949,23,437,57,2615,5741
0.842,6,10,1687,7,100,140,100,384,3,1179,298,1179,1303
1772.707,6,181,15589,120,69,14896,69,8940,61,69,29543,69,6649
1792.435,17,403,106041,403,235,4458,422,106041,0,0,0,0,0
535.539,6,33,2367,21,31,26776,31,1433,12,31,48684,31,934
2.017,6,13,2311,8,188,288,245,700,5,1407,442,1407,1611
0.162,17,2,586,1,46,0,46,74,1,484,0,484,512
1798.36,17,447,39580,403,35,4473,288,25676,44,288,40947,288,13904
280.454,6,29,7392,13,158,23371,267,1317,16,603,18694,2760,6075
280.252,6,28,7352,13,158,23354,267,1317,15,678,20014,3436,6035
1785.124,6,364,23116,212,69,8460,69,12620,152,69,11822,69,10496
522.032,1,3,168,3,28,261016,28,168,0,0,0,0,0
0.0,17,2,144,1,36,0,36,64,1,52,0,52,80
5.66,6,41,7349,22,218,269,314,3503,19,513,300,1179,3846
3.716,6,2,88,2,0,0,0,88,0,0,0,0,0
94.836,17,5,679,5,107,23709,355,679,0,0,0,0,0
8.555,6,30,8872,14,158,658,267,1357,16,763,566,1781,7515
1783.809,6,363,25959,208,105,8617,469,15205,155,69,11583,69,10754
91.519,6,83,13467,48,304,1947,304,9836,35,83,2691,83,3631
280.033,6,27,7312,13,158,23336,267,1317,14,775,21538,2800,5995
15.35,6,24,6993,13,275,1279,275,1078,11,910,1033,1440,5915
0.901,6,10,1403,6,196,180,196,456,4,775,227,775,947
1773.376,6,180,15480,120,69,14902,69,8940,60,69,30049,69,6540
1786.123,6,102,8364,68,66,26658,66,4964,34,60,54122,60,3400
0.053,17,2,198,1,39,0,39,67,1,103,0,103,131
1700.45,17,12,498,11,14,170045,14,462,1,8,0,8,36
99.139,6,22,10202,12,433,71,990,1823,10,1327,11000,3928,8379
1744.59,2,28,896,28,8,64614,8,896,0,0,0,0,0
1743.754,6,95,7203,63,38,28125,205,4476,32,33,56240,98,2727
0.909,6,10,1687,7,100,151,100,384,3,1179,329,1179,1303
3.687,17,2,204,1,34,0,34,62,1,114,0,114,142
1.403,6,47,18161,26,882,56,1360,12545,21,433,60,1360,5616
1780.583,17,142,11360,71,48,25435,48,5396,71,56,25436,56,5964
0.345,17,2,212,1,46,0,46,74,1,110,0,110,138
1783.19,17,83,3480,82,14,22014,14,3444,1,8,0,8,36
54.459,6,32,9021,14,158,4189,267,1357,18,694,3197,2076,7664
1.431,6,51,22756,29,994,51,1460,17100,22,476,55,2615,5656
1745.462,6,95,7203,63,38,28152,205,4476,32,33,56293,98,2727
1780.979,6,295,28601,148,133,12114,208,21822,147,31,12197,31,6779
0.509,17,2,167,1,39,0,39,67,1,72,0,72,100
1787.604,6,365,24894,212,94,8472,469,14496,153,69,11758,69,10398
12.505,6,2163,1993957,1332,1416,9,1448,1946081,831,776,14,1448,47876
12.228,17,18,7215,9,448,1528,1350,4292,9,296,1518,1350,2923
0.168,17,4,352,2,37,1,37,130,2,83,123,89,222
61.829,6,77,53564,47,1223,1344,1408,45272,30,960,2124,3847,8292
2.232,6,13,2311,8,188,318,245,700,5,1407,496,1407,1611
1.106,6,22,7900,11,164,93,267,1236,11,1216,93,3819,6664
0.652,6,23,5080,11,137,65,267,1132,12,577,51,1400,3948
0.014,6,9,1930,5,666,3,666,934,4,780,4,780,996
382.419,6,7,508,5,106,95602,106,420,2,0,382409,0,88
1604.646,1,27,1512,27,28,61717,28,1512,0,0,0,0,0
1074.749,17,212,16112,212,48,5093,48,16112,0,0,0,0,0
0.073,17,2,214,1,39,0,39,67,1,119,0,119,147
20.685,6,25,6757,12,181,1880,267,1212,13,717,1722,2800,5545
101.759,6,44,8757,21,348,453,730,1990,23,364,4618,1360,6767
159.076,6,120,92545,78,1260,2065,1408,82239,42,811,1884,3847,10306
33.865,6,32,5344,16,154,2257,721,1910,16,371,2244,2026,3434
1.19,6,4,184,2,0,1190,0,88,2,0,1003,0,96
1.404,6,50,19850,27,931,54,1460,14154,23,433,55,1460,5696
12.125,17,10,830,5,47,3029,47,375,5,63,2998,63,455
1783.188,17,83,3480,82,14,22014,14,3444,1,8,0,8,36
105.122,6,31,7763,10,185,2253,267,1336,21,348,5255,1460,6427
1.33,17,22,10820,9,431,166,1350,4134,13,486,104,1350,6686
4.878,6,39,7269,19,218,271,314,3383,20,513,240,1179,3886
4.55,6,2,88,2,0,0,0,88,0,0,0,0,0
1794.951,1,345,28980,345,56,5217,56,28980,0,0,0,0,0
0.152,6,9,1338,5,549,38,549,753,4,421,44,421,585
1799.999,17,141,11276,71,48,25714,48,5396,70,56,25725,56,5880
1784.174,6,102,8296,68,65,26629,65,4930,34,59,54063,59,3366
50.708,6,28,7217,13,155,4225,267,1306,15,482,3621,1997,5911
97.103,6,130,102566,84,1270,1169,1368,92045,46,676,2152,1368,10521
280.348,6,28,7352,12,158,25486,267,1277,16,603,18683,1400,6075
55.232,6,37,9622,18,164,3248,517,2272,19,706,3067,1408,7350
1775.532,17,390,64991,390,138,4564,391,64991,0,0,0,0,0
1786.54,6,106,8456,68,65,26664,65,4930,38,59,48282,59,3526
7.68,6,23,6587,9,138,960,267,923,14,566,589,1460,5664
1787.583,6,102,8228,68,64,26680,64,4896,34,58,54166,58,3332
0.041,6,12,3704,6,171,7,171,491,6,964,7,1448,3213
0.454,6,13,1693,7,288,74,288,588,6,426,56,434,1105
1681.597,17,14,1036,7,30,280260,30,406,7,62,280260,62,630
300.551,6,18,1227,6,177,60075,177,497,12,110,27307,110,730
4.046,17,7,7079,2,723,4046,1350,1503,5,1087,576,1350,5576
0.135,6,16,6653,8,138,19,138,562,8,1134,19,1448,6091
1637.649,6,71,7049,49,86,34117,138,4720,22,69,24504,69,2329
67.303,6,22,10322,12,397,72,884,1717,10,1365,7462,3928,8605
280.229,6,29,7392,13,158,23352,267,1317,16,603,18676,2800,6075
0.004,17,4,398,2,46,0,46,148,2,97,1,103,250
2.751,6,28,7845,13,156,229,267,1462,15,722,189,1452,6383
5.857,6,39,7285,21,218,292,314,3463,18,516,330,1179,3822
42.811,17,4,1344,4,308,14270,308,1344,0,0,0,0,0
141.792,17,4,352,2,60,141791,60,176,2,60,141791,60,176
0.019,6,10,1673,6,553,3,949,1350,4,159,6,159,323
23.123,6,41,10469,20,773,560,1360,4734,21,375,1147,4027,5735
1798.824,17,272,54788,272,173,6637,422,54788,0,0,0,0,0
0.125,6,9,1339,5,145,31,145,349,4,826,36,826,990
1799.864,17,434,79693,434,155,4156,386,79693,0,0,0,0,0
32.905,17,19,6630,9,432,4109,1350,4147,10,220,3652,1350,2483
1.328,6,8,342,4,0,442,0,164,4,7,263,7,178
1786.196,6,102,8296,68,65,26659,65,4930,34,59,54124,59,3366
11.312,6,28,6361,12,225,1028,383,2065,16,456,736,1179,4296
0.249,6,4,263,1,31,0,31,83,3,0,124,0,180
0.275,17,2,602,1,46,0,46,74,1,500,0,500,528
0.013,17,2,419,1,44,0,44,72,1,319,0,319,347
178.362,6,22,9920,11,433,81,990,1771,11,1099,17822,1440,8149
0.084,17,4,420,2,33,77,33,122,2,121,75,145,298
28.171,6,6,328,4,0,9390,0,216,2,0,28154,0,112
6.313,17,2,672,2,308,6313,308,672,0,0,0,0,0
0.985,17,4,820,2,36,980,36,128,2,318,980,318,692
1681.578,1,15,840,15,28,120112,28,840,0,0,0,0,0
0.738,6,27,5927,13,156,61,267,1462,14,650,51,1420,4465
1777.272,17,73,3060,72,14,25032,14,3024,1,8,0,8,36
1783.811,6,365,23156,211,69,8494,69,12856,154,69,11658,69,10300
1774.076,6,182,15698,120,69,14908,69,8940,62,69,29080,69,6758
1786.166,6,143,13959,75,66,24136,517,5453,68,232,26658,2407,8506
1.022,17,3,404,2,64,997,64,184,1,192,0,192,220
312.373,6,9,522,2,106,312358,106,194,7,0,52059,0,328
1792.123,17,180,14040,180,50,10011,50,14040,0,0,0,0,0
1777.627,17,73,3060,72,14,25037,14,3024,1,8,0,8,36
361.006,2,6,192,6,8,72201,8,192,0,0,0,0,0
25.18,6,36,8477,18,191,1481,721,2253,18,687,1469,2840,6224
0.028,6,11,1566,6,503,5,503,823,5,475,6,475,743
1768.802,6,201,17645,102,119,17511,239,12476,99,31,18047,31,5169
910.106,6,188,11867,107,69,8585,69,6557,81,69,11375,69,5310
117.058,6,23,11398,12,397,67,884,1717,11,1318,11693,3928,9681
29.415,6,111,90058,71,853,420,1162,7965,40,2353,753,6864,82093
1793.5,17,144,11520,72,48,25255,48,5472,72,56,25255,56,6048
0.038,17,2,180,1,30,0,30,58,1,94,0,94,122
1785.7,1,210,11760,210,28,8544,28,11760,0,0,0,0,0
1794.492,17,140,11200,70,48,26006,48,5320,70,56,26006,56,5880
40.124,6,3266,2814223,1902,1389,21,1448,2733031,1364,776,29,1448,81192
14.088,17,4,1344,4,308,4696,308,1344,0,0,0,0,0
0.197,17,2,2380,2,1162,197,1162,2380,0,0,0,0,0
882.468,2,5,160,5,8,220617,8,160,0,0,0,0,0
4.774,6,39,7269,19,218,265,314,3383,20,513,236,1179,3886
15.265,6,4,192,1,0,0,0,48,3,0,5017,0,144
0.01,6,19,4192,10,101,1,101,629,9,441,1,500,3563
0.834,6,11,1727,7,100,139,100,384,4,589,194,1152,1343
1795.959,6,357,22698,207,69,8718,69,12420,150,69,12053,69,10278
240.222,6,52,17212,27,766,9239,1402,14447,25,208,10009,580,2765
0.086,17,2,632,1,288,0,288,316,1,288,0,288,316
1784.079,17,142,11360,71,48,25486,48,5396,71,56,25486,56,5964
127.131,17,2,122,2,33,127131,33,122,0,0,0,0,0
1740.65,17,29,30624,29,1028,62166,1028,30624,0,0,0,0,0
216.552,6,29,6735,18,154,12738,516,1804,11,498,21634,1452,4931
782.082,2,8,256,8,8,111726,8,256,0,0,0,0,0
82.01,17,20,1520,20,48,4316,48,1520,0,0,0,0,0
1.349,6,39,11298,22,547,64,1360,5842,17,529,72,4075,5456
0.005,17,4,288,2,36,4,36,128,2,52,3,52,160
0.009,17,2,162,1,36,0,36,64,1,70,0,70,98
2.026,6,37,8284,19,332,112,1234,2788,18,476,90,2615,5496
51.44,1,5,1361,5,244,12860,299,1361,0,0,0,0,0
222.345,6,22,12414,14,905,17103,1408,6159,8,1166,31744,3935,6255
134.939,1,4,224,4,28,44979,28,224,0,0,0,0,0
1788.625,17,87,3648,86,14,21042,14,3612,1,8,0,8,36
1678.354,1,8,448,8,28,239764,28,448,0,0,0,0,0
1797.888,1,345,28980,345,56,5226,56,28980,0,0,0,0,0
19.152,17,4,824,2,48,19143,48,152,2,308,19143,308,672
0.664,6,35,12091,22,641,31,1188,8200,13,534,47,1048,3891
3.863,6,69,64695,38,919,104,1360,11664,31,2157,122,10880,53031
0.002,17,4,352,2,60,1,60,176,2,60,0,60,176
11.611,6,1707,1590085,1123,1365,10,1432,1562434,584,427,19,1432,27651
9.223,6,31,8912,14,158,709,267,1357,17,763,570,2076,7555
1786.904,6,106,8586,70,65,25897,65,5140,36,59,51050,59,3446
1685.278,17,14,1036,7,30,280872,30,406,7,62,280868,62,630
1672.143,1,7,392,7,28,278690,28,392,0,0,0,0,0
1.373,6,61,15165,30,551,47,1429,5128,31,418,43,2920,10037
0.297,6,24,6064,12,181,27,537,1526,12,651,26,1408,4538
10.989,6,27,11433,13,275,915,275,1078,14,1087,785,1440,10355
1770.998,6,99,9240,66,65,27246,65,5577,33,59,55340,59,3663
15.68,17,27,5994,12,220,1422,1350,2984,15,172,1117,1350,3010
514.828,17,28,2378,28,56,19067,352,2378,0,0,0,0,0
1753.251,6,261,31932,132,111,13383,721,15227,129,235,13695,1414,16705
1318.33,6,134,11501,88,69,15153,69,6625,46,69,29295,69,4876
6.768,6,27,7384,11,155,676,267,1226,16,459,450,3426,6158
1785.393,17,87,3648,86,14,21004,14,3612,1,8,0,8,36
0.589,6,20,7168,12,319,53,602,1908,8,1209,83,1906,5260
0.683,17,2,384,1,39,0,39,67,1,289,0,289,317
0.005,17,2,355,1,33,0,33,61,1,266,0,266,294
0.199,6,2,100,1,0,0,0,60,1,0,0,0,40
0.141,6,2,80,1,0,0,0,40,1,0,0,0,40
34.951,6,28,7217,13,155,2912,267,1306,15,482,2495,1997,5911
0.443,6,27,9043,13,252,36,647,1692,14,945,31,1408,7351
18.995,17,38,7925,17,189,1185,1350,3690,21,173,948,1350,4235
33.386,6,28,4939,14,180,2568,722,1808,14,399,2554,2118,3131
164.62,6,30,8914,11,181,16462,267,1168,19,498,9122,1400,7746
1795.754,17,448,39612,404,35,4455,288,25708,44,288,40948,288,13904
0.505,17,2,904,2,424,505,548,904,0,0,0,0,0
0.593,17,2,167,1,39,0,39,67,1,72,0,72,100
372.387,6,25,1651,17,177,23274,177,1117,8,110,9238,110,534
414.4,6,40,6117,25,127,17266,516,2275,15,269,29592,1452,3842
466.779,6,37,7547,16,139,15749,499,1763,21,274,23334,1420,5784
212.088,6,802,704057,538,1334,394,1360,685902,264,210,805,2667,18155
1796.209,1,284,15904,284,28,6347,28,15904,0,0,0,0,0
453.461,6,58,3219,29,31,16189,31,1718,29,31,16189,31,1501
1746.353,6,97,7307,63,38,28166,205,4476,34,33,52906,98,2831
1800.0,6,225,15584,85,46,21080,46,6488,140,46,12949,46,9096
277.267,6,31,8912,14,158,21328,267,1357,17,687,17323,1781,7555
81.177,6,32,8952,14,158,6244,267,1357,18,624,4772,1400,7595
47.921,6,27,8752,13,158,3993,267,1317,14,981,3682,3445,7435
1772.475,6,180,15480,120,69,14894,69,8940,60,69,30034,69,6540
0.039,6,14,4044,8,88,5,88,452,6,1670,7,1880,3592
0.009,17,2,554,1,30,0,30,58,1,468,0,468,496
1745.144,6,95,7203,63,38,28147,205,4476,32,33,56287,98,2727
88.87,6,986,489039,545,835,163,1152,463198,441,372,201,1152,25841
5.772,6,630,541973,386,1334,14,1368,524621,244,776,22,2736,17352
9.956,6,31,7518,16,380,663,885,3491,15,645,693,1767,4027
206.157,6,29,1896,12,46,18741,46,848,17,46,12875,46,1048
86.235,6,17,5897,8,290,12319,517,1005,9,1102,10775,1418,4892
31.166,6,23,6496,9,154,3895,267,832,14,637,2393,1460,5664
1797.891,6,366,23610,207,69,8727,69,12558,159,69,11378,69,11052
0.406,17,7,2438,7,320,67,354,2438,0,0,0,0,0
378.771,17,19,798,19,14,21042,14,798,0,0,0,0,0
0.627,6,15,2638,8,288,75,288,640,7,568,74,853,1998
15.575,6,19,3802,11,210,1556,210,1210,8,545,2224,904,2592
1785.863,6,362,22898,210,69,8544,69,12678,152,69,11826,69,10220
1680.702,17,13,534,11,14,168052,14,462,2,8,1680522,8,72
1.603,6,17,3022,9,329,200,595,1782,8,396,221,580,1240
300.354,6,49,19923,28,1009,11118,1360,14281,21,399,15009,1360,5642
1.421,6,56,20825,28,918,52,1440,14929,28,433,46,1440,5896
1741.358,6,87,6322,58,31,30550,31,3915,29,31,62191,31,2407
0.56,6,20,7252,13,337,46,674,2032,7,1212,85,1946,5220
1787.631,6,356,22520,208,69,8635,69,12460,148,69,12160,69,10060
1.709,6,45,11595,24,547,74,1360,5934,21,400,74,1360,5661
41.829,6,40,10050,20,706,468,1360,4386,20,373,2191,2720,5664
1768.887,6,104,9654,68,65,26401,65,5811,36,59,50536,59,3843
7.152,6,1594,1455125,994,1385,7,1408,1419261,600,931,11,2816,35864
0.094,17,2,317,1,43,0,43,71,1,218,0,218,246
1788.528,1,58,4872,58,56,31377,56,4872,0,0,0,0,0
127.568,6,16,7598,3,92,484,92,268,13,604,10614,2026,7330
298.765,6,130,102508,85,1269,3556,1368,92040,45,676,2195,1368,10468
13.473,6,19,6745,10,275,1497,275,958,9,1353,1374,1440,5787
0.059,6,10,585,5,45,14,45,313,5,0,13,0,272
0.393,6,25,6032,12,164,35,453,1442,13,558,30,1448,4590
16.282,17,22,5649,11,277,1624,1350,3365,11,179,1625,1350,2284
1787.43,17,87,3648,86,14,21028,14,3612,1,8,0,8,36
7.226,6,1803,1688835,1155,1385,6,1408,1650475,648,931,10,2816,38360
0.173,17,15,9470,8,832,19,1350,6882,7,341,22,1350,2588
8.148,6,24,4542,12,213,740,597,1689,12,441,719,1368,2853
0.248,6,25,6039,12,164,22,453,1442,13,652,19,1448,4597
1791.542,1,339,28476,339,56,5300,56,28476,0,0,0,0,0
31.564,6,7,336,1,0,0,0,48,6,0,6311,0,288
20.39,6,27,7177,13,155,1699,267,1306,14,530,1567,3417,5871
0.011,17,2,519,1,40,0,40,68,1,423,0,423,451
1787.108,6,104,8376,68,65,26673,65,4930,36,59,51056,59,3446
62.489,6,13,5569,4,106,20823,106,274,9,985,7809,1460,5295
1792.285,1,286,16016,286,28,6288,28,16016,0,0,0,0,0
1793.192,2,16,512,16,8,119546,8,512,0,0,0,0,0
0.844,6,32,9127,17,238,45,572,2166,15,793,48,1360,6961
66.622,6,180,131708,90,430,748,648,6027,90,1390,746,2816,125681
228.289,17,4,352,2,60,228288,60,176,2,60,228288,60,176
1786.353,6,365,25501,212,100,8466,469,14896,153,69,11749,69,10605
1771.607,6,99,9306,66,66,27255,66,5610,33,60,55359,60,3696
0.884,6,28,8460,14,266,56,540,1924,14,994,55,1791,6536
1682.325,17,14,1036,7,30,280385,30,406,7,62,280385,62,630
22.876,6,24,6232,14,117,1759,159,1337,10,873,2540,1675,4895
1798.778,17,450,39960,405,35,4452,288,25740,45,288,40020,288,14220
1.292,6,47,19093,27,886,49,1360,13517,20,476,58,2715,5576
17.162,17,32,6411,14,192,1318,1350,3093,18,156,1007,1350,3318
280.223,6,30,7432,14,158,21555,267,1357,16,603,18678,2800,6075
1.279,6,50,19275,27,890,49,1360,13579,23,476,50,2715,5696
0.367,6,22,7342,12,335,32,668,1974,10,1210,39,2816,5368
0.998,6,4,160,2,0,862,0,80,2,0,150,0,80
90.916,6,24,6286,13,220,7576,516,1405,11,554,9079,1452,4881
167.759,1,8,672,8,56,23965,56,672,0,0,0,0,0
188.672,17,3,996,3,304,94336,312,996,0,0,0,0,0
1.718,6,66,43001,37,1246,47,1448,35588,29,842,55,1448,7413
1.415,6,52,23834,30,996,48,1460,18178,22,476,57,2615,5656
1.29,6,10,924,5,283,279,283,551,5,105,279,105,373
1.035,17,2,166,1,47,0,47,75,1,63,0,63,91
1741.719,6,105,8238,69,42,25613,205,4980,36,38,49754,149,3258
280.372,6,30,7432,13,158,23364,267,1317,17,543,17514,1400,6115
1773.344,6,180,15480,120,69,14902,69,8940,60,69,30050,69,6540
0.286,6,26,6150,13,181,23,537,1578,13,555,22,1542,4572
0.131,6,22,10013,11,136,13,136,716,11,1089,13,1448,9297
52.931,17,4,352,2,60,52930,60,176,2,60,52930,60,176
0.03,6,3,120,2,0,30,0,80,1,0,0,0,40
240.118,6,42,5040,21,179,12005,609,2550,21,153,12005,842,2490
179.03,2,3,96,3,8,89515,8,96,0,0,0,0,0
8.073,6,77,23761,39,563,212,1152,18457,38,472,211,1179,5304
65.815,1,10,560,10,28,7312,28,560,0,0,0,0,0
3.723,6,111,74959,57,851,66,1440,11709,54,1357,67,1652,63250
0.921,17,3,174,2,30,872,30,116,1,30,0,30,58
5.732,6,38,7229,20,218,301,314,3423,18,513,320,1179,3806
6.207,6,1763,1656867,1128,1392,5,1408,1619183,635,931,9,2816,37684
1792.048,17,180,14040,180,50,10011,50,14040,0,0,0,0,0
2.087,17,4,624,2,64,1888,64,184,2,192,2073,192,440
17.433,6,19,4710,6,407,3454,722,1134,13,320,1439,1408,3576
283.151,17,4,240,2,32,283150,32,120,2,32,283150,32,120
120.48,6,6,378,3,106,60240,106,234,3,0,1521,0,144
1730.354,2,27,864,27,8,66552,8,864,0,0,0,0,0
19.656,6,41,8508,22,202,935,501,2312,19,1083,1091,1731,6196
1.759,17,20,5180,20,231,92,388,5180,0,0,0,0,0
1739.09,6,87,6322,58,31,30510,31,3915,29,31,62109,31,2407
223.552,6,36,11598,20,516,11765,1360,4458,16,648,14892,2720,7140
1259.561,2,11,352,11,8,125956,8,352,0,0,0,0,0
61.577,6,30,4673,15,138,4398,174,1156,15,413,3240,1452,3517
5.011,17,4,502,2,36,5006,36,128,2,159,5005,159,374
1401.541,17,12,888,6,30,280305,30,348,6,62,280305,62,540
0.945,6,25,8068,13,164,78,267,1352,12,869,69,1408,6716
0.149,6,13,2100,7,329,24,500,1030,6,375,29,500,1070
1787.47,6,102,8364,68,66,26678,66,4964,34,60,54162,60,3400
460.844,1,58,3248,0,0,0,0,0,58,28,8084,28,3248
95.771,6,26,12869,15,519,57,884,2721,11,1385,9564,3928,10148
1794.522,6,351,22803,196,69,9202,69,11980,155,69,11652,69,10823
9.356,6,88,26909,45,540,212,1152,20707,43,407,216,1152,6202
2.239,6,112,87260,49,131,46,232,2489,63,1418,31,2860,84771
0.946,6,9,1647,6,100,189,100,344,3,1179,344,1179,1303
154.385,6,15,612,5,0,6189,0,204,10,0,17152,0,408
1786.474,17,140,11200,70,48,25890,48,5320,70,56,25890,56,5880
280.447,6,29,7392,13,158,23370,267,1317,16,603,18692,2036,6075
1744.596,2,23,736,23,8,79299,8,736,0,0,0,0,0
16.705,17,23,7548,11,410,1666,1350,4821,12,199,1515,1350,2727
173.769,6,20741,20081423,13998,1357,12,1408,19726075,6743,931,25,2801,355348
5.051,6,39,7285,20,218,265,314,3423,19,516,266,1179,3862
1.202,6,24,8004,12,164,92,267,1288,12,1014,92,2411,6716
0.941,17,4,360,2,30,897,30,116,2,94,898,94,244
1681.664,17,14,1036,7,30,280274,30,406,7,62,280274,62,630
0.868,6,10,1687,7,100,144,100,384,3,1179,313,1179,1303
0.253,6,7,380,4,0,84,0,216,3,0,121,0,164
1788.222,6,362,24774,211,94,8515,469,14387,151,69,11919,69,10387
0.011,17,2,453,1,36,0,36,64,1,361,0,361,389
1785.53,6,416,24920,208,69,8625,69,12460,208,34,8625,64,12460
0.17,6,2,142,1,62,0,62,102,1,0,0,0,40
1795.818,6,356,22520,208,69,8675,69,12460,148,69,12214,69,10060
1794.981,1,66,5544,66,56,27615,56,5544,0,0,0,0,0
82.715,1,5,722,5,116,20678,177,722,0,0,0,0,0
1755.567,6,105,6240,60,26,29754,26,3510,45,26,39898,26,2730
1512.277,2,11,352,11,8,151227,8,352,0,0,0,0,0
90.702,17,18,1584,9,48,11336,48,684,9,72,11336,72,900
1.999,17,6,460,3,40,990,41,206,3,56,990,57,254
0.068,17,4,368,2,32,39,32,120,2,96,40,96,248
1679.532,17,12,498,11,14,167953,14,462,1,8,0,8,36
1771.554,6,80,4250,40,26,45423,26,2132,40,26,45423,26,2118
1786.423,17,487,67311,234,178,7667,1350,48385,253,46,7087,1350,18926
0.108,6,19,8976,10,124,12,124,652,9,1308,13,1802,8324
1.342,6,26,7290,14,108,103,147,999,12,829,117,1608,6291
0.516,6,23,7307,13,318,43,600,1958,10,1205,45,1851,5349
1741.434,17,30,31680,30,1028,60049,1028,31680,0,0,0,0,0
1795.418,17,179,13962,179,50,10086,50,13962,0,0,0,0,0
255.453,6,29,7392,13,158,21287,267,1317,16,603,17027,2036,6075
1773.433,6,4229,3810975,1600,151,1109,934,90041,2629,1400,674,1675,3720934
240.239,6,54,17731,29,786,8579,1418,14881,25,192,10009,580,2850
1783.499,6,184,15847,123,69,14618,69,9198,61,69,29723,69,6649
240.188,6,53,18276,29,812,8577,1402,15333,24,210,10442,580,2943
4.972,6,39,7269,20,218,261,314,3423,19,513,262,1179,3846
6.6,6,25,3918,13,185,550,293,1823,12,537,576,1179,2095
0.301,6,22,7333,12,334,26,663,1969,10,806,32,1408,5364
0.031,6,32,19072,16,126,1,126,966,16,1328,1,1448,18106
1795.331,17,448,39896,403,35,4465,288,25676,45,288,40019,288,14220
1633.19,1,8,448,8,28,233312,28,448,0,0,0,0,0
146.828,6,23,6177,9,272,117,516,1180,14,403,11286,1452,4997
8.236,6,748,639237,461,1314,17,1368,619649,287,931,28,2841,19588
5.008,17,4,288,2,36,5007,36,128,2,52,5008,52,160
1799.633,17,449,39928,404,35,4465,288,25708,45,288,40015,288,14220
1785.859,6,363,24952,210,94,8544,469,14416,153,69,11749,69,10536
0.031,17,4,350,2,34,0,34,124,2,85,4,91,226
1776.795,17,140,11200,70,48,25750,48,5320,70,56,25750,56,5880
19.039,1,6,336,6,28,3807,28,336,0,0,0,0,0
0.933,6,11,1727,7,100,155,100,384,4,589,222,1152,1343
0.007,6,2,1460,1,0,0,0,40,1,1380,0,1380,1420
92.839,6,11,719,11,31,9283,31,719,0,0,0,0,0
1798.868,17,553,185808,553,308,3258,308,185808,0,0,0,0,0
1796.264,17,446,39264,403,35,4468,288,25676,43,288,40016,288,13588
17.173,6,27,7411,8,156,2453,267,1112,19,368,944,1420,6299
179.153,6,30,7432,13,158,14929,267,1317,17,543,11192,1400,6115
300.026,6,43,14137,24,834,13042,1360,8530,19,402,16656,2667,5607
0.107,17,2,389,1,34,0,34,62,1,299,0,299,327
47.966,6,42,13850,22,917,426,1360,8248,20,435,2514,2667,5602
6.258,6,1379,1275754,872,1384,6,1408,1244726,507,931,12,2816,31028
21.619,6,5,284,3,0,10726,0,164,2,0,21453,0,120
9.729,6,83,26229,42,557,237,1152,20091,41,449,236,1179,6138
9.116,6,92,28308,45,560,207,1152,21978,47,404,192,1152,6330
0.299,17,2,136,1,32,0,32,60,1,48,0,48,76
167.75,6,12,492,6,0,33550,0,244,6,0,33526,0,248
31.476,6,7,308,1,0,0,0,44,6,0,6277,0,264
1796.642,17,485,42700,405,35,4447,288,25784,80,183,22341,288,16916
1699.402,17,12,498,11,14,169940,14,462,1,8,0,8,36
732.194,17,94,18420,47,48,15917,48,3572,47,287,15916,308,14848
0.86,6,26,9232,15,208,61,475,1478,11,1043,69,3926,7754
1799.328,17,443,37748,405,35,4453,288,25740,38,288,47597,288,12008
13.0,6,19,9699,8,275,1857,275,603,11,1440,1126,1440,9096
232.084,17,4,304,2,48,232076,48,152,2,48,232076,48,152
1772.511,6,202,22250,130,75,13740,267,10057,72,136,24960,2840,12193
1797.371,17,448,39896,403,35,4471,288,25676,45,288,40017,288,14220
14.057,6,14,2351,6,188,356,245,620,8,1407,1973,1407,1731
1591.76,6,252,23305,138,81,11618,267,10101,114,143,10579,1460,13204
1.159,6,3,210,1,0,0,0,40,2,90,973,90,170
1.366,6,39,9888,20,502,71,1460,4352,19,433,65,1460,5536
1787.222,6,104,8308,68,64,26674,64,4896,36,58,51060,58,3412
1787.822,6,108,6582,60,27,30302,27,3588,48,27,38037,27,2994
1787.44,6,4310,3795997,1893,128,944,331,125168,2417,1512,739,4206,3670829
117.877,6,25,9789,12,531,62,1460,2637,13,945,9811,1460,7152
10.67,6,86,24997,43,527,254,1152,19120,43,461,247,1179,5877
0.004,17,2,587,1,36,0,36,64,1,495,0,495,523
1786.362,6,104,8444,68,66,26662,66,4964,36,60,51036,60,3480
1799.824,6,249,25360,102,67,17818,659,9472,147,131,12326,1360,15888
0.321,17,2,154,1,33,0,33,61,1,65,0,65,93
1772.714,6,180,15480,120,69,14896,69,8940,60,69,30037,69,6540
4.434,17,2,214,1,39,0,39,67,1,119,0,119,147
32.593,6,34,7802,13,152,2716,267,1444,21,367,1625,1460,6358
0.322,6,10,1328,5,299,74,299,567,5,246,71,460,761
1207.92,17,172,13072,172,48,7063,48,13072,0,0,0,0,0
1774.864,6,180,15480,120,69,14914,69,8940,60,69,30079,69,6540
280.248,6,28,7352,12,158,25477,267,1277,16,603,18679,1400,6075
0.355,6,10,968,5,256,86,256,460,5,304,87,304,508
11.619,6,25,8453,13,275,968,275,1078,12,983,765,1420,7375
18.801,6,17,5662,8,275,2685,275,874,9,1104,2055,1440,4788
120.061,2,2,64,2,8,120061,8,64,0,0,0,0,0
1799.652,17,449,39928,404,35,4465,288,25708,45,288,40016,288,14220
1780.544,17,142,11360,71,48,25436,48,5396,71,56,25436,56,5964
1.088,6,202,148406,114,1344,9,1420,140428,88,421,12,1883,7978
1785.57,6,102,8296,68,65,26650,65,4930,34,59,54105,59,3366
1.253,6,82,33762,49,605,26,1360,24379,33,536,35,4649,9383
560.634,17,6,444,3,30,280295,30,174,3,62,280293,62,270
226.341,17,6,362,3,32,113169,33,181,3,32,113170,33,181
5.725,6,17,2700,9,178,715,193,856,8,473,796,891,1844
287.944,6,71,18678,35,337,32,1460,9534,36,334,8223,1629,9144
834.696,17,13,4360,13,307,69558,308,4360,0,0,0,0,0
379.727,6,18,1242,14,180,29209,180,916,4,110,20057,110,326
280.446,6,31,7472,13,158,23370,267,1317,18,603,16491,2760,6155
246.12,6,208,33500,117,304,2121,304,23600,91,83,2733,83,9900
0.091,17,2,572,1,39,0,39,67,1,477,0,477,505
8.251,6,12,4098,6,100,1650,100,344,6,702,1534,1152,3754
1761.319,6,134,8204,72,26,24806,26,4348,62,26,28872,26,3856
1787.871,6,224,20021,113,118,15961,208,14589,111,31,16251,31,5432
5.931,6,7,296,3,0,2846,0,124,4,0,1897,0,172
280.228,6,29,7392,13,158,23352,267,1317,16,603,18678,2800,6075
0.497,6,51,21170,28,990,18,1380,16008,23,383,21,1380,5162
10.235,6,81,24797,41,561,255,1152,19056,40,459,255,1179,5741
288.404,1,4,326,4,53,96134,78,326,0,0,0,0,0
1786.467,6,104,8444,68,66,26663,66,4964,36,60,51039,60,3480
137.742,6,23,4456,8,296,1821,722,1313,15,235,9826,1448,3143
1787.306,6,103,8326,68,64,26676,64,4896,35,58,52565,58,3430
0.242,17,2,152,1,48,0,48,76,1,48,0,48,76
61.681,6,64,44964,41,1194,1542,1408,35626,23,903,2794,2816,9338
31.267,6,6,1225,4,319,10422,398,799,2,173,31070,254,426
208.697,17,4,352,2,60,208696,60,176,2,60,208696,60,176
1.142,17,35,20494,19,863,63,1350,16946,16,193,70,1350,3548
1789.156,1,112,6272,112,28,16118,28,6272,0,0,0,0,0
1752.56,17,27,9032,27,306,67406,308,9032,0,0,0,0,0
19.873,17,24,3528,12,48,1805,48,912,12,190,1805,308,2616
30.46,6,35,8390,18,401,517,888,1956,17,522,1894,2720,6434
1792.269,1,58,4872,58,56,31443,56,4872,0,0,0,0,0
1773.65,17,140,11200,70,48,25704,48,5320,70,56,25704,56,5880
1.64,6,48,18563,27,845,63,1360,12947,21,476,71,2715,5616
124.03,6,20,5353,12,107,11275,159,1074,8,966,17718,2816,4279
0.206,6,10,1669,6,551,41,947,1346,4,159,68,159,323
0.163,17,3,415,2,39,17,39,134,1,253,0,253,281
0.226,17,2,194,1,61,0,61,89,1,77,0,77,105
19.378,6,404,127302,185,422,104,1205,11318,219,493,87,2491,115984
11.217,6,20,4442,11,275,1121,275,998,9,768,775,1440,3444
7.121,6,686,635598,454,1334,15,1368,618870,232,931,29,2736,16728
1.319,6,37,8212,19,320,73,1162,2716,18,476,67,2715,5496
0.0,17,1,193,1,165,0,165,193,0,0,0,0,0
18.278,17,3,125,1,9,0,9,37,2,16,5000,16,88
0.408,6,52,23049,29,980,14,1380,15964,23,558,16,1923,7085
0.582,6,3,120,1,0,0,0,40,2,0,0,0,80
499.939,6,57,3564,28,50,18510,208,2032,29,31,17849,31,1532
0.136,1,2,112,2,28,136,28,112,0,0,0,0,0
67.653,6,68,48355,45,1190,1537,1448,40429,23,746,2799,1448,7926
1799.227,17,448,39896,403,35,4475,288,25676,45,288,40021,288,14220
1798.121,6,368,25690,215,99,8402,469,15085,153,69,11827,69,10605
125.382,6,17,3346,8,92,17911,92,504,9,338,15649,1402,2842
1772.989,6,181,15589,120,69,14899,69,8940,61,69,29544,69,6649
371.314,6,24,1587,16,177,24754,177,1053,8,110,9242,110,534
1750.28,1,58,4872,58,56,30706,56,4872,0,0,0,0,0
1745.214,6,95,7203,63,38,28148,205,4476,32,33,56283,98,2727
15.255,17,20,5542,9,292,1903,1350,2883,11,213,1522,1350,2659
1785.0,6,102,8228,68,64,26641,64,4896,34,58,54088,58,3332
75.643,6,19,780,9,0,6177,0,364,10,0,8403,0,416
1797.177,1,294,31164,294,78,6133,78,31164,0,0,0,0,0
1215.929,6,222,30630,97,212,12665,1360,13601,125,129,9804,4649,17029
1753.391,6,100,7860,66,45,26975,205,4896,34,35,53125,98,2964
3.715,17,2,656,2,300,3715,300,656,0,0,0,0,0
0.791,17,12,5933,6,585,158,1350,3678,6,347,74,1350,2255
1767.811,17,168,14018,156,30,11405,37,9090,12,382,155274,463,4928
85.449,6,48,10124,24,450,981,766,2865,24,349,3709,4848,7259
251.182,17,6,424,3,42,125590,64,212,3,42,125590,64,212
6.54,6,46,8449,23,227,297,314,4102,23,489,283,1179,4347
1787.067,6,109,8706,70,65,25899,65,5140,39,59,47024,59,3566
1773.007,6,203,22290,130,75,13744,267,10057,73,134,24622,1414,12233
9.97,6,16,3911,9,275,1246,275,643,7,992,832,1440,3268
1.539,6,32,8952,14,158,118,267,1357,18,624,75,1300,7595
0.024,17,2,152,1,48,0,48,76,1,48,0,48,76
1753.443,6,111,9311,72,59,24696,205,5761,39,39,46135,98,3550
14.045,17,4,352,2,48,14030,48,152,2,72,14025,72,200
1771.499,6,96,8960,64,65,28119,65,5408,32,59,57142,59,3552
0.031,17,2,154,1,33,0,33,61,1,65,0,65,93
11.419,17,4,352,2,48,11402,48,152,2,72,11396,72,200
1.487,6,48,17722,26,844,59,1360,12066,22,476,60,2715,5656
0.243,6,21,5000,10,137,27,267,1092,11,577,23,1400,3908
3.045,17,4,324,2,34,3002,34,124,2,72,3036,72,200
1614.691,1,8,448,8,28,230670,28,448,0,0,0,0,0
8.783,6,39,9367,21,259,439,464,1650,18,537,504,1374,7717
1772.862,6,180,15480,120,69,14898,69,8940,60,69,30048,69,6540
1720.827,17,12,498,11,14,172082,14,462,1,8,0,8,36
1744.214,6,95,7203,63,38,28132,205,4476,32,33,56258,98,2727
1797.792,6,3549,3153005,1365,121,1318,350,77116,2184,1402,823,1418,3075889
1783.006,6,358,22600,208,69,8613,69,12460,150,69,11965,69,10140
1793.558,17,180,11520,180,36,10019,36,11520,0,0,0,0,0
0.012,6,30,7887,17,131,0,131,1023,13,561,0,1000,6864
1782.058,17,138,11040,69,48,26206,48,5244,69,56,26206,56,5796
1796.885,1,214,11984,214,28,8436,28,11984,0,0,0,0,0
1794.102,17,180,14040,180,50,10022,50,14040,0,0,0,0,0
1776.221,6,179,17769,97,67,18502,721,7757,82,140,21923,2840,10012
179.119,6,23,9823,12,410,56,922,1742,11,1089,17898,2720,8081
1771.911,6,180,15480,120,69,14890,69,8940,60,69,30031,69,6540
246.008,17,4,240,2,32,246007,32,120,2,32,246006,32,120
0.018,17,3,392,2,60,9,60,176,1,188,0,188,216
481.246,2,5,160,5,8,120311,8,160,0,0,0,0,0
19.936,17,2,152,2,48,19936,48,152,0,0,0,0,0
0.457,17,3,527,2,39,452,39,134,1,365,0,365,393
143.183,17,6,2120,6,325,28636,382,2120,0,0,0,0,0
7.42,6,7,1707,7,191,1236,247,1707,0,0,0,0,0
1.326,6,31,6467,15,164,94,267,1922,16,650,77,1452,4545
240.23,6,57,20691,31,844,8007,1418,17674,26,207,9608,580,3017
0.33,17,8,2742,8,314,47,353,2742,0,0,0,0,0
14.557,6,2276,2109151,1424,1401,10,1448,2060183,852,776,16,1448,48968
367.091,6,23,1535,16,177,24472,177,1053,7,110,10365,110,482
1781.773,6,386,23720,206,69,8691,69,12380,180,45,9953,69,11340
1744.684,2,15,480,15,8,124620,8,480,0,0,0,0,0
186.043,17,6,2248,6,346,37208,548,2248,0,0,0,0,0
881.864,2,5,160,5,8,220466,8,160,0,0,0,0,0
66.529,6,20,1128,9,0,8316,0,500,11,0,6626,0,628
316.943,6,109,35984,53,577,6095,1360,24669,56,312,5760,1929,11315
76.495,6,71,47946,45,1172,1738,1408,39860,26,960,2465,3847,8086
1783.829,6,102,8296,68,65,26624,65,4930,34,59,54052,59,3366
179.991,6,1406,718938,777,858,231,1152,686909,629,403,286,1179,32029
0.013,17,3,244,2,32,9,32,120,1,96,0,96,124
1780.58,6,133,8152,72,26,25078,26,4334,61,26,29675,26,3818
1787.819,1,208,11648,208,28,8636,28,11648,0,0,0,0,0
0.004,17,2,246,1,37,0,37,65,1,153,0,153,181
31.593,6,7,336,1,0,0,0,48,6,0,6316,0,288
0.449,6,48,22542,28,1089,16,1380,17512,20,421,22,1923,5030
1121.273,17,10,740,5,30,280314,30,290,5,62,280309,62,450
0.011,17,2,431,1,65,0,65,93,1,310,0,310,338
2.512,6,1727,1697669,1041,221,2,230,60531,686,2341,3,19712,1637138
0.424,17,2,152,1,48,0,48,76,1,48,0,48,76
1771.169,6,99,9306,66,66,27248,66,5610,33,60,55346,60,3696
0.004,17,2,354,1,33,0,33,61,1,265,0,265,293
1.256,6,49,19905,28,875,46,1360,14289,21,476,54,2715,5616
1772.677,6,180,15480,120,69,14896,69,8940,60,69,30037,69,6540
1791.665,1,58,4872,58,56,31432,56,4872,0,0,0,0,0
38.929,1,12,1248,0,0,0,0,0,12,76,3539,76,1248
247.05,6,349,338779,127,193,1960,877,9136,222,1529,1117,4254,329643
1645.068,6,24,3624,16,241,109671,241,2568,8,92,234981,92,1056
1795.678,17,448,39896,403,35,4466,288,25676,45,288,40018,288,14220
54.265,1,8,448,8,28,7752,28,448,0,0,0,0,0
0.956,6,10,1687,7,100,159,100,384,3,1179,353,1179,1303
1629.631,1,8,448,8,28,232804,28,448,0,0,0,0,0
481.271,2,4,128,4,8,160423,8,128,0,0,0,0,0
1.405,6,50,20115,28,887,52,1360,14459,22,433,57,1360,5656
325.906,6,127,102196,81,1116,4073,1408,28841,46,2288,1237,16659,73355
1796.77,17,180,14040,180,50,10037,50,14040,0,0,0,0,0
236.966,6,27,7312,12,158,21542,267,1277,15,603,16925,2036,6035
127.393,6,16,4013,3,92,147,92,256,13,279,10601,2026,3757
0.291,6,26,8903,13,234,24,575,1620,13,1099,23,2816,7283
0.606,17,4,624,2,64,604,64,184,2,192,486,192,440
0.059,17,4,344,2,47,0,47,150,2,69,10,75,194
240.281,6,42,8739,21,519,12013,1402,5775,21,233,12013,618,2964
7.244,6,1691,1562920,1068,1387,6,1408,1525860,623,931,11,2801,37060
66.058,6,8,332,4,0,22019,0,164,4,0,21465,0,168
55.684,6,28,7217,13,155,4640,267,1306,15,482,3977,1997,5911
2.521,17,2,374,1,47,0,47,75,1,271,0,271,299
5.908,6,558,455957,325,1332,17,1368,439177,233,776,24,2736,16780
1744.703,2,29,928,29,8,62310,8,928,0,0,0,0,0
1764.898,2,14,448,14,8,135761,8,448,0,0,0,0,0
27.872,6,17,744,8,0,3981,0,348,9,0,2248,0,396
240.211,6,56,20403,30,849,8282,1418,17707,26,167,9608,580,2696
1.766,6,25,8709,15,276,126,560,1432,10,981,176,1420,7277
0.422,17,3,543,2,39,416,39,134,1,381,0,381,409
1786.602,6,126,15178,80,167,22615,1288,9883,46,86,39700,268,5295
339.393,6,35,7149,15,168,11629,516,1615,20,278,17858,1452,5534
1795.471,1,92,5152,92,28,19730,28,5152,0,0,0,0,0
6.956,6,571,496991,359,1318,18,1368,481303,212,776,31,2736,15688
11.736,6,1751,1578130,1113,1366,10,1380,1547620,638,421,18,1923,30510
6.646,6,714,621939,447,1324,14,1368,603391,267,776,24,1473,18548
19.66,6,1145,1024786,749,1296,26,1368,999530,396,931,49,2736,25256
8.243,6,78,24341,40,550,211,1152,18680,38,459,215,1179,5661
1786.012,17,83,3480,82,14,22049,14,3444,1,8,0,8,36
1786.955,6,102,8364,68,66,26670,66,4964,34,60,54147,60,3400
0.013,17,2,382,1,44,0,44,72,1,282,0,282,310
83.15,17,3,228,3,48,41575,48,228,0,0,0,0,0
1757.019,6,116,7002,65,26,27452,26,3858,51,26,35139,26,3144
999.881,6,202,12772,116,69,8694,69,7055,86,69,11763,69,5717
1773.556,6,180,15480,120,69,14903,69,8940,60,69,30051,69,6540
280.177,6,27,7312,12,158,25470,267,1277,15,678,20012,2045,6035
107.345,6,38,8581,16,206,7156,721,2089,22,431,5037,2840,6492
1795.283,6,368,23345,213,69,8468,69,13005,155,69,11657,69,10340
63.136,6,7,420,7,0,0,0,420,0,0,0,0,0
0.778,6,24,5755,13,158,64,370,1315,11,799,76,1420,4440
1796.966,1,271,15176,271,28,6655,28,15176,0,0,0,0,0
13.512,6,9,556,4,46,4503,46,218,5,46,3377,46,338
0.505,6,11,1015,6,185,89,185,690,5,45,118,45,325
3.826,17,10,1070,5,39,942,39,335,5,119,941,119,735
123.918,6,34,7797,12,155,29,267,1266,22,331,5900,1420,6531
1790.182,17,79,3312,78,14,23249,14,3276,1,8,0,8,36
0.523,17,3,543,2,39,123,39,134,1,381,0,381,409
5.431,6,38,7229,19,218,301,314,3383,19,513,287,1179,3846
42.169,17,24,2112,12,48,3832,48,912,12,72,3832,72,1200
0.02,17,2,251,1,36,0,36,64,1,159,0,159,187
0.494,6,21,7290,13,335,41,668,2026,8,968,61,1475,5264
579.446,17,68,5168,68,48,8648,48,5168,0,0,0,0,0
45.102,17,4,352,2,60,45100,60,176,2,60,45100,60,176
1784.187,6,356,22520,208,69,8619,69,12460,148,69,12136,69,10060
420.29,2,3,96,3,8,210145,8,96,0,0,0,0,0
1174.251,1,14,1794,14,100,90327,173,1794,0,0,0,0,0
1656.533,1,8,448,8,28,236647,28,448,0,0,0,0,0
1742.393,1,15,840,15,28,124456,28,840,0,0,0,0,0
1.315,6,47,16685,25,833,54,1440,11029,22,433,54,1440,5656
1781.205,17,142,11360,71,48,25445,48,5396,71,56,25445,56,5964
240.303,6,41,8883,20,523,12647,1408,5758,21,225,12014,617,3125
630.731,2,5,160,5,8,157682,8,160,0,0,0,0,0
0.256,17,3,451,2,39,126,39,134,1,289,0,289,317
1772.775,6,180,15480,120,69,14897,69,8940,60,69,30041,69,6540
1794.777,17,142,11360,71,48,25639,48,5396,71,56,25639,56,5964
1797.842,1,57,4788,57,56,32104,56,4788,0,0,0,0,0
1797.17,6,385,26784,220,97,8206,469,15699,165,69,10957,69,11085
1.591,6,47,19561,27,919,61,1360,13985,20,433,73,1360,5576
1782.958,6,368,25621,214,99,8370,469,15045,154,69,11653,69,10576
300.247,6,27,10820,14,146,23095,237,1321,13,1103,25019,1436,9499
1786.767,6,356,22520,208,69,8631,69,12460,148,69,12154,69,10060
1788.311,17,138,11040,69,48,26298,48,5244,69,56,26297,56,5796
1.448,6,52,20490,27,971,55,1440,14714,25,433,52,1440,5776
12.751,6,95,28153,48,527,271,1152,21450,47,401,271,1152,6703
1226.488,6,79,11027,49,99,20341,498,4241,30,214,42289,1420,6786
1791.562,6,447,32258,240,103,7496,469,19217,207,69,8694,69,13041
1745.081,6,97,7307,63,38,28146,205,4476,34,33,52875,98,2831
0.557,6,10,3951,5,690,101,1460,2960,5,263,95,269,991
0.421,6,22,5040,11,137,42,267,1132,11,692,39,1467,3908
1785.257,1,342,28728,342,56,5235,56,28728,0,0,0,0,0
1740.46,17,30,31680,30,1028,60015,1028,31680,0,0,0,0,0
0.093,6,3,120,2,0,93,0,80,1,0,0,0,40
1795.064,17,448,39896,403,35,4465,288,25676,45,288,40020,288,14220
2.442,6,29,9051,17,371,152,845,1797,12,846,211,1380,7254
1745.383,6,95,7203,63,38,28151,205,4476,32,33,56295,98,2727
7.9,6,67,20166,35,540,232,1152,15459,32,489,246,1179,4707
706.868,17,36,12096,36,308,20196,308,12096,0,0,0,0,0
1797.454,17,448,39896,403,35,4471,288,25676,45,288,40021,288,14220
264.832,6,31,10808,15,396,18903,1440,2789,16,796,17643,1440,8019
0.083,6,9,1343,5,145,20,145,349,4,830,24,830,994
0.019,6,17,6068,10,88,2,88,556,7,1740,3,1880,5512
82.188,17,4,352,2,60,82187,60,176,2,60,82187,60,176
1785.857,6,384,23640,208,69,8627,69,12460,176,47,10204,69,11180
372.429,6,50,6639,25,112,15511,722,2653,25,207,15510,1408,3986
25.833,6,37,9318,20,114,1359,316,1746,17,860,1605,4662,7572
1681.544,17,14,1036,7,30,280255,30,406,7,62,280253,62,630
6.067,6,40,7325,21,218,303,314,3463,19,516,322,1179,3862
1755.134,1,56,4704,56,56,31911,56,4704,0,0,0,0,0
0.59,6,23,7420,13,337,49,674,2032,10,1212,57,1946,5388
13.069,6,14,3706,3,92,6534,92,244,11,320,1288,1408,3462
155.357,17,4,240,2,32,155355,32,120,2,32,155356,32,120
0.016,6,2,218,1,138,0,138,178,1,0,0,0,40
15.504,17,12,5315,6,490,3087,1350,3109,6,339,3085,1350,2206
22.929,17,43,7867,19,166,1272,1350,3691,24,146,995,1350,4176
1786.309,6,422,25277,211,69,8506,69,12580,211,34,8506,48,12697
4.149,17,2,116,2,30,4149,30,116,0,0,0,0,0
1769.854,6,99,9306,66,66,27228,66,5610,33,60,55304,60,3696
0.012,6,2,104,2,0,0,0,104,0,0,0,0,0
1.44,6,51,18854,28,919,53,1460,13113,23,400,56,1460,5741
1.38,6,38,8324,19,332,76,1234,2788,19,433,66,1440,5536
0.357,6,21,7203,12,318,32,600,1906,9,803,42,1448,5297
1688.661,1,8,848,8,78,241237,78,848,0,0,0,0,0
1796.508,6,211,24187,133,89,13609,965,11142,78,134,23327,1460,13045
0.005,17,2,313,1,45,0,45,73,1,212,0,212,240
1.794,17,20,5190,20,231,94,389,5190,0,0,0,0,0
1729.21,6,63,4601,41,33,43230,33,2825,22,31,82334,31,1776
1797.432,17,347,26372,347,48,5194,48,26372,0,0,0,0,0
7.434,17,6,528,3,48,3655,48,228,3,72,3656,72,300
87.153,6,28,13979,14,836,62,1460,5608,14,1114,6690,1460,8371
280.196,17,4,1098,2,30,280192,30,116,2,463,280191,463,982
0.786,6,11,1727,7,100,131,100,384,4,589,176,1152,1343
52.576,6,18,4150,9,296,6572,722,1353,9,465,6542,1408,2797
1766.817,1,82,6888,82,56,21812,56,6888,0,0,0,0,0
1787.916,6,454,27532,222,69,8090,69,13296,232,36,7739,48,14236
1789.122,1,176,9856,176,28,10223,28,9856,0,0,0,0,0
1793.713,6,149,21125,93,169,19496,1286,11522,56,167,32610,2642,9603
372.091,6,25,1651,17,177,23255,177,1117,8,110,9225,110,534
15.305,6,11,2033,7,326,2550,589,1025,4,396,37,580,1008
1742.854,6,98,7359,63,38,28110,205,4476,35,33,51249,98,2883
15.283,17,6,528,3,48,7637,48,228,3,72,7637,72,300
33.381,6,31,5166,15,163,2384,722,1919,16,342,2213,1402,3247
61.899,2,2,64,2,8,61899,8,64,0,0,0,0,0
9.218,6,29,7930,14,150,709,267,1622,15,712,644,4846,6308
6.928,6,617,522954,374,1328,18,1368,505654,243,776,27,2736,17300
1791.09,17,144,11520,72,48,25226,48,5472,72,56,25226,56,6048
2.245,6,13,2311,8,188,320,245,700,5,1407,496,1407,1611
60.091,17,28,2355,26,30,2403,37,1515,2,392,351,463,840
0.179,17,2,152,1,48,0,48,76,1,48,0,48,76
1792.647,1,200,11200,200,28,9008,28,11200,0,0,0,0,0
0.163,6,27,7296,14,155,12,267,1341,13,603,13,2800,5955
1787.326,6,102,8296,68,65,26676,65,4930,34,59,54157,59,3366
0.05,6,2,80,1,0,0,0,40,1,0,0,0,40
1796.67,1,248,13888,248,28,7273,28,13888,0,0,0,0,0
280.482,6,29,7392,13,158,23373,267,1317,16,603,18696,2036,6075
0.512,6,50,20473,27,1014,19,1380,15311,23,421,21,1923,5162
0.307,6,27,9081,13,261,25,683,1740,14,943,22,1408,7341
1797.314,6,289,20185,173,69,10449,69,11129,116,69,15628,69,9056
0.245,6,27,7296,13,155,20,267,1301,14,603,17,2036,5995
1772.512,6,180,15480,120,69,14895,69,8940,60,69,30036,69,6540
1771.932,6,99,9306,66,66,27260,66,5610,33,60,55370,60,3696
68.143,17,4,352,2,60,68142,60,176,2,60,68142,60,176
1.564,6,14,2351,8,188,223,245,700,6,703,259,1152,1651
12.797,6,2015,1766133,1225,1387,10,1420,1730312,790,467,16,1883,35821
37.002,6,38,8535,18,410,509,882,1982,20,441,1940,1460,6553
2.747,6,9,1647,6,100,549,100,344,3,1179,1244,1179,1303
1.535,17,19,7099,9,482,186,1350,4590,10,222,162,1350,2509
21.521,17,2,642,1,300,0,300,328,1,286,0,286,314
1689.601,1,8,448,8,28,241371,28,448,0,0,0,0,0
0.581,6,14,1745,7,288,67,288,600,7,426,66,434,1145
0.33,6,2,92,1,0,0,0,40,1,0,0,0,52
1756.435,6,107,6344,60,26,29769,26,3510,47,26,38182,26,2834
1780.03,6,102,8296,68,65,26567,65,4930,34,59,53937,59,3366
1783.457,17,83,3480,82,14,22017,14,3444,1,8,0,8,36
1741.662,6,70,5882,35,36,51223,36,1892,35,436,51222,443,3990
1768.085,1,128,7168,128,28,13921,28,7168,0,0,0,0,0
1792.163,17,180,14040,180,50,10012,50,14040,0,0,0,0,0
2.27,6,30,10995,17,350,141,1042,2137,13,925,148,1460,8858
0.568,6,17,4511,10,327,61,634,1836,7,767,92,1328,2675
53.619,6,29,7392,14,158,4124,267,1357,15,678,3827,3436,6035
0.174,1,2,112,2,28,174,28,112,0,0,0,0,0
1790.034,6,356,22589,207,69,8689,69,12420,149,69,12094,69,10169
0.01,6,10,1510,5,657,2,657,925,5,317,2,317,585
254.56,6,8,482,2,106,254560,106,194,6,0,6558,0,288
0.319,6,26,6065,14,164,24,453,1570,12,643,28,1542,4495
0.513,17,3,543,2,39,445,39,134,1,381,0,381,409
492.184,17,5,984,5,168,123046,361,984,0,0,0,0,0
6.093,6,1286,1160401,776,1415,7,1448,1129217,510,776,11,1448,31184
843.285,17,68,5440,34,48,25553,48,2584,34,56,25553,56,2856
1791.368,1,265,28090,265,78,6785,78,28090,0,0,0,0,0
300.765,2,4,128,4,8,100255,8,128,0,0,0,0,0
292.884,1,4,326,4,53,97628,78,326,0,0,0,0,0
1681.728,17,16,1265,8,30,240245,37,471,8,71,240244,136,794
0.003,6,3,144,2,0,3,0,92,1,0,0,0,52
240.219,6,54,17800,29,797,8579,1418,15074,25,177,10008,580,2726
17.792,6,2156,1942852,1355,1374,13,1380,1899386,801,421,22,1923,43466
280.064,6,30,7432,13,158,23338,267,1317,17,543,17502,1400,6115
6.028,6,5,365,1,0,0,0,40,4,39,1993,39,325
1771.522,6,101,9344,66,65,27254,65,5577,35,59,52099,59,3767
840.816,17,10,821,5,31,210199,37,297,5,76,210196,136,524
1771.836,6,180,15480,120,69,14889,69,8940,60,69,30030,69,6540
1.097,17,6,552,3,64,548,64,276,3,64,547,64,276
5.847,17,4,272,2,32,3003,32,120,2,48,4705,48,152
12.027,17,12,1008,6,34,2404,34,372,6,78,2404,84,636
1785.973,6,366,23196,211,69,8504,69,12787,155,69,11595,69,10409
0.054,17,2,158,1,34,0,34,62,1,68,0,68,96
1799.023,17,142,11360,71,48,25700,48,5396,71,56,25700,56,5964
146.105,6,26,10621,13,632,158,1360,3713,13,1062,12162,2232,6908
300.125,6,42,10530,22,655,14284,1360,4866,20,373,15786,2667,5664
82.217,6,11,452,4,0,4047,0,164,7,0,13701,0,288
1684.466,2,27,864,27,8,64787,8,864,0,0,0,0,0
0.039,6,3,120,2,0,6,0,80,1,0,0,0,40
553.336,6,45,7939,29,115,19762,501,2550,16,338,32432,1420,5389
11.017,6,20,4442,11,275,1101,275,998,9,768,795,1440,3444
1740.61,17,29,6815,29,207,62164,207,6815,0,0,0,0,0
0.66,6,10,1185,6,279,132,279,587,4,191,81,272,598
1772.085,6,180,15480,120,69,14891,69,8940,60,69,30032,69,6540
0.002,6,2,135,1,43,0,43,95,1,0,0,0,40
1.158,6,27,8945,14,288,89,796,1747,13,952,80,1460,7198
139.728,6,25,11778,12,746,76,1460,3498,13,1106,11633,1460,8280
140.811,6,27,15719,13,651,93,1360,3144,14,1333,10820,2720,12575
0.226,6,46,21522,26,1102,9,1420,16501,20,467,11,1883,5021
1776.921,6,102,8296,68,65,26521,65,4930,34,59,53842,59,3366
1786.686,6,102,8296,68,65,26666,65,4930,34,59,54138,59,3366
1794.265,6,394,24184,211,69,8544,69,12580,183,45,9858,69,11604
0.038,17,4,308,2,38,0,38,132,2,60,10,66,176
15.126,17,28,14162,14,739,1160,1350,10745,14,216,1160,1350,3417
373.247,1,12,1272,12,78,33931,78,1272,0,0,0,0,0
0.962,6,24,10658,14,741,74,1360,3558,10,1114,87,3068,7100
1772.676,6,180,15480,120,69,14896,69,8940,60,69,30037,69,6540
0.015,17,2,503,1,40,0,40,68,1,407,0,407,435
280.208,6,28,7352,13,158,23350,267,1317,15,678,20013,3436,6035
1787.156,6,102,8296,68,65,26673,65,4930,34,59,54153,59,3366
1.678,6,25,8773,15,286,119,592,1464,10,986,167,1420,7309
1770.625,6,99,9240,66,65,27240,65,5577,33,59,55329,59,3663
1.592,6,12,1304,6,256,316,256,756,6,304,316,304,548
1772.809,6,181,15589,120,69,14897,69,8940,61,69,29543,69,6649
0.298,17,3,1167,3,361,149,361,1167,0,0,0,0,0
173.901,6,10,695,5,275,43475,275,479,5,0,2015,0,216
0.16,6,20,4363,11,165,16,456,1394,9,498,19,888,2969
1.57,6,51,21380,29,908,56,1360,15724,22,433,65,1360,5656
5.008,17,4,542,2,36,5003,36,128,2,179,5003,187,414
1788.736,6,356,22520,208,69,8641,69,12460,148,69,12168,69,10060
6.392,6,28,10643,15,633,456,1257,2544,13,840,521,1360,8099
5.04,17,4,304,4,48,1680,48,304,0,0,0,0,0
1792.695,1,270,15120,270,28,6664,28,15120,0,0,0,0,0
1.32,6,52,22498,29,975,47,1440,16802,23,433,52,1440,5696
9.129,6,89,29028,46,582,202,1152,22826,43,447,211,1179,6202
1.572,6,29,10388,17,373,98,851,1803,12,1012,135,1420,8585
0.152,1,2,112,2,28,152,28,112,0,0,0,0,0
1796.151,17,448,39612,404,35,4456,288,25708,44,288,40948,288,13904
1772.222,6,180,15480,120,69,14892,69,8940,60,69,30032,69,6540
1.627,6,51,18805,29,850,58,1360,13104,22,437,68,2715,5701
1773.591,6,180,15480,120,69,14904,69,8940,60,69,30052,69,6540
0.857,6,10,1687,7,100,142,100,384,3,1179,305,1179,1303
1.007,6,5,637,3,241,503,241,373,2,92,455,92,264
141.245,17,4,1344,4,308,47081,308,1344,0,0,0,0,0
377.816,2,3,96,3,8,188908,8,96,0,0,0,0,0
1.082,6,3,300,1,0,0,0,40,2,90,896,90,260
61.859,6,71,47773,44,1166,1438,1408,39636,27,960,2370,3847,8137
1775.067,6,180,15480,120,69,14916,69,8940,60,69,30079,69,6540
280.661,6,30,7432,13,158,23388,267,1317,17,543,17535,1400,6115
3.048,6,23,5564,13,151,251,380,1281,10,969,335,1771,4283
1772.434,6,180,15480,120,69,14894,69,8940,60,69,30039,69,6540
31.62,6,45,10285,22,702,457,1440,4470,23,325,1429,1440,5815
1729.166,6,69,4980,44,33,40213,33,3017,25,31,72041,31,1963
1789.512,17,83,3480,82,14,22092,14,3444,1,8,0,8,36
265.013,17,4,352,2,60,265012,60,176,2,60,265012,60,176
5.131,17,3,208,2,36,5003,36,128,1,52,0,52,80
8.432,6,1681,1362492,891,1431,9,1448,1310280,790,776,10,1448,52212
0.368,6,13,2121,7,324,61,585,1009,6,396,72,580,1112
35.207,6,19,832,8,0,5029,0,348,11,0,3030,0,484
4.879,6,39,7269,20,218,256,314,3423,19,513,256,1179,3846
17.359,17,4,352,2,48,17348,48,152,2,72,17350,72,200
0.432,6,7,371,4,0,144,0,204,3,7,108,7,167
252.595,2,2,64,2,8,252595,8,64,0,0,0,0,0
1781.421,6,102,8296,68,65,26588,65,4930,34,59,53979,59,3366
0.602,6,15,1785,8,288,63,288,640,7,426,72,434,1145
0.295,17,2,180,1,30,0,30,58,1,94,0,94,122
1773.148,6,180,15480,120,69,14900,69,8940,60,69,30046,69,6540
1772.951,6,180,15480,120,69,14898,69,8940,60,69,30047,69,6540
1773.455,6,182,15629,121,69,14778,69,8980,61,69,29549,69,6649
1278.214,6,152,17973,92,78,13220,267,7226,60,151,21664,1917,10747
1741.461,17,28,29512,28,1026,64498,1026,29512,0,0,0,0,0
1.312,17,6,360,3,32,655,32,180,3,32,655,32,180
1.822,17,28,14393,15,585,127,1350,9200,13,371,149,1350,5193
11.725,1,8,832,0,0,0,0,0,8,76,1675,76,832
2.039,17,3,3140,3,1018,1019,1438,3140,0,0,0,0,0
0.217,17,2,2752,2,1348,217,1348,2752,0,0,0,0,0
1740.464,2,30,960,30,8,60016,8,960,0,0,0,0,0
0.833,6,20,5948,11,281,83,544,1288,9,716,93,1420,4660
1772.825,6,180,15480,120,69,14897,69,8940,60,69,30043,69,6540
1772.914,6,180,15480,120,69,14898,69,8940,60,69,30045,69,6540
0.545,17,3,543,2,39,530,39,134,1,381,0,381,409
2.94,17,4,624,4,128,980,128,624,0,0,0,0,0
300.833,6,53,23173,24,653,13079,1438,5178,29,824,10743,1438,17995
281.918,6,31,7472,14,158,21686,267,1357,17,543,17608,1400,6115
0.929,6,11,1864,6,262,185,517,844,5,752,232,752,1020
1744.738,2,26,832,26,8,69789,8,832,0,0,0,0,0
517.062,17,14,4672,14,305,39774,308,4672,0,0,0,0,0
1796.229,17,449,39928,404,35,4457,288,25708,45,288,40027,288,14220
38.215,6,45,10209,22,533,724,910,3083,23,364,1731,2720,7126
310.957,6,14,1502,8,302,44422,302,1016,6,83,62188,83,486
134.555,6,106,77249,66,1271,2070,1448,67005,40,679,2601,1448,10244
1764.176,2,11,352,11,8,176417,8,352,0,0,0,0,0
3.565,6,13,3117,8,49,509,92,535,5,772,50,2026,2582
1792.782,17,175,11200,175,36,10303,36,11200,0,0,0,0,0
4.902,6,37,7205,19,218,272,314,3383,18,516,271,1179,3822
2.156,6,11,975,6,304,431,304,624,5,83,534,83,351
16.327,6,11,612,7,0,2721,0,380,4,0,5237,0,232
1.397,6,50,18686,27,848,53,1360,12990,23,433,54,1360,5696
8.132,6,47,8489,23,227,369,314,4102,24,427,342,1152,4387
142.367,6,27,9549,13,698,112,1360,3356,14,702,10936,2720,6193
0.682,6,10,924,5,283,117,283,551,5,105,120,105,373
1751.733,6,100,7866,66,45,26949,205,4902,34,35,53074,98,2964
338.675,1,64,5376,64,56,5375,56,5376,0,0,0,0,0
119.685,17,6,1984,6,302,23937,308,1984,0,0,0,0,0
1785.734,6,106,8456,68,65,26652,65,4930,38,59,48260,59,3526
7.205,6,31,8076,17,346,450,731,1751,14,575,527,4863,6325
0.21,6,43,17886,24,993,9,1420,12905,19,467,11,1883,4981
0.131,17,3,1170,3,362,65,362,1170,0,0,0,0,0
1.28,17,3,1167,3,361,640,361,1167,0,0,0,0,0
0.269,17,4,284,2,32,262,32,120,2,54,262,60,164
0.012,17,2,363,1,29,0,29,57,1,278,0,278,306
352.502,17,12,2472,6,48,70498,48,456,6,308,70498,308,2016
0.907,6,10,1687,7,100,151,100,384,3,1179,321,1179,1303
1793.746,17,87,3648,86,14,21102,14,3612,1,8,0,8,36
1798.339,1,345,28980,345,56,5227,56,28980,0,0,0,0,0
97.352,6,34,5247,14,332,7488,332,3380,20,83,5123,83,1867
0.213,17,8,2758,8,316,30,355,2758,0,0,0,0,0
0.109,17,2,279,1,36,0,36,64,1,187,0,187,215
5.044,17,3,208,2,36,5005,36,128,1,52,0,52,80
1742.421,1,16,896,16,28,116161,28,896,0,0,0,0,0
1750.146,6,95,7203,63,38,28228,205,4476,32,33,56446,98,2727
32.597,6,37,4303,19,304,1810,304,2584,18,83,1842,83,1719
1.488,6,38,8254,19,321,82,1164,2718,19,476,72,2715,5536
0.018,6,6,3285,5,995,3,1368,3245,1,0,0,0,40
937.726,1,17,952,17,28,58607,28,952,0,0,0,0,0
7.649,6,76,23353,37,570,212,1152,18025,39,418,194,1152,5328
1.394,17,18,5612,7,309,232,1350,2359,11,267,78,1350,3253
0.329,6,27,9071,13,252,27,647,1716,14,945,24,1408,7355
1790.295,6,414,24888,208,69,8648,69,12460,206,35,8733,69,12428
0.419,6,10,968,5,256,100,256,460,5,304,100,304,508
13.421,6,90,28187,44,574,312,1152,21865,46,407,291,1152,6322
7.117,6,1702,1524530,1043,1381,6,1408,1485598,659,931,10,2816,38932
0.04,17,4,368,2,32,39,32,120,2,96,4,96,248
60.478,6,15,12784,3,92,148,92,256,12,1322,5481,1448,12528
156.444,6,30,7432,13,158,13037,267,1317,17,543,9775,1400,6115
0.478,6,51,21360,28,1003,17,1380,16198,23,421,19,2760,5162
1771.0,6,101,9344,66,65,27246,65,5577,35,59,52085,59,3767
1797.82,6,362,22898,210,69,8602,69,12678,152,69,11906,69,10220
370.908,6,18,1242,14,180,28531,180,916,4,110,20070,110,326
165.683,6,27,6494,11,220,6307,516,1326,16,348,11038,1452,5168
6.112,6,14,1247,7,222,1013,222,728,7,231,1015,231,519
1.929,17,2,784,2,364,1929,364,784,0,0,0,0,0
1.909,6,30,8971,18,286,112,591,1583,12,986,152,1420,7388
1.648,6,11,1271,6,283,296,283,886,5,105,368,105,385
1796.983,17,448,39896,403,35,4470,288,25676,45,288,40022,288,14220
1.387,6,25,8056,12,164,107,267,1288,13,869,94,1448,6768
1.532,6,15,2237,8,324,218,585,1073,7,396,231,580,1164
1796.389,17,538,46800,410,36,4392,288,26360,128,131,13938,288,20440
0.022,17,2,188,1,37,0,37,65,1,95,0,95,123
1797.548,17,180,14040,180,50,10042,50,14040,0,0,0,0,0
22.844,17,33,11082,17,477,1425,1350,8589,16,127,1520,1350,2493
300.143,17,6,2016,6,308,60028,308,2016,0,0,0,0,0
240.323,6,48,10251,24,197,10446,751,2649,24,528,10447,1368,7602
152.599,6,96,23069,46,385,3391,1360,13055,50,333,3111,1360,10014
1792.947,6,381,24210,218,69,8262,69,13481,163,69,11067,69,10729
0.81,6,27,5927,13,156,67,267,1462,14,650,57,1420,4465
26.169,6,27,7177,13,155,2180,267,1306,14,530,2012,3417,5871
1786.669,6,360,24694,210,94,8548,469,14347,150,69,11990,69,10347
1796.837,1,345,28980,345,56,5223,56,28980,0,0,0,0,0
0.165,6,7,423,4,43,15,43,259,3,0,73,0,164
927.98,17,5,1640,5,300,231995,300,1640,0,0,0,0,0
0.335,17,4,624,2,64,207,64,184,2,192,209,192,440
0.475,6,10,968,5,256,110,256,460,5,304,104,304,508
145.464,17,60,15540,60,231,2465,388,15540,0,0,0,0,0
4.017,17,8,616,4,33,1333,33,244,4,65,1333,65,372
280.285,6,29,7392,13,158,23357,267,1317,16,603,18682,2800,6075
134.863,6,79,24360,36,557,416,1152,16485,43,410,3202,1179,7875
0.009,6,2,84,1,0,0,0,44,1,0,0,0,40
3.712,6,35,6209,17,206,232,314,2744,18,456,204,1152,3465
0.518,17,3,543,2,39,474,39,134,1,381,0,381,409
19.089,6,2552,2367293,1574,1420,12,1448,2307785,978,776,19,1448,59508
372.327,6,23,1535,16,177,24821,177,1053,7,110,10394,110,482
1792.408,6,372,23574,214,69,8415,69,13114,158,69,11416,69,10460
1795.067,1,58,4872,58,56,31492,56,4872,0,0,0,0,0
0.477,6,76,79971,51,217,9,256,4001,25,3246,19,9856,75970
1771.28,6,101,9344,66,65,27250,65,5577,35,59,52094,59,3767
280.216,6,28,7352,13,158,23351,267,1317,15,678,20012,2045,6035
1741.13,6,87,6322,58,31,30546,31,3915,29,31,62182,31,2407
11.717,6,1850,1618901,1122,1387,10,1420,1585560,728,526,16,3303,33341
959.031,6,64,4597,39,31,25237,31,2641,25,31,39958,31,1956
1775.039,6,181,15589,120,69,14916,69,8940,61,69,29578,69,6649
1740.403,17,30,31680,30,1028,60013,1028,31680,0,0,0,0,0
1792.444,17,142,11360,71,48,25606,48,5396,71,56,25606,56,5964
0.127,6,32,8025,17,289,7,517,1881,15,502,8,1420,6144
0.24,17,11,4625,5,432,60,1350,2300,6,359,33,1350,2325
0.049,17,4,368,2,32,48,32,120,2,96,8,96,248
0.093,17,4,284,2,32,48,32,120,2,54,46,60,164
1799.745,1,282,29892,282,78,6404,78,29892,0,0,0,0,0
0.165,17,2,279,1,36,0,36,64,1,187,0,187,215
240.182,6,59,18067,33,751,7505,1408,15260,26,160,9607,580,2807
17.962,6,2874,2802499,1937,1372,9,1408,2749111,937,776,19,1408,53388
117.881,17,4,304,4,48,39293,48,304,0,0,0,0,0
77.17,6,29526,24411434,13347,329,5,338,729528,16179,1412,4,4224,23681906
1772.774,6,180,15480,120,69,14897,69,8940,60,69,30040,69,6540
240.196,6,53,18058,28,803,8896,1408,15124,25,203,10008,580,2934
0.021,17,2,308,1,34,0,34,62,1,218,0,218,246
882.17,2,6,192,6,8,176434,8,192,0,0,0,0,0
1.429,6,49,18241,28,878,52,1460,12580,21,400,62,1460,5661
1787.005,6,107,8691,71,65,25528,65,5245,36,59,51053,59,3446
0.195,17,4,420,2,33,0,33,122,2,121,0,145,298
299.15,1,4,326,4,53,99716,78,326,0,0,0,0,0
8.364,6,67,35679,34,722,253,1408,6116,33,1210,261,1408,29563
1709.161,1,8,448,8,28,244165,28,448,0,0,0,0,0
365.79,6,18,1242,14,180,28137,180,916,4,110,20058,110,326
280.4,6,30,7432,13,158,23366,267,1317,17,543,17518,1400,6115
11.685,6,14,2186,9,325,1460,586,1126,5,396,2892,580,1060
0.682,6,27,7296,13,155,56,267,1301,14,603,43,2036,5995
0.95,6,27,8120,14,266,60,540,1924,13,944,64,1591,6196
0.896,6,11,1727,7,100,149,100,384,4,589,212,1152,1343
0.265,17,2,588,1,39,0,39,67,1,493,0,493,521
1788.357,1,148,8288,148,28,12165,28,8288,0,0,0,0,0
36.666,17,22,1936,11,48,3660,48,836,11,72,3659,72,1100
0.912,6,23,6488,13,326,75,968,2154,10,982,100,1731,4334
840.659,17,8,2196,4,30,280216,30,232,4,463,280216,463,1964
1772.672,6,180,15480,120,69,14896,69,8940,60,69,30040,69,6540
0.192,6,22,6633,10,181,16,267,1128,12,717,16,2036,5505
1795.374,17,80,3354,79,14,23017,14,3318,1,8,0,8,36
0.343,17,2,184,1,32,0,32,60,1,96,0,96,124
176.551,17,4,240,2,32,176550,32,120,2,32,176550,32,120
3.006,17,3,264,3,60,1503,60,264,0,0,0,0,0
1799.997,6,120,10091,74,66,24653,722,6385,46,35,39990,98,3706
300.806,6,50,10526,25,433,12533,910,3258,25,312,539,1460,7268
13.114,6,100,31878,51,570,262,1152,25420,49,449,267,1179,6458
1747.633,6,95,7203,63,38,28187,205,4476,32,33,56362,98,2727
2.682,17,55,41358,22,341,127,1350,8136,33,978,60,1350,33222
244.612,1,8,448,8,28,34944,28,448,0,0,0,0,0
1720.707,17,13,534,11,14,172052,14,462,2,8,1720519,8,72
118.914,17,4,240,2,32,118913,32,120,2,32,118912,32,120
1.16,17,2,166,1,39,0,39,67,1,71,0,71,99
0.579,17,2,152,1,48,0,48,76,1,48,0,48,76
0.206,6,27,7296,13,155,17,267,1301,14,603,14,1400,5995
87.623,17,4,352,2,60,87622,60,176,2,60,87622,60,176
11.52,17,4,304,4,48,3840,48,304,0,0,0,0,0
280.043,6,28,7352,13,158,23336,267,1317,15,678,19999,4200,6035
85.708,1,4,224,4,28,28569,28,224,0,0,0,0,0
174.422,6,1597,788993,862,850,202,1152,752383,735,379,237,1152,36610
4.589,6,7,400,3,0,2294,0,160,4,0,1032,0,240
16.513,17,4,352,2,48,16503,48,152,2,72,16499,72,200
0.093,17,2,279,1,36,0,36,64,1,187,0,187,215
229.406,17,4,352,2,60,229405,60,176,2,60,229405,60,176
99.735,6,21,7464,12,127,9066,127,754,9,1056,12457,1704,6710
7.401,1,13,1352,0,0,0,0,0,13,76,616,76,1352
0.126,17,2,390,1,46,0,46,74,1,288,0,288,316
0.001,6,3,120,2,0,1,0,80,1,0,0,0,40
59.714,17,4,304,4,48,19904,48,304,0,0,0,0,0
1620.662,1,8,448,8,28,231523,28,448,0,0,0,0,0
1795.322,17,80,3354,79,14,23016,14,3318,1,8,0,8,36
1.581,6,10,773,5,0,395,0,272,5,217,56,217,501
1791.634,6,371,23465,213,69,8451,69,13005,158,69,11411,69,10460
70.877,1,2,120,2,32,70877,32,120,0,0,0,0,0
60.072,2,2,64,2,8,60072,8,64,0,0,0,0,0
1798.914,17,87,3648,86,14,21163,14,3612,1,8,0,8,36
0.474,17,2,384,1,39,0,39,67,1,289,0,289,317
1750.764,6,95,7203,63,38,28238,205,4476,32,33,56463,98,2727
0.936,6,24,6416,13,299,78,838,2019,11,790,92,1420,4397
33.663,6,33,5207,16,154,2244,721,1911,17,301,2091,1368,3296
0.127,17,2,390,1,46,0,46,74,1,288,0,288,316
241.805,6,49,10825,24,470,10506,1418,5500,25,441,10031,1418,5325
1794.03,6,365,23018,211,69,8543,69,12787,154,69,11685,69,10231
4.88,17,4,3964,4,963,1626,1451,3964,0,0,0,0,0
48.23,6,8,596,2,69,2710,69,149,6,69,9642,69,447
1679.591,6,115,13996,75,86,22697,498,6100,40,165,43064,1420,7896
0.059,17,4,336,2,34,1,34,124,2,78,0,84,212
46.259,17,8,704,4,48,15417,48,304,4,72,15416,72,400
45.095,6,27,7177,13,155,3757,267,1306,14,530,3468,3417,5871
0.485,1,2,112,2,28,485,28,112,0,0,0,0,0
0.26,6,25,6032,12,164,23,453,1442,13,651,20,1408,4590
1800.0,6,224,19147,83,75,21585,301,8495,141,69,12857,1062,10652
384.993,6,18,1242,14,180,29614,180,916,4,110,20065,110,326
47.529,17,4,240,2,32,47528,32,120,2,32,47528,32,120
0.242,6,27,6160,14,164,18,453,1570,13,651,19,2194,4590
300.84,6,38,9598,21,540,15042,1360,4116,17,435,541,2667,5482
1787.161,6,103,8336,68,65,26674,65,4930,35,59,52560,59,3406
2.31,6,13,2311,8,188,330,245,700,5,1407,515,1407,1611
18.354,17,24,16565,11,521,1832,1350,6049,13,780,1526,1350,10516
197.903,6,27,7312,13,158,16491,267,1317,14,775,15220,2800,5995
0.074,17,2,198,1,37,0,37,65,1,105,0,105,133
1.675,6,47,19032,25,949,69,1460,13376,22,433,68,1460,5656
137.728,6,29,13828,17,486,52,1360,2669,12,1523,12507,3928,11159
2.199,17,21,6683,8,329,314,1350,2859,13,266,135,1350,3824
7.081,6,1154,991313,679,1378,10,1408,961949,475,776,14,1408,29364
0.04,17,2,251,1,36,0,36,64,1,159,0,159,187
2.705,6,32,6233,17,138,169,267,1657,15,567,170,1420,4576
1745.631,6,92,6985,61,38,29093,205,4341,31,33,58178,98,2644
1790.135,6,387,30107,227,122,7920,693,17154,160,91,11258,725,12953
1.807,6,15,3877,8,171,257,171,603,7,964,296,1448,3274
1787.411,6,104,8504,69,66,26285,66,5004,35,60,52567,60,3500
0.367,6,27,8984,13,234,30,575,1620,14,828,26,1438,7364
1738.346,1,42,2352,42,28,42398,28,2352,0,0,0,0,0
1.445,2,2,64,2,8,1445,8,64,0,0,0,0,0
0.78,17,6,660,3,78,390,84,320,3,85,221,104,340
1781.511,17,142,11360,71,48,25450,48,5396,71,56,25450,56,5964
300.526,6,11,866,6,180,60072,180,500,5,110,75090,110,366
1798.85,17,346,26296,346,48,5214,48,26296,0,0,0,0,0
1793.958,6,117,15317,72,81,25267,501,5830,45,187,40769,1420,9487
1790.432,6,244,35804,152,302,11857,302,26032,92,83,19675,83,9772
1741.387,1,65,5460,65,56,27209,56,5460,0,0,0,0,0
1787.805,6,102,8296,68,65,26683,65,4930,34,59,54173,59,3366
1796.663,6,369,28079,182,216,9925,515,11338,187,38,9655,76,16741
300.886,6,45,13888,25,899,12536,1440,8241,20,371,456,1440,5647
4.449,6,34,6185,18,206,261,314,2784,16,551,279,1179,3401
1786.535,6,104,8376,68,65,26664,65,4930,36,59,51041,59,3446
84.599,17,4,240,2,32,84598,32,120,2,32,84598,32,120
0.013,17,4,1123,2,33,0,33,122,2,472,1,507,1001
1787.36,6,102,8228,68,64,26677,64,4896,34,58,54158,58,3332
280.835,6,29,7392,13,158,23402,267,1317,16,603,18711,2036,6075
11.859,17,16,2352,8,48,1692,48,608,8,190,1692,308,1744
0.3,17,2,167,1,39,0,39,67,1,72,0,72,100
0.796,6,11,1727,7,100,132,100,384,4,589,179,1152,1343
1779.054,6,368,30887,203,90,8807,1093,14208,165,132,10847,1420,16679
1.006,6,10,1687,7,100,167,100,384,3,1179,366,1179,1303
1.612,6,49,19507,29,903,57,1360,13886,20,437,74,2715,5621
300.998,6,34,16422,17,195,18812,431,1672,17,989,8987,2736,14750
60.126,2,2,64,2,8,60126,8,64,0,0,0,0,0
1796.934,1,342,28728,342,56,5269,56,28728,0,0,0,0,0
1606.347,1,8,448,8,28,229478,28,448,0,0,0,0,0
1780.891,6,370,23494,213,69,8400,69,13074,157,69,11415,69,10420
1701.516,2,24,768,24,8,73978,8,768,0,0,0,0,0
1787.859,6,4243,3892116,1584,129,1129,353,99369,2659,1414,672,4254,3792747
9.077,6,16,3672,9,150,1134,174,664,7,681,1489,1420,3008
0.74,6,24,5755,13,158,60,370,1315,11,799,73,1420,4440
0.03,6,9,1348,5,145,7,145,349,4,835,7,835,999
1762.039,6,100,7729,66,42,27108,205,4786,34,34,53385,98,2943
1.377,6,10,1687,7,100,229,100,384,3,1179,559,1179,1303
1795.674,6,379,32402,211,108,8550,1460,15817,168,128,10752,1917,16585
1791.203,17,142,11360,71,48,25587,48,5396,71,56,25587,56,5964
18.291,6,16,6151,4,189,6026,267,547,12,639,1661,1452,5604
83.715,6,71,48920,45,1202,1902,1408,40833,26,961,2463,3847,8087
16.974,17,22,5843,11,278,1694,1350,3366,11,197,1694,1350,2477
0.889,6,11,1727,7,100,148,100,384,4,589,211,1152,1343
10.769,6,20,4442,11,275,1076,275,998,9,768,749,1440,3444
0.006,6,4,224,2,0,3,0,112,2,0,4,0,112
262.195,17,14,4704,14,308,20168,308,4704,0,0,0,0,0
240.279,6,43,8646,21,519,12013,1402,5775,22,191,11441,619,2871
1744.607,2,21,672,21,8,87230,8,672,0,0,0,0,0
0.369,6,22,7255,13,318,30,600,1958,9,964,43,1471,5297
7.175,2,2,64,2,8,7175,8,64,0,0,0,0,0
5.127,17,3,3213,3,1043,2563,1043,3213,0,0,0,0,0
504.438,2,4,128,4,8,168146,8,128,0,0,0,0,0
9.884,6,93,30601,48,588,210,1152,24303,45,449,218,1179,6298
5.749,6,46,8449,24,227,249,314,4142,22,427,261,1152,4307
35.189,6,21,2657,11,211,3505,211,1034,10,545,3905,904,1623
0.416,6,9,1340,5,145,104,145,349,4,827,92,827,991
63.826,6,14,1067,7,177,10637,177,585,7,110,10383,110,482
0.053,6,14,5885,7,186,8,267,661,7,1234,8,3417,5224
1680.602,17,28,6580,28,207,62244,207,6580,0,0,0,0,0
131.162,17,4,240,2,32,131161,32,120,2,32,131161,32,120
6.949,6,52,10862,27,347,267,727,3927,25,370,269,1360,6935
23.018,17,31,8110,14,292,1768,1350,4487,17,185,1436,1350,3623
1744.667,2,18,576,18,8,102627,8,576,0,0,0,0,0
62.169,17,4,240,2,32,62168,32,120,2,32,62168,32,120
1746.551,6,106,8209,67,45,26462,205,4954,39,35,45952,98,3255
1741.329,17,29,30624,29,1028,62190,1028,30624,0,0,0,0,0
1784.442,6,115,9123,73,65,24783,65,5260,42,59,43520,59,3863
3.02,17,3,468,3,128,1510,128,468,0,0,0,0,0
24.196,6,55,37755,34,1204,733,1360,29099,21,1114,1201,3620,8656
1783.673,17,83,3480,82,14,22020,14,3444,1,8,0,8,36
0.008,6,4,208,2,0,4,0,104,2,0,8,0,104
299.524,6,6,364,4,31,99841,31,222,2,31,299514,31,142
315.939,6,60,12251,28,226,11701,1305,3708,32,302,9984,1629,8543
0.115,17,2,788,2,366,115,366,788,0,0,0,0,0
0.147,1,2,163,2,53,147,78,163,0,0,0,0,0
1797.375,17,448,39896,403,35,4471,288,25676,45,288,40017,288,14220
0.009,17,2,166,1,39,0,39,67,1,71,0,71,99
43.084,6,36,9244,15,294,99,1189,2672,21,477,2153,1917,6572
240.217,6,54,15051,27,699,9239,1408,11922,27,190,9238,580,3129
7.598,6,1391,1266514,848,1414,8,1448,1233590,543,776,13,1448,32924
0.297,17,2,602,1,46,0,46,74,1,500,0,500,528
3.799,6,25,8056,12,164,325,267,1288,13,869,298,1368,6768
198.732,17,4,352,2,60,198731,60,176,2,60,198731,60,176
0.139,17,2,586,1,46,0,46,74,1,484,0,484,512
16.539,6,22,4547,11,211,1637,722,1636,11,778,1637,1408,2911
8.265,17,3,4112,3,1342,4132,1346,4112,0,0,0,0,0
118.598,6,24,10043,12,653,74,1360,3126,12,1070,10766,2720,6917
1.623,6,132,81780,71,1310,23,1432,71093,61,540,24,2218,10687
0.203,6,26,7256,13,155,16,267,1301,13,678,15,2045,5955
1744.687,6,93,7037,60,38,29570,205,4289,33,33,54508,98,2748
0.091,17,2,136,1,32,0,32,60,1,48,0,48,76
27.407,17,3,228,3,48,13703,48,228,0,0,0,0,0
3.844,17,27,17385,12,507,349,1350,6422,15,702,272,1350,10963
133.201,6,16,1991,9,302,16650,302,1370,7,83,22197,83,621
16.087,17,24,6465,11,295,1602,1350,3555,13,195,1333,1350,2910
280.21,6,29,7392,14,158,21554,267,1357,15,678,20011,2800,6035
1799.466,6,131,8627,75,54,24317,208,5457,56,31,32705,31,3170
4.871,6,39,7269,20,218,256,314,3423,19,440,256,1152,3846
81.196,17,10,3360,10,308,9021,308,3360,0,0,0,0,0
1.276,6,2,88,2,0,0,0,88,0,0,0,0,0
300.776,6,44,9835,21,531,15038,1360,4082,23,401,748,2667,5753
128.849,6,27,7127,14,275,9911,275,1118,13,684,10702,1414,6009
0.237,6,24,5937,12,164,21,453,1442,12,772,20,2181,4495
1750.494,6,98,7359,62,38,28696,205,4424,36,33,50006,98,2935
1777.501,6,183,15807,120,69,14936,69,8940,63,69,28666,69,6867
242.503,6,32,8952,14,158,18654,267,1357,18,624,14263,1400,7595
82.365,6,24,980,11,0,5552,0,448,13,0,6860,0,532
0.772,6,389,632423,196,194,3,230,10979,193,3201,3,9814,621444
0.08,17,2,367,1,33,0,33,61,1,278,0,278,306
1751.964,6,110,8267,68,38,26148,205,4829,42,32,42720,98,3438
26.548,6,42,9571,19,371,509,797,2025,23,440,1199,2128,7546
1799.997,6,368,25690,214,99,8450,469,15114,154,69,11699,69,10576
165.687,17,4,352,2,60,165686,60,176,2,60,165686,60,176
0.319,6,26,9013,13,257,26,669,1714,13,945,25,1402,7299
1787.456,6,102,8364,68,66,26678,66,4964,34,60,54161,60,3400
1772.412,6,180,15480,120,69,14894,69,8940,60,69,30040,69,6540
1799.443,6,127,8051,73,47,24992,208,4961,54,31,33944,31,3090
1799.59,6,122,12428,76,67,23994,722,6521,46,94,39982,1408,5907
0.065,17,2,184,1,32,0,32,60,1,96,0,96,124
1787.904,6,371,26279,214,104,8393,469,15583,157,69,11460,69,10696
1798.513,17,290,67217,290,203,6223,422,67217,0,0,0,0,0
0.014,17,2,656,1,300,0,300,328,1,300,0,300,328
1788.518,17,87,3648,86,14,21041,14,3612,1,8,0,8,36
39.062,17,22,1672,22,48,1860,48,1672,0,0,0,0,0
0.6,17,12,7779,7,802,99,1350,5813,5,365,131,1350,1966
1799.53,17,766,46262,766,32,2352,37,46262,0,0,0,0,0
3.908,6,33,6129,17,206,244,314,2744,16,548,242,1179,3385
0.053,17,2,178,1,53,0,53,81,1,69,0,69,97
1772.698,6,180,15480,120,69,14896,69,8940,60,69,30043,69,6540
62.041,6,75,53903,48,1201,1320,1368,45762,27,747,2376,1368,8141
1777.279,17,73,3060,72,14,25032,14,3024,1,8,0,8,36
2.536,6,31,6255,16,338,169,1314,2334,15,331,180,1420,3921
1740.62,17,30,31680,30,1028,60021,1028,31680,0,0,0,0,0
1771.944,6,99,9306,66,66,27260,66,5610,33,60,55370,60,3696
0.054,17,2,157,1,31,0,31,59,1,70,0,70,98
1798.492,6,368,25690,215,99,8404,469,15085,153,69,11830,69,10605
0.642,6,14,1745,7,288,78,288,600,7,426,76,434,1145
0.086,6,10,1514,5,503,21,503,771,5,475,21,475,743
1772.102,6,180,15480,120,69,14891,69,8940,60,69,30034,69,6540
0.298,6,2,126,1,0,0,0,40,1,46,0,46,86
14.047,17,4,824,2,48,14031,48,152,2,308,14031,308,672
0.072,17,2,157,1,31,0,31,59,1,70,0,70,98
1795.584,17,447,39580,403,35,4466,288,25676,44,288,40016,288,13904
1040.072,17,105,6720,105,36,10000,36,6720,0,0,0,0,0
2.341,6,112,87504,51,131,46,232,2569,61,1473,34,2860,84935
0.853,6,10,861,5,222,210,222,426,5,231,210,231,435
293.213,17,4,352,2,60,293212,60,176,2,60,293212,60,176
1.972,17,2,255,1,43,0,43,71,1,156,0,156,184
0.87,17,4,1116,2,32,865,32,120,2,470,135,470,996
1012.024,17,194,14744,194,48,5243,48,14744,0,0,0,0,0
1797.157,1,345,28980,345,56,5224,56,28980,0,0,0,0,0
280.259,6,30,7773,14,158,21558,267,1357,16,641,18682,2045,6416
280.52,6,29,7392,13,158,23376,267,1317,16,603,18694,2760,6075
133.812,1,40,3360,40,56,3431,56,3360,0,0,0,0,0
1.405,6,25,8056,12,164,111,267,1288,13,869,102,1440,6768
1744.726,2,21,672,21,8,87236,8,672,0,0,0,0,0
75.26,6,14,3143,5,92,18815,92,348,9,387,9369,1408,2795
0.473,6,22,5960,11,265,45,517,1642,11,747,45,1448,4318
1738.658,6,87,6322,58,31,30502,31,3915,29,31,62094,31,2407
240.224,6,51,14355,27,628,9238,1418,11467,24,204,10443,580,2888
280.521,6,27,7312,13,158,23376,267,1317,14,678,21574,2085,5995
0.114,6,3,253,2,51,114,51,131,1,82,0,82,122
1795.102,17,80,3354,79,14,23014,14,3318,1,8,0,8,36
11.17,6,27,11373,13,275,930,275,1078,14,1080,785,1420,10295
126.611,17,20,2940,10,48,14066,48,760,10,190,14066,308,2180
212.013,17,6,525,3,32,105988,37,181,3,86,105980,136,344
0.182,6,7,423,4,43,34,43,259,3,0,43,0,164
1.568,6,49,20240,28,898,58,1360,14624,21,476,69,2715,5616
4.46,6,34,6169,18,206,262,314,2784,16,456,280,1152,3385
22.084,6,9,520,3,0,11042,0,160,6,0,3247,0,360
5.571,6,40,7325,22,218,265,314,3503,18,516,304,1179,3822
685.999,17,8,2089,4,31,228661,37,239,4,434,228663,463,1850
0.298,17,2,183,1,26,0,26,54,1,101,0,101,129
9.17,17,8,1684,4,47,3052,47,300,4,318,3052,318,1384
0.031,1,2,112,2,28,31,28,112,0,0,0,0,0
0.512,17,3,543,2,39,333,39,134,1,381,0,381,409
380.56,6,14,812,9,106,47568,106,580,5,0,95137,0,232
0.431,17,4,377,2,33,416,37,123,2,99,416,136,254
0.556,6,21,7627,12,279,50,766,1760,9,898,56,1440,5867
1772.35,6,180,15480,120,69,14893,69,8940,60,69,30034,69,6540
1776.174,17,73,3060,72,14,25016,14,3024,1,8,0,8,36
5.035,17,3,208,2,36,5014,36,128,1,52,0,52,80
0.0,17,1,311,1,283,0,283,311,0,0,0,0,0
5.017,17,4,716,2,32,5004,32,120,2,270,5008,270,596
18.396,6,30,5053,15,154,1314,721,1870,15,399,1300,2026,3183
1792.229,17,142,11360,71,48,25600,48,5396,71,56,25602,56,5964
1798.172,17,142,11360,71,48,25688,48,5396,71,56,25688,56,5964
0.039,17,2,904,1,300,0,300,328,1,548,0,548,576
280.229,6,30,7432,13,158,23352,267,1317,17,543,17511,1400,6115
124.018,6,35,7837,13,155,27,267,1306,22,331,5905,1420,6531
46.526,6,8,460,2,0,46526,0,100,6,0,6174,0,360
277.425,1,22,2332,22,78,13210,78,2332,0,0,0,0,0
129.114,17,4,352,2,60,129113,60,176,2,60,129113,60,176
15.146,6,57,39705,34,262,458,265,2300,23,1905,687,2876,37405
0.857,17,8,2934,8,338,122,361,2934,0,0,0,0,0
1762.494,17,347,95224,347,246,5093,422,95224,0,0,0,0,0
1794.788,1,261,14616,261,28,6903,28,14616,0,0,0,0,0
1792.173,17,180,14040,180,50,10012,50,14040,0,0,0,0,0
68.439,17,4,352,2,48,68428,48,152,2,72,68428,72,200
0.179,6,27,7296,13,155,14,267,1301,14,603,12,2036,5995
1771.769,6,99,9240,66,65,27257,65,5577,33,59,55365,59,3663
0.241,6,3,582,2,219,1,233,542,1,0,0,0,40
3.738,6,11,2883,6,100,747,100,344,5,1165,868,1179,2539
4.005,6,12,500,6,0,801,0,248,6,0,723,0,252
385.966,6,79,16429,37,178,10721,721,5051,42,484,9359,1440,11378
560.553,17,8,673,4,31,186845,37,239,4,80,186846,136,434
7.202,6,506,451486,329,1309,21,1368,437618,177,931,39,2736,13868
251.586,2,6,192,6,8,50317,8,192,0,0,0,0,0
1741.451,6,87,6322,58,31,30551,31,3915,29,31,62194,31,2407
1.285,6,32,6507,16,164,85,267,1962,16,650,75,1452,4545
4.907,6,2,92,1,0,0,0,40,1,0,0,0,52
1.768,17,23,6181,10,260,196,1350,2884,13,225,65,1350,3297
16.777,6,7,380,4,0,5592,0,216,3,0,8379,0,164
35.988,17,20,1760,10,48,3997,48,760,10,72,3997,72,1000
4.245,6,16,2431,8,188,606,245,700,8,703,568,1152,1731
240.229,6,53,17897,28,808,8896,1418,15207,25,172,10009,580,2690
1786.639,6,102,8364,68,66,26666,66,4964,34,60,54137,60,3400
8.663,6,84,26637,42,569,211,1152,20475,42,407,205,1152,6162
138.972,6,25,9903,12,410,57,922,1742,13,847,11569,1360,8161
20.353,6,23,5534,13,107,1696,159,1126,10,967,2252,1709,4408
1.138,6,24,8028,12,164,87,267,1312,12,1014,87,2411,6716
20.322,6,24,6232,14,117,1563,159,1337,10,727,2254,1418,4895
8.899,6,78,24890,40,568,228,1152,19229,38,459,233,1179,5661
1767.527,6,104,8161,69,44,25993,205,5114,35,35,51953,98,3047
1.587,17,17,9513,9,746,198,1350,6966,8,290,207,1350,2547
9.821,6,1701,1637706,1130,1375,8,1408,1603350,571,776,16,1408,34356
1736.65,1,56,4704,56,56,31575,56,4704,0,0,0,0,0
0.5,17,2,476,1,39,0,39,67,1,381,0,381,409
7.479,6,1739,1447950,946,1433,7,1448,1395006,793,776,9,1448,52944
0.776,17,4,377,2,33,762,37,123,2,99,758,136,254
0.241,17,7,2438,7,320,40,354,2438,0,0,0,0,0
25.08,6,3495,3278814,2198,1411,11,1448,3206670,1297,776,19,1448,72144
0.068,17,2,144,1,36,0,36,64,1,52,0,52,80
1.666,6,13,2311,8,188,238,245,700,5,1407,352,1407,1611
1777.041,6,242,24932,96,67,18703,659,9174,146,135,12254,1938,15758
3.98,17,4,232,4,30,1326,30,232,0,0,0,0,0
1741.523,17,29,30566,29,1026,62197,1026,30566,0,0,0,0,0
7.627,6,12,5525,3,106,3806,106,234,9,985,951,1440,5291
3.409,6,2,88,2,0,0,0,88,0,0,0,0,0
141.719,17,4,240,2,32,141718,32,120,2,32,141718,32,120
0.122,17,2,572,1,39,0,39,67,1,477,0,477,505
1780.941,17,138,11040,69,48,26190,48,5244,69,56,26190,56,5796
19.902,17,28,6400,14,256,1528,1350,3982,14,144,1528,1350,2418
35.63,6,27,7177,13,155,2969,267,1306,14,530,2740,3417,5871
2.883,6,40,8391,21,321,144,1164,2810,19,437,150,2715,5581
0.011,17,3,342,2,31,2,31,118,1,196,0,196,224
240.171,6,54,18092,29,805,8577,1408,15207,25,197,10006,580,2885
0.617,17,2,152,1,48,0,48,76,1,48,0,48,76
0.077,17,6,912,3,60,13,60,264,3,188,15,188,648
0.296,17,2,152,1,48,0,48,76,1,48,0,48,76
42.196,17,4,240,2,32,42195,32,120,2,32,42195,32,120
0.927,6,23,6568,13,344,76,1061,2248,10,979,102,1731,4320
11.607,6,1843,1601380,1111,1386,10,1420,1567867,732,526,15,3303,33513
1.99,17,3,174,3,30,995,30,174,0,0,0,0,0
1740.471,17,30,20190,30,645,60016,645,20190,0,0,0,0,0
1751.113,17,90,30064,90,306,19675,308,30064,0,0,0,0,0
316.987,6,70,19100,36,354,9056,1360,9621,34,386,9601,3289,9479
0.816,6,26,9017,13,257,68,669,1714,13,945,59,1438,7303
300.562,6,18,1275,9,177,37548,177,701,9,110,37548,110,574
0.015,6,6,897,3,483,4,483,639,3,102,4,102,258
2.546,17,2,384,1,39,0,39,67,1,289,0,289,317
28.169,6,1980,1764409,1232,1375,22,1380,1726671,748,421,37,1923,37738
1.32,6,25,8056,12,164,102,267,1288,13,869,94,1408,6768
60.558,6,30,7297,14,155,4658,267,1346,16,441,4036,1420,5951
1744.381,6,95,7203,63,38,28135,205,4476,32,33,56263,98,2727
0.417,6,13,1693,7,288,65,288,588,6,426,45,434,1105
3.713,6,2,88,2,0,0,0,88,0,0,0,0,0
1754.465,1,8,448,8,28,250637,28,448,0,0,0,0,0
1774.687,6,180,15480,120,69,14913,69,8940,60,69,30076,69,6540
23.754,6,104,30880,49,566,494,1152,23500,55,431,434,1179,7380
1791.275,17,142,11360,71,48,25589,48,5396,71,56,25589,56,5964
5.408,6,38,7229,19,218,300,314,3383,19,513,286,1179,3846
1783.252,17,83,3480,82,14,22015,14,3444,1,8,0,8,36
30.07,6,40,9595,20,299,1582,722,3207,20,697,1559,2760,6388
1799.415,6,200,21106,105,105,17302,721,10660,95,144,19140,1420,10446
60.135,2,2,64,2,8,60135,8,64,0,0,0,0,0
281.267,6,34,8002,16,143,18751,267,1506,18,524,16544,1400,6496
25.401,6,46,12914,22,199,1209,721,2478,24,676,1095,1440,10436
1.352,6,28,9126,13,214,112,585,1756,15,938,91,1438,7370
248.259,1,2,112,2,28,248259,28,112,0,0,0,0,0
1.501,6,25,9260,14,350,115,1042,1993,11,1135,110,2920,7267
254.604,17,9,684,9,48,31825,48,684,0,0,0,0,0
0.112,17,2,184,1,32,0,32,60,1,96,0,96,124
1772.145,6,180,15480,120,69,14891,69,8940,60,69,30032,69,6540
1795.314,6,378,28780,220,126,8197,469,17630,158,69,11432,69,11150
1.161,6,53,17038,33,351,36,1360,9085,20,793,54,4649,7953
29.602,6,41,9602,21,299,1480,721,3245,20,693,1547,1420,6357
90.807,6,25,11118,12,433,72,990,1823,13,973,7556,1440,9295
1.292,6,37,8212,19,320,71,1162,2716,18,476,66,2715,5496
0.019,17,2,263,1,36,0,36,64,1,171,0,171,199
0.323,17,2,118,1,31,0,31,59,1,31,0,31,59
1008.132,2,7,224,7,8,168022,8,224,0,0,0,0,0
1787.025,1,58,4872,58,56,31351,56,4872,0,0,0,0,0
1781.762,6,354,22440,207,69,8649,69,12420,147,69,12203,69,10020
5.108,17,28,10219,12,456,464,1350,5813,16,247,242,1350,4406
1681.407,6,334,21088,195,69,8667,69,11664,139,69,12184,69,9424
69.567,6,26,7206,12,155,6324,267,1266,14,537,5350,3426,5940
1.627,6,11,975,6,304,325,304,624,5,83,403,83,351
950.95,1,32,2688,32,56,30675,56,2688,0,0,0,0,0
171.207,6,19,7136,10,203,113,299,1029,9,1147,21377,2720,6107
0.164,6,26,7256,13,155,13,267,1301,13,678,13,2800,5955
1770.151,6,319,21988,133,46,13383,46,8982,186,46,9568,46,13006
1796.152,17,446,39548,402,35,4479,288,25644,44,288,40951,288,13904
1789.998,6,368,23276,212,69,8483,69,12896,156,69,11548,69,10380
306.948,6,36,6568,19,286,17052,1314,2485,17,309,19182,2673,4083
299.509,17,4,352,2,60,299508,60,176,2,60,299507,60,176
0.029,6,2,111,1,0,0,0,40,1,31,0,31,71
1690.152,6,189,13080,68,46,25226,46,5480,121,46,14083,46,7600
0.352,6,27,9098,13,261,29,683,1728,14,829,26,1438,7370
0.152,17,2,152,1,48,0,48,76,1,48,0,48,76
0.022,17,2,178,1,47,0,47,75,1,75,0,75,103
1787.694,6,118,13949,76,83,23835,516,6038,42,163,43599,1452,7911
0.575,6,20,7229,13,334,47,663,2021,7,1209,90,1946,5208
97.096,17,4,240,2,32,97095,32,120,2,32,97095,32,120
70.62,6,31,7811,12,174,6420,267,1533,19,393,3914,1420,6278
1795.885,17,142,11360,71,48,25655,48,5396,71,56,25655,56,5964
21.371,6,37,8200,19,311,1187,619,1726,18,441,530,1360,6474
0.826,17,16,6116,7,425,137,1350,3171,9,299,57,1350,2945
1697.678,17,16,1265,8,30,242523,37,471,8,71,242523,136,794
2.586,6,18,3257,10,99,268,182,924,8,477,344,1343,2333
1793.864,17,144,11520,72,48,25265,48,5472,72,56,25265,56,6048
1772.7,6,180,15480,120,69,14896,69,8940,60,69,30042,69,6540
1072.165,1,72,4032,72,28,15100,28,4032,0,0,0,0,0
0.257,6,9,527,5,43,64,43,311,4,0,84,0,216
1744.725,2,17,544,17,8,109045,8,544,0,0,0,0,0
35.085,17,20,1760,10,48,3897,48,760,10,72,3897,72,1000
1.483,6,48,19472,27,910,57,1460,13856,21,433,63,1460,5616
5.786,6,23,7561,12,268,518,517,1450,11,923,570,2447,6111
1744.683,2,14,448,14,8,134206,8,448,0,0,0,0,0
300.958,2,6,192,6,8,60191,8,192,0,0,0,0,0
1792.251,6,240,35580,150,302,12028,302,25920,90,83,20137,83,9660
0.048,6,2,133,1,0,0,0,40,1,53,0,53,93
4.171,6,15,3402,7,49,695,92,459,8,420,559,1408,2943
17.273,17,17,9080,9,745,2154,1350,6960,8,237,2461,1350,2120
44.488,6,43,12054,19,392,139,1189,5086,24,352,1933,1420,6968
180.413,2,4,128,4,8,60137,8,128,0,0,0,0,0
1784.18,6,208,14761,104,73,17320,208,9671,104,31,17320,31,5090
201.005,6,120,87465,74,1260,2753,1408,76952,46,811,2595,3847,10513
31.235,6,7,392,2,0,31230,0,112,5,0,7807,0,280
300.255,6,38,29102,22,190,14297,444,1913,16,2395,16014,5632,27189
1681.528,1,15,840,15,28,120109,28,840,0,0,0,0,0
0.023,17,2,128,1,28,0,28,56,1,44,0,44,72
0.609,6,22,9754,12,410,55,922,1742,10,1085,52,1696,8012
240.864,6,48,9038,24,456,10466,1418,5820,24,240,10469,904,3218
110.466,6,20,10080,11,433,73,990,1771,9,1587,13791,3928,8309
3.878,17,3,1176,3,364,1939,364,1176,0,0,0,0,0
1080.888,17,112,9356,104,30,10494,37,6060,8,384,146022,463,3296
4.035,17,6,5701,2,723,4035,1350,1503,4,1021,863,1350,4198
1680.534,17,12,498,11,14,168035,14,462,1,8,0,8,36
10.475,6,5,293,4,31,3491,31,222,1,31,0,31,71
21.488,17,8,10942,8,1339,3069,1348,10942,0,0,0,0,0
3.208,6,12,507,7,0,534,0,288,5,7,751,7,219
0.01,6,16,5719,9,134,1,134,514,7,1637,1,2920,5205
0.02,6,10,1903,5,657,4,657,925,5,710,4,710,978
1048.422,6,221,16429,123,117,8593,469,9749,98,69,10806,69,6680
73.314,17,10,760,10,48,8146,48,760,0,0,0,0,0
10.977,6,18,5610,10,275,1219,275,958,8,1440,852,1440,4652
2.096,17,59,46734,26,494,82,1350,13597,33,976,64,1350,33137
0.059,17,2,288,1,59,0,59,87,1,173,0,173,201
1772.53,6,180,15480,120,69,14895,69,8940,60,69,30040,69,6540
2.097,6,1900,1871210,1073,215,1,230,59959,827,2143,2,17665,1811251
19.364,17,4,352,2,48,19356,48,152,2,72,19287,72,200
1708.853,1,8,448,8,28,244121,28,448,0,0,0,0,0
6.205,6,1647,1536845,1019,1429,5,1448,1499513,628,776,9,1448,37332
1796.855,6,361,22858,210,69,8597,69,12678,151,69,11978,69,10180
15.139,17,6,4948,6,796,3027,1451,4948,0,0,0,0,0
20.145,6,22,5470,12,107,1831,159,1074,10,773,2237,1402,4396
1.592,6,48,18536,27,843,61,1360,12920,21,433,69,1360,5616
20.342,6,19,2432,10,189,2260,517,1298,9,323,2534,499,1134
72.963,6,80,51266,47,1187,1586,1408,42810,33,748,1924,1408,8456
181.286,17,4,352,2,60,181284,60,176,2,60,181285,60,176
1799.084,6,356,22589,207,69,8733,69,12420,149,69,12155,69,10169
0.499,17,2,152,1,48,0,48,76,1,48,0,48,76
1761.837,6,77,4056,39,26,46362,26,2054,38,26,47615,26,2002
1795.735,17,80,3354,79,14,23022,14,3318,1,8,0,8,36
105.488,6,19,772,9,0,13186,0,364,10,0,11704,0,408
1761.998,6,4458,4425993,1416,155,1245,986,83787,3042,1410,579,2836,4342206
1744.687,6,95,7203,63,38,28140,205,4476,32,33,56271,98,2727
1791.361,1,202,21412,202,78,8912,78,21412,0,0,0,0,0
4.693,17,4,304,4,48,1564,48,304,0,0,0,0,0
0.333,6,20,4960,10,137,37,267,1092,10,692,34,1467,3868
1764.896,2,12,384,12,8,160445,8,384,0,0,0,0,0
0.372,6,3,120,2,0,372,0,80,1,0,0,0,40
1798.874,1,364,37856,0,0,0,0,0,364,76,4955,76,37856
1786.621,6,103,8401,69,65,26273,65,5035,34,59,54136,59,3366
175.641,6,31,13250,15,488,348,1440,3073,16,952,11700,1440,10177
1799.411,6,109,9048,70,70,26078,293,5269,39,63,47352,247,3779
1721.07,17,12,498,11,14,172107,14,462,1,8,0,8,36
1774.663,17,140,11200,70,48,25719,48,5320,70,56,25719,56,5880
1.395,6,23,5715,13,158,115,370,1315,10,999,154,1731,4400
1758.379,1,57,4788,57,56,31399,56,4788,0,0,0,0,0
75.709,6,15,712,6,0,15141,0,280,9,0,4192,0,432
286.78,1,10,560,10,28,31864,28,560,0,0,0,0,0
1003.383,17,194,14744,194,48,5198,48,14744,0,0,0,0,0
1754.516,6,178,25150,95,84,18665,722,8353,83,292,21392,2535,16797
1744.703,6,95,7203,63,38,28140,205,4476,32,33,56271,98,2727
0.775,6,30,7128,17,244,48,656,2394,13,601,51,1420,4734
4.096,17,31,16890,13,402,341,1350,5592,18,599,234,1350,11298
1.392,6,50,19681,27,919,53,1460,13985,23,433,54,1460,5696
6.498,2,3,96,3,8,3249,8,96,0,0,0,0,0
15.696,17,33,13723,17,574,978,1350,10246,16,189,1043,1350,3477
2.947,17,3,1021,2,308,1950,308,672,1,321,0,321,349
298.693,1,4,224,4,28,99564,28,224,0,0,0,0,0
5.89,17,12,1008,6,45,1176,45,438,6,67,1175,73,570
1799.469,17,449,39928,404,35,4465,288,25708,45,288,40014,288,14220
0.242,6,27,6202,13,181,20,537,1578,14,555,17,1542,4624
2.993,17,4,1564,4,363,997,363,1564,0,0,0,0,0
1792.393,6,357,22767,206,69,8743,69,12380,151,69,11946,69,10387
20.582,6,20,2484,10,189,2286,517,1298,10,323,2280,499,1186
4.974,17,28,6640,11,236,497,1350,2908,17,191,198,1350,3732
1.913,6,34,13046,19,525,106,1440,3430,15,818,123,1440,9616
1263.385,2,10,320,10,8,140376,8,320,0,0,0,0,0
17.518,6,1941,1832548,1283,1375,13,1380,1798842,658,383,26,1380,33706
1.644,6,40,8427,21,321,82,1164,2846,19,437,80,2715,5581
240.267,6,59,20989,30,857,8284,1418,17861,29,201,8580,580,3128
1675.134,1,7,392,7,28,279189,28,392,0,0,0,0,0
682.286,6,48,14326,31,369,22742,1360,7179,17,645,42631,3494,7147
7.566,6,39,7610,20,218,398,314,3423,19,489,405,1179,4187
72.907,17,4,240,2,32,72906,32,120,2,32,72906,32,120
1744.295,6,94,7151,62,38,28595,205,4424,32,33,56259,98,2727
1784.391,6,102,8296,68,65,26632,65,4930,34,59,54069,59,3366
252.469,6,45,20426,24,842,10976,1408,9670,21,1072,12623,1706,10756
1790.746,6,359,22709,209,69,8609,69,12569,150,69,12018,69,10140
1793.391,1,58,4872,58,56,31463,56,4872,0,0,0,0,0
67.706,17,4,240,2,32,67705,32,120,2,32,67704,32,120
0.174,17,2,346,1,37,0,37,65,1,253,0,253,281
1134.244,2,9,288,9,8,141780,8,288,0,0,0,0,0
1680.726,1,15,840,15,28,120051,28,840,0,0,0,0,0
0.003,6,2,100,1,0,0,0,60,1,0,0,0,40
299.528,6,6,364,4,31,99842,31,222,2,31,299516,31,142
209.128,6,30,7432,13,158,17427,267,1317,17,543,13068,1400,6115
0.129,17,2,2386,2,1165,129,1165,2386,0,0,0,0,0
1091.732,17,112,9356,104,30,10599,37,6060,8,384,147153,463,3296
1772.193,6,180,15480,120,69,14892,69,8940,60,69,30033,69,6540
43.231,6,37,8495,18,410,511,882,1982,19,441,2393,1360,6513
1785.917,6,102,8296,68,65,26655,65,4930,34,59,54115,59,3366
11.586,6,24,8413,13,275,965,275,1078,11,1147,831,2840,7335
40.573,6,13,536,9,0,5071,0,364,4,0,4005,0,172
1797.368,17,449,39928,404,35,4459,288,25708,45,288,40021,288,14220
0.037,6,2,80,1,0,0,0,40,1,0,0,0,40
0.169,17,2,180,1,30,0,30,58,1,94,0,94,122
97.432,17,4,1313,4,300,32477,301,1313,0,0,0,0,0
1799.048,17,248,79705,248,293,7283,373,79705,0,0,0,0,0
73.536,6,35,16544,21,919,3676,1360,8248,14,965,5642,4445,8296
110.847,6,968,498892,554,842,200,1152,477200,414,394,267,1152,21692
102.023,6,23,8359,11,525,89,1237,2048,12,831,9258,1360,6311
1794.43,6,364,25530,212,99,8504,469,14965,152,69,11880,69,10565
1742.774,6,95,7203,63,38,28109,205,4476,32,33,56207,98,2727
1.789,17,19,12397,9,650,223,1350,6104,10,601,148,1350,6293
37.916,6,29,8421,14,523,2916,1050,2341,15,529,2685,1491,6080
3.101,6,2,88,2,0,0,0,88,0,0,0,0,0
503.965,2,4,128,4,8,167988,8,128,0,0,0,0,0
1757.081,6,110,6647,62,27,28803,27,3665,48,27,37383,27,2982
1772.279,6,180,15480,120,69,14893,69,8940,60,69,30036,69,6540
23.348,6,31,8016,15,188,1667,721,1923,16,778,1542,2840,6093
5.814,17,8,668,4,39,1317,39,268,4,72,1926,72,400
1740.429,17,30,31680,30,1028,60014,1028,31680,0,0,0,0,0
1791.083,17,144,11520,72,48,25226,48,5472,72,56,25226,56,6048
0.0,6,1,40,0,0,0,0,0,1,0,0,0,40
0.001,17,3,993,3,303,0,332,993,0,0,0,0,0
1786.763,6,104,8444,68,66,26668,66,4964,36,60,51047,60,3480
1764.005,2,14,448,14,8,135692,8,448,0,0,0,0,0
19.744,6,8,440,5,0,4936,0,268,3,0,9780,0,172
683.121,1,20,1120,20,28,35953,28,1120,0,0,0,0,0
5.586,6,40,7325,20,218,294,314,3423,20,442,280,1152,3902
0.35,17,4,1331,4,304,116,355,1331,0,0,0,0,0
45.272,17,8,1648,4,48,15088,48,304,4,308,15086,308,1344
1789.758,1,214,11984,214,28,8402,28,11984,0,0,0,0,0
0.231,6,9,1002,5,213,57,213,417,4,421,51,421,585
20.483,6,26,6348,15,117,1463,159,1389,11,873,2043,1709,4959
61.83,6,70,48089,44,1178,1437,1408,40003,26,960,2463,3847,8086
8.241,6,75,22366,39,556,216,1152,17158,36,470,228,1179,5208
0.12,17,2,280,1,64,0,64,92,1,160,0,160,188
26.02,6,36,8331,17,175,1626,721,2087,19,608,1423,1440,6244
1.439,6,196,139960,107,1366,13,1432,128785,89,632,16,3303,11175
35.308,6,4981,4702185,3253,1367,10,1408,4607665,1728,931,20,2816,94520
11.764,6,1867,1625653,1126,1389,10,1420,1591792,741,467,15,1883,33861
19.062,6,2621,2495333,1735,1362,10,1408,2444597,886,931,21,2801,50736
1796.426,17,142,11360,71,48,25663,48,5396,71,56,25663,56,5964
0.058,17,2,167,1,39,0,39,67,1,72,0,72,100
1765.095,1,262,27772,262,78,6762,78,27772,0,0,0,0,0
1741.46,6,90,6521,59,31,30025,31,3998,31,31,58044,31,2523
0.031,17,2,904,1,300,0,300,328,1,548,0,548,576
0.27,2,2,64,2,8,270,8,64,0,0,0,0,0
0.005,17,2,160,1,48,0,48,76,1,56,0,56,84
1756.854,6,249,36866,154,302,11482,302,26756,95,83,18689,83,10110
0.594,6,14,1745,7,288,71,288,600,7,426,69,434,1145
1787.409,6,102,8228,68,64,26677,64,4896,34,58,54159,58,3332
1.371,6,23,5779,13,184,114,385,1446,10,982,151,1731,4333
59.925,17,4,1344,4,308,19975,308,1344,0,0,0,0,0
30.839,17,18,1368,18,48,1814,48,1368,0,0,0,0,0
0.319,17,4,334,2,39,178,39,134,2,72,0,72,200
1711.122,1,68,7208,68,78,25539,78,7208,0,0,0,0,0
1798.432,17,449,39928,404,35,4462,288,25708,45,288,40016,288,14220
363.346,6,23,1535,16,177,24223,177,1053,7,110,10344,110,482
4.992,17,4,542,2,36,4988,36,128,2,179,4986,187,414
0.071,6,9,1339,5,145,17,145,349,4,826,22,826,990
61.731,6,48,11368,23,877,710,1460,5411,25,290,2565,1460,5957
300.945,6,34,15566,17,195,18809,431,1696,17,927,6135,2736,13870
1789.025,17,140,11200,70,48,25927,48,5320,70,56,25927,56,5880
1744.514,6,95,7203,63,38,28137,205,4476,32,33,56264,98,2727
1699.475,1,52,2912,52,28,33323,28,2912,0,0,0,0,0
295.804,6,33,6982,16,262,19717,517,1628,17,744,18485,1418,5354
5.786,6,12,2105,6,503,1157,503,835,6,475,1157,475,1270
0.521,6,28,9221,13,268,43,710,1758,15,832,34,1368,7463
1777.465,1,57,4788,57,56,31740,56,4788,0,0,0,0,0
0.039,6,3,120,1,0,0,0,40,2,0,11,0,80
1681.576,17,16,1265,8,30,240223,37,471,8,71,240223,136,794
10.762,6,18,5610,10,275,1195,275,958,8,1440,823,1440,4652
8.278,6,77,24834,39,568,217,1152,19173,38,459,216,1179,5661
1786.825,6,156,19686,93,302,19421,302,13904,63,83,28819,83,5782
104.093,6,74,44392,42,1164,2538,1448,35973,32,843,2031,2359,8419
34.096,6,29,4991,14,180,2622,722,1807,15,342,2415,1448,3184
240.104,6,44,5643,23,247,10913,832,2947,21,177,12004,548,2696
148.876,6,158,25054,92,304,1636,304,17692,66,83,2290,83,7362
0.265,6,10,1512,5,503,66,503,771,5,473,66,473,741
1.3,17,4,368,2,32,973,32,120,2,96,987,96,248
61.768,17,7,532,7,48,10294,48,532,0,0,0,0,0
0.255,17,3,451,2,39,242,39,134,1,289,0,289,317
1.504,17,3,1167,3,361,752,361,1167,0,0,0,0,0
1782.413,17,83,3480,82,14,22005,14,3444,1,8,0,8,36
2.958,6,10,419,5,0,739,0,204,5,7,398,7,215
1783.102,17,83,3480,82,14,22013,14,3444,1,8,0,8,36
1755.545,6,3516,4302800,1279,150,1373,934,79754,2237,1899,785,7010,4223046
288.972,6,291,46920,161,304,1806,304,32928,130,83,2239,83,13992
1789.486,6,371,23603,212,69,8480,69,13034,159,69,11325,69,10569
0.373,6,10,968,5,256,90,256,460,5,304,90,304,508
1781.248,6,357,22629,208,69,8605,69,12529,149,69,12035,69,10100
1.67,17,2,166,1,47,0,47,75,1,63,0,63,91
420.983,1,7,674,7,68,70163,88,674,0,0,0,0,0
280.226,6,28,7352,13,158,23352,267,1317,15,678,20013,2800,6035
369.4,6,25,1651,17,177,23087,177,1117,8,110,9211,110,534
144.939,6,45,6610,21,149,7246,722,2591,24,212,6293,1408,4019
0.212,17,2,212,1,46,0,46,74,1,110,0,110,138
12.394,17,3,228,3,48,6197,48,228,0,0,0,0,0
280.521,6,30,7432,13,158,23376,267,1317,17,543,17530,1400,6115
172.218,17,8,2688,8,308,24602,308,2688,0,0,0,0,0
1007.692,2,7,224,7,8,167948,8,224,0,0,0,0,0
1785.858,6,372,26319,215,104,8345,469,15623,157,69,11447,69,10696
11.898,6,1762,1634752,1153,1365,10,1432,1606089,609,475,19,1871,28663
294.001,6,36,8086,13,158,24500,267,1317,23,365,13363,1400,6769
2.221,17,4,1568,4,364,740,364,1568,0,0,0,0,0
136.68,6,23,10088,6,154,27336,267,712,17,724,8529,1460,9376
19.939,17,24,3528,12,48,1811,48,912,12,190,1811,308,2616
0.039,6,26,14254,13,127,2,127,811,13,1275,3,1448,13443
0.114,6,3,168,1,0,0,0,52,2,0,2,0,116
0.446,17,4,560,2,64,445,64,184,2,160,327,160,376
1771.71,6,99,9306,66,66,27257,66,5610,33,60,55363,60,3696
280.209,6,28,7352,13,158,23350,267,1317,15,678,20012,2800,6035
280.717,6,30,7432,13,158,23393,267,1317,17,543,17543,1400,6115
16.515,6,35,17999,20,755,869,1360,7068,15,1146,1167,1360,10931
1799.927,1,16,896,16,28,119995,28,896,0,0,0,0,0
1799.264,17,449,39928,404,35,4464,288,25708,45,288,40016,288,14220
125.362,6,71,47255,44,1187,2915,1408,39118,27,960,2372,3847,8137
1.408,6,50,18603,27,841,54,1360,12907,23,433,55,1360,5696
1799.644,6,263,18869,161,69,11247,69,10649,102,69,17818,69,8220
89.678,6,34,18794,15,795,112,1460,3827,19,1091,4967,1460,14967
0.491,17,2,384,1,39,0,39,67,1,289,0,289,317
0.191,6,27,7296,13,155,15,267,1301,14,603,13,2036,5995
1793.674,17,66,2766,65,14,28026,14,2730,1,8,0,8,36
296.352,17,15,14682,15,950,21168,1451,14682,0,0,0,0,0
21.833,6,237,107336,129,781,170,1152,98193,108,438,201,1179,9143
1797.704,17,448,39896,403,35,4471,288,25676,45,288,40018,288,14220
1.14,6,24,8004,12,164,88,267,1288,12,1014,87,2411,6716
0.0,17,2,692,2,318,0,353,692,0,0,0,0,0
117.434,6,51,10161,25,249,4893,1189,3251,26,418,4694,2077,6910
39.001,6,26,7137,12,155,3545,267,1266,14,530,2998,2006,5871
1746.375,1,62,5208,62,56,28629,56,5208,0,0,0,0,0
1.183,6,26,9564,13,164,83,267,1388,13,1070,83,2816,8176
0.035,17,4,284,2,32,23,32,120,2,54,22,60,164
4.174,17,2,134,2,39,4174,39,134,0,0,0,0,0
14.855,17,4,352,2,60,14854,60,176,2,60,14854,60,176
0.024,6,3,151,1,0,0,0,40,2,31,1,31,111
3.037,6,15,2637,9,288,376,288,1532,6,426,566,434,1105
0.087,17,4,364,2,52,1,52,160,2,74,79,80,204
1785.65,17,142,11360,71,48,25508,48,5396,71,56,25508,56,5964
61.906,6,31,12972,15,552,4421,939,3046,16,908,4115,1673,9926
1771.887,6,180,15480,120,69,14889,69,8940,60,69,30031,69,6540
92.921,17,4,352,2,60,92920,60,176,2,60,92920,60,176
2.159,6,12,1771,8,100,308,100,424,4,1179,633,1179,1347
10.787,6,18,5610,10,275,1198,275,958,8,1440,834,1440,4652
0.155,17,2,2382,2,1163,155,1163,2382,0,0,0,0,0
1.639,6,16,2125,9,288,203,288,968,7,426,240,434,1157
0.128,17,2,438,1,33,0,33,61,1,349,0,349,377
252.383,2,2,64,2,8,252383,8,64,0,0,0,0,0
1.978,17,3,180,3,32,989,32,180,0,0,0,0,0
4.088,6,11,459,6,0,817,0,244,5,7,752,7,215
1.183,6,23,7952,12,164,91,267,1288,11,1216,100,3819,6664
70.678,6,9,468,9,0,0,0,468,0,0,0,0,0
0.013,17,2,406,1,61,0,61,89,1,289,0,289,317
2.895,17,4,624,4,128,965,128,624,0,0,0,0,0
28.393,6,1423,1267046,831,1439,33,1448,1229058,592,776,47,1448,37988
2.474,6,13,3463,7,188,412,245,660,6,1279,444,1407,2803
33.741,6,34,5249,16,154,2249,722,1911,18,266,1972,1408,3338
174.068,17,4,240,2,32,174067,32,120,2,32,174067,32,120
292.611,1,8,448,8,28,41801,28,448,0,0,0,0,0
108.953,6,38,8498,18,389,520,852,1944,20,478,5725,2128,6554
1800.0,6,211,16342,78,70,22986,313,7748,133,48,13636,78,8594
3.076,6,2,88,2,0,0,0,88,0,0,0,0,0
807.906,6,217,23691,117,157,6952,1189,11613,100,175,8160,2077,12078
0.046,17,2,588,1,39,0,39,67,1,493,0,493,521
296.796,17,30,4770,15,40,21198,40,1020,15,222,21198,249,3750
1776.199,17,142,11360,71,48,25374,48,5396,71,56,25374,56,5964
10.316,17,2,128,2,36,10316,36,128,0,0,0,0,0
240.319,6,53,17507,28,773,8900,1402,14618,25,197,10013,580,2889
560.555,6,36,2768,18,63,25374,63,1287,18,44,32969,57,1481
1772.251,6,180,15480,120,69,14892,69,8940,60,69,30036,69,6540
1.502,6,10,924,5,283,330,283,551,5,105,331,105,373
15.286,17,12,5229,6,490,3042,1350,3110,6,325,3042,1350,2119
280.231,6,27,7312,13,158,23352,267,1317,14,775,21552,4836,5995
98.981,6,15,1086,4,180,125,180,396,11,110,9880,110,690
1.018,17,18,6023,7,346,169,1350,2623,11,281,83,1350,3400
1.613,17,2,435,1,44,0,44,72,1,335,0,335,363
20.761,17,12,1056,6,48,4150,48,456,6,72,4149,72,600
244.6,6,88,23155,42,520,5965,1418,13658,46,394,5435,2410,9497
1767.035,1,16,896,16,28,117802,28,896,0,0,0,0,0
1790.429,1,144,8064,144,28,12520,28,8064,0,0,0,0,0
1798.486,17,449,39644,405,35,4451,288,25740,44,288,40952,288,13904
1763.03,6,191,11709,94,47,18957,208,6837,97,31,18362,31,4872
221.471,17,32,2464,32,49,7144,49,2464,0,0,0,0,0
240.261,6,55,17657,29,781,8580,1408,14821,26,184,9610,580,2836
73.933,17,4,352,2,60,73932,60,176,2,60,73932,60,176
1772.234,6,180,15480,120,69,14892,69,8940,60,69,30034,69,6540
148.894,17,3,228,3,48,74447,48,228,0,0,0,0,0
1785.858,6,362,22898,210,69,8544,69,12678,152,69,11826,69,10220
1.894,17,4,502,2,31,1883,31,118,2,164,1881,164,384
6.001,17,6,786,5,30,1052,30,290,1,468,0,468,496
1799.558,17,1964,149191,1070,40,1683,41,73470,894,56,2015,57,75721
0.182,17,2,279,1,36,0,36,64,1,187,0,187,215
281.294,6,29,7392,13,158,23441,267,1317,16,543,18743,1400,6075
1783.576,6,102,8228,68,64,26620,64,4896,34,58,54045,58,3332
102.478,6,32,8952,14,158,7882,267,1357,18,624,6025,1400,7595
4.121,6,2,88,2,0,0,0,88,0,0,0,0,0
5.002,17,4,288,2,36,5001,36,128,2,52,4955,52,160
1740.569,17,30,31680,30,1028,60019,1028,31680,0,0,0,0,0
0.021,17,2,300,1,45,0,45,73,1,199,0,199,227
93.524,6,18,1532,6,180,123,180,680,12,110,8485,110,852
3.66,6,36,16568,20,593,192,1460,4395,16,1152,233,2368,12173
6.14,17,12,2427,6,33,1227,33,366,6,315,1227,327,2061
2.336,6,13,2311,8,188,333,245,700,5,1407,521,1407,1611
1797.528,1,58,4872,58,56,31535,56,4872,0,0,0,0,0
1773.157,6,180,15480,120,69,14900,69,8940,60,69,30050,69,6540
0.427,6,7,288,4,0,142,0,164,3,0,100,0,124
1724.024,1,8,448,8,28,246289,28,448,0,0,0,0,0
116.298,6,20,9096,11,499,79,1193,1971,9,1350,14515,3639,7125
325.121,6,60,10646,27,148,12504,721,3616,33,356,7813,1440,7030
0.111,17,4,820,2,36,100,36,128,2,318,93,318,692
46.673,17,4,352,2,60,46672,60,176,2,60,46672,60,176
1.811,6,30,6427,15,164,129,267,1922,15,780,119,1452,4505
1.807,6,31,6002,15,125,129,267,1355,16,500,116,1420,4647
1.338,6,42,11418,22,547,63,1360,5842,20,433,60,1360,5576
0.335,17,6,2056,6,314,67,354,2056,0,0,0,0,0
3.433,6,2,88,2,0,0,0,88,0,0,0,0,0
9.158,6,69,20598,35,554,269,1152,15811,34,427,269,1152,4787
0.483,17,14,5163,6,364,96,1350,2356,8,322,35,1350,2807
0.537,6,20,4960,10,137,59,267,1092,10,692,57,1467,3868
2.851,17,3,468,3,128,1425,128,468,0,0,0,0,0
1594.061,1,28,1568,28,28,59039,28,1568,0,0,0,0,0
280.601,6,29,7392,13,158,23383,267,1317,16,678,18694,3456,6075
1731.215,6,73,5340,46,33,38471,33,3187,27,31,66577,31,2153
5.552,6,38,7229,20,218,292,314,3423,18,513,311,1179,3806
204.302,17,4,352,2,60,204301,60,176,2,60,204301,60,176
240.574,2,4,128,4,8,80191,8,128,0,0,0,0,0
280.435,6,28,7352,13,158,23369,267,1317,15,603,20028,2760,6035
0.59,6,14,2181,8,324,84,585,1061,6,396,115,580,1120
0.073,17,4,352,2,37,0,37,130,2,83,37,89,222
1.672,6,42,10108,24,394,72,1360,4555,18,480,86,4075,5553
371.696,1,4,224,4,28,123898,28,224,0,0,0,0,0
2.404,6,43,16567,22,584,114,1360,4478,21,802,108,1379,12089
41.123,17,44,6468,22,48,1954,48,1672,22,190,1954,308,4796
12.005,6,2146,1989242,1369,1375,8,1408,1944174,777,931,15,2801,45068
0.01,17,2,438,1,30,0,30,58,1,352,0,352,380
1777.434,17,140,11200,70,48,25759,48,5320,70,56,25759,56,5880
0.522,17,3,543,2,39,480,39,134,1,381,0,381,409
1657.479,1,8,448,8,28,236782,28,448,0,0,0,0,0
8.677,6,12,945,6,222,1732,222,466,6,231,1732,231,479
1794.33,17,80,3354,79,14,23004,14,3318,1,8,0,8,36
300.601,6,39,8545,20,299,15821,852,2031,19,441,470,1360,6514
1791.76,17,144,11520,72,48,25235,48,5472,72,56,25235,56,6048
1797.431,1,124,6944,124,28,14613,28,6944,0,0,0,0,0
30.199,17,4,352,2,60,30198,60,176,2,60,30197,60,176
7.781,6,42,7656,22,222,370,314,3770,20,513,394,1179,3886
1786.786,6,104,8376,68,65,26668,65,4930,36,59,51047,59,3446
1798.83,17,448,39612,404,35,4463,288,25708,44,288,40948,288,13904
1794.739,6,359,22709,209,69,8628,69,12569,150,69,12045,69,10140
1787.883,1,76,4256,76,28,23838,28,4256,0,0,0,0,0
26.304,17,8,608,8,48,3757,48,608,0,0,0,0,0
18.056,6,27,15246,8,170,2559,214,728,19,1145,995,1440,14518
48.314,17,19,1856,15,44,3451,288,1088,4,164,12754,288,768
1.333,17,6,1186,3,36,664,36,192,3,303,664,318,994
44.166,17,15,7808,8,655,6309,1350,5466,7,306,2517,1350,2342
0.188,6,10,584,5,44,47,44,312,5,0,39,0,272
1.285,6,10,1687,7,100,214,100,384,3,1179,521,1179,1303
0.874,6,11,1727,7,100,145,100,384,4,589,207,1152,1343
1788.484,17,87,3648,86,14,21040,14,3612,1,8,0,8,36
12.795,6,2647,2465963,1688,1382,7,1408,2411431,959,931,13,2801,54532
1.268,17,2,136,1,32,0,32,60,1,48,0,48,76
5.021,17,3,208,2,36,5002,36,128,1,52,0,52,80
1796.72,6,358,22669,209,69,8638,69,12569,149,69,12139,69,10100
5.009,17,4,558,2,36,5004,36,128,2,187,5000,187,430
2.597,17,2,144,1,36,0,36,64,1,52,0,52,80
300.716,6,38,8534,20,307,15827,882,2061,18,441,504,1360,6473
1776.912,17,73,3060,72,14,25026,14,3024,1,8,0,8,36
6.889,6,15474,16781701,4428,158,1,313,237412,11046,1446,0,2876,16544289
1.305,6,48,18741,27,858,50,1360,13125,21,476,56,2715,5616
1790.052,17,120,9600,60,48,30339,48,4560,60,56,30339,56,5040
205.954,1,20,1120,20,28,10839,28,1120,0,0,0,0,0
21.949,6,24,6232,14,117,1688,159,1337,10,727,2435,1418,4895
1799.345,6,355,22480,207,69,8734,69,12420,148,69,12240,69,10060
0.962,6,24,6635,13,350,79,1088,2275,11,783,95,1420,4360
11.641,17,4,304,4,48,3880,48,304,0,0,0,0,0
1788.723,17,83,3480,82,14,22083,14,3444,1,8,0,8,36
370.882,6,18,1242,14,180,28529,180,916,4,110,20058,110,326
67.31,6,88,63521,55,1238,1246,1368,54878,33,747,1940,1368,8643
18.615,17,34,6480,14,191,1431,1350,3067,20,142,978,1350,3413
83.559,6,753,380206,425,829,197,1152,362279,328,436,254,1179,17927
1798.747,17,457,41624,406,35,4441,288,25856,51,281,35477,308,15768
282.331,17,4,296,2,30,282093,30,116,2,62,282001,62,180
0.033,17,2,116,1,30,0,30,58,1,30,0,30,58
20.408,17,30,12773,16,613,1358,1350,10267,14,151,1567,1350,2506
1795.093,17,142,11360,71,48,25644,48,5396,71,56,25644,56,5964
0.042,6,9,1340,5,145,10,145,349,4,827,11,827,991
0.117,6,3,151,2,31,0,31,111,1,0,0,0,40
1786.505,6,106,8524,68,66,26664,66,4964,38,60,48281,60,3560
28.471,6,12,724,3,106,14230,106,234,9,90,3557,90,490
1794.862,17,142,11360,71,48,25640,48,5396,71,56,25637,56,5964
112.126,17,4,240,2,32,112125,32,120,2,32,112125,32,120
0.49,6,22,7345,13,334,40,663,2021,9,1209,54,1946,5324
0.315,6,26,9019,13,252,26,647,1716,13,1103,25,2816,7303
1799.568,6,351,22320,204,69,8764,69,12300,147,69,12325,69,10020
34.174,17,20,1760,10,48,3796,48,760,10,72,3795,72,1000
28.335,6,12,724,4,106,9441,106,274,8,90,4046,90,450
0.032,6,2,123,1,0,0,0,40,1,31,0,31,83
12.956,6,32,4819,18,148,762,293,2505,14,350,973,1152,2314
1793.564,17,180,14040,180,50,10019,50,14040,0,0,0,0,0
1795.384,17,448,39896,403,35,4466,288,25676,45,288,40019,288,14220
0.41,6,20,7238,12,335,36,668,1974,8,1210,57,1906,5264
5.598,6,578,523833,376,1329,14,1368,508665,202,931,26,2841,15168
1775.913,17,140,11200,70,48,25737,48,5320,70,56,25737,56,5880
1797.917,2,24,768,24,8,78170,8,768,0,0,0,0,0
0.015,17,3,392,2,60,0,60,176,1,188,0,188,216
91.897,6,59,31552,29,600,3282,954,3931,30,1085,1458,1440,27621
194.985,6,14,784,6,0,38995,0,312,8,56,27853,56,472
1732.946,1,92,5152,92,28,19043,28,5152,0,0,0,0,0
1.165,17,22,14104,10,697,129,1350,7258,12,542,103,1350,6846
1799.632,1,16,896,16,28,119975,28,896,0,0,0,0,0
19.381,6,2739,2494103,1683,1400,11,1448,2434527,1056,776,18,1448,59576
93.433,6,24,10727,13,726,272,1329,3457,11,974,9324,1791,7270
1775.097,6,180,15480,120,69,14916,69,8940,60,69,30082,69,6540
2.961,6,11,467,6,0,592,0,248,5,7,694,7,219
316.917,6,93,34016,49,644,6602,1360,23273,44,358,7367,4649,10743
3.426,6,17,3324,6,92,685,92,400,11,387,292,1448,2924
4.946,17,4,272,2,32,4927,32,120,2,48,4933,48,152
0.199,17,2,230,1,40,0,40,68,1,134,0,134,162
0.404,17,2,778,2,361,404,361,778,0,0,0,0,0
28.054,6,42,8695,20,161,1476,721,2260,22,504,1286,1440,6435
1785.861,6,369,25730,214,99,8384,469,15114,155,69,11596,69,10616
173.202,6,102,75798,65,1271,2706,1448,65711,37,679,2363,1448,10087
1.592,6,49,19839,28,871,58,1360,14223,21,433,68,1360,5616
1679.838,1,15,840,15,28,119988,28,840,0,0,0,0,0
0.238,17,3,451,2,39,86,39,134,1,289,0,289,317
1774.515,6,27,4077,18,241,104383,241,2889,9,92,221792,92,1188
1.938,6,28,5780,14,125,149,267,1315,14,650,144,1420,4465
0.505,17,3,451,2,39,476,39,134,1,289,0,289,317
13.987,6,109,36167,55,620,259,1152,29509,54,449,258,1179,6658
1.325,6,48,18708,26,921,53,1460,13052,22,433,54,1460,5656
61.326,6,26,10728,13,757,5110,1448,3751,13,899,5073,1448,6977
1770.94,6,104,9580,68,64,26431,64,5724,36,58,50595,58,3856
0.186,17,2,2752,2,1348,186,1348,2752,0,0,0,0,0
21.041,6,23,4602,13,205,1753,517,1931,10,428,2336,499,2671
40.866,17,22,1936,11,48,4085,48,836,11,72,4085,72,1100
0.388,6,44,16760,24,893,16,1380,11718,20,421,18,1923,5042
137.028,6,32,8952,14,158,10540,267,1357,18,624,8057,1400,7595
1763.805,2,14,448,14,8,135677,8,448,0,0,0,0,0
2.233,6,21,6368,10,268,243,517,1334,11,744,219,1418,5034
15.46,6,7,328,2,0,15460,0,88,5,0,3816,0,240
1.269,6,47,18161,26,882,50,1360,12545,21,433,54,1360,5616
0.036,17,2,144,1,36,0,36,64,1,52,0,52,80
0.059,17,4,350,2,34,2,34,124,2,85,11,91,226
0.877,6,10,1687,7,100,146,100,384,3,1179,312,1179,1303
6.329,6,16,3272,8,49,880,92,523,8,1164,879,1408,2749
2.053,6,52,17987,26,853,82,1440,12171,26,433,73,1440,5816
0.78,6,13,1794,7,90,130,174,465,6,1085,155,1085,1329
14.754,6,23,6857,13,275,1229,275,1078,10,1073,1081,1440,5779
1740.405,6,87,6322,58,31,30533,31,3915,29,31,62155,31,2407
240.27,6,59,17570,29,760,8580,1418,14439,30,195,8284,580,3131
1783.809,17,138,11040,69,48,26232,48,5244,69,56,26232,56,5796
1.419,6,50,18796,25,922,59,1440,13020,25,433,51,1440,5776
8.389,1,5,140,5,0,0,0,140,0,0,0,0,0
38.632,17,22,1672,22,48,1839,48,1672,0,0,0,0,0
19.904,2,2,64,2,8,19904,8,64,0,0,0,0,0
1770.3,6,115,10681,71,65,25290,65,6056,44,59,41166,59,4625
0.709,6,6,324,4,0,236,0,216,2,0,487,0,108
0.941,17,2,780,2,362,941,362,780,0,0,0,0,0
158.444,6,175,58993,85,759,1886,1440,40032,90,338,1778,1440,18961
4.114,17,8,1868,4,39,1340,39,268,4,372,1343,477,1600
0.487,6,48,20093,27,928,18,1380,15020,21,467,21,1923,5073
69.567,17,4,352,2,60,69566,60,176,2,60,69566,60,176
0.159,6,46,20756,26,1048,6,1420,15735,20,467,8,1883,5021
1.37,6,40,11338,22,547,65,1360,5842,18,476,70,2715,5496
1.02,17,2,122,2,33,1020,33,122,0,0,0,0,0
1776.345,6,188,18667,123,95,14560,981,10862,65,80,27750,453,7805
0.472,6,51,21583,28,1014,17,1380,16421,23,383,19,1380,5162
2.818,17,4,624,4,128,939,128,624,0,0,0,0,0
0.219,6,11,440,6,0,43,0,240,5,0,44,0,200
6.35,6,1349,1234292,845,1383,7,1408,1203420,504,931,12,2816,30872
240.473,6,40,6135,19,331,13358,1056,3318,21,214,12022,580,2817
1291.528,1,54,5724,54,78,24368,78,5724,0,0,0,0,0
1783.346,6,354,22509,206,69,8699,69,12380,148,69,12131,69,10129
0.154,6,9,1002,5,213,38,213,417,4,421,48,421,585
120.475,17,10,760,10,48,13386,48,760,0,0,0,0,0
0.246,17,2,1922,2,933,246,933,1922,0,0,0,0,0
1792.184,17,180,14040,180,50,10012,50,14040,0,0,0,0,0
10.232,6,15,2037,6,593,2046,593,909,9,212,1278,212,1128
1082.916,2,10,320,10,8,120324,8,320,0,0,0,0,0
0.254,17,3,451,2,39,69,39,134,1,289,0,289,317
3.056,17,2,656,2,300,3056,300,656,0,0,0,0,0
170.69,17,4,352,2,60,170689,60,176,2,60,170689,60,176
1772.398,6,180,15480,120,69,14894,69,8940,60,69,30039,69,6540
0.005,17,4,288,2,33,1,33,122,2,55,0,61,166
0.065,17,2,198,1,39,0,39,67,1,103,0,103,131
12.621,6,3,156,1,0,0,0,52,2,0,12621,0,104
102.292,17,4,352,2,60,102291,60,176,2,60,102291,60,176
0.012,17,2,381,1,53,0,53,81,1,272,0,272,300
16.065,17,24,8403,12,368,1457,1350,4756,12,275,1457,1350,3647
8.115,17,10,9960,2,723,4034,1350,1503,8,1029,1154,1350,8457
280.168,6,28,7352,13,158,23347,267,1317,15,603,20011,2036,6035
1.968,17,4,694,3,32,975,32,180,1,486,0,486,514
0.087,17,2,548,2,246,87,246,548,0,0,0,0,0
1764.519,17,170,14432,157,30,11310,37,9155,13,377,142065,463,5277
1791.528,17,142,11360,71,48,25593,48,5396,71,56,25593,56,5964
221.078,17,4,240,2,32,221077,32,120,2,32,221077,32,120
252.491,6,9,514,3,106,126240,106,234,6,0,50496,0,280
1.592,6,31,8981,15,158,113,267,1397,16,867,101,3465,7584
42.086,17,24,2112,12,48,3825,48,912,12,72,3825,72,1200
367.912,17,8,2688,8,308,52558,308,2688,0,0,0,0,0
1786.723,1,8,448,8,28,255246,28,448,0,0,0,0,0
1263.362,2,11,352,11,8,126336,8,352,0,0,0,0,0
1783.504,17,83,3480,82,14,22018,14,3444,1,8,0,8,36
1.04,6,30,10709,17,511,65,1360,3280,13,766,70,2561,7429
0.279,6,26,9019,13,247,23,624,1672,13,951,22,2816,7347
168.338,6,256,201148,153,1348,1107,1448,184574,103,580,1648,1448,16574
64.44,6,38,9500,16,320,147,1189,2888,22,440,3068,1420,6612
552.086,1,8,448,8,28,78869,28,448,0,0,0,0,0
0.273,17,2,152,1,48,0,48,76,1,48,0,48,76
0.524,17,2,192,1,60,0,60,88,1,76,0,76,104
74.409,6,22,10354,12,408,72,884,1749,10,1365,8252,3928,8605
1788.313,6,105,8348,68,64,26691,64,4896,37,58,49672,58,3452
0.4,6,7,667,4,177,133,177,393,3,110,107,110,274
0.232,17,14,8635,6,521,46,1350,3294,8,639,27,1350,5341
263.452,17,4,240,2,32,263451,32,120,2,32,263451,32,120
56.813,6,31,7725,11,155,9,267,1226,20,355,2989,3417,6499
1791.456,1,197,11032,197,28,9140,28,11032,0,0,0,0,0
1775.746,1,58,4872,58,56,31153,56,4872,0,0,0,0,0
1.358,6,38,9127,20,399,71,1360,3631,18,433,70,1360,5496
0.05,17,4,336,2,34,0,34,124,2,78,0,84,212
1.188,6,27,9396,14,451,91,1406,2992,13,635,85,3047,6404
301.011,6,35,8513,20,317,15842,922,2161,15,574,631,4848,6352
2.532,17,2,136,1,32,0,32,60,1,48,0,48,76
1787.649,6,106,8456,68,65,26681,65,4930,38,59,48312,59,3526
1.9,17,2,124,2,34,1900,34,124,0,0,0,0,0
3.644,6,7,396,3,0,1771,0,164,4,0,1158,0,232
1759.05,1,212,11872,212,28,8336,28,11872,0,0,0,0,0
10.572,6,86,24965,45,560,240,1152,19168,41,461,257,1179,5797
3.134,6,61,36638,33,875,97,1460,10979,28,1226,111,1460,25659
1765.323,6,81,4340,41,26,44131,26,2196,40,26,45263,26,2144
13.545,6,22,3982,12,210,1228,210,1286,10,545,1504,904,2696
66.307,6,22,7983,12,378,57,799,1682,10,981,7354,4080,6301
26.512,6,35,7359,20,190,1395,517,2784,15,420,1893,499,4575
1744.128,6,95,7203,63,38,28131,205,4476,32,33,56250,98,2727
1788.364,17,87,3648,86,14,21039,14,3612,1,8,0,8,36
1.646,17,24,15382,11,597,164,1350,6884,13,625,113,1350,8498
1741.415,17,30,31680,30,1028,60048,1028,31680,0,0,0,0,0
0.576,6,120,87932,53,131,11,232,2649,67,1354,8,1420,85283
47.551,6,42,9938,21,671,490,1360,4265,21,401,2369,2667,5673
11.708,6,1864,1618095,1125,1384,10,1420,1584314,739,467,15,1883,33781
11.049,17,4,1344,4,308,3683,308,1344,0,0,0,0,0
9.817,6,82,24485,41,550,245,1152,18704,41,459,239,1179,5781
0.006,17,2,284,1,35,0,35,63,1,193,0,193,221
34.002,6,464,325658,252,1315,134,1360,311460,212,285,160,1360,14198
1787.559,1,158,16748,158,78,11385,78,16748,0,0,0,0,0
0.006,6,2,218,1,138,0,138,178,1,0,0,0,40
300.455,6,32,11915,17,592,18778,1402,4457,15,741,17174,1402,7458
163.872,6,26,11102,13,313,76,632,1517,13,1005,13644,1440,9585
1203.271,2,12,384,12,8,109388,8,384,0,0,0,0,0
245.783,17,4,352,2,60,245782,60,176,2,60,245782,60,176
19.431,6,2912,2834268,1886,1425,10,1448,2776063,1026,692,18,1448,58205
51.304,6,30,7297,14,155,3946,267,1346,16,441,3419,1420,5951
541.47,2,7,224,7,8,90245,8,224,0,0,0,0,0
1771.832,6,106,9892,69,66,26056,66,5856,37,60,49214,60,4036
1797.938,17,180,14040,180,50,10044,50,14040,0,0,0,0,0
60.518,6,9,774,5,180,15129,180,448,4,110,20100,110,326
233.341,1,3,168,3,28,116670,28,168,0,0,0,0,0
55.239,6,539,463661,263,683,210,1368,27210,276,1610,200,4104,436451
1799.946,1,345,28980,345,56,5232,56,28980,0,0,0,0,0
0.315,17,8,2742,8,314,45,353,2742,0,0,0,0,0
0.115,6,10,584,5,44,28,44,312,5,0,26,0,272
6.977,6,43,8329,22,227,332,314,4062,21,489,334,1179,4267
76.049,1,4,224,4,28,25349,28,224,0,0,0,0,0
0.236,17,4,284,2,32,0,32,120,2,54,0,60,164
0.392,17,6,2056,6,314,78,354,2056,0,0,0,0,0
0.37,17,4,1536,4,356,123,356,1536,0,0,0,0,0
1784.125,17,142,11360,71,48,25487,48,5396,71,56,25486,56,5964
34.221,17,10,760,10,48,3802,48,760,0,0,0,0,0
1.109,6,25,8056,12,164,85,267,1288,13,869,78,1408,6768
5.009,17,4,748,2,37,4997,37,130,2,281,4998,289,618
29.592,6,32,8275,16,192,1972,721,2182,16,908,1904,2840,6093
0.265,17,3,451,2,39,223,39,134,1,289,0,289,317
10.883,6,18,5610,10,275,1209,275,958,8,1440,833,1440,4652
351.744,1,3,168,3,28,175872,28,168,0,0,0,0,0
244.07,6,88,54579,41,1316,10,1408,45590,47,594,5305,1408,8989
1774.732,6,180,15480,120,69,14913,69,8940,60,69,30077,69,6540
0.031,17,3,434,2,60,14,60,176,1,230,0,230,258
300.831,6,50,10526,25,433,12534,910,3258,25,312,530,1460,7268
352.385,17,7,532,7,48,58730,48,532,0,0,0,0,0
0.014,17,2,528,1,53,0,53,81,1,419,0,419,447
1780.647,6,373,23683,214,69,8359,69,13183,159,69,11269,69,10500
43.713,17,41,3117,22,40,2081,41,1509,19,56,2427,57,1608
4.122,17,5,340,5,40,1030,40,340,0,0,0,0,0
33.671,6,31,5092,15,154,2405,721,1857,16,342,2232,1408,3235
1740.001,1,55,4620,0,0,0,0,0,55,56,32222,56,4620
1546.365,1,19,1778,19,65,85909,88,1778,0,0,0,0,0
1749.314,6,112,8371,70,38,25352,205,4933,42,32,42658,98,3438
0.051,17,2,245,1,32,0,32,60,1,157,0,157,185
22.644,6,17,6831,7,275,3774,275,559,10,1171,2107,1440,6272
34.309,17,10,760,10,48,3812,48,760,0,0,0,0,0
3.263,6,18,2523,10,188,362,245,784,8,703,430,1152,1739
1771.574,6,114,10535,73,65,24605,65,6184,41,59,44287,59,4351
390.04,6,18,1242,14,180,30003,180,916,4,110,20059,110,326
1775.682,1,120,6720,120,28,14921,28,6720,0,0,0,0,0
0.773,6,8,440,5,0,193,0,268,3,0,351,0,172
46.943,1,6,336,6,28,9388,28,336,0,0,0,0,0
619.555,6,26,1352,13,0,51626,0,676,13,0,51626,0,676
378.116,2,4,128,4,8,126038,8,128,0,0,0,0,0
31.693,6,7,308,1,0,0,0,44,6,0,6319,0,264
1779.394,6,217,23115,137,120,13083,981,13293,80,82,22517,256,9822
5.965,6,1565,1450655,991,1386,5,1408,1416143,574,931,10,2801,34512
1664.156,1,8,448,8,28,237736,28,448,0,0,0,0,0
0.018,17,2,904,1,300,0,300,328,1,548,0,548,576
599.995,1,8,2996,8,346,85713,376,2996,0,0,0,0,0
1798.527,1,342,28728,342,56,5274,56,28728,0,0,0,0,0
5.379,6,44,8369,21,227,268,314,4022,23,489,232,1179,4347
1792.533,6,356,22520,208,69,8659,69,12460,148,69,12193,69,10060
0.081,17,2,384,1,32,0,32,60,1,296,0,296,324
1785.002,6,136,8389,73,27,24791,27,4432,63,27,28789,27,3957
70.413,17,4,352,2,60,70411,60,176,2,60,70412,60,176
0.591,6,5,272,3,0,295,0,164,2,0,392,0,108
0.147,6,10,1188,5,145,36,145,349,5,635,23,635,839
1797.689,17,448,39896,403,35,4471,288,25676,45,288,40022,288,14220
4.068,17,5,290,5,30,1017,30,290,0,0,0,0,0
1684.453,2,25,800,25,8,70185,8,800,0,0,0,0,0
264.606,6,49,6822,27,129,10177,722,2952,22,170,12587,1408,3870
255.026,6,7,418,4,106,85008,106,274,3,0,1523,0,144
1787.068,6,102,8296,68,65,26672,65,4930,34,59,54150,59,3366
6.004,17,2,150,2,47,6004,47,150,0,0,0,0,0
30.104,6,28,6138,15,210,2150,210,1478,13,664,2508,904,4660
2.229,17,8,672,4,45,740,45,292,4,67,740,73,380
1787.188,6,104,8366,68,63,26674,64,4868,36,57,51059,58,3498
0.621,6,10,861,5,222,153,222,426,5,231,153,231,435
0.273,17,3,451,2,39,242,39,134,1,289,0,289,317
1765.158,1,65,5460,65,56,27580,56,5460,0,0,0,0,0
15.143,6,5,752,3,46,7571,46,166,2,506,14954,506,586
541.364,2,4,128,4,8,180454,8,128,0,0,0,0,0
95.135,6,15,1132,4,226,118,226,442,11,110,9495,110,690
55.546,6,722,598926,463,1329,75,1360,581061,259,200,214,2667,17865
0.135,17,2,152,1,48,0,48,76,1,48,0,48,76
1790.861,6,244,35804,152,302,11860,302,26032,92,83,19679,83,9772
0.392,17,2,144,1,36,0,36,64,1,52,0,52,80
0.157,17,2,152,2,48,157,48,152,0,0,0,0,0
0.064,17,4,284,2,32,18,32,120,2,54,48,60,164
2.611,17,23,8027,9,272,326,1350,2706,14,352,123,1350,5321
1793.599,6,356,22589,207,69,8706,69,12420,149,69,12118,69,10169
0.243,1,2,112,2,28,243,28,112,0,0,0,0,0
10.459,17,20,9477,10,637,1159,1350,6656,10,254,1158,1350,2821
1742.467,6,157,16223,84,69,20993,721,6836,73,174,24197,1420,9387
282.171,17,4,352,2,60,282170,60,176,2,60,282169,60,176
0.789,6,27,6161,13,108,65,147,959,14,662,56,1430,5202
0.505,17,18,6108,8,389,64,1350,3337,10,249,48,1350,2771
1.025,17,4,454,3,32,506,32,180,1,246,0,246,274
300.266,6,31,11848,17,592,18766,1408,4473,14,829,18478,1408,7375
161.082,17,4,530,2,36,161078,36,128,2,173,161077,187,402
0.546,17,4,624,2,64,356,64,184,2,192,346,192,440
1740.715,17,30,7050,30,207,60024,207,7050,0,0,0,0,0
472.878,6,77,11592,41,94,11821,267,3530,36,220,13510,1997,8062
155.022,17,4,240,2,32,155021,32,120,2,32,155021,32,120
451.329,6,87,30255,41,595,11282,1418,11065,46,730,10029,1418,19190
33.711,6,30,5042,15,154,2407,721,1858,15,400,2395,2026,3184
175.269,17,2,72,1,8,0,8,36,1,8,0,8,36
1740.441,17,30,6930,30,203,60015,203,6930,0,0,0,0,0
1773.237,6,180,15480,120,69,14901,69,8940,60,69,30050,69,6540
134.358,6,6,1255,4,327,44786,413,814,2,180,134128,269,441
17.084,6,22,4011,14,211,1313,211,1417,8,545,2438,904,2594
1744.124,6,99,7504,64,38,27684,205,4528,35,33,51286,98,2976
0.023,6,9,1880,5,910,5,910,1178,4,486,7,486,702
0.015,17,2,904,2,424,15,548,904,0,0,0,0,0
1772.289,6,180,15480,120,69,14893,69,8940,60,69,30032,69,6540
15.366,6,10,432,4,0,217,0,168,6,0,3071,0,264
236.302,6,30,7432,13,158,19691,267,1317,17,603,14765,2076,6115
280.353,6,30,7432,13,158,23362,267,1317,17,543,17518,1400,6115
1.002,17,2,122,2,33,1002,33,122,0,0,0,0,0
1793.461,17,179,13962,179,50,10075,50,13962,0,0,0,0,0
1772.902,6,182,15629,121,69,14774,69,8980,61,69,29546,69,6649
1780.342,6,102,8296,68,65,26572,65,4930,34,59,53946,59,3366
4.223,6,40,7309,20,218,222,314,3423,20,513,209,1179,3886
11.43,6,27,11433,13,275,952,275,1078,14,1087,829,1440,10355
33.663,6,30,5041,15,154,2404,721,1858,15,399,2390,2026,3183
1757.018,6,113,6830,63,27,28338,27,3762,50,27,35856,27,3068
0.018,17,2,307,1,33,0,33,61,1,218,0,218,246
36.89,17,6,2016,6,308,7378,308,2016,0,0,0,0,0
220.57,6,30,7432,13,158,18380,267,1317,17,603,13781,2076,6115
1.874,6,30,11825,17,367,117,833,1785,13,1057,148,1420,10040
3.014,17,8,1642,4,47,1001,47,300,4,307,1001,341,1342
0.349,17,2,168,1,48,0,48,76,1,64,0,64,92
1794.736,6,329,65111,148,356,12208,1360,46231,181,132,9970,2720,18880
0.463,17,2,152,1,48,0,48,76,1,48,0,48,76
4.832,1,8,832,0,0,0,0,0,8,76,690,76,832
0.075,17,2,384,1,32,0,32,60,1,296,0,296,324
1795.171,17,449,39416,404,34,4454,288,25444,45,282,40018,288,13972
1765.152,6,127,7726,69,26,25957,26,4142,58,26,30966,26,3584
0.832,17,2,179,1,43,0,43,71,1,80,0,80,108
0.019,17,2,152,1,48,0,48,76,1,48,0,48,76
0.156,1,2,163,2,53,156,78,163,0,0,0,0,0
366.809,6,27,1767,18,177,21577,177,1181,9,110,8791,110,586
1799.007,6,358,22669,209,69,8649,69,12569,149,69,12155,69,10100
15.892,17,12,5138,6,490,3164,1350,3110,6,310,3161,1350,2028
1764.558,2,15,480,15,8,126039,8,480,0,0,0,0,0
601.58,2,6,192,6,8,120316,8,192,0,0,0,0,0
1787.657,6,105,8416,68,65,26681,65,4930,37,59,49653,59,3486
10.683,6,50,36915,34,1157,323,1368,30715,16,1786,696,5255,6200
321.81,17,11,4368,11,369,32181,548,4368,0,0,0,0,0
14.519,6,24,6993,13,275,1209,275,1078,11,910,949,1440,5915
1797.97,6,356,22520,208,69,8685,69,12460,148,69,12231,69,10060
1.012,6,24,8765,13,290,84,802,1713,11,942,82,1460,7052
1798.364,2,24,768,24,8,78189,8,768,0,0,0,0,0
0.775,6,28,7336,14,155,59,267,1341,14,603,58,2800,5995
0.006,17,3,819,1,137,0,137,165,2,299,4,299,654
5.055,17,4,288,2,36,5005,36,128,2,52,5023,52,160
1628.695,17,96,7672,49,48,33930,48,3724,47,56,35406,56,3948
38.481,17,11,836,11,48,3848,48,836,0,0,0,0,0
64.993,17,60,15540,60,231,1101,388,15540,0,0,0,0,0
618.529,1,82,4592,82,28,7636,28,4592,0,0,0,0,0
1.445,6,49,20153,28,892,53,1360,14537,21,476,63,2715,5616
1794.211,17,295,68534,295,204,6102,422,68534,0,0,0,0,0
1796.77,6,355,22480,207,69,8722,69,12420,148,69,12222,69,10060
1763.829,2,14,448,14,8,135679,8,448,0,0,0,0,0
1799.928,17,447,39296,403,35,4477,288,25392,44,288,40950,288,13904
1405.329,17,14,1036,7,30,234171,30,406,7,62,234218,62,630
132.053,6,25,3965,11,517,13203,517,2672,14,126,10156,158,1293
1773.533,6,183,15807,120,69,14903,69,8940,63,69,28597,69,6867
333.065,6,183,154189,124,1287,2707,1368,141603,59,679,1570,2519,12586
1797.614,6,368,25690,215,99,8400,469,15085,153,69,11826,69,10605
0.774,17,2,782,2,363,774,363,782,0,0,0,0,0
33.761,6,31,5094,15,154,2411,722,1858,16,342,2238,2026,3236
1543.737,6,173,18327,89,86,17540,721,8522,84,184,18597,1414,9805
249.51,6,54,10626,24,216,10847,1189,3349,30,357,8603,1997,7277
1780.088,6,359,22709,208,69,8599,69,12529,151,69,11866,69,10180
57.351,6,25,7097,12,155,5213,267,1266,13,589,4778,3426,5831
232.897,17,4,352,2,60,232896,60,176,2,60,232896,60,176
12.716,17,4,352,2,48,12708,48,152,2,72,12706,72,200
0.708,6,12,3462,6,75,141,75,395,6,1373,141,1448,3067
1.257,6,53,20012,30,867,43,1360,14271,23,400,49,1360,5741
1787.343,6,104,8376,68,65,26676,65,4930,36,59,51063,59,3446
1774.776,1,58,3248,58,28,31136,28,3248,0,0,0,0,0
280.441,6,28,7352,13,158,23370,267,1317,15,678,20029,3456,6035
31.584,6,7,308,1,0,0,0,44,6,0,6297,0,264
37.181,17,22,1936,11,48,3712,48,836,11,72,3714,72,1100
2.592,17,2,237,1,72,0,72,100,1,109,0,109,137
0.084,6,11,913,6,182,16,182,490,5,77,19,134,423
291.745,17,4,1383,1,308,0,308,336,3,321,145376,321,1047
1795.615,6,362,22898,210,69,8591,69,12678,152,69,11891,69,10220
280.502,6,28,7352,12,158,25500,267,1277,16,678,18696,2085,6075
280.449,6,27,7312,13,158,23370,267,1317,14,775,21570,3465,5995
1764.058,2,30,960,30,8,60829,8,960,0,0,0,0,0
242.713,6,43,6225,19,332,13483,1056,3321,24,164,10552,580,2904
2.527,6,116,87384,50,131,51,232,2529,66,1347,34,1430,84855
1740.333,6,87,6322,58,31,30532,31,3915,29,31,62152,31,2407
1797.242,17,769,46429,769,32,2340,37,46429,0,0,0,0,0
2.302,6,13,2311,8,188,328,245,700,5,1407,512,1407,1611
51.151,6,1386,1214937,937,1316,28,1360,1185760,449,169,113,2667,29177
1.561,6,24,8004,12,164,121,267,1288,12,1014,119,2331,6716
1791.833,1,180,19080,180,78,10010,78,19080,0,0,0,0,0
163.196,6,156,24654,83,304,1990,304,17504,73,83,2260,83,7150
0.04,17,2,327,1,35,0,35,63,1,236,0,236,264
8.076,6,1645,1581070,1086,1381,7,1408,1547338,559,931,14,2816,33732
52.313,17,16,18211,16,1110,3487,1451,18211,0,0,0,0,0
925.864,6,138,20209,70,100,13415,721,7134,68,333,13816,1414,13075
177.576,6,25,10101,13,531,46,1360,2689,12,988,16132,1360,7412
0.063,17,2,192,1,44,0,44,72,1,92,0,92,120
32.096,6,393,422157,130,125,248,299,7137,263,1543,122,8508,415020
0.512,17,3,543,2,39,241,39,134,1,381,0,381,409
1771.23,6,101,9278,66,64,27249,64,5544,35,58,52091,58,3734
4.669,6,40,7309,21,218,233,314,3463,19,513,245,1179,3846
0.572,17,2,178,1,29,0,29,57,1,93,0,93,121
1753.924,1,61,5124,61,56,29232,56,5124,0,0,0,0,0
1792.081,17,142,11360,71,48,25601,48,5396,71,56,25601,56,5964
1680.481,1,14,784,14,28,129267,28,784,0,0,0,0,0
0.849,17,2,122,2,33,849,33,122,0,0,0,0,0
1783.62,17,83,3480,82,14,22020,14,3444,1,8,0,8,36
2.063,6,13,724,9,0,257,0,516,4,0,523,0,208
280.19,6,29,7392,13,158,23349,267,1317,16,603,18676,1400,6075
32.409,17,4,352,2,60,32408,60,176,2,60,32407,60,176
0.216,6,21,5000,10,137,24,267,1092,11,692,21,1467,3908
7.148,6,4,240,4,0,0,0,240,0,0,0,0,0
1.474,6,47,18748,27,861,56,1360,13172,20,476,67,2715,5576
1681.253,17,14,3843,7,30,280206,30,406,7,463,280206,463,3437
35.85,6,53,22679,25,451,163,666,3125,28,822,1327,1491,19554
0.23,17,2,167,1,39,0,39,67,1,72,0,72,100
365.714,6,18,1242,14,180,28131,180,916,4,110,20058,110,326
0.921,6,10,1687,7,100,153,100,384,3,1179,334,1179,1303
1744.401,6,95,7203,63,38,28135,205,4476,32,33,56258,98,2727
242.5,6,97,16734,41,272,6062,1189,7637,56,236,4399,1460,9097
289.328,17,60,22005,60,338,4903,361,22005,0,0,0,0,0
1797.984,1,342,28728,342,56,5272,56,28728,0,0,0,0,0
1680.743,1,14,812,14,30,129287,30,812,0,0,0,0,0
4.503,6,27,5488,13,88,374,147,1137,14,599,345,1418,4351
0.018,6,12,3940,7,88,3,88,388,5,3340,4,3340,3552
1781.78,17,73,3060,72,14,25095,14,3024,1,8,0,8,36
300.88,6,45,13829,25,892,12536,1460,8182,20,371,453,1460,5647
1783.808,6,355,22480,207,69,8659,69,12420,148,69,12134,69,10060
1784.787,17,142,11360,71,48,25496,48,5396,71,56,25496,56,5964
0.569,17,19,12499,11,889,56,1350,10089,8,273,76,1350,2410
240.248,6,54,18006,29,804,8579,1418,15197,25,187,10009,580,2809
89.296,17,7,532,7,48,14882,48,532,0,0,0,0,0
0.743,17,2,196,1,62,0,62,90,1,78,0,78,106
1.455,6,49,19273,27,893,55,1460,13617,22,476,58,2615,5656
38.718,17,22,1936,11,48,3870,48,836,11,72,3870,72,1100
1797.611,6,364,25599,212,99,8519,469,15034,152,69,11902,69,10565
1.304,6,17,6337,10,141,144,275,686,7,1073,51,2840,5651
1.363,6,41,8429,20,320,71,1162,2768,21,400,59,1440,5661
1792.815,17,142,11360,71,48,25611,48,5396,71,56,25611,56,5964
181.344,17,6,456,6,48,36268,48,456,0,0,0,0,0
21.911,6,47,8505,20,227,240,314,3982,27,491,833,1179,4523
2.344,17,5,468,4,40,781,40,272,1,168,0,168,196
3.958,17,2,656,2,300,3958,300,656,0,0,0,0,0
0.305,17,8,2750,8,315,43,354,2750,0,0,0,0,0
2.13,6,13,2311,8,188,304,245,700,5,1407,468,1407,1611
64.011,6,21,5992,11,272,6401,516,1260,10,618,7102,1452,4732
0.028,17,2,182,1,34,0,34,62,1,92,0,92,120
20.442,6,3285,3185809,2241,1348,9,1368,3126857,1044,931,19,2736,58952
1744.715,2,24,768,24,8,75857,8,768,0,0,0,0,0
75.643,1,6,336,6,28,15128,28,336,0,0,0,0,0
1789.764,1,342,28728,342,56,5248,56,28728,0,0,0,0,0
1795.003,1,342,28728,342,56,5263,56,28728,0,0,0,0,0
10.787,6,20,4442,11,275,1078,275,998,9,768,752,1440,3444
1.288,6,48,18693,27,854,49,1360,13077,21,476,55,2715,5616
0.412,17,2,418,1,37,0,37,65,1,325,0,325,353
1709.438,1,56,3136,56,28,31080,28,3136,0,0,0,0,0
280.039,6,31,7472,14,158,21541,267,1357,17,543,17499,1400,6115
141.427,6,24,11434,13,682,60,1360,3963,11,1403,14128,3957,7471
15.361,6,19,5501,10,125,1706,125,657,9,1448,1250,1448,4844
300.717,6,38,8573,20,317,15827,922,2101,18,441,502,1360,6472
1779.095,6,121,12204,76,62,23721,722,6350,45,94,40427,1408,5854
1706.166,1,68,3808,68,28,25465,28,3808,0,0,0,0,0
127.597,6,25,11003,12,414,75,935,1768,13,967,10621,1460,9235
0.283,6,26,9058,13,257,23,667,1739,13,947,22,1408,7319
0.022,17,4,865,2,47,0,47,150,2,329,5,341,715
1773.554,6,180,15480,120,69,14903,69,8940,60,69,30053,69,6540
0.213,6,4,160,2,0,152,0,80,2,0,212,0,80
1799.333,17,449,39928,404,35,4464,288,25708,45,288,40017,288,14220
1.393,6,40,8391,21,321,69,1164,2810,19,437,67,2715,5581
0.473,6,50,21110,27,1060,18,1380,15960,23,383,19,1380,5150
126.666,6,25,7161,11,155,31,267,1226,14,536,9743,3426,5935
0.053,17,2,136,1,32,0,32,60,1,48,0,48,76
851.857,1,18,1008,18,28,50109,28,1008,0,0,0,0,0
46.229,17,4,304,2,48,46212,48,152,2,48,46213,48,152
5.009,17,4,514,2,36,5005,36,128,2,165,5004,187,386
0.039,1,10,840,10,56,4,56,840,0,0,0,0,0
0.655,6,23,6433,13,315,53,913,2099,10,982,71,1699,4334
280.345,6,30,7432,13,158,23362,267,1317,17,543,17519,1400,6115
1743.637,6,97,7307,63,38,28123,205,4476,34,33,52830,98,2831
0.057,17,2,214,1,47,0,47,75,1,111,0,111,139
300.88,6,56,27318,27,862,11572,1408,9189,29,830,2209,1491,18129
0.878,6,20,5948,11,281,87,544,1288,9,716,98,1420,4660
81.506,2,4,128,4,8,27168,8,128,0,0,0,0,0
1798.245,1,345,28980,345,56,5227,56,28980,0,0,0,0,0
281.672,6,32,7516,14,158,21667,267,1357,18,543,16563,1400,6159
0.406,2,3,96,3,8,203,8,96,0,0,0,0,0
3.042,17,8,688,4,47,1010,47,300,4,69,1011,75,388
3.786,17,10,2546,5,30,943,30,290,5,423,944,468,2256
27.428,17,4,240,2,32,27427,32,120,2,32,27427,32,120
1795.171,17,80,3354,79,14,23015,14,3318,1,8,0,8,36
0.07,17,2,656,2,300,70,300,656,0,0,0,0,0
0.343,17,2,152,1,48,0,48,76,1,48,0,48,76
1770.915,6,99,9240,66,65,27244,65,5577,33,59,55338,59,3663
1787.147,6,356,22520,208,69,8633,69,12460,148,69,12155,69,10060
1797.232,6,133,8322,75,46,24286,208,5103,58,31,31524,31,3219
1786.474,6,107,8696,70,66,25890,66,5176,37,60,49612,60,3520
0.434,6,26,8890,13,232,36,569,1614,13,941,33,1438,7276
1501.296,17,104,8320,52,48,29437,48,3952,52,56,29437,56,4368
280.331,6,29,7392,13,158,23360,267,1317,16,603,18682,1400,6075
482.456,6,50,4277,33,69,15076,69,2424,17,69,30152,69,1853
297.285,17,4,352,2,60,297284,60,176,2,60,297284,60,176
2.436,6,16,2431,9,125,304,245,740,7,703,364,1152,1691
280.248,6,29,7392,13,158,23354,267,1317,16,603,18677,2800,6075
1786.71,6,106,8524,68,66,26667,66,4964,38,60,48286,60,3560
1799.031,6,103,10345,72,76,25338,229,6873,31,60,55310,60,3472
12.846,6,27,7177,13,155,1070,267,1306,14,530,987,3417,5871
61.819,6,68,46350,43,1163,1471,1408,38316,25,960,2565,3847,8034
22.387,6,3475,3265774,2256,1369,9,1408,3197722,1219,931,18,2816,68052
1.363,6,48,17196,26,805,54,1360,11540,22,476,56,2715,5656
0.758,6,26,5887,13,156,63,267,1462,13,650,57,1420,4425
1744.7,2,27,864,27,8,67103,8,864,0,0,0,0,0
1.016,17,4,368,2,32,789,32,120,2,96,835,96,248
1.44,6,18,3257,10,99,141,182,924,8,477,181,1343,2333
6.011,17,2,120,2,32,6011,32,120,0,0,0,0,0
1776.104,17,142,11360,71,48,25372,48,5396,71,56,25372,56,5964
0.392,17,2,776,2,360,392,360,776,0,0,0,0,0
231.533,6,46,6431,22,135,11017,722,2371,24,188,10059,1408,4060
236.905,17,8,2688,8,308,33843,308,2688,0,0,0,0,0
1695.995,1,8,448,8,28,242285,28,448,0,0,0,0,0
1700.504,17,12,498,11,14,170050,14,462,1,8,0,8,36
5.81,6,41,7349,21,218,290,314,3463,20,513,289,1179,3886
0.07,6,12,3462,6,75,14,75,395,6,1373,14,1448,3067
0.045,6,11,1686,6,131,9,131,451,5,967,11,967,1235
1.286,6,14,3976,8,170,183,170,764,6,964,241,1448,3212
1762.982,1,8,448,8,28,251854,28,448,0,0,0,0,0
1786.99,6,102,8172,68,63,26671,64,4868,34,57,54148,58,3304
1796.306,17,443,39168,400,35,4502,288,25580,43,288,41928,288,13588
1788.425,1,276,29256,276,78,6503,78,29256,0,0,0,0,0
0.069,6,14,3436,8,106,9,106,518,6,866,11,1448,2918
18.05,17,30,9078,15,388,1287,1350,6250,15,160,1287,1350,2828
0.409,6,10,1185,6,279,81,279,587,4,191,58,272,598
1681.32,17,14,3799,7,30,280218,30,406,7,456,280218,463,3393
301.066,6,36,10887,20,593,15845,1368,4013,16,548,586,2206,6874
1.26,6,50,20137,28,888,46,1360,14481,22,433,51,1360,5656
1791.205,1,150,8400,150,28,12021,28,8400,0,0,0,0,0
1796.79,1,58,4872,58,56,31522,56,4872,0,0,0,0,0
168.767,17,8,2688,8,308,24109,308,2688,0,0,0,0,0
280.444,6,31,7472,13,158,23370,267,1317,18,603,16491,2076,6155
5.249,6,39,7269,20,218,276,314,3423,19,513,277,1179,3846
1799.323,17,142,11360,71,48,25704,48,5396,71,56,25704,56,5964
4.191,6,2,88,2,0,0,0,88,0,0,0,0,0
1.236,6,24,8016,11,164,105,267,1248,13,869,87,1408,6768
1796.681,17,348,26448,348,48,5177,48,26448,0,0,0,0,0
8.014,6,16,1131,9,275,1001,275,643,7,96,1117,96,488
1763.495,6,224,21062,110,76,16178,721,10081,114,164,15603,1440,10981
1.927,17,4,314,2,31,1919,31,118,2,70,1911,70,196
27.087,17,4,352,2,60,27086,60,176,2,60,27086,60,176
1745.415,6,95,7203,63,38,28151,205,4476,32,33,56292,98,2727
8.473,6,31,23692,10,335,941,335,1194,21,1424,396,1438,22498
1776.218,17,142,11360,71,48,25374,48,5396,71,56,25374,56,5964
1797.048,17,138,11040,69,48,26427,48,5244,69,56,26427,56,5796
1.615,17,4,240,4,32,538,32,240,0,0,0,0,0
18.919,1,4,224,4,28,6306,28,224,0,0,0,0,0
5.103,6,45,8425,22,227,243,314,4062,23,491,218,1179,4363
280.326,6,29,7392,13,158,23360,267,1317,16,603,18686,1400,6075
93.901,6,15,620,6,0,2566,0,244,9,0,11735,0,376
1745.891,6,95,7203,63,38,28159,205,4476,32,33,56308,98,2727
0.838,6,35,8320,18,274,49,753,1887,17,478,45,2720,6433
0.112,17,2,574,1,32,0,32,60,1,486,0,486,514
1788.944,1,240,13440,240,28,7485,28,13440,0,0,0,0,0
1.464,6,25,4894,13,208,122,524,1715,12,507,121,1368,3179
360.598,6,31,7185,11,189,11033,516,1392,20,277,18973,1452,5793
1773.015,6,203,22359,129,75,13851,267,10017,74,133,24281,1452,12342
1.725,17,4,304,3,32,860,32,180,1,96,0,96,124
2.784,6,2,88,2,0,0,0,88,0,0,0,0,0
1.742,17,3,1176,3,364,871,364,1176,0,0,0,0,0
361.023,2,3,96,3,8,180511,8,96,0,0,0,0,0
23.33,6,5,280,3,0,11665,0,160,2,0,996,0,120
1.886,17,4,314,2,31,1854,31,118,2,70,1854,70,196
1772.94,6,185,15887,121,69,14774,69,9049,64,69,28141,69,6838
1771.374,6,101,9410,66,66,27251,66,5610,35,60,52096,60,3800
1744.645,2,29,928,29,8,62308,8,928,0,0,0,0,0
0.198,6,2,80,1,0,0,0,40,1,0,0,0,40
325.073,17,4,1344,4,308,108357,308,1344,0,0,0,0,0
1.289,6,47,18912,26,940,51,1460,13296,21,433,55,1460,5616
813.733,1,24,1344,24,28,35379,28,1344,0,0,0,0,0
1.523,17,4,496,3,64,749,64,276,1,192,0,192,220
4.878,6,3,688,1,0,0,0,40,2,272,4861,272,648
1681.71,17,18,1494,9,31,210211,37,536,9,78,210212,136,958
488.735,6,277,218776,171,1314,2874,1408,199566,106,651,1829,2816,19210
1682.454,17,14,2716,14,166,129419,166,2716,0,0,0,0,0
0.445,1,10,280,10,0,0,0,280,0,0,0,0,0
1785.577,6,356,22520,208,69,8625,69,12460,148,69,12146,69,10060
0.033,17,4,792,3,60,4,60,264,1,500,0,500,528
1796.317,1,42,2352,42,28,43812,28,2352,0,0,0,0,0
664.877,6,45,4491,31,77,22162,223,3082,14,55,51132,58,1409
1795.858,17,437,36704,402,35,4478,288,25644,35,288,51788,288,11060
1.404,6,50,19290,27,891,54,1460,13594,23,433,55,1460,5696
9.483,6,17,2483,9,188,1185,245,744,8,703,1114,1152,1739
0.339,17,2,304,1,60,0,60,88,1,188,0,188,216
0.482,17,3,451,2,39,87,39,134,1,289,0,289,317
295.165,6,41,9953,21,579,14749,1440,4351,20,399,15524,1440,5602
682.382,17,32,1344,32,14,22012,14,1344,0,0,0,0,0
1740.853,6,87,6322,58,31,30541,31,3915,29,31,62172,31,2407
5.081,17,4,352,2,60,5080,60,176,2,60,5079,60,176
0.708,6,52,19723,26,1019,28,1380,14345,26,421,26,1923,5378
1.902,6,14,1465,7,222,315,222,950,7,231,315,231,515
0.044,6,12,3462,6,75,8,75,395,6,1373,8,1448,3067
1714.419,1,8,448,8,28,244917,28,448,0,0,0,0,0
0.045,6,12,3704,6,171,6,171,491,6,964,7,1448,3213
1796.661,1,58,4872,58,56,31520,56,4872,0,0,0,0,0
1682.63,17,14,1036,7,30,280436,30,406,7,62,280435,62,630
0.901,6,11,1727,7,100,150,100,384,4,589,216,1152,1343
4.188,6,34,6185,18,206,246,314,2784,16,551,261,1179,3401
1740.829,6,87,6322,58,31,30540,31,3915,29,31,62171,31,2407
192.665,6,28,6641,10,220,6231,516,1285,18,308,11328,1452,5356
2.646,6,2,80,1,0,0,0,40,1,0,0,0,40
1784.371,17,142,11360,71,48,25490,48,5396,71,56,25490,56,5964
60.279,6,21,10550,12,909,5479,1408,5191,9,974,7529,2523,5359
1783.632,17,142,11360,71,48,25479,48,5396,71,56,25479,56,5964
1787.028,1,93,5208,93,28,19424,28,5208,0,0,0,0,0
1773.602,6,181,15589,120,69,14904,69,8940,61,69,29553,69,6649
755.862,2,5,160,5,8,188965,8,160,0,0,0,0,0
1758.099,1,208,22048,208,78,8493,78,22048,0,0,0,0,0
366.997,6,25,1651,17,177,22937,177,1117,8,110,9183,110,534
240.207,6,54,18233,29,762,8578,1418,15233,25,211,10008,580,3000
1770.01,6,101,9410,66,66,27230,66,5610,35,60,52056,60,3800
0.099,6,3,160,2,0,99,0,100,1,0,0,0,60
1743.518,17,150,20100,150,106,11701,362,20100,0,0,0,0,0
60.609,6,27,7177,13,155,5050,267,1306,14,530,4661,3417,5871
0.466,1,4,1820,4,427,155,548,1820,0,0,0,0,0
0.373,6,26,6150,13,181,31,537,1578,13,555,29,1542,4572
13.906,6,28,5116,13,154,1139,722,1767,15,366,979,1402,3349
0.988,17,4,272,2,32,956,32,120,2,48,806,48,152
0.146,17,2,373,1,34,0,34,62,1,283,0,283,311
1260.79,2,9,288,9,8,157598,8,288,0,0,0,0,0
280.305,6,28,7352,13,158,23358,267,1317,15,678,20019,2045,6035
122.881,6,22,8776,11,314,78,634,1439,11,983,12275,1360,7337
39.164,17,22,1672,22,48,1864,48,1672,0,0,0,0,0
1713.999,1,8,448,8,28,244857,28,448,0,0,0,0,0
188.398,6,17,16233,17,1096,11774,1402,16233,0,0,0,0,0
490.83,6,22,6602,5,112,122707,112,320,17,372,30667,1460,6282
1771.963,1,58,4872,58,56,31087,56,4872,0,0,0,0,0
1681.976,17,14,1036,7,30,280324,30,406,7,62,280324,62,630
27.81,6,7,2065,1,0,0,0,40,6,357,5560,357,2025
1.379,6,32,12163,17,525,86,1360,3350,15,820,79,1380,8813
1795.761,6,388,26973,222,96,8125,469,15848,166,69,10880,69,11125
1782.203,6,102,8364,68,66,26600,66,4964,34,60,54003,60,3400
0.123,6,9,1346,5,145,30,145,349,4,833,26,833,997
109.987,6,24,10328,13,681,523,1194,3315,11,937,10980,2720,7013
12.131,6,1938,1666086,1161,1378,10,1420,1630704,777,425,15,1883,35382
1789.3,6,4389,4349111,1432,129,1250,353,89878,2957,1424,605,5672,4259233
18.98,17,30,8834,15,298,1353,1350,4903,15,234,1353,1350,3931
1799.585,6,356,22520,208,69,8693,69,12460,148,69,12241,69,10060
1775.392,17,142,11360,71,48,25362,48,5396,71,56,25362,56,5964
240.278,17,6,2640,6,412,48055,1238,2640,0,0,0,0,0
1772.326,6,180,15480,120,69,14893,69,8940,60,69,30031,69,6540
0.062,17,2,198,1,39,0,39,67,1,103,0,103,131
1745.221,6,95,7203,63,38,28148,205,4476,32,33,56284,98,2727
1770.136,6,223,19320,83,78,21585,336,8747,140,70,12734,1062,10573
10.746,6,6,328,4,0,3582,0,216,2,0,10523,0,112
1785.655,1,62,5208,0,0,0,0,0,62,56,29273,56,5208
1773.816,6,180,15480,120,69,14906,69,8940,60,69,30062,69,6540
0.415,6,7,295,4,0,138,0,164,3,7,106,7,131
0.166,6,43,19673,25,1054,6,1414,14732,18,467,9,1889,4941
0.12,6,36,21312,18,132,7,132,1076,18,1286,7,1448,20236
60.356,6,14,3888,8,127,8622,127,467,6,1056,12054,1704,3421
7.09,6,1482,1351718,927,1380,7,1408,1318194,555,776,12,1408,33524
1770.489,6,99,9232,66,64,27238,65,5573,33,58,55325,59,3659
0.006,17,3,1764,3,560,3,600,1764,0,0,0,0,0
21.763,17,6,456,6,48,4352,48,456,0,0,0,0,0
0.085,17,2,390,1,46,0,46,74,1,288,0,288,316
6.808,6,605,536292,384,1330,17,1368,520136,221,776,30,1473,16156
208.328,17,66,2660,44,12,4844,16,1772,22,12,4296,16,888
436.856,6,53,9715,20,108,22992,267,2000,33,236,13651,2840,7715
148.746,6,24,11029,12,380,72,832,1665,12,1109,13510,2568,9364
1787.247,17,87,3648,86,14,21026,14,3612,1,8,0,8,36
1795.374,17,448,39896,403,35,4466,288,25676,45,288,40026,288,14220
1784.467,6,356,22520,208,69,8620,69,12460,148,69,12138,69,10060
7.272,17,4,240,2,32,7271,32,120,2,32,7271,32,120
1781.334,6,353,22400,206,69,8689,69,12380,147,69,12200,69,10020
252.674,6,30,9170,13,229,160,498,1672,17,454,15786,1420,7498
262.813,1,16,1664,0,0,0,0,0,16,76,17520,76,1664
90.901,1,6,336,6,28,18180,28,336,0,0,0,0,0
1780.696,1,342,28728,342,56,5221,56,28728,0,0,0,0,0
1790.067,17,140,11200,70,48,25942,48,5320,70,56,25942,56,5880
2.496,17,3,1021,2,308,1987,308,672,1,321,0,321,349
1.425,6,10,1687,7,100,237,100,384,3,1179,582,1179,1303
1.67,6,13,2311,8,188,238,245,700,5,1407,354,1407,1611
1787.013,6,108,8536,68,65,26671,65,4930,40,59,45817,59,3606
5.016,17,4,396,2,37,5005,37,130,2,105,5000,105,266
555.554,17,81,6156,81,48,6944,48,6156,0,0,0,0,0
38.112,17,22,1936,11,48,3810,48,836,11,72,3810,72,1100
1742.655,6,95,7203,63,38,28107,205,4476,32,33,56204,98,2727
1792.539,6,356,22520,208,69,8659,69,12460,148,69,12194,69,10060
881.292,2,6,192,6,8,176258,8,192,0,0,0,0,0
1786.864,17,328,68939,328,182,5464,422,68939,0,0,0,0,0
0.291,17,8,2750,8,315,41,354,2750,0,0,0,0,0
1786.744,6,102,8296,68,65,26667,65,4930,34,59,54140,59,3366
1793.058,6,357,22629,208,69,8662,69,12460,149,69,12114,69,10169
1795.063,17,80,3354,79,14,23013,14,3318,1,8,0,8,36
1586.753,6,69,17406,43,325,37779,1360,9227,26,419,63463,3494,8179
3.537,6,20,3833,11,234,353,564,1504,9,463,416,1343,2329
10.995,6,87,24701,43,533,261,1152,18800,44,413,248,1152,5901
1682.836,17,16,1265,8,30,240401,37,471,8,71,240399,136,794
1046.57,17,13,1307,13,72,87214,355,1307,0,0,0,0,0
2.227,17,2,367,1,64,0,64,92,1,247,0,247,275
2.537,17,3,1167,3,361,1268,361,1167,0,0,0,0,0
1.015,17,2,116,2,30,1015,30,116,0,0,0,0,0
0.542,17,15,7248,7,606,82,1350,4438,8,323,66,1350,2810
1763.21,6,56,2576,28,0,65303,0,1456,28,0,65303,0,1120
0.511,6,19,7590,11,692,51,1408,3336,8,638,55,1408,4254
750.46,6,161,20833,77,158,9874,1189,8166,84,210,8763,1420,12667
3.135,17,16,2052,16,100,209,357,2052,0,0,0,0,0
2.954,17,2,312,2,128,2954,128,312,0,0,0,0,0
0.928,6,10,1687,7,100,154,100,384,3,1179,335,1179,1303
0.025,17,2,354,1,36,0,36,64,1,262,0,262,290
204.494,6,30,7432,14,158,15730,267,1357,16,603,13630,2036,6075
10.817,6,20,4442,11,275,1081,275,998,9,768,802,1440,3444
69.875,6,666,304857,342,827,204,1152,286051,324,417,215,1179,18806
0.114,17,2,187,1,46,0,46,74,1,85,0,85,113
0.257,17,2,148,1,32,0,32,60,1,60,0,60,88
2.8,6,13,2311,8,188,400,245,700,5,1407,631,1407,1611
0.36,17,7,2438,7,320,60,354,2438,0,0,0,0,0
6.669,6,38,7229,20,218,351,314,3423,18,513,361,1179,3806
90.734,17,4,240,2,32,90733,32,120,2,32,90733,32,120
1788.331,6,146,24231,91,245,19870,1289,14439,55,164,33115,1452,9792
0.446,6,25,8816,13,227,37,547,1592,12,1098,39,2896,7224
1786.237,6,360,22818,209,69,8587,69,12569,151,69,11908,69,10249
0.027,17,4,284,2,32,24,32,120,2,54,19,60,164
1787.146,6,107,8626,70,65,25900,65,5140,37,59,49639,59,3486
4.359,6,39,7269,19,218,242,314,3383,20,440,215,1152,3886
26.018,6,41,13497,20,331,1369,722,3121,21,794,1290,2760,10376
1789.321,17,83,3480,82,14,22090,14,3444,1,8,0,8,36
17.953,6,14,2245,8,211,2564,211,846,6,545,3590,904,1399
300.882,6,42,13686,24,891,13081,1460,8133,18,438,519,4027,5553
0.219,17,2,198,1,39,0,39,67,1,103,0,103,131
405.68,6,88,16024,42,775,9894,1418,10839,46,81,9014,580,5185
6.927,6,630,560075,402,1326,16,1368,543555,228,776,29,1473,16520
1794.199,17,144,11520,72,48,25270,48,5472,72,56,25270,56,6048
13.382,6,29,16164,12,483,1203,1440,2476,17,1298,827,1440,13688
360.934,2,4,128,4,8,120311,8,128,0,0,0,0,0
36.035,6,15,3196,8,49,5147,92,511,7,463,37,1408,2685
0.042,17,2,602,1,46,0,46,74,1,500,0,500,528
1798.577,1,345,28980,345,56,5228,56,28980,0,0,0,0,0
280.406,6,30,7432,13,158,23367,267,1317,17,603,17523,2760,6115
7.328,1,2,112,2,28,7328,28,112,0,0,0,0,0
0.34,6,10,1514,5,503,85,503,771,5,475,84,475,743
1788.062,6,117,13601,77,81,23527,505,6034,40,156,45845,1420,7567
371.408,6,18,1239,14,177,28569,177,913,4,110,20060,110,326
627.911,6,34,2237,17,36,39239,36,920,17,445,39239,445,1317
1.355,6,52,19541,29,899,48,1460,13800,23,400,53,1460,5741
4.729,6,39,7285,20,218,248,314,3423,19,516,248,1179,3862
1.395,6,40,11924,22,612,66,1360,6428,18,476,71,2715,5496
172.329,1,6,336,6,28,34465,28,336,0,0,0,0,0
1627.559,1,8,848,8,78,232508,78,848,0,0,0,0,0
1799.192,17,449,39928,404,35,4464,288,25708,45,288,40014,288,14220
1740.486,17,242,70845,242,264,7221,422,70845,0,0,0,0,0
1.028,6,7,295,4,0,342,0,164,3,7,428,7,131
17.777,6,17,4276,9,257,2222,722,1504,8,1164,2514,1448,2772
1799.226,17,448,39896,403,35,4475,288,25676,45,288,40017,288,14220
4.936,6,38,7229,20,218,259,314,3423,18,513,273,1179,3806
14.688,6,1005,936808,654,1358,22,1368,911736,351,776,41,2736,25072
1773.071,6,181,15589,120,69,14899,69,8940,61,69,29548,69,6649
697.375,1,18,1908,18,78,41022,78,1908,0,0,0,0,0
0.23,6,10,767,5,186,56,186,454,5,45,55,45,313
350.266,6,60,7173,29,109,12502,721,2839,31,136,11668,1448,4334
9.42,2,2,64,2,8,9420,8,64,0,0,0,0,0
1779.545,17,140,11200,70,48,25790,48,5320,70,56,25790,56,5880
97.516,17,4,240,2,32,97515,32,120,2,32,97514,32,120
1796.929,17,447,39580,403,35,4469,288,25676,44,288,40946,288,13904
0.799,6,24,5755,13,158,65,370,1315,11,799,79,1420,4440
1797.067,1,123,6888,123,28,14730,28,6888,0,0,0,0,0
47.267,6,6,268,1,0,0,0,40,5,7,11815,7,228
1711.799,1,8,448,8,28,244542,28,448,0,0,0,0,0
1790.873,6,220,17596,83,76,21837,338,8707,137,50,13167,143,8889
1784.481,6,359,22709,209,69,8579,69,12569,150,69,11976,69,10140
1681.275,1,14,784,14,28,129328,28,784,0,0,0,0,0
17.507,17,30,14586,15,698,1248,1350,10898,15,217,1248,1350,3688
126.499,6,9,528,2,112,126490,112,200,7,0,21081,0,328
0.276,6,22,5009,12,89,25,147,1000,10,870,29,1668,4009
280.191,6,28,7352,13,158,23349,267,1317,15,678,20010,2800,6035
7.861,1,2,130,2,37,7861,37,130,0,0,0,0,0
0.235,17,2,176,1,48,0,48,76,1,72,0,72,100
0.8,17,2,677,1,300,0,300,328,1,321,0,321,349
366.992,6,18,1239,14,177,28230,177,913,4,110,20056,110,326
1787.846,6,374,26606,214,104,8393,469,15652,160,69,11244,69,10954
0.008,17,4,414,2,40,0,40,136,2,111,1,117,278
0.045,17,4,368,2,32,14,32,120,2,96,0,96,248
36.172,6,20,4635,10,238,4019,722,1707,10,793,3957,1448,2928
11.618,6,1837,1598648,1113,1381,10,1420,1565467,724,467,16,1883,33181
1.258,6,236,172152,132,1319,9,1420,163677,104,475,12,1883,8475
3.832,6,71,39617,38,712,103,1438,6258,33,1265,118,1682,33359
1.259,6,12,5901,5,189,267,267,587,7,1256,183,4837,5314
20.283,6,20,2484,10,189,2253,517,1298,10,323,2248,499,1186
389.4,6,18,1239,14,177,29953,177,913,4,110,20074,110,326
0.051,6,6,716,3,302,17,302,458,3,102,10,102,258
1.089,17,27,15656,14,730,76,1350,10624,13,359,83,1350,5032
1740.538,6,87,6322,58,31,30535,31,3915,29,31,62161,31,2407
8.654,6,1349,1179520,824,1380,10,1420,1154275,525,526,16,3303,25245
1786.878,6,102,8296,68,65,26669,65,4930,34,59,54143,59,3366
0.267,17,2,201,1,50,0,50,78,1,95,0,95,123
1769.486,6,101,9344,66,65,27222,65,5577,35,59,52039,59,3767
1785.856,6,364,24992,212,94,8463,469,14496,152,69,11826,69,10496
1781.883,6,104,8376,68,65,26595,65,4930,36,59,50908,59,3446
1.355,6,50,20774,28,931,50,1360,15118,22,433,55,1360,5656
0.051,17,4,352,2,37,1,37,130,2,83,1,89,222
0.135,1,6,624,0,0,0,0,0,6,76,27,76,624
2.485,6,29,6175,15,338,177,1314,2294,14,368,190,1420,3881
696.32,6,131,8276,74,69,8755,69,4478,57,69,12434,69,3798
1740.843,6,87,6322,58,31,30541,31,3915,29,31,62172,31,2407
0.028,17,2,451,1,37,0,37,65,1,358,0,358,386
94.162,6,39,9799,14,291,7242,1189,2610,25,309,3923,1420,7189
285.456,17,4,352,2,60,285455,60,176,2,60,285455,60,176
0.079,6,3,144,2,0,79,0,104,1,0,0,0,40
30.901,17,4,240,2,32,30900,32,120,2,32,30900,32,120
1681.824,17,14,1036,7,30,280298,30,406,7,62,280298,62,630
245.346,6,52,9462,24,514,10667,1408,5942,28,171,9086,580,3520
126.6,2,2,64,2,8,126600,8,64,0,0,0,0,0
1773.443,6,180,15480,120,69,14902,69,8940,60,69,30049,69,6540
9.127,6,1549,1259266,830,1417,10,1448,1209470,719,776,12,1448,49796
6.469,6,9,520,4,0,2156,0,220,5,0,790,0,300
0.165,17,2,176,1,48,0,48,76,1,72,0,72,100
0.0,1,1,126,1,98,0,98,126,0,0,0,0,0
1799.102,17,253,49591,253,168,7139,358,49591,0,0,0,0,0
1772.821,6,266,32137,110,134,16263,1460,15590,156,131,11436,4562,16547
0.981,6,10,1687,7,100,163,100,384,3,1179,356,1179,1303
2.011,17,6,1340,4,40,670,41,274,2,505,2,505,1066
1775.93,1,81,6804,0,0,0,0,0,81,56,22199,56,6804
1776.72,17,298,70168,298,207,5982,422,70168,0,0,0,0,0
60.234,6,39,20411,19,131,3346,134,1520,20,991,3166,1448,18891
21.77,17,3,238,2,30,2034,30,116,1,94,0,94,122
60.467,6,13,3818,7,406,10077,721,1173,6,1164,12050,1448,2645
1770.093,6,99,9306,66,66,27232,66,5610,33,60,55312,60,3696
0.168,6,46,22670,27,1105,6,1420,17689,19,467,8,1883,4981
1783.737,6,111,8957,69,65,26231,65,5035,42,59,43503,59,3922
1652.237,1,8,448,8,28,236033,28,448,0,0,0,0,0
4.0,17,8,1840,4,64,1331,64,368,4,340,1331,360,1472
72.26,6,23,6772,6,156,14452,267,718,17,447,4499,1460,6054
669.569,6,116,8360,58,54,11746,69,3196,58,39,11699,63,5164
0.362,6,24,5937,12,164,32,453,1442,12,643,30,1542,4495
3.001,1,3,318,3,78,1500,78,318,0,0,0,0,0
69.239,6,689,315602,350,831,198,1152,295855,339,386,204,1152,19747
1741.608,6,87,6322,58,31,30554,31,3915,29,31,62199,31,2407
0.67,6,21,7220,13,319,55,602,1960,8,967,90,1471,5260
67.631,6,15,1590,6,226,13526,226,760,9,110,8431,110,830
1776.285,1,59,4956,59,56,30625,56,4956,0,0,0,0,0
0.923,6,27,8420,15,222,57,540,1964,12,1192,68,3151,6456
1769.926,6,99,9174,66,64,27229,64,5544,33,58,55296,58,3630
3.072,6,11,467,6,0,614,0,248,5,7,720,7,219
0.046,17,4,284,2,32,6,32,120,2,54,41,60,164
1785.758,6,104,8376,68,65,26653,65,4930,36,59,51019,59,3446
1.273,6,10,1687,7,100,212,100,384,3,1179,503,1179,1303
3.001,17,2,1430,2,687,3001,687,1430,0,0,0,0,0
1795.291,17,447,39864,402,35,4477,288,25644,45,288,40017,288,14220
280.379,6,29,7392,13,158,23364,267,1317,16,603,18690,1400,6075
0.018,17,2,358,1,64,0,64,92,1,238,0,238,266
0.016,17,2,136,1,32,0,32,60,1,48,0,48,76
1672.134,6,187,12954,67,46,25334,46,5394,120,46,14051,46,7560
1621.782,1,14,784,14,28,124752,28,784,0,0,0,0,0
1.346,6,48,18695,26,920,53,1460,13039,22,433,55,1460,5656
521.14,17,40,8719,40,189,13362,464,8719,0,0,0,0,0
264.29,6,23,6177,9,272,107,516,1180,14,403,20322,1452,4997
381.117,6,18,1242,14,180,29316,180,916,4,110,20065,110,326
1792.526,1,212,22472,212,78,8495,78,22472,0,0,0,0,0
0.239,6,26,7256,13,155,19,267,1301,13,603,18,1400,5955
1.351,17,24,10260,9,399,168,1350,3848,15,399,66,1350,6412
241.831,6,51,11382,25,158,10076,346,2602,26,616,9673,1408,8780
1776.695,17,140,11200,70,48,25748,48,5320,70,56,25748,56,5880
1770.984,6,97,9077,65,65,27671,65,5525,32,59,57125,59,3552
0.004,6,2,126,1,0,0,0,40,1,46,0,46,86
1751.392,6,94,7151,62,38,28711,205,4424,32,33,56483,98,2727
3.308,17,5,340,5,40,827,40,340,0,0,0,0,0
0.158,6,2,80,1,0,0,0,40,1,0,0,0,40
1.258,6,15,3479,7,288,194,288,588,8,639,155,853,2891
4.277,17,2,656,2,300,4277,300,656,0,0,0,0,0
1747.181,6,154,10149,82,57,21546,208,6339,72,31,24607,31,3810
1772.111,6,180,15480,120,69,14891,69,8940,60,69,30031,69,6540
75.604,6,31,7613,12,155,29,267,1266,19,398,4199,3417,6347
35.931,17,20,1760,10,48,3991,48,760,10,72,3991,72,1000
259.27,17,5,670,5,106,64817,346,670,0,0,0,0,0
2.034,17,3,3140,3,1018,1017,1438,3140,0,0,0,0,0
1799.354,17,449,39928,404,35,4464,288,25708,45,288,40019,288,14220
586.275,1,6,336,6,28,117255,28,336,0,0,0,0,0
21.6,17,2,904,1,300,0,300,328,1,548,0,548,576
0.069,17,2,588,1,39,0,39,67,1,493,0,493,521
10.244,6,1863,1683444,1166,1366,8,1402,1642536,697,776,14,2804,40908
1787.124,17,358,60797,358,141,5005,386,60797,0,0,0,0,0
1683.584,17,14,3843,7,30,280595,30,406,7,463,280594,463,3437
0.39,6,26,7068,12,155,35,267,1266,14,523,28,1460,5802
1790.2,1,58,4872,58,56,31407,56,4872,0,0,0,0,0
0.05,17,4,368,2,32,28,32,120,2,96,1,96,248
8.4,6,20,6847,11,275,840,275,723,9,1150,675,1414,6124
1759.379,6,128,8122,72,48,24779,208,4859,56,31,31984,31,3263
3.831,17,36,26290,17,561,239,1350,10028,19,827,203,1350,16262
1772.625,6,180,15480,120,69,14896,69,8940,60,69,30035,69,6540
1764.47,2,13,416,13,8,147039,8,416,0,0,0,0,0
0.0,17,1,904,1,876,0,876,904,0,0,0,0,0
317.073,6,56,12745,28,245,11743,1305,3686,28,377,11738,2720,9059
0.731,6,25,5847,13,156,60,267,1462,12,650,60,1420,4385
289.29,6,31,7480,13,158,24107,267,1317,18,603,17016,1400,6163
371.734,6,49,10312,31,266,12391,1360,4745,18,402,510,2667,5567
1.104,6,23,9472,14,350,84,1041,1992,9,1421,113,3830,7480
60.637,17,4,352,2,60,60636,60,176,2,60,60636,60,176
1777.419,6,196,21204,128,109,13995,965,12128,68,93,26528,485,9076
11.832,6,82,24565,41,552,295,1152,18784,41,459,289,1179,5781
0.232,17,5,1674,5,306,58,332,1674,0,0,0,0,0
1655.923,1,8,448,8,28,236560,28,448,0,0,0,0,0
1797.996,1,344,28896,344,56,5241,56,28896,0,0,0,0,0
1.893,6,2,87,1,0,0,0,40,1,7,0,7,47
1795.738,1,268,28408,268,78,6725,78,28408,0,0,0,0,0
75.122,17,4,272,2,40,75121,47,136,2,40,75121,47,136
1775.663,6,183,15807,120,69,14921,69,8940,63,69,28634,69,6867
5.03,6,42,8289,21,227,251,314,4022,21,489,237,1179,4267
0.186,6,3,160,2,0,186,0,100,1,0,0,0,60
240.492,6,58,24334,26,548,9619,1418,6299,32,861,7757,1418,18035
0.66,6,35,11825,20,563,34,1188,7801,15,539,40,1188,4024
48.131,6,434,333019,227,1385,212,1408,316585,207,1124,232,2816,16434
1787.467,6,104,8308,68,64,26678,64,4896,36,58,51068,58,3412
1552.319,1,78,4368,78,28,20159,28,4368,0,0,0,0,0
17.57,6,21,6686,5,154,4392,267,672,16,487,1166,1452,6014
5.131,6,38,7245,19,218,285,314,3383,19,516,271,1179,3862
122.065,6,26,9452,10,245,2864,383,2368,16,644,8121,1152,7084
1799.819,17,80,3354,79,14,23074,14,3318,1,8,0,8,36
531.589,2,10,320,10,8,59065,8,320,0,0,0,0,0
0.315,17,2,212,1,46,0,46,74,1,110,0,110,138
1796.37,17,422,37360,380,35,4739,288,24088,42,288,42943,288,13272
1680.495,1,15,870,15,30,120035,30,870,0,0,0,0,0
216.86,17,4,352,2,60,216859,60,176,2,60,216859,60,176
358.354,6,41,9874,21,158,17917,1018,3013,20,387,3238,1491,6861
0.038,17,2,384,1,32,0,32,60,1,296,0,296,324
1680.44,1,13,754,13,30,140036,30,754,0,0,0,0,0
26.753,17,4,320,2,48,26740,48,152,2,56,26740,56,168
1792.489,17,179,11456,179,36,10070,36,11456,0,0,0,0,0
12.665,6,2181,2026873,1396,1374,8,1408,1981389,785,931,15,2816,45484
1.273,6,52,19952,29,929,45,1460,14211,23,437,49,2615,5741
1796.824,6,354,22440,206,69,8764,69,12380,148,69,12223,69,10060
739.964,17,84,7033,78,30,9609,37,4545,6,386,136220,463,2488
778.948,1,60,3360,60,28,13202,28,3360,0,0,0,0,0
1795.195,17,142,11360,71,48,25645,48,5396,71,56,25645,56,5964
285.744,6,27,2905,14,324,21979,585,1385,13,282,23811,580,1520
7.515,6,32,8952,14,158,578,267,1357,18,687,431,2076,7595
1.53,6,45,17811,26,861,61,1360,12275,19,476,74,2715,5536
0.039,17,2,241,1,52,0,52,80,1,133,0,133,161
11.962,6,25,8473,13,275,996,275,1078,12,986,871,1440,7395
0.01,17,2,390,1,61,0,61,89,1,273,0,273,301
1295.557,17,243,18468,243,48,5353,48,18468,0,0,0,0,0
1738.93,6,87,6322,58,31,30507,31,3915,29,31,62103,31,2407
0.123,6,13,3514,7,75,20,75,447,6,1373,24,1448,3067
0.393,6,13,1693,7,288,64,288,588,6,426,43,434,1105
1740.747,6,89,6426,58,31,30539,31,3915,31,31,58024,31,2511
11.607,6,1830,1598588,1110,1385,10,1420,1565567,720,467,16,1883,33021
0.092,17,2,245,1,32,0,32,60,1,157,0,157,185
0.596,6,3,144,2,0,1,0,92,1,0,0,0,52
1680.573,17,12,498,11,14,168057,14,462,1,8,0,8,36
38.618,17,6,1236,3,48,19293,48,228,3,308,19301,308,1008
994.925,17,195,14820,195,48,5128,48,14820,0,0,0,0,0
0.241,17,2,152,1,48,0,48,76,1,48,0,48,76
243.741,6,54,11558,22,108,8910,267,2080,32,292,7862,1460,9478
0.256,17,2,268,1,54,0,54,82,1,158,0,158,186
2.0,6,12,2587,6,517,400,517,833,6,1418,216,1418,1754
7.52,6,6,280,2,0,7520,0,88,4,0,2430,0,192
281.324,6,31,7610,13,158,23443,267,1317,18,506,16523,1400,6293
0.018,6,9,1930,5,666,4,666,934,4,780,6,780,996
6.298,1,4,224,4,28,2099,28,224,0,0,0,0,0
1799.831,17,3942,189216,1971,20,913,20,94608,1971,20,913,20,94608
137.449,17,4,352,2,60,137447,60,176,2,60,137448,60,176
1772.445,6,180,15480,120,69,14894,69,8940,60,69,30039,69,6540
1771.23,6,101,9278,66,64,27249,64,5544,35,58,52092,58,3734
2.789,6,2,80,1,0,0,0,40,1,0,0,0,40
1681.301,17,14,3783,7,30,280216,30,406,7,454,280216,463,3377
194.173,17,4,240,2,32,194172,32,120,2,32,194172,32,120
14.501,6,14,5625,4,106,4830,106,274,10,706,1610,1420,5351
211.733,17,4,352,2,60,211731,60,176,2,60,211731,60,176
1033.859,1,87,4872,87,28,12021,28,4872,0,0,0,0,0
2.78,6,2,88,2,0,0,0,88,0,0,0,0,0
0.02,6,2,100,1,0,0,0,60,1,0,0,0,40
6.993,6,5,264,3,0,3496,0,160,2,0,1000,0,104
1.789,6,32,10333,19,277,99,564,1596,13,1026,135,1420,8737
1780.412,6,358,22738,208,69,8601,69,12598,150,69,11948,69,10140
0.027,6,2,116,1,0,0,0,52,1,0,0,0,64
8.103,6,9,527,5,43,2025,43,311,4,0,2699,0,216
12.862,6,20,7986,8,275,1837,275,599,12,767,1147,2760,7387
6.378,6,45,8409,24,227,277,314,4142,21,489,305,1179,4267
277.195,17,4,240,2,32,277194,32,120,2,32,277194,32,120
27.541,6,23,6180,14,117,2118,159,1337,9,873,3438,1675,4843
367.386,6,25,1651,17,177,22961,177,1117,8,110,9199,110,534
0.02,17,2,116,1,30,0,30,58,1,30,0,30,58
1624.255,2,15,480,15,8,116018,8,480,0,0,0,0,0
0.555,6,22,7345,13,334,46,663,2021,9,1209,64,1946,5324
1778.564,17,142,11360,71,48,25407,48,5396,71,56,25407,56,5964
1784.047,1,342,28728,342,56,5231,56,28728,0,0,0,0,0
3.746,17,4,352,2,48,3738,48,152,2,72,3736,72,200
1794.537,1,198,11088,198,28,9109,28,11088,0,0,0,0,0
1779.92,1,342,28728,342,56,5219,56,28728,0,0,0,0,0
1798.658,17,142,11360,71,48,25694,48,5396,71,56,25694,56,5964
1670.3,1,7,392,7,28,278383,28,392,0,0,0,0,0
0.278,6,27,9043,13,247,23,624,1672,14,947,20,1408,7371
250.193,6,4463,3547130,2599,1343,71,1360,3447323,1864,144,134,1360,99807
176.787,6,26,11996,12,832,125,1460,4687,14,842,13585,1551,7309
1779.511,17,291,62480,291,186,6136,392,62480,0,0,0,0,0
1784.714,17,142,11360,71,48,25495,48,5396,71,56,25495,56,5964
1787.539,6,104,8326,68,64,26679,65,4905,36,58,51064,59,3421
377.662,2,3,96,3,8,188831,8,96,0,0,0,0,0
1.011,17,2,116,2,30,1011,30,116,0,0,0,0,0
1791.518,6,380,67812,246,304,7312,304,50496,134,83,13469,83,17316
1796.804,6,98,7421,65,38,28075,205,4611,33,33,56137,98,2810
368.589,1,5,496,5,71,92147,142,496,0,0,0,0,0
16.386,17,17,5366,8,318,2336,1350,2769,9,260,2043,1350,2597
37.446,1,43,4472,0,0,0,0,0,43,76,891,76,4472
1681.356,17,18,4639,9,31,210168,37,536,9,427,210168,463,4103
0.584,6,115,87875,61,131,9,232,2969,54,1723,10,5440,84906
1773.225,6,180,15480,120,69,14901,69,8940,60,69,30046,69,6540
1.267,6,50,18600,27,842,48,1360,12904,23,433,49,1360,5696
1.282,6,49,19602,27,916,49,1360,13946,22,433,50,1360,5656
13.813,17,8,704,4,48,4600,48,304,4,72,4600,72,400
1783.814,6,369,23454,213,69,8414,69,12867,156,69,11508,69,10587
235.054,6,32,9657,15,158,16789,267,1397,17,841,14685,3456,8260
8.556,17,6,528,3,48,4274,48,228,3,72,4273,72,300
264.912,17,4,352,2,60,264911,60,176,2,60,264911,60,176
253.36,6,304,207611,165,1254,1544,1408,169175,139,725,329,2693,38436
280.012,6,27,7312,13,158,23334,267,1317,14,775,21538,4836,5995
0.417,6,13,1693,7,288,69,288,588,6,284,39,434,1105
240.21,6,55,19755,30,847,8282,1418,16826,25,202,10008,580,2929
1783.41,17,83,3480,82,14,22017,14,3444,1,8,0,8,36
240.216,6,56,18569,30,744,8283,1408,15716,26,186,9608,580,2853
1796.684,17,448,39896,403,35,4469,288,25676,45,288,40022,288,14220
243.38,6,62,14977,30,622,8392,1408,10959,32,192,7850,580,4018
0.102,17,2,180,1,30,0,30,58,1,94,0,94,122
1.626,6,39,9888,21,440,81,1360,4392,18,476,83,2715,5496
0.24,6,27,7296,13,155,20,267,1301,14,603,16,2036,5995
1773.025,6,181,15589,120,69,14899,69,8940,61,69,29547,69,6649
1620.406,17,28,29568,28,1028,60015,1028,29568,0,0,0,0,0
1773.789,6,180,15480,120,69,14905,69,8940,60,69,30056,69,6540
1.311,6,41,11380,21,616,65,1460,5804,20,433,59,1460,5576
1.808,6,12,2077,6,324,361,585,957,6,396,341,580,1120
0.052,1,2,112,2,28,52,28,112,0,0,0,0,0
3.933,17,8,736,4,64,1310,64,368,4,64,1310,64,368
1793.181,6,356,22520,208,69,8662,69,12460,148,69,12198,69,10060
1.011,6,27,8120,15,222,60,540,1964,12,1132,75,3051,6156
0.229,6,12,2105,6,503,45,503,835,6,475,45,475,1270
0.044,6,11,3650,6,170,8,170,490,5,1446,10,2675,3160
2.321,6,29,10361,17,366,145,832,1784,12,1011,203,1420,8577
1681.571,17,14,1036,7,30,280256,30,406,7,62,280256,62,630
0.258,6,4,1037,2,0,220,0,104,2,853,39,853,933
0.017,6,10,1654,5,625,4,625,893,5,493,4,493,761
0.013,17,2,513,1,40,0,40,68,1,417,0,417,445
0.234,1,2,112,2,28,234,28,112,0,0,0,0,0
0.275,1,2,112,2,28,275,28,112,0,0,0,0,0
263.884,1,6,336,6,28,52776,28,336,0,0,0,0,0
0.023,17,2,152,1,48,0,48,76,1,48,0,48,76
0.409,6,13,1693,7,288,64,288,588,6,426,43,434,1105
1662.084,17,157,54778,1,306,0,306,334,156,321,10716,321,54444
11.812,6,1878,1631748,1135,1383,10,1420,1597807,743,467,15,1883,33941
1.001,17,3,174,3,30,500,30,174,0,0,0,0,0
35.077,17,20,1760,10,48,3896,48,760,10,72,3896,72,1000
1777.262,17,140,11200,70,48,25757,48,5320,70,56,25757,56,5880
1786.27,6,102,8296,68,65,26660,65,4930,34,59,54126,59,3366
33.622,6,29,4990,15,180,2401,722,1859,14,399,2570,1448,3131
1.02,17,2,134,2,39,1020,39,134,0,0,0,0,0
280.5,6,31,7813,14,158,21576,267,1357,17,524,17529,1400,6456
0.256,6,24,6064,12,181,23,537,1526,12,651,22,1448,4538
1778.959,1,60,5040,60,56,30151,56,5040,0,0,0,0,0
300.182,6,42,13907,24,821,13043,1360,8385,18,435,17647,2667,5522
1682.34,17,16,1265,8,30,240329,37,471,8,71,240329,136,794
0.338,17,8,2750,8,315,48,354,2750,0,0,0,0,0
175.294,6,41,9242,19,200,9735,517,2433,22,564,8344,2736,6809
9.797,6,84,24885,43,526,233,1152,19088,41,461,238,1179,5797
38.881,17,22,1936,11,48,3887,48,836,11,72,3887,72,1100
1750.643,17,12,498,11,14,175064,14,462,1,8,0,8,36
21.408,17,12,1056,6,48,4279,48,456,6,72,4279,72,600
4.613,6,33,6129,17,206,288,314,2744,16,548,289,1179,3385
24.617,1,4,224,4,28,8205,28,224,0,0,0,0,0
1794.744,2,20,640,20,8,94460,8,640,0,0,0,0,0
0.026,17,2,184,1,32,0,32,60,1,96,0,96,124
300.261,6,28,8292,16,441,20017,1178,2618,12,630,2859,1491,5674
0.731,17,2,776,2,360,731,360,776,0,0,0,0,0
36.287,17,4,352,2,60,36286,60,176,2,60,36286,60,176
1780.781,6,209,16916,134,69,13389,69,9569,75,69,24064,69,7347
1.016,6,2,100,1,0,0,0,60,1,0,0,0,40
1799.942,6,1134,252711,592,421,3045,1380,127837,542,237,3326,469,124874
1741.208,6,87,6322,58,31,30547,31,3915,29,31,62185,31,2407
7.998,6,9,392,4,0,2666,0,172,5,0,1131,0,220
33.682,6,32,5146,15,154,2405,722,1860,17,299,2091,1408,3286
1787.513,17,87,3648,86,14,21029,14,3612,1,8,0,8,36
0.046,17,4,336,2,34,0,34,124,2,78,21,84,212
0.032,17,2,362,1,46,0,46,74,1,260,0,260,288
296.887,1,4,224,4,28,98962,28,224,0,0,0,0,0
1799.786,17,4430,212640,2215,20,812,20,106320,2215,20,812,20,106320
0.249,6,45,21428,26,1099,9,1420,16447,19,526,13,3303,4981
180.507,6,20,1040,10,0,20056,0,520,10,0,20056,0,520
280.282,6,30,7432,13,158,23356,267,1317,17,603,17514,2036,6115
270.133,6,31,8912,14,158,20779,267,1357,17,763,16876,2760,7555
1799.918,17,4464,214272,2232,20,806,20,107136,2232,20,806,20,107136
299.901,6,41,10035,21,593,14986,1360,4433,20,399,15774,1360,5602
0.273,6,114,115483,47,199,5,254,3261,67,1672,3,7501,112222
1789.634,17,140,11200,70,48,25936,48,5320,70,56,25936,56,5880
1740.359,6,87,6322,58,31,30532,31,3915,29,31,62155,31,2407
2.71,17,2,925,1,548,0,548,576,1,321,0,321,349
0.047,17,2,214,1,47,0,47,75,1,111,0,111,139
101.535,17,4,1344,4,308,33845,308,1344,0,0,0,0,0
280.208,17,4,1098,2,30,280199,30,116,2,463,280203,463,982
1682.082,17,14,1036,7,30,280341,30,406,7,62,280341,62,630
0.767,17,2,198,1,39,0,39,67,1,103,0,103,131
22.014,6,36,8455,18,410,513,882,1982,18,478,1286,2720,6473
9.859,6,23,5271,12,351,896,1382,2242,11,430,984,1420,3029
2.559,17,4,288,2,36,2228,36,128,2,52,2225,52,160
4.669,6,11,1155,6,185,929,267,795,5,53,1131,85,360
175.254,17,2,72,1,8,0,8,36,1,8,0,8,36
1740.94,6,87,6322,58,31,30542,31,3915,29,31,62175,31,2407
232.099,17,6,456,6,48,46419,48,456,0,0,0,0,0
1789.19,17,142,11360,71,48,25559,48,5396,71,56,25559,56,5964
1748.211,6,95,7203,63,38,28196,205,4476,32,33,56382,98,2727
1.529,6,39,8292,19,320,84,1162,2716,20,433,69,1460,5576
61.338,6,35,15923,22,809,2920,1408,9249,13,855,5091,3847,6674
0.042,17,4,336,2,34,0,34,124,2,78,0,84,212
1669.275,1,8,448,8,28,238467,28,448,0,0,0,0,0
1773.184,6,180,15480,120,69,14900,69,8940,60,69,30048,69,6540
204.822,17,4,352,2,60,204820,60,176,2,60,204821,60,176
9.112,17,16,1152,8,33,1301,33,488,8,55,1301,61,664
33.71,6,30,5042,15,154,2407,722,1859,15,399,2395,1402,3183
0.075,17,2,181,1,32,0,32,60,1,93,0,93,121
1787.37,1,215,12040,215,28,8352,28,12040,0,0,0,0,0
1776.164,17,73,3060,72,14,25016,14,3024,1,8,0,8,36
1798.851,6,356,22520,208,69,8690,69,12460,148,69,12237,69,10060
6.411,6,42,7864,22,275,305,975,4735,20,465,324,1179,3129
4.298,6,5,6008,5,1161,1074,1196,6008,0,0,0,0,0
157.646,1,4,224,4,28,52548,28,224,0,0,0,0,0
1771.231,17,310,66591,310,186,5732,422,66591,0,0,0,0,0
11.654,6,1792,1604685,1135,1363,10,1380,1572240,657,511,17,1923,32445
0.675,6,15,2638,8,288,91,288,640,7,568,82,853,1998
300.009,6,23,6742,11,158,30000,267,1237,12,836,27273,2045,5505
12.691,17,4,352,2,48,12676,48,152,2,72,12670,72,200
63.812,6,51,16547,30,849,2192,1360,10631,21,389,3178,4027,5916
249.996,6,8,2017,5,355,62499,413,1267,3,210,124892,269,750
154.279,6,30,7432,13,158,12856,267,1317,17,543,9640,1400,6115
11.88,6,17,1442,9,275,1485,275,918,8,96,1133,96,524
1.06,17,2,122,2,33,1060,33,122,0,0,0,0,0
32.197,6,218,212134,71,123,459,291,4061,147,1401,220,1418,208073
34.845,17,22,1936,11,48,3478,48,836,11,72,3476,72,1100
1780.021,17,140,11200,70,48,25797,48,5320,70,56,25797,56,5880
240.199,6,54,17926,30,800,8282,1418,15184,24,212,10442,580,2742
213.161,6,52,23166,28,770,7894,1162,5329,24,921,1850,2071,17837
14.125,6,14,2242,8,210,2017,210,844,6,545,2820,904,1398
0.305,6,22,7342,13,335,24,668,2026,9,968,36,1475,5316
10.772,6,20,7130,11,275,1077,275,998,9,1440,718,1440,6132
5.04,17,3,208,2,36,5003,36,128,1,52,0,52,80
316.664,6,935,798805,612,1335,518,1360,777919,323,184,77,1360,20886
1781.288,6,354,22440,207,69,8647,69,12420,147,69,12200,69,10020
7.872,6,32,8148,15,191,562,722,1944,17,613,410,1380,6204
1799.838,17,456,61917,213,188,8489,1350,46059,243,37,7414,1350,15858
11.826,6,25,8473,13,275,985,275,1078,12,986,859,1440,7395
1133.992,1,28,1568,28,28,41999,28,1568,0,0,0,0,0
240.698,6,50,9491,25,198,10027,751,2895,25,479,10027,1368,6596
1771.205,6,101,9410,66,66,27249,66,5610,35,60,52091,60,3800
7.6,6,1965,1829678,1249,1387,5,1408,1787782,716,931,10,2801,41896
1793.766,1,58,4872,58,56,31469,56,4872,0,0,0,0,0
1740.795,2,22,704,22,8,82895,8,704,0,0,0,0,0
1799.939,1,16,896,16,28,119995,28,896,0,0,0,0,0
6.892,6,25,7603,12,274,622,517,1466,13,780,570,1408,6137
1769.245,6,105,9828,68,66,26406,66,5792,37,60,49141,60,4036
1772.945,6,180,15480,120,69,14898,69,8940,60,69,30042,69,6540
1792.646,1,252,14112,252,28,7142,28,14112,0,0,0,0,0
5.618,6,40,7309,20,218,295,314,3423,20,513,280,1179,3886
0.403,6,7,376,4,0,134,0,216,3,0,99,0,160
0.014,17,2,332,1,43,0,43,71,1,233,0,233,261
61.338,6,37,15929,22,799,2920,1448,9151,15,665,4362,1448,6778
32.938,17,18,1368,18,48,1937,48,1368,0,0,0,0,0
1798.07,1,189,20034,189,78,9564,78,20034,0,0,0,0,0
1.362,6,49,21238,29,904,48,1360,15662,20,476,63,2715,5576
1740.402,17,29,30624,29,1028,62157,1028,30624,0,0,0,0,0
25.681,6,36,8360,18,378,511,786,1886,18,478,1501,2720,6474
14.517,6,8,440,5,0,3629,0,268,3,0,6906,0,172
4.571,6,23,11144,14,194,351,194,1010,9,1609,567,4464,10134
1740.439,6,87,6322,58,31,30534,31,3915,29,31,62157,31,2407
7.931,6,585,532761,375,1352,20,1368,516001,210,776,36,2736,16760
3.968,17,8,1176,4,48,1319,48,304,4,190,1318,308,872
64.009,6,23,9202,12,304,73,597,1461,11,1041,6382,2720,7741
0.178,6,20,5856,12,181,16,537,1526,8,781,24,2224,4330
377.282,6,18,1242,14,180,29021,180,916,4,110,20058,110,326
90.494,6,26,9788,14,467,856,675,2943,12,794,8213,1360,6845
2.079,6,30,10405,18,367,122,833,1825,12,1012,181,1420,8580
150.619,6,1370,696341,768,843,196,1152,666058,602,413,250,1179,30283
0.057,17,2,384,1,32,0,32,60,1,296,0,296,324
192.741,6,35,11798,19,653,10707,1418,9476,16,185,12848,580,2322
0.923,17,4,420,2,33,917,33,122,2,121,916,145,298
0.244,17,4,284,2,32,0,32,120,2,54,0,60,164
1791.793,17,142,11360,71,48,25596,48,5396,71,56,25596,56,5964
1798.7,6,367,25650,214,99,8444,469,15045,153,69,11831,69,10605
11.716,6,1827,1618129,1142,1363,10,1380,1585523,685,383,17,1380,32606
2.124,6,15,5671,8,272,303,516,1140,7,849,328,1452,4531
0.042,6,3,128,2,0,42,0,84,1,0,0,0,44
181.425,17,10,760,10,48,20158,48,760,0,0,0,0,0
1.044,6,25,6055,13,108,87,147,959,12,768,90,1581,5096
1777.904,6,201,22210,129,75,13889,267,10017,72,136,25036,1926,12193
0.07,17,2,2386,2,1165,70,1165,2386,0,0,0,0,0
111.597,6,79,56902,51,1211,2231,1368,48710,28,841,2290,2736,8192
386.46,6,24,1587,16,177,25764,177,1053,8,110,9345,110,534
1386.271,2,11,352,11,8,138627,8,352,0,0,0,0,0
6.153,6,1489,1356223,926,1386,6,1408,1322283,563,931,10,2801,33940
137.502,1,6,336,6,28,27500,28,336,0,0,0,0,0
0.106,6,9,1340,5,145,26,145,349,4,827,27,827,991
1763.969,6,126,7674,69,26,25940,26,4128,57,26,31498,26,3546
1781.093,1,144,8064,144,28,12455,28,8064,0,0,0,0,0
12.448,6,1225,1134739,751,1431,16,1448,1104219,474,776,25,1448,30520
156.492,1,6,636,6,78,31298,78,636,0,0,0,0,0
11.424,6,94,28482,48,578,243,1152,22160,46,407,248,1152,6322
1681.741,17,14,1036,7,30,280287,30,406,7,62,280288,62,630
3.807,17,4,352,2,48,3798,48,152,2,72,3796,72,200
820.357,1,44,2464,44,28,19078,28,2464,0,0,0,0,0
0.267,6,22,4442,11,165,26,456,1394,11,493,25,888,3048
274.522,6,8,2017,5,355,68630,413,1267,3,210,137157,269,750
899.461,6,12,728,8,31,128494,31,444,4,31,299723,31,284
4.908,17,2,136,1,32,0,32,60,1,48,0,48,76
39.071,17,44,6468,22,48,1860,48,1672,22,190,1860,308,4796
1795.066,17,144,11520,72,48,25282,48,5472,72,56,25282,56,6048
756.23,1,9,837,9,65,94528,88,837,0,0,0,0,0
30.75,17,28,11633,14,505,2362,1350,7469,14,269,2362,1350,4164
39.266,6,31,7354,14,179,3020,517,1824,17,463,2453,499,5530
317.135,6,56,12285,25,222,13213,1267,3506,31,342,10564,1629,8779
0.005,17,2,588,1,39,0,39,67,1,493,0,493,521
103.927,6,872,432257,488,826,213,1152,412106,384,435,270,1179,20151
1786.621,6,104,8444,68,66,26665,66,4964,36,60,51043,60,3480
27.437,6,39,8505,20,184,1444,721,2284,19,778,1512,1440,6221
1680.838,17,13,534,11,14,168064,14,462,2,8,1680554,8,72
111.773,6,42,25113,19,884,37,1360,6097,23,1130,5073,1696,19016
14.946,6,12,3076,7,49,2398,92,471,5,1164,3615,1448,2605
1.182,6,25,8056,12,164,91,267,1288,13,869,84,1408,6768
184.325,17,5,380,5,48,46081,48,380,0,0,0,0,0
1782.429,17,83,3480,82,14,22005,14,3444,1,8,0,8,36
9.143,6,23,6586,7,154,1523,267,752,16,518,577,1460,5834
8.524,6,17,5391,9,275,1065,275,643,8,1104,841,1440,4748
5.055,17,2,152,2,48,5055,48,152,0,0,0,0,0
300.696,6,39,8431,20,271,15826,738,1917,19,441,475,1440,6514
0.179,6,26,7256,13,155,14,267,1301,13,678,14,2800,5955
1682.859,17,14,1036,7,30,280467,30,406,7,62,280464,62,630
18.601,6,55,20392,26,950,744,1440,14372,29,433,652,1440,6020
1785.302,6,125,9978,74,64,24456,64,5328,51,58,35704,58,4650
1.346,6,44,15675,25,758,56,1360,10139,19,476,64,2715,5536
21.238,6,65,28055,35,560,623,1448,5786,30,900,731,1583,22269
1.481,6,29,6091,16,145,98,267,1666,13,650,97,1420,4425
4.355,6,2,88,2,0,0,0,88,0,0,0,0,0
236.534,17,4,352,2,60,236533,60,176,2,60,236533,60,176
1787.548,6,102,8296,68,65,26679,65,4930,34,59,54164,59,3366
344.393,17,52,3952,52,48,6752,48,3952,0,0,0,0,0
0.008,17,2,251,1,36,0,36,64,1,159,0,159,187
27.871,6,8,440,5,0,6967,0,268,3,0,13930,0,172
1727.704,1,77,4312,77,28,22732,28,4312,0,0,0,0,0
1772.892,6,181,15589,120,69,14898,69,8940,61,69,29544,69,6649
1786.829,17,142,11360,71,48,25525,48,5396,71,56,25525,56,5964
8.013,6,12,945,6,222,1600,222,466,6,231,1600,231,479
1.443,6,39,9888,20,502,75,1440,4352,19,433,68,1440,5536
5.015,17,4,558,2,36,5005,36,128,2,187,5005,187,430
1798.249,17,767,46250,767,32,2347,37,46250,0,0,0,0,0
7.074,6,465,409251,298,1311,23,1368,395903,167,776,41,1473,13348
1791.837,17,179,13962,179,50,10066,50,13962,0,0,0,0,0
1.018,6,27,6161,13,108,84,147,959,14,773,69,1608,5202
26.931,6,14,1605,5,308,252,565,884,9,61,3365,152,721
0.446,6,27,8942,13,232,37,569,1614,14,941,32,1438,7328
62.189,6,43,14435,25,447,2591,1282,4915,18,659,3645,1470,9520
1793.81,17,144,11520,72,48,25264,48,5472,72,56,25264,56,6048
18.302,6,42,8574,21,318,915,639,1886,21,389,431,2128,6688
1773.155,6,185,15887,122,69,14654,69,9020,63,69,28594,69,6867
1773.99,6,181,15589,120,69,14907,69,8940,61,69,29564,69,6649
0.311,17,11,4029,11,338,31,359,4029,0,0,0,0,0
1784.769,6,457,78030,274,304,6537,304,56452,183,83,9805,83,21578
301.259,6,75,57162,50,1229,6148,1368,50540,25,664,1231,1571,6622
1744.665,2,18,576,18,8,102627,8,576,0,0,0,0,0
1740.408,17,30,20190,30,645,60014,645,20190,0,0,0,0,0
0.002,6,2,933,1,0,0,0,40,1,853,0,853,893
0.006,17,2,531,1,40,0,40,68,1,435,0,435,463
52.472,6,44,10351,21,723,495,1360,4536,23,325,2377,1360,5815
12.133,17,6,510,3,37,6063,37,195,3,77,6062,77,315
331.464,17,6,424,3,42,165731,64,212,3,42,165731,64,212
240.235,6,53,18239,28,820,8897,1418,15414,25,189,10009,580,2825
11.813,6,1872,1632881,1134,1386,10,1420,1599140,738,467,16,1883,33741
1796.236,17,448,39896,403,35,4468,288,25676,45,288,40016,288,14220
58.799,6,11,851,11,31,5879,31,851,0,0,0,0,0
0.18,17,2,2386,2,1165,180,1165,2386,0,0,0,0,0
300.604,6,435,575972,178,145,1698,230,9844,257,2193,1174,7010,566128
68.522,6,9,515,5,43,17130,43,299,4,0,22837,0,216
1793.961,17,144,11520,72,48,25266,48,5472,72,56,25266,56,6048
1795.694,17,447,39864,402,35,4478,288,25644,45,288,40023,288,14220
1.483,6,46,17099,26,803,59,1360,11523,20,476,67,2715,5576
1749.293,6,94,7151,62,38,28676,205,4424,32,33,56417,98,2727
137.164,6,28,6621,16,168,9144,516,1655,12,498,10014,1452,4966
316.94,6,104,35906,54,567,5980,1360,24877,50,322,6465,3289,11029
171.953,1,2,120,2,32,171953,32,120,0,0,0,0,0
89.111,6,27,9324,13,570,70,1360,2834,14,739,6842,2720,6490
1772.119,6,180,15480,120,69,14891,69,8940,60,69,30034,69,6540
316.952,6,102,34376,55,532,5869,1360,23513,47,345,6887,2720,10863
0.01,17,2,326,1,32,0,32,60,1,238,0,238,266
1.684,6,25,8763,15,285,120,587,1459,10,985,167,1420,7304
2.083,6,24,8923,10,164,209,267,1196,14,873,146,1440,7727
31.736,6,7,396,1,0,0,0,60,6,0,6314,0,336
1757.596,1,58,3248,58,28,30835,28,3248,0,0,0,0,0
0.135,17,2,187,1,46,0,46,74,1,85,0,85,113
20.232,6,105,31561,54,552,381,1152,24245,51,439,387,1179,7316
37.352,17,22,1936,11,48,3734,48,836,11,72,3734,72,1100
470.253,6,52,14699,33,347,14695,1360,7283,19,604,26115,3494,7416
12.102,6,1900,1666559,1152,1391,10,1420,1632418,748,420,16,1420,34141
1721.118,17,199,48708,199,216,8692,422,48708,0,0,0,0,0
1767.385,1,58,4872,0,0,0,0,0,58,56,31006,56,4872
11.644,6,983,848082,559,1431,20,1448,819372,424,899,26,1448,28710
9.196,6,78,24341,40,550,235,1152,18680,38,459,240,1179,5661
56.685,17,4,352,2,48,56676,48,152,2,72,56676,72,200
291.164,1,4,224,4,28,97054,28,224,0,0,0,0,0
0.956,6,10,1687,7,100,159,100,384,3,1179,349,1179,1303
5.003,17,4,288,2,36,5002,36,128,2,52,5002,52,160
107.761,17,4,352,2,60,107760,60,176,2,60,107759,60,176
1796.339,6,247,36274,153,302,11818,302,26386,94,83,19315,83,9888
1797.413,17,447,39296,404,35,4460,288,25708,43,288,41931,288,13588
1.37,6,48,19145,26,955,54,1460,13489,22,433,56,1460,5656
240.212,6,54,18235,28,806,8896,1402,15176,26,212,9608,580,3059
1.623,17,3,1176,3,364,811,364,1176,0,0,0,0,0
239.077,17,8,1380,4,40,79689,40,272,4,249,79689,249,1108
15.668,17,5,380,5,48,3917,48,380,0,0,0,0,0
0.168,17,4,624,2,64,167,64,184,2,192,55,192,440
1740.809,17,30,31680,30,1028,60027,1028,31680,0,0,0,0,0
10.789,6,21,4442,12,275,980,275,1038,9,758,754,1420,3404
1794.29,17,144,11520,72,48,25271,48,5472,72,56,25271,56,6048
3.67,6,7,400,3,0,1835,0,160,4,0,1031,0,240
280.278,6,28,7352,13,158,23356,267,1317,15,678,20013,3436,6035
1786.403,6,104,8376,68,65,26662,65,4930,36,59,51037,59,3446
2.712,17,3,1176,3,364,1356,364,1176,0,0,0,0,0
252.034,2,3,96,3,8,126017,8,96,0,0,0,0,0
64.049,6,27,7177,13,155,5337,267,1306,14,530,4926,3417,5871
1772.521,6,180,15480,120,69,14895,69,8940,60,69,30035,69,6540
1773.46,6,180,15480,120,69,14903,69,8940,60,69,30050,69,6540
143.712,6,31,7843,17,158,8982,191,1542,14,1103,9923,1408,6301
0.011,17,2,186,1,29,0,29,57,1,101,0,101,129
0.371,6,8,335,4,0,123,0,164,4,7,63,7,171
4.753,17,5,4754,5,922,1188,1451,4754,0,0,0,0,0
1793.916,6,355,22480,207,69,8708,69,12420,148,69,12203,69,10060
0.051,17,2,212,1,46,0,46,74,1,110,0,110,138
12.71,6,1886,1740595,1224,1369,10,1380,1707317,662,421,19,1923,33278
0.026,17,2,672,2,308,26,308,672,0,0,0,0,0
0.374,6,50,22408,28,1075,13,1380,17286,22,421,16,1923,5122
0.524,17,3,451,2,39,257,39,134,1,289,0,289,317
0.524,6,7,295,4,0,174,0,164,3,7,152,7,131
1793.052,6,363,23007,211,69,8538,69,12718,152,69,11874,69,10289
0.037,6,11,3652,6,171,6,171,491,5,1446,8,2675,3161
120.149,6,54,29748,32,1067,3874,1448,23015,22,466,5715,1559,6733
31.558,6,7,420,2,0,1533,0,120,5,0,7888,0,300
1315.008,6,307,18421,153,69,8651,69,9156,154,34,8594,48,9265
842.274,2,11,352,11,8,84227,8,352,0,0,0,0,0
1746.581,6,95,7203,63,38,28170,205,4476,32,33,56328,98,2727
1769.482,6,104,9565,67,65,26810,65,5694,37,59,49147,59,3871
4.077,17,5,340,5,40,1019,40,340,0,0,0,0,0
0.008,6,3,232,2,112,3,112,192,1,0,0,0,40
54.738,6,36,8455,18,410,514,882,1982,18,478,3210,2128,6473
1785.283,6,201,26046,111,304,16229,304,17772,90,83,20058,83,8274
383.654,6,7,408,5,112,95909,112,320,2,0,383638,0,88
6.029,6,11,467,6,0,1205,0,248,5,7,748,7,219
3.216,6,5,216,2,0,45,0,84,3,0,1600,0,132
0.848,6,35,8152,19,241,47,619,1758,16,522,47,2880,6394
1786.681,6,360,22818,209,69,8589,69,12569,151,69,11911,69,10249
0.016,17,4,780,2,32,1,32,120,2,302,0,308,660
1.592,6,55,21662,31,912,53,1360,15881,24,400,59,1360,5781
0.414,6,21,7203,12,318,37,600,1906,9,964,46,1471,5297
5.826,17,26,11035,12,564,529,1350,7106,14,252,443,1350,3929
0.011,17,4,344,2,47,5,47,150,2,69,7,75,194
1793.999,17,268,58602,268,190,6719,422,58602,0,0,0,0,0
1793.819,17,67,2802,65,14,28025,14,2730,2,8,1793636,8,72
300.78,6,71,53639,46,1247,6684,1368,47326,25,715,1916,1571,6313
1.716,6,14,2351,8,188,245,245,700,6,703,290,1152,1651
291.836,2,2,64,2,8,291836,8,64,0,0,0,0,0
1797.921,1,345,28980,345,56,5226,56,28980,0,0,0,0,0
1741.49,6,91,6604,59,31,30025,31,3998,32,31,56176,31,2606
0.84,6,255,262754,72,781,11,1408,13288,183,1378,4,2816,249466
1.949,17,4,240,2,32,1948,32,120,2,32,1948,32,120
1797.043,17,482,69677,234,184,7712,1350,49710,248,52,7267,1350,19967
1791.19,1,229,12824,229,28,7856,28,12824,0,0,0,0,0
1798.062,1,228,24168,228,78,7920,78,24168,0,0,0,0,0
1799.834,17,448,39612,404,35,4466,288,25708,44,288,40950,288,13904
280.322,6,29,7392,13,158,23360,267,1317,16,603,18684,2036,6075
171.191,6,21,9112,11,378,63,815,1606,10,1182,19006,2606,7506
1775.833,6,104,8308,68,64,26504,64,4896,36,58,50735,58,3412
126.387,2,2,64,2,8,126387,8,64,0,0,0,0,0
1.709,17,2,204,1,34,0,34,62,1,114,0,114,142
0.429,6,14,1733,7,288,67,288,588,7,284,39,434,1145
20.16,6,21,6720,7,275,3360,275,559,14,466,1409,1414,6161
1798.262,17,448,39896,403,35,4473,288,25676,45,288,40026,288,14220
136.291,17,4,352,2,60,136290,60,176,2,60,136290,60,176
14.439,6,16,3165,8,194,2062,293,1298,8,308,1056,1179,1867
240.456,6,54,23709,25,538,10018,1402,6158,29,1002,8587,2782,17551
0.074,6,9,1344,5,145,18,145,349,4,831,20,831,995
57.813,6,48,10447,22,541,741,910,3139,26,312,2306,1460,7308
207.866,17,6,360,3,32,103932,32,180,3,32,103932,32,180
0.1,1,2,112,2,28,100,28,112,0,0,0,0,0
1797.918,17,449,39928,404,35,4461,288,25708,45,288,40019,288,14220
92.807,6,9,998,8,105,13258,105,954,1,0,0,0,44
1533.727,6,24,3973,16,262,102248,413,2740,8,114,219073,269,1233
240.185,6,54,18137,29,794,8577,1402,15027,25,225,10007,580,3110
1.526,17,3,639,2,39,1001,39,134,1,477,0,477,505
2.084,17,2,672,2,308,2084,308,672,0,0,0,0,0
1772.357,6,180,15480,120,69,14893,69,8940,60,69,30032,69,6540
54.133,6,43,10186,17,533,47,910,2847,26,314,2160,2128,7339
1788.536,17,87,3648,86,14,21041,14,3612,1,8,0,8,36
69.782,6,49,10455,22,533,729,910,3107,27,312,2678,1360,7348
1774.015,6,182,15629,121,69,14783,69,8980,61,69,29561,69,6649
86.676,17,8,704,4,48,28889,48,304,4,72,28889,72,400
0.065,17,4,588,2,48,60,48,152,2,190,57,308,436
1777.301,17,140,11200,70,48,25757,48,5320,70,56,25757,56,5880
1772.268,6,180,15480,120,69,14893,69,8940,60,69,30036,69,6540
4.298,6,14,2355,7,188,716,245,660,7,1407,675,1407,1695
0.489,6,10,968,5,256,119,256,460,5,304,118,304,508
274.624,17,4,240,2,32,274623,32,120,2,32,274623,32,120
1.633,6,13,2311,8,188,233,245,700,5,1407,346,1407,1611
0.4,6,19,6129,10,400,43,559,1754,9,649,49,1408,4375
0.883,6,10,1687,7,100,147,100,384,3,1179,318,1179,1303
1776.761,17,139,11116,70,48,25749,48,5320,69,56,26128,56,5796
0.051,17,4,336,2,34,0,34,124,2,78,2,84,212
1360.358,6,116,9288,66,88,20928,270,6544,50,31,27758,31,2744
10.845,6,1603,1480006,1045,1365,10,1432,1453383,558,427,19,1432,26623
60.349,6,20,8837,11,734,6034,1448,3518,9,807,7537,1448,5319
45.152,6,19,4202,9,296,5644,722,1353,10,465,4993,1408,2849
1741.422,17,29,30624,29,1028,62193,1028,30624,0,0,0,0,0
0.486,6,6,324,4,0,162,0,216,2,0,249,0,108
0.144,6,40,17634,24,982,6,1420,12773,16,467,9,1883,4861
1794.517,17,87,3648,86,14,21111,14,3612,1,8,0,8,36
15.631,17,18,5552,9,334,1950,1350,3262,9,226,1950,1350,2290
5.737,6,43,8329,21,227,286,314,4022,22,489,260,1179,4307
3.911,6,53,19093,29,864,139,1460,13300,24,400,149,1460,5793
23.718,6,73,32252,39,896,624,1360,22260,34,606,711,1938,9992
1786.572,6,104,8376,68,65,26665,65,4930,36,59,51042,59,3446
1.611,6,50,20056,28,883,59,1360,14400,22,433,67,1360,5656
1.624,6,7,295,4,0,541,0,164,3,7,308,7,131
0.143,17,2,180,1,30,0,30,58,1,94,0,94,122
1754.047,6,98,7421,65,38,27406,205,4611,33,33,54803,98,2810
60.49,6,31,7315,17,142,3780,174,1110,14,512,3622,1452,6205
0.971,6,24,8004,12,164,88,267,1288,12,869,72,1408,6716
240.231,6,57,19606,29,838,8579,1402,16619,28,190,8897,580,2987
2.792,6,23,6473,11,268,274,517,1385,12,744,249,1418,5088
59.278,17,4,240,2,32,59277,32,120,2,32,59277,32,120
1542.146,6,305,19238,178,69,8712,69,10639,127,69,12239,69,8599
4.425,6,14,3142,6,92,885,92,400,8,463,328,1448,2742
574.558,1,37,2072,37,28,15959,28,2072,0,0,0,0,0
75.786,6,32,7653,13,155,6315,267,1306,19,398,4209,3417,6347
57.673,6,11,1003,6,332,11534,332,652,5,83,14395,83,351
0.229,17,4,368,2,32,119,32,120,2,96,125,96,248
122.85,17,2,136,2,40,122850,47,136,0,0,0,0,0
7.485,6,497,412893,302,1300,24,1368,398089,195,776,37,1473,14804
99.652,17,6,528,3,48,49824,48,228,3,72,49822,72,300
12.915,6,24,4601,12,204,1158,722,1656,12,579,1158,1448,2945
0.751,6,163,108383,88,1300,8,1420,101080,75,427,9,1420,7303
0.255,17,2,152,1,48,0,48,76,1,48,0,48,76
22.039,6,42,14227,22,964,427,1360,8625,20,399,1150,1360,5602
1778.0,6,338,31014,145,67,12345,659,11708,193,98,9259,1638,19306
1761.703,6,160,9681,84,44,21222,208,5742,76,31,23487,31,3939
4.434,6,37,7189,19,218,246,314,3383,18,513,244,1179,3806
0.085,6,13,4277,7,127,13,127,499,6,1152,15,1845,3778
1792.84,17,87,3648,86,14,21092,14,3612,1,8,0,8,36
0.306,17,2,158,1,34,0,34,62,1,68,0,68,96
93.143,1,30,3120,0,0,0,0,0,30,76,3211,76,3120
1796.078,6,358,28766,204,75,8847,267,13155,154,131,11738,1460,15611
9.864,6,80,24485,39,552,259,1152,18704,41,459,240,1179,5781
373.359,6,23,1538,16,180,24890,180,1056,7,110,10382,110,482
1770.597,1,182,10192,182,28,9782,28,10192,0,0,0,0,0
1737.146,1,56,4704,56,56,31584,56,4704,0,0,0,0,0
0.411,6,22,7342,12,335,36,668,1974,10,1210,45,1906,5368
1741.529,6,90,6521,59,31,30026,31,3998,31,31,58045,31,2523
1793.298,17,140,11200,70,48,25989,48,5320,70,56,25989,56,5880
1794.082,17,271,55272,271,175,6644,422,55272,0,0,0,0,0
1791.175,6,360,22887,209,69,8611,69,12500,151,69,11941,69,10387
1776.158,1,214,11984,214,28,8338,28,11984,0,0,0,0,0
4.163,6,2,88,2,0,0,0,88,0,0,0,0,0
1799.134,6,356,22520,208,69,8691,69,12460,148,69,12238,69,10060
6.021,17,4,488,4,94,2007,94,488,0,0,0,0,0
1793.783,6,436,26428,219,69,8135,69,13176,217,37,8304,69,13252
503.588,2,3,96,3,8,251794,8,96,0,0,0,0,0
1782.494,1,66,5544,66,56,27422,56,5544,0,0,0,0,0
300.976,6,37,8351,19,271,16720,739,1878,18,441,518,1440,6473
1787.86,17,87,3648,86,14,21033,14,3612,1,8,0,8,36
0.003,6,3,120,2,0,3,0,80,1,0,0,0,40
300.081,6,51,11240,25,687,12496,1460,5243,26,290,11996,1460,5997
4.909,17,19,7716,9,523,609,1350,4959,10,247,541,1350,2757
0.07,6,3,144,2,0,0,0,104,1,0,0,0,40
1790.116,17,88,3687,86,13,21055,14,3607,2,12,1790116,16,80
18.323,17,38,26382,19,790,1013,1350,15547,19,542,1011,1350,10835
316.948,6,109,36106,56,553,5762,1360,24957,53,322,6092,3289,11149
1799.789,6,354,22509,205,69,8822,69,12340,149,69,12160,69,10169
20.173,6,24,5847,14,107,1551,159,1190,10,825,2237,1669,4657
1.44,6,39,9900,21,440,72,1360,4404,18,433,73,1360,5496
292.039,6,36,7137,17,262,18249,517,1680,19,744,16221,1418,5457
1793.458,6,320,21425,187,69,9563,69,11965,133,69,13586,69,9460
192.834,17,4,352,2,60,192833,60,176,2,60,192833,60,176
1795.648,17,449,39928,404,35,4455,288,25708,45,288,40016,288,14220
1730.23,6,70,5108,45,33,39323,33,3102,25,31,72084,31,2006
2.544,6,36,8394,18,357,149,1384,2898,18,433,131,1440,5496
1795.206,1,58,4872,58,56,31494,56,4872,0,0,0,0,0
280.412,6,28,7352,12,158,25492,267,1277,16,603,18686,1400,6075
13.78,6,27,4867,13,154,1129,722,1767,14,394,1046,1402,3100
4.597,6,633,683616,265,230,17,255,18149,368,1780,12,8448,665467
1.533,6,62,45016,39,1237,40,1408,37915,23,1179,62,3819,7101
14.775,6,21,6825,12,275,1343,275,1038,9,1353,1221,1440,5787
8.994,6,17,6735,9,275,1124,275,643,8,1440,1020,1440,6092
42.002,17,48,7056,24,48,1825,48,1824,24,190,1825,308,5232
15.89,6,149,59309,78,703,206,1152,52360,71,456,223,1179,6949
1782.042,6,109,8712,70,65,25826,65,5205,39,59,46828,59,3507
1741.979,1,56,4704,56,56,31672,56,4704,0,0,0,0,0
14.62,6,6,280,2,0,14620,0,88,4,0,2352,0,192
14.575,6,29,12315,16,728,971,1368,4484,13,1021,1211,2285,7831
1700.754,17,12,498,11,14,170075,14,462,1,8,0,8,36
0.014,6,15,4004,8,124,1,124,572,7,1020,2,1448,3432
0.479,6,24,6041,13,108,39,147,959,11,773,45,1608,5082
1793.233,17,180,14040,180,50,10018,50,14040,0,0,0,0,0
295.251,1,2,120,2,32,295251,32,120,0,0,0,0,0
186.539,17,7,2352,7,308,31089,308,2352,0,0,0,0,0
80.902,6,29,12983,14,608,117,1360,3644,15,1090,5764,1360,9339
0.151,17,9,4349,4,433,50,1350,1847,5,472,20,1350,2502
7.423,17,12,1764,6,48,1480,48,456,6,190,1480,308,1308
1740.138,1,15,840,15,28,124295,28,840,0,0,0,0,0
1795.536,17,448,39896,403,35,4466,288,25676,45,288,40020,288,14220
0.223,6,12,1480,6,304,44,304,952,6,102,43,102,528
3.11,17,5,588,4,64,1030,64,368,1,192,0,192,220
0.522,17,27,14251,14,802,40,1350,11627,13,173,40,1350,2624
48.057,6,45,8924,22,412,806,889,2220,23,481,2178,3488,6704
0.03,17,4,865,2,47,0,47,150,2,329,3,341,715
1778.1,6,104,8376,68,65,26538,65,4930,36,59,50800,59,3446
0.125,17,2,2380,2,1162,125,1162,2380,0,0,0,0,0
405.488,6,25,2320,11,330,40547,330,1264,14,83,31190,83,1056
1700.432,17,12,498,11,14,170043,14,462,1,8,0,8,36
0.109,6,10,766,5,185,26,185,453,5,45,26,45,313
276.406,6,51,14366,23,168,12563,267,2445,28,674,10236,2800,11921
240.357,6,44,9332,22,524,11444,1418,5868,22,256,11444,639,3464
29.475,6,45,8762,21,345,773,720,1955,24,364,1275,1460,6807
0.219,6,2,672,1,0,0,0,40,1,580,0,580,632
324.372,6,47,13455,23,168,14741,267,2445,24,836,14102,3436,11010
92.7,6,51,14207,21,490,2033,1189,5262,30,407,3193,1460,8945
197.098,17,4,352,2,60,197096,60,176,2,60,197097,60,176
4.063,6,39,7269,20,218,213,314,3423,19,440,212,1152,3846
1791.317,1,341,28644,341,56,5268,56,28644,0,0,0,0,0
392.543,6,23,1538,16,180,26169,180,1056,7,110,10421,110,482
1790.787,6,265,43991,152,304,11859,304,31200,113,83,15988,83,12791
4.0,6,11,467,6,0,800,0,248,5,7,742,7,219
1418.389,6,109,11256,64,70,22511,722,5509,45,100,32232,1408,5747
1776.523,6,180,15480,120,69,14928,69,8940,60,69,30103,69,6540
48.317,6,6419,6078572,4106,1400,11,1448,5953620,2313,776,20,1448,124952
243.907,6,39,8095,20,198,12837,629,2836,19,387,13550,1539,5259
1789.682,17,138,11040,69,48,26318,48,5244,69,56,26318,56,5796
1778.045,1,58,4872,58,56,31193,56,4872,0,0,0,0,0
1.411,17,18,5662,8,368,196,1350,3170,10,221,148,1350,2492
1.528,6,10,924,5,283,338,283,551,5,105,336,105,373
0.097,6,9,1338,5,549,24,549,753,4,421,26,421,585
315.463,6,20,2429,7,242,52576,517,1111,13,323,26288,499,1318
10.569,6,21,3240,10,282,1174,531,1666,11,493,1044,828,1574
1787.559,6,104,8376,68,65,26679,65,4930,36,59,51069,59,3446
1720.639,17,13,534,11,14,172045,14,462,2,8,1720457,8,72
9.99,6,80,24757,41,561,249,1152,19056,39,413,255,1152,5701
24.006,6,41,9081,22,390,1143,1216,2522,19,445,483,1928,6559
1634.673,1,8,448,8,28,233524,28,448,0,0,0,0,0
2.154,17,6,460,3,40,994,41,206,3,56,1066,57,254
299.995,1,2,112,2,28,299995,28,112,0,0,0,0,0
1772.514,6,204,22399,131,75,13634,267,10097,73,135,24615,2840,12302
1783.897,6,368,25690,213,99,8414,469,15005,155,69,11583,69,10685
710.103,6,69,11571,30,106,19087,516,2800,39,218,18684,1452,8771
240.199,6,56,19556,30,799,8282,1408,16761,26,179,9607,580,2795
23.048,6,35,8260,16,175,1536,722,2047,19,778,1265,2760,6213
10.97,6,18,4266,10,275,1218,275,958,8,992,884,1440,3308
240.289,6,43,8967,21,523,12014,1408,5812,22,222,11442,618,3155
240.835,6,93,71416,63,1243,3884,1408,61718,30,739,3876,2439,9698
1.145,6,24,8004,12,164,88,267,1288,12,1014,88,2804,6716
5.854,6,552,494697,354,1333,15,1368,479737,198,776,28,1473,14960
0.091,17,2,198,1,39,0,39,67,1,103,0,103,131
368.779,6,25,1651,17,177,23048,177,1117,8,110,9194,110,534
1263.39,2,13,416,13,8,105282,8,416,0,0,0,0,0
12.198,17,10,845,5,34,3048,34,310,5,79,3047,79,535
13.398,17,4,352,2,48,13389,48,152,2,72,13389,72,200
48.591,6,14,777,4,0,16197,0,204,10,7,5376,7,573
1.517,6,53,19303,29,879,54,1360,13522,24,400,57,1360,5781
0.923,17,2,122,2,33,923,33,122,0,0,0,0,0
240.212,6,55,17553,28,772,8896,1402,14602,27,192,9238,580,2951
1789.576,17,144,11520,72,48,25205,48,5472,72,56,25205,56,6048
37.096,1,43,4472,0,0,0,0,0,43,76,883,76,4472
0.214,17,2,176,1,48,0,48,76,1,72,0,72,100
1744.693,2,16,512,16,8,116312,8,512,0,0,0,0,0
1791.853,1,342,28728,342,56,5254,56,28728,0,0,0,0,0
1787.495,6,104,8376,68,65,26679,65,4930,36,59,51066,59,3446
1.914,6,25,5795,14,158,146,370,1355,11,999,190,1737,4440
0.363,6,12,1653,6,288,71,288,548,6,426,40,434,1105
12.236,6,1932,1667379,1179,1362,10,1380,1632972,753,387,16,1923,34407
9.308,6,69,21163,36,575,265,1152,16416,33,489,282,1179,4747
0.1,6,9,1340,5,145,25,145,349,4,827,25,827,991
0.541,17,2,154,1,33,0,33,61,1,65,0,65,93
15.824,17,20,13207,11,977,1574,1350,11065,9,210,1968,1350,2142
12.37,17,8,3864,8,455,1767,548,3864,0,0,0,0,0
865.085,6,89,7631,58,71,15176,138,4390,31,69,28835,69,3241
0.084,2,2,64,2,8,84,8,64,0,0,0,0,0
1792.682,6,286,36370,119,139,15191,1360,17232,167,148,10798,3302,19138
0.016,17,8,2454,8,278,2,317,2454,0,0,0,0,0
214.98,1,6,336,6,28,42996,28,336,0,0,0,0,0
0.0,17,2,1152,1,548,0,548,576,1,548,0,548,576
280.867,6,32,7650,13,158,23405,267,1317,19,464,15603,1400,6333
3.09,6,52,19774,27,920,118,1440,13998,25,433,116,1440,5776
9.182,17,8,552,4,33,3058,33,244,4,49,3058,49,308
10.065,6,16,3911,9,275,1258,275,643,7,992,874,1440,3268
0.075,17,2,708,1,40,0,40,68,1,612,0,612,640
9.331,6,27,8752,13,158,777,267,1317,14,981,713,3445,7435
296.293,6,6,364,4,31,98764,31,222,2,31,296276,31,142
503.62,2,5,160,5,8,125905,8,160,0,0,0,0,0
1797.66,1,246,26076,246,78,7337,78,26076,0,0,0,0,0
1455.135,6,179,13700,68,70,21716,316,6585,111,48,13227,78,7115
8.249,6,1700,1538725,1051,1384,7,1408,1500301,649,931,12,2816,38424
32.06,6,23,6180,14,117,2466,159,1337,9,873,4006,1675,4843
1629.558,1,8,448,8,28,232794,28,448,0,0,0,0,0
280.411,6,30,7432,13,158,23367,267,1317,17,603,17521,2076,6115
11.356,6,26,9953,13,275,946,275,1078,13,1042,809,1440,8875
1694.961,6,108,8614,69,65,24925,65,4840,39,58,44601,59,3774
0.016,6,6,300,5,0,0,0,260,1,0,0,0,40
0.938,6,24,8004,12,164,85,267,1288,12,869,69,1402,6716
21.728,6,9,527,5,43,5432,43,311,4,0,7240,0,216
307.526,6,1929,1888167,691,331,445,333,38923,1238,1449,248,4314,1849244
240.195,6,54,18068,28,800,8895,1402,15080,26,203,9607,580,2988
12.086,6,1682,1548179,1092,1365,11,1432,1520168,590,427,20,1432,28011
0.029,6,14,4044,8,88,4,88,452,6,1670,5,1880,3592
1401.772,17,12,888,6,30,280351,30,348,6,62,280352,62,540
1720.446,17,12,498,11,14,172044,14,462,1,8,0,8,36
281.297,6,30,7432,13,158,23441,267,1317,17,543,17559,1400,6115
12.233,6,1276,1174741,776,1433,15,1448,1142705,500,776,23,1448,32036
146.072,17,9,3690,9,382,18259,392,3690,0,0,0,0,0
300.408,6,25,9313,13,356,25034,826,2121,12,820,3057,1440,7192
240.174,6,50,15097,26,732,9606,1402,12352,24,186,10442,580,2745
1.01,17,2,244,2,94,1010,94,244,0,0,0,0,0
31.025,17,5,3575,5,687,7756,687,3575,0,0,0,0,0
0.021,6,10,1677,6,555,4,951,1354,4,159,6,159,323
1782.065,6,102,8296,68,65,26597,65,4930,34,59,53999,59,3366
1775.149,6,180,15480,120,69,14917,69,8940,60,69,30081,69,6540
0.532,6,10,968,5,256,131,256,460,5,304,131,304,508
4.921,17,4,288,2,36,4904,36,128,2,52,4904,52,160
0.172,6,46,21241,26,1082,6,1420,16220,20,467,8,1883,5021
0.157,6,10,1677,6,555,31,951,1354,4,159,27,159,323
280.513,6,30,7432,13,158,23376,267,1317,17,603,17528,2076,6115
1.101,17,8,660,4,33,365,33,244,4,76,365,82,416
280.252,6,30,7432,13,158,23354,267,1317,17,543,17514,1400,6115
1.042,6,20,5920,11,285,104,556,1300,9,709,115,1380,4620
1.179,6,57,15031,28,549,43,1429,5008,29,465,41,1986,10023
11.945,6,90,26269,44,551,277,1152,19947,46,407,260,1152,6322
0.128,17,2,362,1,32,0,32,60,1,274,0,274,302
560.437,17,6,444,3,30,280209,30,174,3,62,280209,62,270
1.225,6,23,7952,12,164,95,267,1288,11,1216,104,3819,6664
369.717,6,25,1651,17,177,23107,177,1117,8,110,9230,110,534
1645.974,1,7,392,7,28,274329,28,392,0,0,0,0,0
1746.858,6,95,7203,63,38,28175,205,4476,32,33,56342,98,2727
3.274,6,561,458466,329,1366,9,1420,444965,232,467,14,1883,13501
20.901,6,78,55539,47,394,454,541,3312,31,1960,273,9940,52227
37.595,17,22,1672,22,48,1790,48,1672,0,0,0,0,0
114.439,17,4,1344,4,308,38146,308,1344,0,0,0,0,0
901.831,6,59,9507,37,111,18099,498,3383,22,262,42940,1420,6124
1798.128,1,296,16576,296,28,6095,28,16576,0,0,0,0,0
61.35,6,42,23100,26,1013,2454,1402,15544,16,839,4073,2804,7556
1786.655,6,104,8504,69,66,26274,66,5004,35,60,52542,60,3500
167.114,17,4,240,2,32,167112,32,120,2,32,167112,32,120
8.585,6,76,24565,39,560,225,1152,18928,37,461,231,1179,5637
3.205,17,2,784,2,364,3205,364,784,0,0,0,0,0
18.255,6,14,4052,8,243,2582,722,1396,6,2328,3615,2328,2656
0.824,17,2,685,1,308,0,308,336,1,321,0,321,349
1792.57,17,177,11328,177,36,10185,36,11328,0,0,0,0,0
0.034,17,2,186,1,41,0,41,69,1,89,0,89,117
842.076,2,10,320,10,8,93564,8,320,0,0,0,0,0
98.095,6,30,8872,14,158,7545,267,1357,16,763,6537,2045,7515
416.574,6,39,8950,17,142,17005,516,1825,22,328,19832,1452,7125
0.082,17,2,904,2,424,82,548,904,0,0,0,0,0
0.126,17,8,2750,8,315,18,354,2750,0,0,0,0,0
60.502,6,22,10902,7,193,1961,193,1337,15,874,4321,1551,9565
1788.541,17,87,3648,86,14,21041,14,3612,1,8,0,8,36
1797.806,1,58,4872,58,56,31540,56,4872,0,0,0,0,0
0.009,6,2,281,1,0,0,0,40,1,189,0,189,241
123.806,6,26,7916,12,261,11255,467,1405,14,525,9503,2728,6511
1772.861,17,125,8000,125,36,14297,36,8000,0,0,0,0,0
120.096,17,4,764,2,31,120091,34,119,2,294,120092,299,645
1.054,17,405,356396,149,68,7,1350,14337,256,1308,3,1350,342059
145.695,6,64,44744,43,1155,3468,1408,36918,21,960,3076,3847,7826
0.076,1,2,112,2,28,76,28,112,0,0,0,0,0
1780.503,1,342,28728,342,56,5221,56,28728,0,0,0,0,0
56.88,6,7638,7473112,5295,1337,10,1368,7346612,2343,931,24,2736,126500
1791.064,1,342,28728,342,56,5252,56,28728,0,0,0,0,0
1792.065,6,359,22709,209,69,8615,69,12569,150,69,12025,69,10140
19.245,6,31,8912,14,158,1480,267,1357,17,687,1190,2036,7555
281.242,6,32,7853,14,158,21634,267,1357,18,524,16542,1400,6496
240.459,6,50,9645,26,209,9618,835,2873,24,501,10454,2816,6772
4.696,6,27,6716,14,268,358,517,1562,13,744,388,1408,5154
1681.256,17,16,1265,8,30,240176,37,471,8,71,240176,136,794
1768.165,6,123,7518,66,27,27201,27,3978,57,27,31573,27,3540
156.946,6,33,9962,17,446,64,1360,2509,16,680,10451,2720,7453
10.612,6,18,5610,10,275,1179,275,958,8,1440,798,1440,4652
305.999,6,3,120,3,0,0,0,120,0,0,0,0,0
1750.217,6,185,17942,95,68,18619,721,7773,90,168,19661,1414,10169
1.075,17,3,1164,3,360,537,360,1164,0,0,0,0,0
1783.464,17,142,11360,71,48,25477,48,5396,71,56,25478,56,5964
2.019,6,13,2311,8,188,288,245,700,5,1407,441,1407,1611
1779.479,1,174,18444,174,78,10286,78,18444,0,0,0,0,0
300.166,6,39,10089,21,615,15000,1360,4567,18,435,17647,2667,5522
1783.313,17,83,3480,82,14,22016,14,3444,1,8,0,8,36
0.01,6,2,302,1,210,0,210,262,1,0,0,0,40
0.125,17,2,574,1,32,0,32,60,1,486,0,486,514
1786.322,17,87,3648,86,14,21015,14,3612,1,8,0,8,36
1.349,6,49,19588,27,915,51,1440,13932,22,433,55,1440,5656
1786.431,17,87,3648,86,14,21016,14,3612,1,8,0,8,36
1769.9,6,105,9552,66,65,27229,65,5577,39,59,46574,59,3975
5.154,6,40,7309,21,218,257,314,3463,19,513,272,1179,3846
1789.06,6,354,22440,206,69,8727,69,12380,148,69,12170,69,10060
1.641,6,14,2351,8,188,234,245,700,6,703,279,1152,1651
377.202,6,18,1242,14,180,29015,180,916,4,110,20057,110,326
0.066,17,4,284,2,32,33,32,120,2,54,34,60,164
1207.486,17,92,7344,48,48,25691,48,3648,44,56,25669,56,3696
1770.064,1,69,5796,0,0,0,0,0,69,56,26030,56,5796
240.655,2,2,64,2,8,240655,8,64,0,0,0,0,0
1780.491,17,142,11360,71,48,25435,48,5396,71,56,25435,56,5964
1770.772,1,180,10080,180,28,9892,28,10080,0,0,0,0,0
7.353,6,68,20238,35,541,216,1152,15475,33,491,221,1179,4763
1775.768,6,244,19194,91,73,19728,336,9089,153,49,11679,143,10105
264.089,6,57,20690,36,678,7545,1360,15048,21,435,438,2667,5642
100.806,6,32,23761,19,840,36,1360,5835,13,2899,8388,8511,17926
316.879,6,70,18683,37,315,8802,1360,9704,33,695,9898,4649,8979
0.037,17,2,588,1,60,0,60,88,1,472,0,472,500
12.567,6,1842,1600497,1114,1381,11,1420,1567156,728,467,17,1883,33341
1.28,6,50,21050,28,949,47,1360,15394,22,433,52,1360,5656
1771.524,6,101,9344,66,65,27254,65,5577,35,59,52100,59,3767
57.646,17,4,352,2,60,57645,60,176,2,60,57645,60,176
1796.668,17,449,39928,404,35,4458,288,25708,45,288,40021,288,14220
1788.419,17,142,11360,71,48,25547,48,5396,71,56,25548,56,5964
1793.498,17,180,11520,180,36,10019,36,11520,0,0,0,0,0
1787.058,17,343,81201,343,208,5225,422,81201,0,0,0,0,0
10.836,6,20,4442,11,275,1083,275,998,9,768,761,1440,3444
10.585,6,30,7432,13,158,882,267,1317,17,543,659,1400,6115
9.146,17,42,11090,13,299,761,1350,4251,29,207,325,1350,6839
0.004,17,2,382,1,36,0,36,64,1,290,0,290,318
21.444,17,12,2472,6,48,4286,48,456,6,308,4286,308,2016
0.052,17,2,317,1,43,0,43,71,1,218,0,218,246
1756.833,6,97,7405,64,38,27886,205,4528,33,35,54893,98,2877
1682.05,1,15,840,15,28,120146,28,840,0,0,0,0,0
0.928,6,11,1727,7,100,154,100,384,4,589,220,1152,1343
1.965,17,3,201,3,39,982,39,201,0,0,0,0,0
5.04,17,4,288,2,36,5005,36,128,2,52,5008,52,160
0.098,17,4,566,2,31,85,31,118,2,196,76,196,448
0.562,6,21,7203,13,318,46,600,1958,8,964,73,1471,5245
0.01,17,2,586,1,46,0,46,74,1,484,0,484,512
1775.612,6,130,7960,70,27,25733,27,4225,60,27,30088,27,3735
8.754,6,40,7325,20,218,460,314,3423,20,516,447,1179,3902
1781.832,17,136,10880,68,48,26594,48,5168,68,56,26594,56,5712
5.262,6,44,8369,21,227,263,314,4022,23,427,227,1152,4347
1795.804,17,86,3606,85,14,21378,14,3570,1,8,0,8,36
3.912,17,5,290,5,30,978,30,290,0,0,0,0,0
14.104,17,4,352,2,48,14096,48,152,2,72,14093,72,200
0.406,6,10,968,5,256,98,256,460,5,304,98,304,508
1777.404,6,180,15480,120,69,14936,69,8940,60,69,30112,69,6540
0.328,6,27,9042,13,247,27,624,1672,14,947,24,1408,7370
130.336,17,16,18239,16,1111,8689,1452,18239,0,0,0,0,0
47.332,6,27,7177,13,155,3944,267,1306,14,530,3640,3417,5871
0.315,6,27,8932,13,227,26,547,1604,14,941,23,1408,7328
1771.349,6,99,9306,66,66,27251,66,5610,33,60,55351,60,3696
1791.291,17,986,316681,472,574,3803,1350,284453,514,34,3491,1350,32228
1794.396,17,144,11520,72,48,25273,48,5472,72,56,25273,56,6048
28.293,6,3839,3656173,2547,1359,11,1408,3584325,1292,776,21,1408,71848
0.083,17,4,2876,2,689,83,1350,1434,2,693,47,1350,1442
0.645,6,14,1745,7,288,77,288,600,7,426,73,434,1145
0.006,17,2,251,1,36,0,36,64,1,159,0,159,187
0.026,6,16,7142,8,139,3,139,563,8,1231,3,1448,6579
1790.268,1,342,28728,342,56,5250,56,28728,0,0,0,0,0
0.007,17,2,350,1,39,0,39,67,1,255,0,255,283
40.106,17,5,5554,5,1082,10026,1234,5554,0,0,0,0,0
1793.56,1,274,29044,274,78,6569,78,29044,0,0,0,0,0
5.651,6,40,7309,21,218,282,314,3463,19,513,299,1179,3846
1780.072,6,310,80076,186,718,9622,723,54222,124,156,14471,269,25854
1741.366,17,30,31680,30,1028,60047,1028,31680,0,0,0,0,0
5.071,17,3,208,2,36,5001,36,128,1,52,0,52,80
0.162,6,2,84,1,0,0,0,44,1,0,0,0,40
101.329,6,941,448199,501,828,202,1152,424412,440,412,230,1179,23787
65.303,6,53,16689,27,1057,605,1360,10692,26,290,2605,1360,5997
1786.993,6,359,22709,209,69,8591,69,12569,150,69,11993,69,10140
7.699,6,71,43233,38,1160,208,1448,33336,33,906,221,1448,9897
12.408,6,106,37465,55,624,229,1152,30943,51,447,242,1179,6522
10.404,6,1658,1441307,1003,1384,10,1420,1410634,655,420,15,1420,30673
2.796,17,3,1176,3,364,1398,364,1176,0,0,0,0,0
1786.443,6,109,8830,71,66,25520,66,5150,38,60,48279,60,3680
0.017,17,2,399,1,39,0,39,67,1,304,0,304,332
1772.287,6,180,15480,120,69,14893,69,8940,60,69,30037,69,6540
1785.583,1,44,2464,44,28,41525,28,2464,0,0,0,0,0
40.602,1,4,224,4,28,13534,28,224,0,0,0,0,0
4.456,6,47,16702,25,447,185,1460,3798,22,706,203,1460,12904
1780.908,1,252,14112,252,28,7095,28,14112,0,0,0,0,0
0.248,6,25,7216,12,155,22,267,1261,13,678,19,2045,5955
1786.388,6,108,8595,69,65,26270,65,4970,39,59,47007,59,3625
1795.112,17,447,39864,402,35,4476,288,25644,45,288,40015,288,14220
17.907,17,4,1344,4,308,5969,308,1344,0,0,0,0,0
1799.895,17,768,46343,768,32,2346,37,46343,0,0,0,0,0
13.401,6,1904,1653431,1163,1369,11,1380,1614657,741,630,18,3303,38774
8.387,6,16,2373,9,211,1048,211,922,7,545,1397,904,1451
0.04,17,4,284,2,32,37,32,120,2,54,33,60,164
0.924,6,10,1687,7,100,154,100,384,3,1179,331,1179,1303
1782.319,17,83,3480,82,14,22003,14,3444,1,8,0,8,36
12.003,6,29,12651,17,464,750,1360,2568,12,1370,1074,3928,10083
0.178,17,2,152,1,48,0,48,76,1,48,0,48,76
1.235,17,13,7459,6,585,247,1350,3678,7,512,149,1350,3781
240.21,6,53,19245,29,823,8578,1418,16341,24,235,10443,580,2904
2.22,17,2,685,1,308,0,308,336,1,321,0,321,349
1787.591,17,83,3480,82,14,22069,14,3444,1,8,0,8,36
0.306,17,2,152,1,48,0,48,76,1,48,0,48,76
1652.578,1,7,742,7,78,275429,78,742,0,0,0,0,0
55.108,6,27,7177,13,155,4592,267,1306,14,530,4238,3417,5871
0.182,6,3,120,2,0,182,0,80,1,0,0,0,40
29.495,6,9,376,6,0,5899,0,244,3,0,1554,0,132
170.264,6,30,8872,14,158,13097,267,1357,16,687,11350,2036,7515
1798.267,17,448,39896,403,35,4473,288,25676,45,288,40020,288,14220
0.34,17,2,152,1,48,0,48,76,1,48,0,48,76
1.532,6,24,8004,11,164,132,267,1236,13,1014,110,2736,6768
1681.149,17,13,534,11,14,168096,14,462,2,8,1680957,8,72
0.341,6,24,7390,11,270,33,797,1660,13,841,27,1402,5730
4.001,17,4,268,4,39,1333,39,268,0,0,0,0,0
3.176,17,30,16798,15,599,226,1350,9418,15,464,122,1350,7380
3.024,17,17,9732,8,540,432,1350,4549,9,547,288,1350,5183
1784.737,6,356,22520,208,69,8621,69,12460,148,69,12141,69,10060
1143.097,2,11,352,11,8,114309,8,352,0,0,0,0,0
33.768,17,40,5880,20,48,1776,48,1520,20,190,1776,308,4360
211.265,17,4,240,2,32,211264,32,120,2,32,211263,32,120
9.5,6,87,27052,42,561,231,1152,20786,45,446,209,1179,6266
0.132,6,12,3704,6,171,24,171,491,6,964,25,1448,3213
180.409,2,3,96,3,8,90204,8,96,0,0,0,0,0
5.892,6,34,8357,18,400,346,885,1964,16,521,383,3488,6393
4.056,6,33,6145,18,206,238,314,2784,15,551,271,1179,3361
1791.613,17,87,3648,86,14,21077,14,3612,1,8,0,8,36
146.302,6,19,4237,7,92,1657,92,480,12,347,12514,1448,3757
68.328,6,25,10829,12,380,76,832,1665,13,959,5681,1440,9164
1745.166,6,94,7151,62,38,28609,205,4424,32,33,56289,98,2727
1.289,6,47,19332,27,903,49,1360,13756,20,433,58,1360,5576
93.114,17,4,1344,4,308,31038,308,1344,0,0,0,0,0
1738.602,6,84,6104,56,31,31610,31,3780,28,31,64392,31,2324
0.419,6,16,5162,8,75,59,75,543,8,1398,59,1448,4619
0.347,6,26,9038,13,262,28,690,1735,13,945,28,1408,7303
0.04,17,2,554,1,30,0,30,58,1,468,0,468,496
1.021,17,14,6937,7,613,169,1350,4493,7,321,164,1350,2444
0.012,17,2,144,1,36,0,36,64,1,52,0,52,80
4.356,6,57,20621,28,898,161,1440,14625,29,433,148,1440,5996
0.058,17,2,890,1,286,0,286,314,1,548,0,548,576
1793.447,6,358,22669,209,69,8622,69,12500,149,69,12117,69,10169
11.595,6,702,601234,441,1293,25,1368,582998,261,776,43,1473,18236
0.497,17,3,543,2,39,345,39,134,1,381,0,381,409
2.851,17,2,778,2,361,2851,361,778,0,0,0,0,0
1772.202,6,180,15480,120,69,14892,69,8940,60,69,30031,69,6540
129.101,6,30,8872,13,158,10758,267,1317,17,687,8065,1400,7555
1740.447,17,30,7050,30,207,60015,207,7050,0,0,0,0,0
0.924,17,2,362,1,46,0,46,74,1,260,0,260,288
173.237,1,10,560,10,28,19248,28,560,0,0,0,0,0
181.063,6,24,10262,13,372,80,808,1680,11,1161,18092,4416,8582
36.113,1,42,4368,0,0,0,0,0,42,76,880,76,4368
310.954,6,82,10999,35,113,9145,267,2877,47,230,6759,1460,8122
1772.216,6,180,15480,120,69,14892,69,8940,60,69,30036,69,6540
76.75,6,744,350428,391,829,196,1152,331517,353,435,217,1179,18911
1.354,6,43,12929,23,640,61,1360,7353,20,476,61,2715,5576
1786.694,6,102,8364,68,66,26667,66,4964,34,60,54139,60,3400
0.511,17,3,451,2,39,135,39,134,1,289,0,289,317
0.226,17,2,136,1,32,0,32,60,1,48,0,48,76
1786.48,6,102,8364,68,66,26663,66,4964,34,60,54133,60,3400
388.793,6,18,1242,14,180,29907,180,916,4,110,20077,110,326
0.25,17,12,918,6,40,0,41,411,6,56,0,57,507
5.017,17,4,288,2,36,4999,36,128,2,52,5000,52,160
1791.3,6,356,22520,208,69,8653,69,12460,148,69,12185,69,10060
1772.877,6,180,15480,120,69,14898,69,8940,60,69,30043,69,6540
11.826,17,3,984,3,300,5913,300,984,0,0,0,0,0
90.638,17,4,352,2,60,90637,60,176,2,60,90637,60,176
54.639,6,552,249806,284,816,193,1152,233581,268,423,203,1179,16225
1776.454,6,183,11858,95,55,18898,208,7408,88,31,20397,31,4450
7.085,6,1393,1267207,873,1374,7,1408,1235503,520,931,13,2801,31704
1799.912,1,55,4620,55,56,33331,56,4620,0,0,0,0,0
280.326,6,28,7352,12,158,25484,267,1277,16,603,18686,1400,6075
1799.996,6,222,18737,83,71,21951,301,8230,139,69,13043,1062,10507
1799.353,17,449,39928,404,35,4464,288,25708,45,288,40027,288,14220
1786.511,6,104,8376,68,65,26664,65,4930,36,59,51040,59,3446
309.972,6,38,7332,16,141,12204,502,1776,22,292,14756,1420,5556
1735.528,1,64,3584,64,28,27548,28,3584,0,0,0,0,0
377.237,6,18,1242,14,180,29018,180,916,4,110,20065,110,326
0.844,6,28,5967,13,156,70,267,1462,15,650,55,1420,4505
280.23,6,29,7392,13,158,23352,267,1317,16,543,18680,1400,6075
1789.254,6,366,23196,211,69,8520,69,12856,155,69,11618,69,10340
368.437,6,26,1703,17,177,23027,177,1117,9,110,9154,110,586
0.85,2,4,160,4,16,283,16,160,0,0,0,0,0
204.034,17,4,304,4,48,68011,48,304,0,0,0,0,0
369.653,6,25,1651,17,177,23103,177,1117,8,110,9231,110,534
10.655,6,92,27085,46,540,236,1152,20747,46,449,231,1179,6338
1799.353,6,2001,2053881,758,150,2376,863,51650,1243,1660,1448,11216,2002231
56.517,6,87,125952,52,430,1108,647,3990,35,3754,1657,15488,121962
1788.284,6,356,22520,208,69,8639,69,12460,148,69,12165,69,10060
1787.201,6,364,23116,211,69,8510,69,12787,153,69,11757,69,10329
15.73,17,40,10380,40,231,403,389,10380,0,0,0,0,0
1798.025,6,259,24599,158,75,11452,267,11246,101,136,17980,2840,13353
0.862,17,4,352,2,60,861,60,176,2,60,854,60,176
1787.833,6,357,22629,207,69,8678,69,12489,150,69,11995,69,10140
1711.799,1,8,848,8,78,244542,78,848,0,0,0,0,0
3.983,17,4,244,4,33,1327,33,244,0,0,0,0,0
1793.449,17,179,11456,179,36,10075,36,11456,0,0,0,0,0
1770.698,6,182,29677,105,258,17025,1144,19141,77,123,23295,351,10536
300.548,6,25,8327,13,356,25045,858,2109,12,698,4186,1448,6218
16.295,17,18,9238,10,669,1806,1350,6971,8,255,2322,1350,2267
280.251,6,29,7392,13,158,23354,267,1317,16,603,18682,2036,6075
68.844,6,41,13001,15,290,4917,1189,2644,26,489,2746,1420,10357
0.452,6,9,527,5,43,113,43,311,4,0,145,0,216
1799.972,17,448,39612,404,35,4466,288,25708,44,288,40948,288,13904
1319.869,17,55,18464,55,307,24442,308,18464,0,0,0,0,0
1752.775,6,95,7203,63,38,28270,205,4476,32,33,56533,98,2727
828.577,1,4,224,4,28,276192,28,224,0,0,0,0,0
145.946,17,6,528,3,60,72972,60,264,3,60,72972,60,264
0.54,17,3,451,2,39,465,39,134,1,289,0,289,317
1681.324,17,16,1265,8,30,240186,37,471,8,71,240186,136,794
0.113,17,2,404,1,44,0,44,72,1,304,0,304,332
249.635,6,8,320,8,0,0,0,320,0,0,0,0,0
1.058,17,20,11713,9,402,132,1350,3873,11,684,96,1350,7840
0.008,6,2,129,1,37,0,37,89,1,0,0,0,40
240.674,2,5,160,5,8,60168,8,160,0,0,0,0,0
1784.661,1,8,848,8,78,254951,78,848,0,0,0,0,0
0.938,6,10,1687,7,100,156,100,384,3,1179,336,1179,1303
32.896,6,4729,4569919,3178,1362,10,1408,4484603,1551,776,21,1408,85316
0.375,6,4,220,2,0,375,0,100,2,0,305,0,120
280.475,6,30,7432,14,158,21575,267,1357,16,678,18693,3456,6075
0.067,17,2,574,1,32,0,32,60,1,486,0,486,514
3.853,17,3,183,3,33,1926,33,183,0,0,0,0,0
0.036,6,5,8876,1,0,0,0,40,4,2157,0,2876,8836
1770.808,6,319,75012,137,493,13020,1460,62758,182,67,9782,754,12254
1799.93,17,448,39896,403,35,4477,288,25676,45,288,40018,288,14220
336.51,6,95,14629,43,159,8012,1189,4598,52,317,6522,1460,10031
32.2,6,25,7026,6,154,6440,267,712,19,396,1768,1460,6314
1788.51,17,87,3648,86,14,21041,14,3612,1,8,0,8,36
300.253,6,53,31517,30,190,10353,444,2461,23,1638,11071,8448,29056
37.446,17,22,1936,11,48,3743,48,836,11,72,3743,72,1100
1785.742,6,105,8348,68,64,26652,64,4896,37,58,49601,58,3452
0.311,17,4,284,2,32,0,32,120,2,54,1,60,164
8.941,6,3,180,3,0,0,0,180,0,0,0,0,0
2.446,2,2,64,2,8,2446,8,64,0,0,0,0,0
6.851,6,1255,1134720,780,1377,8,1408,1105356,475,931,14,2816,29364
10.793,6,18,5610,10,275,1199,275,958,8,1440,822,1440,4652
288.493,6,34,3485,17,324,18030,585,1589,17,169,18030,580,1896
1797.49,6,378,26766,218,103,8283,469,15881,160,69,11302,69,10885
1761.622,6,105,7559,65,31,27525,31,4496,40,31,45168,31,3063
1792.88,6,364,23047,210,69,8578,69,12747,154,69,11716,69,10300
1.335,6,49,21147,28,958,49,1440,15531,21,433,58,1440,5616
0.009,17,2,162,1,34,0,34,62,1,72,0,72,100
8.971,6,68,20206,34,562,271,1152,15419,34,489,263,1179,4787
122.767,6,51,10644,20,249,6460,1189,3051,31,288,4091,1420,7593
105.534,6,23,6098,13,216,8794,501,1390,10,614,11715,1420,4708
1740.683,17,28,29568,28,1028,64469,1028,29568,0,0,0,0,0
1798.302,1,345,28980,345,56,5227,56,28980,0,0,0,0,0
0.0,17,1,1088,1,1060,0,1060,1088,0,0,0,0,0
1673.622,1,8,448,8,28,239088,28,448,0,0,0,0,0
52.782,6,27,7177,13,155,4398,267,1306,14,530,4059,3417,5871
1774.295,1,59,4956,0,0,0,0,0,59,56,30591,56,4956
1788.111,1,167,9352,167,28,10771,28,9352,0,0,0,0,0
829.168,17,8,608,8,48,118452,48,608,0,0,0,0,0
283.151,6,29,7396,12,158,25741,267,1277,17,603,17692,2036,6119
3.19,17,4,1564,4,363,1063,363,1564,0,0,0,0,0
1756.719,1,54,4536,54,56,33145,56,4536,0,0,0,0,0
151.542,6,28,7352,12,158,13776,267,1277,16,603,10093,1400,6075
0.031,17,2,292,1,53,0,53,81,1,183,0,183,211
0.876,6,11,1727,7,100,146,100,384,4,589,207,1152,1343
5.453,6,29,8403,13,155,454,267,1306,16,537,362,3417,7097
0.061,17,4,368,2,32,60,32,120,2,96,14,96,248
125.053,17,4,240,2,32,125052,32,120,2,32,125052,32,120
1.047,17,4,676,2,33,990,33,122,2,249,0,249,554
1733.183,6,77,5636,48,33,36876,33,3336,29,31,61892,31,2300
1143.009,2,10,320,10,8,127001,8,320,0,0,0,0,0
73.54,6,42,10751,21,819,507,1360,5016,21,375,3668,4027,5735
1782.26,17,83,3480,82,14,22003,14,3444,1,8,0,8,36
22.833,17,33,9642,15,366,1628,1350,5923,18,178,1341,1350,3719
3.42,6,2,88,2,0,0,0,88,0,0,0,0,0
0.069,17,2,230,1,40,0,40,68,1,134,0,134,162
270.749,1,29,1624,29,28,9669,28,1624,0,0,0,0,0
60.306,6,27,8512,7,133,1300,267,821,20,491,3173,1997,7691
82.223,6,54,40971,33,1241,29,1360,28674,21,1635,4102,3734,12297
0.95,6,27,8120,14,266,60,540,1924,13,944,65,1591,6196
10.616,6,30,8848,13,155,884,267,1306,17,527,662,3417,7542
11.302,6,90,27586,46,573,251,1152,21344,44,447,256,1179,6242
0.045,17,4,284,2,32,1,32,120,2,54,1,60,164
1794.392,17,142,11360,71,48,25633,48,5396,71,56,25633,56,5964
1785.959,6,102,8364,68,66,26656,66,4964,34,60,54117,60,3400
1797.958,6,370,25977,214,99,8441,469,15114,156,69,11596,69,10863
1785.493,6,108,8724,70,66,25876,66,5044,38,60,48253,60,3680
8.169,6,28,7836,14,215,628,721,1854,14,774,449,1414,5982
367.215,6,27,1767,18,177,21600,177,1181,9,110,8601,110,586
0.059,17,2,912,1,308,0,308,336,1,548,0,548,576
0.323,6,42,19842,21,171,16,313,1902,21,1202,15,1648,17940
1.482,6,274,198568,149,1346,10,1432,189084,125,428,11,1871,9484
78.893,6,78,53565,49,1187,1643,1368,45320,29,841,2214,2519,8245
1.0,6,182,141556,109,1326,9,1432,134345,73,475,13,1871,7211
45.859,6,42,7389,17,218,330,314,3303,25,440,1900,1152,4086
1.5,6,38,8252,19,320,83,1162,2716,19,476,71,2715,5536
168.122,6,23,10236,11,397,78,884,1665,12,1009,15270,1360,8571
0.688,6,10,924,5,283,114,283,551,5,105,120,105,373
283.654,6,28,7704,14,175,21819,267,1618,14,788,21790,4845,6086
10.01,17,2,150,2,47,10010,47,150,0,0,0,0,0
6.746,6,690,603182,433,1323,15,1368,585154,257,776,25,1473,18028
0.264,17,3,451,2,39,184,39,134,1,289,0,289,317
38.302,17,52,15172,26,381,1530,1350,10634,26,146,1530,1350,4538
1788.629,6,390,31932,217,92,8280,1189,14864,173,131,10398,1420,17068
47.678,6,12,1205,4,517,15890,517,741,8,0,6809,0,464
0.251,17,2,152,1,48,0,48,76,1,48,0,48,76
1755.575,6,115,6938,64,26,27865,26,3794,51,26,35110,26,3144
1796.642,17,447,39296,404,35,4458,288,25708,43,288,40978,288,13588
132.304,6,20,9096,11,499,86,1193,1971,9,1350,16515,3639,7125
13.23,6,2497,2432615,1677,1376,7,1408,2385311,820,931,15,2801,47304
0.074,17,4,284,2,32,1,32,120,2,54,16,60,164
1784.837,6,104,8376,68,65,26639,65,4930,36,59,50992,59,3446
412.477,6,24803,20112681,10833,340,38,342,696114,13970,1354,29,4104,19416567
60.673,6,11,2992,6,92,12134,92,400,5,1164,15084,1448,2592
0.11,6,2,80,2,0,0,0,80,0,0,0,0,0
63.936,6,40,10915,17,297,3996,1189,3069,23,461,2905,1420,7846
3.502,17,4,240,2,32,3501,32,120,2,32,3501,32,120
252.104,2,3,96,3,8,126052,8,96,0,0,0,0,0
300.63,6,47,8984,24,291,13070,786,2217,23,364,400,1360,6767
11.298,6,1788,1561454,1105,1362,10,1380,1529880,683,421,16,1923,31574
1773.699,6,180,15480,120,69,14905,69,8940,60,69,30055,69,6540
0.034,6,6,897,3,483,9,483,639,3,102,10,102,258
1790.018,17,87,3648,86,14,21059,14,3612,1,8,0,8,36
1772.02,6,180,15480,120,69,14890,69,8940,60,69,30032,69,6540
4.089,17,5,290,5,30,1022,30,290,0,0,0,0,0
82.986,6,23,8214,11,520,92,1223,2034,12,812,7527,1440,6180
1797.948,6,298,20476,178,69,10157,69,11398,120,69,15107,69,9078
1756.785,6,101,7980,66,45,27027,205,4933,35,35,51662,98,3047
10.771,6,18,5610,10,275,1196,275,958,8,1440,821,1440,4652
76.724,6,280,245445,112,140,691,344,6618,168,1411,459,2836,238827
3.561,6,28,6320,14,181,273,537,1650,14,781,269,2224,4670
0.096,6,3,187,2,31,10,31,147,1,0,0,0,40
280.348,6,29,7392,13,158,23362,267,1317,16,603,18684,2036,6075
1796.471,17,448,39896,403,35,4468,288,25676,45,288,40016,288,14220
213.982,1,6,336,6,28,42796,28,336,0,0,0,0,0
1.497,6,38,8254,19,321,83,1164,2718,19,476,72,2720,5536
88.819,6,30,7238,9,154,35,267,832,21,347,4440,1420,6406
0.013,17,2,227,1,32,0,32,60,1,139,0,139,167
7.989,6,16,1310,10,275,887,275,958,6,96,1148,96,352
99.155,6,30,4485,15,302,7082,302,2926,15,83,7056,83,1559
1795.72,1,58,4872,58,56,31503,56,4872,0,0,0,0,0
1792.059,6,356,22520,208,69,8657,69,12460,148,69,12190,69,10060
1785.233,6,354,22440,207,69,8666,69,12420,147,69,12227,69,10020
1756.82,1,8,448,8,28,250974,28,448,0,0,0,0,0
1.236,6,24,8004,12,164,94,267,1288,12,1014,95,2896,6716
7.272,6,43,8276,21,239,363,314,3953,22,429,268,1152,4323
1783.809,6,356,22520,208,69,8617,69,12460,148,69,12134,69,10060
0.027,17,4,352,2,60,26,60,176,2,60,25,60,176
1770.558,6,99,9306,66,66,27239,66,5610,33,60,55327,60,3696
1779.796,17,140,11200,70,48,25794,48,5320,70,56,25794,56,5880
0.166,17,2,152,2,48,166,48,152,0,0,0,0,0
280.19,6,29,7392,14,158,21553,267,1357,15,678,20010,3436,6035
1740.499,1,14,812,14,30,133884,30,812,0,0,0,0,0
1786.797,17,87,3648,86,14,21021,14,3612,1,8,0,8,36
0.552,6,20,7238,13,335,46,668,2026,7,1210,81,1946,5212
3.441,6,2,88,2,0,0,0,88,0,0,0,0,0
4.509,6,38,7245,19,218,250,314,3383,19,516,235,1179,3862
2.814,6,2,88,2,0,0,0,88,0,0,0,0,0
2.756,6,13,2311,8,188,393,245,700,5,1407,622,1407,1611
377.609,6,23,1535,16,177,25173,177,1053,7,110,10415,110,482
0.282,6,27,9086,13,257,23,667,1715,14,947,21,1408,7371
5.852,6,45,8409,23,227,266,314,4102,22,427,266,1152,4307
46.561,6,22,8070,13,497,3880,754,2673,9,984,5806,1930,5397
4.946,6,38,7229,19,218,274,314,3383,19,440,260,1152,3846
224.834,6,33,9061,14,158,17294,267,1357,19,578,12463,1400,7704
54.755,6,47,19812,26,1091,359,1360,14170,21,435,2728,2667,5642
1749.263,6,138,13893,84,72,21075,722,7273,54,84,32997,1448,6620
18.067,6,50,35509,32,1229,582,1360,28357,18,1070,1049,2260,7152
39.554,17,22,1936,11,48,3954,48,836,11,72,3954,72,1100
1799.255,6,121,13747,77,161,23672,1304,9231,44,68,41840,191,4516
0.107,17,2,178,1,29,0,29,57,1,93,0,93,121
1.545,6,47,18164,26,882,61,1460,12548,21,433,66,1460,5616
71.324,6,22,6636,6,154,14264,267,712,16,479,4754,1452,5924
1.346,6,50,19981,28,878,49,1360,14325,22,476,55,2715,5656
193.833,17,4,352,2,60,193832,60,176,2,60,193832,60,176
8.198,6,80,24805,40,563,210,1152,19064,40,413,203,1152,5741
1770.332,6,101,9410,66,66,27235,66,5610,35,60,52065,60,3800
1789.068,6,376,23803,215,69,8360,69,13223,161,69,11179,69,10580
1.676,6,13,2311,8,188,239,245,700,5,1407,354,1407,1611
298.292,17,4,352,2,60,298291,60,176,2,60,298291,60,176
1781.76,6,359,22709,209,69,8566,69,12569,150,69,11958,69,10140
4.031,17,5,290,5,30,1007,30,290,0,0,0,0,0
294.997,6,35,8046,12,158,25474,267,1277,23,365,13408,1400,6769
554.425,6,72,11324,31,93,18480,267,2923,41,192,13860,1420,8401
3.836,17,19,9146,10,557,422,1350,5856,9,337,475,1350,3290
1771.308,6,99,9108,66,63,27250,63,5511,33,57,55350,57,3597
0.917,6,10,1687,7,100,152,100,384,3,1179,328,1179,1303
1796.288,17,449,39928,404,35,4457,288,25708,45,288,40017,288,14220
1799.865,17,11002,528096,5501,20,327,20,264048,5501,20,327,20,264048
12.199,6,6,328,4,0,4066,0,216,2,0,12185,0,112
93.604,6,26,1068,12,0,4437,0,488,14,0,7197,0,580
8.387,17,5,1160,5,204,2096,204,1160,0,0,0,0,0
0.012,17,2,136,1,32,0,32,60,1,48,0,48,76
300.799,6,38,8290,20,245,15831,635,1814,18,441,509,1360,6476
1780.379,17,142,11360,71,48,25433,48,5396,71,56,25433,56,5964
1683.305,1,7,392,7,28,280550,28,392,0,0,0,0,0
0.2,17,4,368,2,32,199,32,120,2,96,56,96,248
31.436,6,7,308,1,0,0,0,44,6,0,6284,0,264
1792.006,6,356,22989,208,75,8656,469,12860,148,69,12190,69,10129
260.679,17,4,352,2,60,260677,60,176,2,60,260677,60,176
0.246,17,4,588,2,48,240,48,152,2,190,239,308,436
0.018,17,2,198,1,39,0,39,67,1,103,0,103,131
1.138,6,10,1687,7,100,189,100,384,3,1179,440,1179,1303
16.97,6,33,9629,13,155,1414,267,1306,20,469,892,1997,8323
163.996,6,24,10258,12,571,56,1360,2799,12,1161,14896,2720,7459
93.168,6,25,11382,12,433,71,990,1847,13,1000,7753,1360,9535
0.184,1,2,112,2,28,184,28,112,0,0,0,0,0
1756.374,6,101,7912,65,45,27443,205,4844,36,35,50174,98,3068
0.022,17,2,549,1,30,0,30,58,1,463,0,463,491
0.233,6,19,8973,10,121,25,121,649,9,1308,29,1802,8324
24.267,6,25,6757,12,181,2206,267,1212,13,717,2020,2036,5545
0.868,6,11,1727,7,100,144,100,384,4,589,205,1152,1343
41.058,6,35,8238,18,334,519,688,1804,17,522,2556,3488,6434
1176.198,1,6,336,6,28,235239,28,336,0,0,0,0,0
1.091,17,2,120,2,32,1091,32,120,0,0,0,0,0
4.33,6,38,7229,20,218,227,314,3423,18,513,238,1179,3806
354.419,17,8,2896,8,334,50631,548,2896,0,0,0,0,0
1788.437,17,87,3648,86,14,21040,14,3612,1,8,0,8,36
83.124,6,24,10017,13,523,54,1360,2645,11,1153,8298,2574,7372
0.331,6,14,6093,7,128,55,128,500,7,1305,55,1448,5593
1.012,6,303,399160,195,201,5,230,11373,108,3639,6,18226,387787
138.252,1,18,1872,0,0,0,0,0,18,76,8132,76,1872
1.702,6,19,3781,11,234,170,564,1504,8,463,215,1343,2277
61.318,6,36,15871,22,798,2919,1408,9145,14,748,4697,2439,6726
38.899,17,3,228,3,48,19449,48,228,0,0,0,0,0
1.197,6,23,7952,11,164,101,267,1236,12,1014,92,2331,6716
5.017,17,4,288,2,36,5000,36,128,2,52,5001,52,160
33.12,6,27,7177,13,155,2760,267,1306,14,530,2546,3417,5871
280.268,6,29,7392,13,158,23355,267,1317,16,603,18677,2036,6075
10.77,6,18,5610,10,275,1196,275,958,8,1440,821,1440,4652
11.908,6,25,8453,13,275,992,275,1078,12,983,814,1420,7375
158.809,6,32,8952,14,158,12216,267,1357,18,624,9332,1400,7595
1.815,6,592,628842,222,331,8,332,15981,370,1626,4,4206,612861
0.222,17,4,588,2,48,213,48,152,2,190,211,308,436
0.002,17,2,144,1,36,0,36,64,1,52,0,52,80
0.114,17,2,349,1,36,0,36,64,1,257,0,257,285
16.923,17,6,528,3,48,8457,48,228,3,72,8456,72,300
1743.697,6,95,7203,63,38,28124,205,4476,32,33,56235,98,2727
1.35,6,51,20302,29,956,48,1460,14601,22,400,55,1460,5701
6.305,6,43,20413,25,827,262,1360,12633,18,879,361,1360,7780
240.504,6,45,9050,22,523,11452,1418,5876,23,218,10931,618,3174
0.026,17,2,466,1,33,0,33,61,1,377,0,377,405
1795.207,17,142,11360,71,48,25645,48,5396,71,56,25645,56,5964
126.132,17,4,304,4,48,42044,48,304,0,0,0,0,0
1772.625,6,187,15967,123,69,14529,69,9129,64,69,28135,69,6838
33.624,6,31,5095,15,154,2401,722,1860,16,342,2228,1408,3235
1789.172,17,142,11360,71,48,25559,48,5396,71,56,25559,56,5964
412.498,17,4,304,4,48,137499,48,304,0,0,0,0,0
1.469,6,47,19005,25,947,61,1460,13349,22,433,60,1460,5656
4.968,17,4,240,2,32,4967,32,120,2,32,4967,32,120
10.002,6,87,26197,42,551,243,1152,19899,45,408,221,1152,6298
1775.689,17,270,61534,270,199,6601,422,61534,0,0,0,0,0
280.204,6,28,7352,12,158,25473,267,1277,16,543,18679,1400,6075
5.02,17,3,208,2,36,4997,36,128,1,52,0,52,80
1.013,6,19,6554,12,493,92,836,2111,7,1017,155,1574,4443
111.0,6,39,11579,20,328,5835,1408,3392,19,554,6159,2816,8187
1783.81,6,424,25453,212,69,8454,69,12689,212,35,8454,69,12764
0.002,17,2,180,1,30,0,30,58,1,94,0,94,122
1789.886,1,254,14224,254,28,7074,28,14224,0,0,0,0,0
1797.394,17,448,39896,403,35,4471,288,25676,45,288,40016,288,14220
1.353,17,2,778,2,361,1353,361,778,0,0,0,0,0
12.14,17,4,352,2,60,12139,60,176,2,60,12139,60,176
29.477,6,4568,4341062,2997,1370,9,1408,4254706,1571,931,18,2801,86356
30.938,6,10,628,4,106,10232,106,274,6,90,6152,90,354
1785.735,6,104,8504,69,66,26260,66,5004,35,60,52518,60,3500
0.886,6,47,20887,26,1052,35,1380,15805,21,421,41,1923,5082
272.968,6,29,6726,11,189,10931,516,1390,18,307,16051,1452,5336
3.944,17,5,290,5,30,986,30,290,0,0,0,0,0
335.512,6,90,13282,37,172,9319,1189,4076,53,214,6451,1420,9206
0.149,6,7,423,4,43,36,43,259,3,0,23,0,164
1772.874,6,180,15480,120,69,14898,69,8940,60,69,30041,69,6540
0.009,17,4,420,2,33,4,33,122,2,121,5,145,298
8.054,1,9,756,0,0,0,0,0,9,56,1006,56,756
0.039,17,2,144,1,36,0,36,64,1,52,0,52,80
534.967,1,10,1227,10,94,59440,117,1227,0,0,0,0,0
18.091,6,6,328,4,0,6030,0,216,2,0,18013,0,112
0.499,17,19,7392,9,495,62,1350,4715,10,239,49,1350,2677
0.285,1,2,112,2,28,285,28,112,0,0,0,0,0
14.122,6,29,6882,14,137,1086,267,1252,15,558,949,1400,5630
0.024,17,2,247,1,36,0,36,64,1,155,0,155,183
300.087,6,6,364,4,31,100029,31,222,2,31,299810,31,142
0.008,1,2,954,2,449,8,449,954,0,0,0,0,0
0.153,17,2,241,1,36,0,36,64,1,149,0,149,177
1.435,6,37,8212,19,320,79,1162,2716,18,476,72,2715,5496
2.685,6,10,472,6,0,537,0,280,4,0,666,0,192
10.564,6,18,3769,8,131,1509,131,579,10,874,1108,1448,3190
152.468,17,2,642,1,300,0,300,328,1,286,0,286,314
35.678,6,33,5199,16,154,2378,722,1911,17,300,2195,1448,3288
179.829,6,20,8672,11,314,71,634,1415,9,1377,22463,3928,7257
626.16,1,12,672,12,28,56923,28,672,0,0,0,0,0
1800.0,6,219,17457,82,75,22222,375,8522,137,50,13235,143,8935
126.565,6,28,6707,11,220,5655,516,1326,17,335,7904,1452,5381
300.531,6,18,1227,5,177,75091,177,445,13,110,25030,110,782
1799.68,6,367,25650,214,99,8449,469,15045,153,69,11839,69,10605
280.264,6,28,7352,13,158,23355,267,1317,15,678,20018,3436,6035
292.201,6,35,8073,17,262,18259,517,1692,18,778,17185,1418,6381
0.255,17,2,2384,2,1164,255,1164,2384,0,0,0,0,0
300.159,6,40,10364,21,655,14999,1360,4802,19,399,16665,1360,5562
1.709,6,27,10173,16,284,113,584,1496,11,1029,148,1420,8677
280.289,6,30,7432,13,158,23357,267,1317,17,543,17513,1400,6115
1.341,6,48,18714,26,922,53,1460,13058,22,433,55,1460,5656
289.753,1,2,112,2,28,289753,28,112,0,0,0,0,0
0.475,6,27,9140,13,268,39,710,1758,14,947,33,1368,7382
1204.535,6,91,5699,52,42,23618,208,3364,39,31,31693,31,2335
1744.324,6,97,7307,63,38,28134,205,4476,34,33,52851,98,2831
1798.936,6,1310,140434,545,112,3306,309,63850,765,110,2354,110,76584
1796.948,1,345,28980,345,56,5223,56,28980,0,0,0,0,0
0.909,6,10,1687,7,100,151,100,384,3,1179,323,1179,1303
1799.999,6,219,17405,83,75,21585,337,8510,136,50,13333,143,8895
1799.323,1,258,14448,258,28,7001,28,14448,0,0,0,0,0
1775.851,17,73,3060,72,14,25011,14,3024,1,8,0,8,36
1.008,17,2,116,2,30,1008,30,116,0,0,0,0,0
41.546,17,22,1672,22,48,1978,48,1672,0,0,0,0,0
280.652,6,29,7392,13,158,23387,267,1317,16,603,18704,2036,6075
97.918,17,4514,3790333,2778,1278,35,1350,3628673,1736,65,55,1350,161660
60.345,6,165,13210,145,132,419,174,6734,20,472,3169,1420,6476
0.418,6,7,295,4,0,139,0,164,3,7,104,7,131
300.661,6,35,8418,20,308,15824,885,2064,15,574,607,4848,6354
4.187,17,11,9966,4,708,1395,1350,2945,7,975,596,1350,7021
7.406,6,1525,1419358,970,1386,7,1408,1385834,555,931,13,2816,33524
280.199,6,29,7392,13,158,23349,267,1317,16,603,18676,2036,6075
240.562,6,46,8552,23,449,10934,1402,5700,23,206,10934,580,2852
282.03,6,29,7392,13,158,23502,267,1317,16,603,18780,2036,6075
0.502,17,3,451,2,39,168,39,134,1,289,0,289,317
0.129,6,10,1669,6,551,25,947,1346,4,159,42,159,323
10.768,6,18,5610,10,275,1196,275,958,8,1440,832,1440,4652
1681.519,17,14,1036,7,30,280248,30,406,7,62,280247,62,630
111.981,17,4,1344,4,308,37327,308,1344,0,0,0,0,0
332.29,6,18,1622,2,106,15430,106,194,16,74,22151,90,1428
5.537,6,40,7325,20,218,291,314,3423,20,442,278,1152,3902
0.58,6,134,90183,67,131,8,232,3209,67,1359,8,2860,86974
1800.0,6,197,13768,70,46,26086,46,5744,127,46,14284,46,8024
10.03,17,2,128,2,36,10030,36,128,0,0,0,0,0
98.43,17,6,781,3,36,49213,36,192,3,168,49212,187,589
1782.519,17,81,3396,80,14,22563,14,3360,1,8,0,8,36
4.861,6,38,7229,20,218,255,314,3423,18,513,269,1179,3806
6.616,6,16,2186,8,211,945,211,671,8,545,860,904,1515
11.475,6,89,26165,45,549,260,1152,19923,44,447,260,1179,6242
5.215,6,24,6994,11,275,521,275,719,13,522,384,1440,6275
280.973,6,65,11698,28,708,10406,1408,7202,37,85,7485,580,4496
141.883,17,24,1824,24,48,6168,48,1824,0,0,0,0,0
0.915,6,17,5164,9,150,114,174,664,8,835,108,1452,4500
1782.093,6,117,13596,77,81,23448,500,6029,40,156,45692,1420,7567
1781.148,6,350,22280,203,69,8817,69,12260,147,69,12199,69,10020
0.965,6,31,12946,16,529,64,1440,3330,15,818,56,1440,9616
221.729,6,31,8912,14,158,17056,267,1357,17,763,13849,2760,7555
76.969,17,8,640,4,48,25651,48,304,4,56,25651,56,336
10.262,6,47,13991,22,289,488,721,3489,25,730,384,1414,10502
1720.511,1,8,448,8,28,245787,28,448,0,0,0,0,0
782.074,2,8,256,8,8,111724,8,256,0,0,0,0,0
34.851,17,4,244,2,33,34850,33,122,2,33,34850,33,122
0.005,17,2,391,1,43,0,43,71,1,292,0,292,320
292.049,17,4,352,2,60,292048,60,176,2,60,292047,60,176
8.969,6,36,8315,18,363,527,774,1841,18,441,512,1460,6474
1755.877,6,105,6258,60,26,29759,27,3519,45,26,39905,27,2739
1784.548,6,106,8446,69,64,26243,64,4936,37,58,49568,58,3510
421.122,2,6,192,6,8,84224,8,192,0,0,0,0,0
1.599,6,9,527,5,43,399,43,311,4,0,511,0,216
75.312,17,4,352,2,60,75310,60,176,2,60,75311,60,176
19.807,6,1613,1461075,959,1440,20,1448,1419531,654,776,29,1448,41544
1781.057,17,142,11360,71,48,25443,48,5396,71,56,25443,56,5964
1798.148,1,345,28980,345,56,5227,56,28980,0,0,0,0,0
1.435,6,41,8435,21,321,71,1168,2814,20,400,65,1460,5621
2.912,17,4,296,4,46,970,46,296,0,0,0,0,0
8.933,6,3,180,3,0,0,0,180,0,0,0,0,0
0.014,17,2,590,1,32,0,32,60,1,502,0,502,530
1637.722,1,8,448,8,28,233960,28,448,0,0,0,0,0
1795.388,6,356,22520,208,69,8673,69,12460,148,69,12213,69,10060
0.024,17,2,912,1,308,0,308,336,1,548,0,548,576
181.258,6,71,10822,30,98,6248,267,2883,41,262,4531,3426,7939
34.033,6,16,2983,10,194,3781,293,1378,6,453,413,1179,1605
1781.439,1,56,4704,56,56,32389,56,4704,0,0,0,0,0
1773.342,6,180,15480,120,69,14902,69,8940,60,69,30047,69,6540
293.676,6,40,8099,19,158,16315,267,1561,21,473,14683,1400,6538
1787.245,6,106,8456,68,65,26675,65,4930,38,59,48301,59,3526
1745.455,6,95,7203,63,38,28152,205,4476,32,33,56294,98,2727
5.435,6,39,7285,20,218,286,314,3423,19,516,287,1179,3862
1786.091,6,104,8376,68,65,26658,65,4930,36,59,51028,59,3446
89.349,17,7,2868,7,381,14891,548,2868,0,0,0,0,0
712.401,6,136,8377,62,69,11678,69,3791,74,37,9758,64,4586
10.771,6,20,4402,11,275,1077,275,998,9,758,753,1420,3404
1741.113,6,87,6322,58,31,30545,31,3915,29,31,62180,31,2407
240.227,6,56,20824,30,854,8283,1418,17797,26,208,9608,580,3027
1.547,6,27,10173,16,284,103,584,1496,11,1029,138,1420,8677
1792.654,17,87,3648,86,14,21090,14,3612,1,8,0,8,36
1771.973,6,99,9240,66,65,27261,65,5577,33,59,55370,59,3663
0.951,6,24,6416,14,299,73,838,2059,10,988,104,1731,4357
1727.488,17,146,13016,73,65,23970,952,6804,73,57,23991,72,6212
42.203,17,44,6468,22,48,2009,48,1672,22,190,2009,308,4796
421.112,2,5,160,5,8,105278,8,160,0,0,0,0,0
69.495,6,30,13193,16,721,134,1309,3593,14,902,5322,1591,9600
0.296,6,11,1373,5,585,74,585,841,6,212,37,212,532
242.974,6,55,14614,28,697,8998,1418,11283,27,191,9344,580,3331
343.148,6,72,50198,46,1203,7625,1408,42112,26,840,2464,2439,8086
1.329,6,41,9968,21,440,66,1360,4392,20,433,58,1360,5576
1.073,6,18,5041,9,290,134,517,1053,9,1165,133,1508,3988
102.62,6,68,45771,43,1182,2443,1448,37717,25,749,2573,1448,8054
336.466,17,7,532,7,48,56077,48,532,0,0,0,0,0
40.867,6,30,7432,13,158,3405,267,1317,17,543,2552,1400,6115
6.076,6,1565,1429868,975,1388,6,1408,1394524,590,931,10,2816,35344
0.832,6,23,6429,13,314,68,909,2095,10,982,91,1737,4334
0.307,6,15,6145,8,128,43,128,552,7,1305,51,1472,5593
1.129,6,25,8056,12,164,87,267,1288,13,869,79,1408,6768
0.125,6,9,1148,5,145,31,145,349,4,635,30,635,799
0.424,17,2,152,1,48,0,48,76,1,48,0,48,76
300.238,6,38,21793,24,1076,13053,1408,16345,14,785,3156,1491,5448
248.43,6,6,378,2,106,248420,106,194,4,0,82806,0,184
1.786,17,28,10406,13,338,146,1350,4768,15,347,125,1350,5638
0.032,6,10,861,6,182,6,182,490,4,77,6,134,371
280.27,6,30,7432,13,158,23355,267,1317,17,543,17510,1400,6115
1776.271,17,73,3060,72,14,25017,14,3024,1,8,0,8,36
0.001,17,2,116,2,30,1,30,116,0,0,0,0,0
0.245,17,3,451,2,39,228,39,134,1,289,0,289,317
0.008,17,2,810,2,377,8,377,810,0,0,0,0,0
17.699,6,14,2243,8,210,2528,210,844,6,545,3539,905,1399
0.5,17,14,6686,7,590,83,1350,4328,7,308,73,1350,2358
1744.215,6,94,7151,62,38,28593,205,4424,32,33,56258,98,2727
12.863,6,12,967,5,275,3215,275,479,7,96,1989,96,488
1796.778,17,447,39580,403,35,4469,288,25676,44,288,40946,288,13904
1786.788,6,102,8296,68,65,26668,65,4930,34,59,54142,59,3366
1792.43,6,181,15526,94,116,19273,208,10992,87,31,20838,31,4534
86.661,6,24,10136,12,541,79,1360,2677,12,1161,7863,2720,7459
3.49,17,2,152,2,48,3490,48,152,0,0,0,0,0
10.773,6,18,5550,10,275,1197,275,958,8,1420,856,1420,4592
4.57,6,36,7624,19,350,253,1152,4615,17,465,269,1179,3009
1743.29,6,103,7455,65,31,27238,31,4420,38,31,47115,31,3035
11.021,6,1379,1269849,887,1356,12,1408,1239601,492,776,22,1408,30248
280.323,6,30,7432,13,158,23360,267,1317,17,543,17515,1300,6115
267.947,6,31,8912,14,158,20611,267,1357,17,687,16742,2036,7555
1796.403,1,363,30492,363,56,4962,56,30492,0,0,0,0,0
1795.815,17,449,39416,404,34,4456,288,25444,45,282,40018,288,13972
305.606,6,25,7400,15,216,3903,501,1470,10,690,33946,1420,5930
7.583,6,29,11769,9,142,947,267,938,20,715,397,1460,10831
1744.708,2,27,864,27,8,67104,8,864,0,0,0,0,0
9.867,6,34,9413,14,155,759,267,1346,20,453,519,1420,8067
1799.136,1,345,28980,345,56,5230,56,28980,0,0,0,0,0
1783.988,17,83,3480,82,14,22024,14,3444,1,8,0,8,36
1.965,6,2,100,1,0,0,0,60,1,0,0,0,40
5.342,6,39,7269,20,218,281,314,3423,19,440,282,1152,3846
36.592,17,3,528,3,148,18296,352,528,0,0,0,0,0
7.731,17,4,300,2,39,7727,39,134,2,55,7498,55,166
3.0,17,3,1021,2,308,2003,308,672,1,321,0,321,349
1729.191,6,62,4547,41,33,43229,33,2804,21,31,86451,31,1743
8.272,6,7,420,2,0,1012,0,120,5,0,2033,0,300
1799.943,6,2302,665957,1169,258,1540,1360,272205,1133,845,1589,4080,393752
3.208,17,5,295,5,31,802,31,295,0,0,0,0,0
1781.756,6,360,24156,210,88,8525,469,13878,150,69,11958,69,10278
461.576,1,16,896,16,28,30771,28,896,0,0,0,0,0
1682.629,17,16,1265,8,30,240370,37,471,8,71,240368,136,794
0.305,6,28,9015,13,232,25,567,1624,15,825,21,1408,7391
0.468,6,12,1653,6,288,90,288,548,6,426,53,434,1105
0.248,6,4,493,2,241,248,241,321,2,92,3,92,172
0.446,6,22,7342,12,335,40,668,1974,10,1210,48,1906,5368
47.257,6,33,8302,15,378,41,787,1766,18,446,2772,3488,6536
1786.195,6,160,20357,94,304,19206,304,14332,66,83,27479,83,6025
1.18,6,4,184,2,0,1180,0,88,2,0,1009,0,96
61.329,6,37,15936,22,800,2920,1448,9158,15,665,4362,1448,6778
10.541,6,81,24445,41,549,263,1152,18688,40,461,263,1179,5757
1.412,6,46,19006,27,882,54,1360,13470,19,476,68,2715,5536
4.676,6,41,7349,21,218,233,314,3463,20,513,232,1179,3886
0.341,6,11,5970,5,167,85,167,423,6,1306,34,1448,5547
959.922,2,10,320,10,8,106658,8,320,0,0,0,0,0
1.936,17,2,672,2,308,1936,308,672,0,0,0,0,0
59.324,17,4,352,2,60,59323,60,176,2,60,59323,60,176
97.472,6,11,900,11,46,9747,46,900,0,0,0,0,0
3.505,17,2,656,2,300,3505,300,656,0,0,0,0,0
280.907,6,29,7392,13,158,23408,267,1317,16,603,18720,2036,6075
0.619,6,14,1745,7,288,72,288,600,7,426,74,434,1145
300.643,6,18,1227,5,177,75116,177,445,13,110,25038,110,782
1772.968,6,180,15480,120,69,14898,69,8940,60,69,30041,69,6540
1800.0,6,398,26666,181,46,9834,63,11592,217,46,8333,46,15074
1788.13,17,142,11360,71,48,25544,48,5396,71,56,25543,56,5964
8.559,6,22,5306,12,383,778,885,2537,10,560,929,1767,2769
42.666,17,4,352,2,60,42665,60,176,2,60,42665,60,176
3.779,6,24,6530,11,268,373,517,1385,13,744,311,1418,5145
1781.748,17,81,3393,79,13,22840,14,3313,2,12,1781567,16,80
0.064,6,2,80,1,0,0,0,40,1,0,0,0,40
1794.098,6,364,24523,212,87,8502,469,14096,152,69,11880,69,10427
1789.44,17,142,11360,71,48,25563,48,5396,71,56,25563,56,5964
0.194,6,29,7376,14,155,14,267,1341,15,543,13,1400,6035
0.004,17,2,294,1,34,0,34,62,1,204,0,204,232
1680.729,1,15,840,15,28,120052,28,840,0,0,0,0,0
1.2,6,4,184,2,0,1200,0,88,2,0,1013,0,96
240.314,6,46,9304,24,524,10447,1418,5972,22,242,11443,618,3332
1739.377,6,104,7507,65,31,27177,31,4420,39,31,45772,31,3087
304.597,6,61,23565,29,993,10871,1360,17068,32,260,9819,1360,6497
1255.704,6,98,12320,57,88,22423,516,4660,41,171,30216,1452,7660
1780.856,6,353,22400,206,69,8687,69,12380,147,69,12197,69,10020
60.143,6,25,7097,12,155,5467,267,1266,13,589,5011,3426,5831
2.498,6,14,2351,8,188,356,245,700,6,703,447,1152,1651
1787.396,1,168,17808,168,78,10702,78,17808,0,0,0,0,0
0.053,17,8,2454,8,278,7,317,2454,0,0,0,0,0
53.886,6,30,8872,15,158,3849,267,1397,15,763,3846,2800,7475
68.024,6,30,7432,13,158,5668,267,1317,17,543,4227,1400,6115
1778.78,1,69,5796,69,56,26158,56,5796,0,0,0,0,0
183.321,17,3,195,3,37,91660,47,195,0,0,0,0,0
0.097,17,4,420,2,33,0,33,122,2,121,86,145,298
0.082,17,2,309,1,40,0,40,68,1,213,0,213,241
1788.421,1,122,6832,122,28,14780,28,6832,0,0,0,0,0
14.793,6,3,160,2,0,14793,0,100,1,0,0,0,60
1630.202,1,8,448,8,28,232886,28,448,0,0,0,0,0
190.294,6,25,1028,8,0,9005,0,324,17,0,11892,0,704
281.709,6,32,7512,14,158,21669,267,1357,18,543,16566,1380,6155
1795.743,17,142,11360,71,48,25653,48,5396,71,56,25653,56,5964
23.354,6,3748,3646768,2514,1375,9,1408,3577912,1234,931,18,2801,68856
8.134,1,5,140,5,0,0,0,140,0,0,0,0,0
1740.572,17,30,31620,30,1026,60019,1026,31620,0,0,0,0,0
0.172,6,44,20054,26,1003,6,1420,15113,18,467,9,1883,4941
1.408,6,51,22157,29,956,50,1440,16501,22,433,57,1440,5656
2.641,17,4,678,3,32,684,32,180,1,470,0,470,498
842.293,2,7,224,7,8,140382,8,224,0,0,0,0,0
1764.083,2,14,448,14,8,135698,8,448,0,0,0,0,0
9.284,6,29,7257,13,155,773,267,1306,16,441,618,1420,5951
1786.81,17,85,3564,84,14,21527,14,3528,1,8,0,8,36
1799.174,6,130,8202,73,47,24985,208,4992,57,31,32124,31,3210
299.648,6,6,364,4,31,99882,31,222,2,31,299629,31,142
1775.645,6,180,15480,120,69,14921,69,8940,60,69,30093,69,6540
1788.268,6,126,14676,80,84,22636,498,6426,46,160,39737,1420,8250
1771.742,6,101,9278,66,64,27257,64,5544,35,58,52106,58,3734
537.638,6,198,160465,131,1300,4135,1408,144651,67,616,3993,2439,15814
66.196,6,30,14169,15,514,356,1440,3717,15,984,4718,1440,10452
241.09,6,44,10320,19,147,13393,517,2049,25,631,10045,1402,8271
110.049,17,4,240,2,32,110048,32,120,2,32,110048,32,120
1794.994,6,177,14710,95,101,19095,208,10071,82,37,22157,112,4639
37.609,6,37,8463,18,399,510,882,1950,19,478,2081,2128,6513
1785.549,17,87,3648,86,14,21006,14,3612,1,8,0,8,36
150.804,6,61,38960,38,1161,4075,1448,31010,23,749,2794,1448,7950
1.017,6,25,9259,14,350,78,1041,1992,11,973,82,1460,7267
40.429,2,4,128,4,8,13476,8,128,0,0,0,0,0
157.814,6,24,10054,12,532,58,1360,2642,12,1153,14334,2720,7412
11.462,6,33,9480,17,225,705,561,2089,16,962,752,1631,7391
31.246,6,11,476,4,0,95,0,168,7,0,5205,0,308
38.214,6,27,7177,13,155,3184,267,1306,14,530,2938,3417,5871
3.99,17,71,83178,70,1159,57,1472,83138,1,12,0,12,40
0.454,6,21,7217,12,318,40,599,1905,9,967,55,1471,5312
58.148,6,27,7177,13,155,4845,267,1306,14,530,4472,3417,5871
5.035,17,4,288,2,36,4995,36,128,2,52,5002,52,160
149.001,6,23,9923,11,375,63,818,1611,12,977,13534,1360,8312
280.208,6,29,7392,13,158,23350,267,1317,16,603,18678,2236,6075
1782.468,17,325,74905,325,202,5501,422,74905,0,0,0,0,0
1778.131,17,79,3312,78,14,23092,14,3276,1,8,0,8,36
47.653,6,27,7177,13,155,3971,267,1306,14,530,3664,3417,5871
0.006,17,3,370,2,34,0,34,124,1,218,0,218,246
337.543,6,91,18895,41,298,8438,1408,7529,50,336,6888,2816,11366
0.117,17,2,144,1,36,0,36,64,1,52,0,52,80
121.122,17,8,1176,4,48,40372,48,304,4,190,40371,308,872
1750.7,6,95,7203,63,38,28237,205,4476,32,33,56464,98,2727
57.471,6,21,5945,11,267,5747,501,1245,10,613,6375,1420,4700
1741.441,17,30,7050,30,207,60049,207,7050,0,0,0,0,0
1773.061,6,180,15480,120,69,14899,69,8940,60,69,30047,69,6540
3.488,17,2,136,1,32,0,32,60,1,48,0,48,76
373.634,6,22,1447,14,177,28741,177,913,8,110,9248,110,534
19.717,1,6,504,6,56,3943,56,504,0,0,0,0,0
0.833,6,10,1687,7,100,138,100,384,3,1179,284,1179,1303
721.971,2,9,288,9,8,90246,8,288,0,0,0,0,0
0.616,6,14,1745,7,288,72,288,600,7,426,71,434,1145
4.005,17,8,1348,4,33,1333,33,244,4,248,1333,277,1104
1783.813,6,356,22520,208,69,8617,69,12460,148,69,12134,69,10060
43.48,6,666,563073,394,1353,110,1368,542857,272,665,159,1368,20216
1.77,6,53,19873,29,920,63,1460,14092,24,400,65,1460,5781
300.696,6,47,8959,24,266,13073,720,2130,23,346,636,2720,6829
0.008,17,2,358,1,59,0,59,87,1,243,0,243,271
1631.63,1,7,392,7,28,271938,28,392,0,0,0,0,0
9.419,6,86,27634,43,579,224,1152,21432,43,407,217,1152,6202
0.066,17,2,154,1,33,0,33,61,1,65,0,65,93
0.277,6,26,6150,13,181,23,537,1578,13,555,22,1542,4572
74.466,6,42,10590,18,773,1667,1360,4642,24,292,3229,2667,5948
1762.505,17,168,14034,156,30,11370,37,9090,12,384,154799,463,4944
0.135,17,4,284,2,32,0,32,120,2,54,124,60,164
128.288,17,4,284,2,32,128281,32,120,2,54,128281,60,164
143.566,17,4,240,2,32,143565,32,120,2,32,143565,32,120
1.801,17,26,13395,12,557,163,1350,7030,14,426,123,1350,6365
0.065,17,2,586,1,41,0,41,69,1,489,0,489,517
1768.91,1,58,4872,58,56,31033,56,4872,0,0,0,0,0
1799.991,1,16,896,16,28,119999,28,896,0,0,0,0,0
187.248,17,14,1064,14,48,14403,48,1064,0,0,0,0,0
295.044,17,4,288,2,36,295008,36,128,2,52,295012,52,160
3.007,6,21,6964,10,185,334,275,961,11,617,218,1440,6003
6.282,1,4,224,4,28,2094,28,224,0,0,0,0,0
1772.429,6,180,15480,120,69,14894,69,8940,60,69,30039,69,6540
0.987,6,22,9224,14,296,75,826,1777,8,1778,116,5290,7447
15.453,17,22,5922,10,295,1713,1350,3234,12,196,1402,1350,2688
1786.673,6,104,8308,68,64,26666,64,4896,36,58,51044,58,3412
1.462,6,51,20152,27,950,56,1460,14416,24,433,51,1460,5736
2.963,6,2,88,2,0,0,0,88,0,0,0,0,0
4.051,17,2,120,2,32,4051,32,120,0,0,0,0,0
3.931,6,2,88,2,0,0,0,88,0,0,0,0,0
0.049,6,2,133,1,0,0,0,40,1,53,0,53,93
6.639,17,23,8441,11,478,663,1350,5572,12,211,600,1350,2869
268.86,17,4,240,2,32,268859,32,120,2,32,268859,32,120
1773.625,6,180,15480,120,69,14904,69,8940,60,69,30056,69,6540
1780.417,6,354,22440,207,69,8642,69,12420,147,69,12194,69,10020
2.926,6,2,88,2,0,0,0,88,0,0,0,0,0
0.364,17,2,144,1,36,0,36,64,1,52,0,52,80
72.723,17,20,1760,10,48,8079,48,760,10,72,8079,72,1000
0.071,17,2,348,1,39,0,39,67,1,253,0,253,281
0.128,6,2,143,1,51,0,51,103,1,0,0,0,40
1756.337,6,6235,5867723,2238,139,785,924,136039,3997,1413,439,2836,5731684
1788.321,17,87,3648,86,14,21039,14,3612,1,8,0,8,36
0.011,6,2,149,1,0,0,0,40,1,69,0,69,109
3.647,6,12,1036,6,283,694,283,603,6,105,694,105,433
3.025,17,6,950,3,33,997,33,183,3,227,0,249,767
280.335,6,30,7432,13,158,23361,267,1317,17,543,17518,1400,6115
1772.376,6,180,15480,120,69,14893,69,8940,60,69,30031,69,6540
1.021,17,3,238,2,30,1019,30,116,1,94,0,94,122
11.596,6,24,9520,13,275,966,275,1078,11,1331,839,1420,8442
240.303,6,43,8930,21,519,12014,1402,5776,22,222,11442,618,3154
0.071,17,4,420,2,33,0,33,122,2,121,0,145,298
13.592,6,27,4914,13,180,1112,721,1767,14,345,1030,1368,3147
0.073,17,4,360,2,30,0,30,116,2,94,31,94,244
122.826,6,31,8912,14,158,9448,267,1357,17,687,7672,1400,7555
21.802,6,37,8503,17,401,626,888,1904,20,413,1140,1460,6599
1747.343,6,95,7203,63,38,28182,205,4476,32,33,56352,98,2727
0.482,17,3,451,2,39,221,39,134,1,289,0,289,317
1789.605,6,356,28617,205,75,8772,267,13195,151,132,11930,1414,15422
1743.645,6,91,6871,59,39,30062,205,4206,32,33,56232,98,2665
2.486,6,6,340,3,0,1150,0,164,3,0,1149,0,176
110.033,1,4,224,4,28,36677,28,224,0,0,0,0,0
318.201,17,8,2688,8,308,45457,308,2688,0,0,0,0,0
1076.903,17,210,15960,210,48,5152,48,15960,0,0,0,0,0
11.042,6,85,26210,43,548,262,1152,20389,42,459,262,1179,5821
1794.072,1,294,24696,294,56,6123,56,24696,0,0,0,0,0
300.24,6,70,54453,45,1271,6823,1408,48140,25,834,1558,2899,6313
249.148,6,43,3368,18,86,14648,295,1767,25,50,10375,78,1601
1788.173,1,240,13440,240,28,7481,28,13440,0,0,0,0,0
0.625,6,10,861,5,222,153,222,426,5,231,153,231,435
65.938,6,28,7213,13,155,5494,267,1306,15,482,4709,2600,5907
154.933,17,4,352,2,60,154932,60,176,2,60,154932,60,176
1680.42,1,15,840,15,28,120030,28,840,0,0,0,0,0
1766.997,1,58,4872,0,0,0,0,0,58,56,30999,56,4872
1786.959,6,106,8524,68,66,26671,66,4964,38,60,48293,60,3560
28.151,17,16,1408,8,48,4020,48,608,8,72,4020,72,800
96.997,6,21,9086,12,304,78,597,1425,9,1457,12103,4441,7661
876.02,17,125,9500,125,48,7064,48,9500,0,0,0,0,0
1.323,6,50,18664,27,846,50,1360,12968,23,433,52,1360,5696
1738.858,6,87,6322,58,31,30506,31,3915,29,31,62101,31,2407
240.215,6,54,17804,29,796,8578,1402,15062,25,179,10008,580,2742
1771.094,6,99,9306,66,66,27247,66,5610,33,60,55344,60,3696
53.566,6,23,1699,17,43,3347,43,1339,6,0,6200,0,360
4.018,17,8,616,4,33,1333,33,244,4,65,1333,65,372
1694.941,1,8,448,8,28,242134,28,448,0,0,0,0,0
371.376,6,27,1767,18,177,21845,177,1181,9,110,8630,110,586
126.262,2,2,64,2,8,126262,8,64,0,0,0,0,0
12.694,6,20,6462,11,275,1269,275,723,9,1073,960,1440,5739
1520.273,1,92,5152,92,28,16706,28,5152,0,0,0,0,0
125.995,6,11,1727,5,100,128,100,304,6,1179,25149,1179,1423
1787.05,6,216,50918,123,578,14647,1250,39627,93,120,19423,192,11291
1789.575,17,142,11360,71,48,25565,48,5396,71,56,25565,56,5964
0.967,17,2,312,2,128,967,128,312,0,0,0,0,0
1772.412,6,252,25255,102,67,17547,659,9596,150,128,11894,3098,15659
0.167,17,8,4839,4,418,55,1350,1787,4,735,39,1350,3052
52.357,2,2,64,2,8,52357,8,64,0,0,0,0,0
2.963,6,3,511,2,0,2963,0,80,1,391,0,391,431
116.254,6,97,64435,56,1217,2113,1368,55341,41,747,1580,1368,9094
2.902,17,28,9304,14,264,220,1350,4101,14,343,220,1350,5203
0.348,17,4,288,2,36,297,36,128,2,52,300,52,160
1799.68,17,450,39960,405,35,4454,288,25740,45,288,40021,288,14220
1039.155,6,119,8210,43,46,24741,46,3422,76,46,13855,46,4788
1799.268,17,450,39960,405,35,4453,288,25740,45,288,40020,288,14220
0.563,6,22,7354,13,335,46,668,2038,9,968,69,1906,5316
1791.598,17,179,13962,179,50,10065,50,13962,0,0,0,0,0
162.796,6,39,8485,15,124,11628,267,1731,24,304,7070,1452,6754
0.052,17,2,179,1,43,0,43,71,1,80,0,80,108
152.242,6,17,6431,4,331,1573,599,879,13,539,12686,580,5552
41.171,2,2,64,2,8,41171,8,64,0,0,0,0,0
240.275,6,45,9042,21,519,12013,1402,5776,24,223,10446,618,3266
96.568,6,16,4875,6,131,19313,131,455,10,967,10725,967,4420
0.674,6,3,354,2,210,226,210,314,1,0,0,0,40
0.884,6,10,1677,6,555,176,951,1354,4,159,279,159,323
0.393,6,8,335,4,0,131,0,164,4,7,68,7,171
20.329,6,25,6283,14,117,1563,159,1337,11,727,2031,1418,4946
0.009,6,15,3984,10,101,0,101,629,5,1029,2,1500,3355
1.809,6,49,20293,28,962,67,1440,14632,21,400,80,1440,5661
0.074,17,2,157,1,31,0,31,59,1,70,0,70,98
2.186,6,13,2311,8,188,312,245,700,5,1407,480,1407,1611
103.197,6,40,12636,14,272,848,721,1927,26,483,4121,2840,10709
32.027,6,49,14149,23,263,1455,721,3562,26,636,1240,1414,10587
1694.406,17,52,2178,51,14,33888,14,2142,1,8,0,8,36
1788.803,6,363,25352,211,100,8518,469,14856,152,69,11846,69,10496
1799.766,1,66,5544,66,56,27688,56,5544,0,0,0,0,0
1.99,6,13,2311,8,188,284,245,700,5,1407,433,1407,1611
1.584,6,25,8769,15,286,113,590,1462,10,986,156,1420,7307
1792.845,6,356,22520,208,69,8661,69,12460,148,69,12196,69,10060
1792.154,17,180,14040,180,50,10012,50,14040,0,0,0,0,0
1794.164,17,66,2766,65,14,28033,14,2730,1,8,0,8,36
1787.404,17,142,11360,71,48,25533,48,5396,71,56,25533,56,5964
1786.785,6,104,8308,68,64,26668,64,4896,36,58,51048,58,3412
148.289,1,22,1232,22,28,7061,28,1232,0,0,0,0,0
1776.27,17,73,3060,72,14,25017,14,3024,1,8,0,8,36
9.734,17,4,5484,4,1343,3244,1348,5484,0,0,0,0,0
233.648,6,165,128941,104,1304,2268,1448,116266,61,633,1320,1448,12675
352.922,6,39,7529,18,143,13406,516,1870,21,267,17641,1452,5659
1791.651,17,140,11184,72,48,25234,48,5472,68,56,26738,56,5712
1574.677,6,158,13698,100,69,14869,69,7450,58,68,27625,69,6248
372.413,6,27,1767,18,177,21906,177,1181,9,110,8683,110,586
1735.216,1,57,4788,57,56,30986,56,4788,0,0,0,0,0
1681.377,17,14,1036,7,30,280226,30,406,7,62,280226,62,630
0.062,17,2,251,1,36,0,36,64,1,159,0,159,187
0.038,17,4,308,2,38,0,38,132,2,60,34,66,176
117.486,6,24,9289,12,557,129,1361,2184,12,944,10656,1460,7105
110.614,6,76,50285,46,1191,2458,1408,40584,30,903,2126,2816,9701
0.27,6,2,1193,2,1113,270,1113,1193,0,0,0,0,0
1783.299,17,83,3480,82,14,22016,14,3444,1,8,0,8,36
280.286,6,28,7352,12,158,25480,267,1277,16,603,18679,1400,6075
1794.487,17,144,11520,72,48,25274,48,5472,72,56,25274,56,6048
129.286,6,25,10081,13,523,55,1360,2669,12,988,11740,1360,7412
280.479,17,4,296,2,30,280443,30,116,2,62,280431,62,180
240.512,6,58,24002,26,548,9619,1418,6299,32,843,7757,1418,17703
4.207,6,40,7309,19,218,233,314,3383,21,440,197,1152,3926
1788.685,6,367,23236,212,69,8477,69,12896,155,69,11614,69,10340
1798.119,6,356,22520,208,69,8686,69,12460,148,69,12231,69,10060
0.555,17,5,1735,5,319,138,354,1735,0,0,0,0,0
0.13,6,4,220,3,0,65,0,156,1,0,0,0,64
1679.508,17,12,498,11,14,167950,14,462,1,8,0,8,36
1771.036,6,99,9306,66,66,27246,66,5610,33,60,55342,60,3696
1.044,6,29,8543,15,225,61,561,1985,14,997,65,2720,6558
368.516,6,18,1239,14,177,28347,177,913,4,110,20057,110,326
1.45,6,39,8294,19,321,80,1164,2718,20,433,66,1460,5576
0.037,17,2,152,1,48,0,48,76,1,48,0,48,76
387.085,6,20,1744,13,226,32257,226,1136,7,110,14838,110,608
68.176,17,4,352,2,60,68175,60,176,2,60,68175,60,176
240.29,6,43,9045,21,523,12014,1408,5811,22,231,11442,619,3234
125.445,6,20,4254,10,296,13938,722,1405,10,387,13917,1408,2849
0.883,17,2,116,2,30,883,30,116,0,0,0,0,0
316.996,6,104,34400,57,494,5660,1360,23629,47,341,6887,2720,10771
120.094,17,4,670,2,31,120089,33,118,2,248,120089,262,552
1.479,6,40,9928,20,440,77,1360,4352,20,433,67,1360,5576
0.013,6,2,111,1,0,0,0,40,1,31,0,31,71
1777.845,6,185,15956,121,69,14815,69,8980,64,69,28212,69,6976
175.539,17,4,240,2,32,175537,32,120,2,32,175538,32,120
15.488,6,2,120,2,0,0,0,120,0,0,0,0,0
277.703,6,39,7561,17,154,10204,516,1764,22,258,13219,1452,5797
33.062,17,5,1680,5,308,8265,308,1680,0,0,0,0,0
1773.052,6,180,15480,120,69,14899,69,8940,60,69,30046,69,6540
38.42,6,30,7432,13,158,3201,267,1317,17,543,2399,1400,6115
1.655,6,14,2351,8,188,236,245,700,6,703,280,1152,1651
1758.301,6,4562,4646946,1663,152,1057,912,106568,2899,1556,606,8508,4540378
1755.003,6,95,7203,63,38,28306,205,4476,32,33,56600,98,2727
69.04,6,17,9328,5,174,17167,174,382,12,1408,6242,1452,8946
0.445,17,3,1063,3,326,222,354,1063,0,0,0,0,0
1796.092,17,448,39896,403,35,4467,288,25676,45,288,40019,288,14220
61.297,6,17,692,9,0,7660,0,364,8,0,8754,0,328
1799.429,17,449,39928,404,35,4465,288,25708,45,288,40019,288,14220
1.586,6,48,18657,27,852,61,1360,13041,21,433,68,1360,5616
0.41,6,25,7711,16,339,27,949,3017,9,721,49,1420,4694
0.101,1,2,112,2,28,101,28,112,0,0,0,0,0
1786.501,6,102,8364,68,66,26664,66,4964,34,60,54133,60,3400
60.611,6,11,905,11,37,6061,37,905,0,0,0,0,0
1795.061,17,447,39580,403,35,4465,288,25676,44,288,40945,288,13904
0.054,17,4,368,2,32,54,32,120,2,96,6,96,248
0.87,17,20,12058,11,606,87,1350,6977,9,536,74,1350,5081
1789.759,1,58,4872,58,56,31399,56,4872,0,0,0,0,0
155.038,6,64,11591,24,223,6740,1189,3424,40,327,3965,1420,8167
1792.002,6,358,22600,208,69,8656,69,12460,150,69,12026,69,10140
1778.06,17,140,11200,70,48,25768,48,5320,70,56,25768,56,5880
294.429,6,31,9082,11,181,29442,267,1168,20,474,15495,1400,7914
1796.935,17,140,11200,70,48,26042,48,5320,70,56,26042,56,5880
139.458,6,23,5239,6,341,20611,722,1343,17,231,8705,1408,3896
4.937,6,38,7229,20,218,259,314,3423,18,513,275,1179,3806
1773.688,6,180,15480,120,69,14904,69,8940,60,69,30054,69,6540
0.891,6,11,1727,7,100,148,100,384,4,589,211,1152,1343
635.799,1,11,616,11,28,63579,28,616,0,0,0,0,0
1680.504,1,15,840,15,28,120036,28,840,0,0,0,0,0
10.705,6,1899,1791959,1233,1377,8,1408,1752663,666,776,15,1408,39296
5.516,6,38,7229,20,218,290,314,3423,18,513,307,1179,3806
1793.04,17,88,3684,86,14,21094,14,3612,2,8,21037,8,72
1681.614,17,14,1036,7,30,280266,30,406,7,62,280267,62,630
86.631,6,29,8841,10,501,25,986,2032,19,415,4812,2899,6809
1798.336,6,355,22480,207,69,8729,69,12420,148,69,12233,69,10060
1799.565,6,123,7829,71,48,25708,208,4819,52,31,35277,31,3010
171.529,6,8,336,3,0,85764,0,124,5,0,42814,0,212
1.319,6,49,22622,30,932,45,1360,17086,19,529,63,4075,5536
4.288,6,32,6105,17,206,268,314,2744,15,551,288,1179,3361
164.096,6,1003,495215,537,853,306,1152,474615,466,390,352,1152,20600
1260.73,2,13,416,13,8,105060,8,416,0,0,0,0,0
320.378,17,82,7736,73,39,4447,288,4892,9,288,40024,288,2844
0.077,17,2,167,1,39,0,39,67,1,72,0,72,100
0.357,6,22,7333,12,334,31,663,1969,10,1209,39,1906,5364
1745.395,6,116,9563,72,55,24583,205,5683,44,39,40585,112,3880
0.234,17,8,2750,8,315,33,354,2750,0,0,0,0,0
1790.779,17,740,44600,740,32,2423,37,44600,0,0,0,0,0
9.307,6,17,3170,10,139,1034,326,935,7,465,1463,1448,2235
1774.666,6,180,15480,120,69,14913,69,8940,60,69,30078,69,6540
1681.871,1,15,870,15,30,120133,30,870,0,0,0,0,0
460.608,17,6,360,3,32,230303,32,180,3,32,230303,32,180
1.4,17,15,8395,8,705,200,1350,5871,7,332,224,1350,2524
2.648,6,29,6175,15,338,189,1314,2294,14,368,202,1420,3881
1779.744,17,50,16784,50,307,36321,308,16784,0,0,0,0,0
0.201,17,6,6312,6,1024,40,1024,6312,0,0,0,0,0
300.657,6,37,8404,20,284,15824,792,1971,17,478,530,1928,6433
251.826,2,2,64,2,8,251826,8,64,0,0,0,0,0
13.97,17,4,351,2,35,13959,37,127,2,84,13957,91,224
0.896,6,19,9236,11,509,89,1221,1999,8,1381,92,3639,7237
280.982,6,29,7392,13,158,23415,267,1317,16,603,18723,2036,6075
4.568,6,38,7229,19,218,253,314,3383,19,513,239,1179,3846
0.777,6,23,5715,13,158,63,370,1315,10,999,84,1699,4400
0.155,1,2,112,2,28,155,28,112,0,0,0,0,0
23.961,6,35,8343,17,165,1497,722,2170,18,778,1397,2760,6173
121.652,6,30,8872,14,158,9357,267,1357,16,858,8105,3456,7515
1796.378,6,372,25988,216,99,8355,469,15194,156,69,11589,69,10794
2.131,6,12,2271,7,188,355,245,660,5,1407,470,1407,1611
0.022,17,2,904,1,300,0,300,328,1,548,0,548,576
152.64,6,8,4102,8,526,21805,1402,4102,0,0,0,0,0
1745.644,6,144,9063,78,49,22670,208,5524,66,31,26852,31,3539
1791.96,6,124,14317,79,81,22973,501,6175,45,154,40724,1420,8142
0.403,17,22,6086,9,331,47,1350,3231,13,191,30,1350,2855
280.343,6,29,7392,13,158,23361,267,1317,16,603,18684,1400,6075
1763.153,17,167,14008,155,30,11449,37,9032,12,386,154855,463,4976
1660.324,1,8,848,8,78,237189,78,848,0,0,0,0,0
39.885,17,44,6468,22,48,1898,48,1672,22,190,1898,308,4796
0.075,17,4,284,2,32,2,32,120,2,54,0,60,164
1798.564,1,345,28980,345,56,5228,56,28980,0,0,0,0,0
1.791,6,13,2311,8,188,255,245,700,5,1407,385,1407,1611
1.072,6,16,2894,8,411,153,585,1646,8,396,141,580,1248
94.044,6,72,25184,33,848,2938,1440,14149,39,489,2437,1440,11035
0.211,6,10,1042,5,213,52,213,417,5,421,43,421,625
66.889,17,11,836,11,48,6688,48,836,0,0,0,0,0
1455.033,17,434,26089,434,32,3360,37,26089,0,0,0,0,0
10.002,17,3,2046,3,654,5001,654,2046,0,0,0,0,0
0.779,6,24,6208,13,264,64,662,1848,11,783,77,1420,4360
71.83,17,4,1344,4,308,23943,308,1344,0,0,0,0,0
5.016,17,4,288,2,36,4985,36,128,2,52,4982,52,160
1789.232,17,140,11200,70,48,25930,48,5320,70,56,25930,56,5880
782.065,2,8,256,8,8,111723,8,256,0,0,0,0,0
1746.288,6,97,7307,63,38,28165,205,4476,34,33,52906,98,2831
128.087,17,6,8242,6,1345,25617,1349,8242,0,0,0,0,0
1724.46,1,8,448,8,28,246351,28,448,0,0,0,0,0
1.499,6,53,19650,29,904,53,1460,13869,24,400,56,1460,5781
4.009,17,8,1272,4,33,1333,33,244,4,229,1332,233,1028
10.715,6,18,5610,10,275,1190,275,958,8,1440,783,1440,4652
280.439,6,30,7432,13,158,23369,267,1317,17,603,17524,2760,6115
1774.111,1,68,5712,68,56,26479,56,5712,0,0,0,0,0
1786.611,6,106,8524,68,66,26665,66,4964,38,60,48284,60,3560
2.029,17,6,462,3,33,1001,33,183,3,65,1001,65,279
1.297,6,43,10105,23,440,58,1360,4484,20,480,59,4075,5621
1740.662,1,15,840,15,28,124333,28,840,0,0,0,0,0
0.074,17,2,586,1,46,0,46,74,1,484,0,484,512
1799.414,17,142,11360,71,48,25705,48,5396,71,56,25705,56,5964
1798.886,17,449,39928,404,35,4463,288,25708,45,288,40019,288,14220
1324.842,6,92,10598,54,65,24997,65,4522,38,116,35804,382,6076
31.151,17,37,11788,17,310,1945,1350,5760,20,273,1637,1350,6028
279.701,6,86,16938,32,184,8864,1189,3876,54,302,5277,1420,13062
3.081,6,2,88,2,0,0,0,88,0,0,0,0,0
0.892,6,11,1727,7,100,148,100,384,4,589,209,1152,1343
13.295,6,23,9176,13,557,1107,1324,2355,10,899,1462,1440,6821
7.257,6,5,240,1,0,0,0,48,4,0,2415,0,192
0.432,17,2,162,1,36,0,36,64,1,70,0,70,98
0.009,17,2,410,1,36,0,36,64,1,318,0,318,346
0.174,17,2,152,1,48,0,48,76,1,48,0,48,76
17.37,6,2931,2749391,1896,1372,9,1408,2690895,1035,931,16,2801,58496
25.824,6,13,2142,8,329,3689,594,1082,5,396,6452,580,1060
1395.236,6,84,6290,54,40,26325,205,3822,30,33,48105,98,2468
8.782,6,28,15372,10,232,975,569,1482,18,995,510,1438,13890
240.633,6,140,82522,61,560,4010,1418,7689,79,1071,3084,1418,74833
1739.955,6,87,6322,58,31,30525,31,3915,29,31,62140,31,2407
0.337,6,24,6071,12,181,30,537,1526,12,652,29,1440,4545
1.326,6,50,20183,27,955,51,1460,14487,23,433,51,1460,5696
280.272,6,29,7392,13,158,23356,267,1317,16,603,18682,2036,6075
20.192,6,17,2316,10,189,2243,517,1298,7,323,3359,499,1018
29.295,6,43,8961,22,186,1395,721,2564,21,693,1454,1420,6397
1786.451,6,224,57207,126,623,14291,1291,44292,98,142,18416,241,12915
79.796,6,37,8409,14,155,6138,267,1346,23,340,3618,1460,7063
0.327,6,26,8868,13,227,27,547,1592,13,941,26,1408,7276
0.348,6,20,4960,10,137,38,267,1092,10,692,37,1467,3868
182.131,6,31,8912,14,158,14010,267,1357,17,858,11375,3456,7555
4.696,6,38,7229,20,218,247,314,3423,18,513,259,1179,3806
1740.577,17,30,7050,30,207,60019,207,7050,0,0,0,0,0
3.154,6,2,88,2,0,0,0,88,0,0,0,0,0
0.405,6,10,2101,5,1195,101,1195,1451,5,370,52,370,650
5.648,6,17,2425,9,211,705,211,922,8,545,806,904,1503
0.446,6,50,20841,28,971,16,1380,15719,22,468,19,3303,5122
61.636,6,55,34383,34,1125,1867,1408,26544,21,962,3069,3847,7839
1789.537,17,144,11520,72,48,25204,48,5472,72,56,25204,56,6048
1.99,17,3,180,3,32,995,32,180,0,0,0,0,0
14.619,6,9,685,0,0,0,0,0,9,31,1827,31,685
69.901,17,4,352,2,60,69899,60,176,2,60,69900,60,176
1783.815,6,361,22858,210,69,8534,69,12678,151,69,11892,69,10180
1795.351,17,29,9686,29,306,64119,306,9686,0,0,0,0,0
0.64,2,2,64,2,8,640,8,64,0,0,0,0,0
1797.485,1,58,4872,0,0,0,0,0,58,56,31534,56,4872
468.973,1,6,636,6,78,93794,78,636,0,0,0,0,0
1790.332,1,260,14560,260,28,6912,28,14560,0,0,0,0,0
108.82,6,49,14106,25,891,448,1360,8220,24,327,4724,2667,5886
1.22,17,29,10333,12,364,108,1350,4706,17,303,74,1350,5627
0.106,1,5,420,5,56,26,56,420,0,0,0,0,0
29.111,6,37,8629,18,454,507,1047,2115,19,441,1609,1440,6514
183.283,6,20,2497,11,324,18328,585,1229,9,396,22907,580,1268
280.394,6,30,7432,13,158,23366,267,1317,17,603,17522,2076,6115
1794.338,6,240,35580,150,302,12042,302,25920,90,83,20161,83,9660
37.182,17,4,240,2,32,37181,32,120,2,32,37181,32,120
38.156,17,11,836,11,48,3815,48,836,0,0,0,0,0
70.196,17,4,352,2,60,70195,60,176,2,60,70195,60,176
11.86,6,1873,1638353,1136,1388,10,1420,1604628,737,467,16,1883,33725
1786.682,1,176,18656,176,78,10209,78,18656,0,0,0,0,0
33.4,6,31,5141,15,180,2385,722,1860,16,305,2213,1408,3281
0.131,17,2,157,1,31,0,31,59,1,70,0,70,98
0.081,17,3,660,2,46,0,46,148,1,484,0,484,512
1784.698,1,216,12096,216,28,8300,28,12096,0,0,0,0,0
3.695,6,17,3347,9,49,461,92,563,8,394,174,1448,2784
8.004,6,15,1073,7,222,1332,222,506,8,231,1141,231,567
301.155,6,56,20653,28,1017,11147,1360,14378,28,285,11147,1360,6275
169.871,17,4,240,2,32,169870,32,120,2,32,169870,32,120
1.419,6,9,527,5,43,354,43,311,4,0,471,0,216
39.442,17,22,1936,11,48,3943,48,836,11,72,3943,72,1100
8.128,1,9,756,9,56,1016,56,756,0,0,0,0,0
0.598,6,27,6161,13,108,49,147,959,14,773,44,1608,5202
251.406,17,4,1344,4,308,83802,308,1344,0,0,0,0,0
0.078,17,4,284,2,32,41,32,120,2,54,41,60,164
240.669,2,3,96,3,8,120334,8,96,0,0,0,0,0
308.688,6,12,879,4,64,17953,64,288,8,38,44085,58,591
108.476,17,8,1790,8,195,15496,207,1790,0,0,0,0,0
38.678,17,22,1936,11,48,3867,48,836,11,72,3866,72,1100
1795.387,6,356,22520,208,69,8673,69,12460,148,69,12212,69,10060
1786.944,6,104,8376,68,65,26670,65,4930,36,59,51052,59,3446
12.35,6,1962,1706155,1185,1385,10,1420,1670854,777,467,15,2840,35301
441.444,2,5,160,5,8,110361,8,160,0,0,0,0,0
1778.164,1,64,5376,64,56,28224,56,5376,0,0,0,0,0
1787.903,6,420,25176,210,69,8554,69,12540,210,34,8554,48,12636
8.989,6,82,24901,40,546,230,1152,19080,42,413,213,1152,5821
1789.341,6,367,24643,213,87,8440,469,14205,154,69,11691,69,10438
7.803,6,28,7336,13,155,650,267,1301,15,543,556,1400,6035
43.883,17,14,1064,14,48,3375,48,1064,0,0,0,0,0
1751.603,1,56,4704,0,0,0,0,0,56,56,31847,56,4704
0.323,6,20,4960,10,137,35,267,1092,10,692,34,1467,3868
1787.384,17,348,26448,348,48,5150,48,26448,0,0,0,0,0
10.735,6,8,1592,3,100,5367,100,224,5,1152,2614,1152,1368
11.558,6,23,9480,12,275,1050,275,1038,11,1331,824,1420,8442
1.006,6,24,5806,13,158,83,370,1315,11,809,100,1731,4491
280.46,6,30,7432,14,158,21573,267,1357,16,678,18695,3456,6075
1791.136,6,5033,6530072,2713,125,660,354,179714,2320,2772,772,14080,6350358
97.447,6,34,7871,13,155,8120,267,1306,21,357,4871,3417,6565
297.183,17,17,18321,17,1049,18573,1451,18321,0,0,0,0,0
1772.601,6,203,22290,130,75,13741,267,10057,73,134,24614,1997,12233
0.813,6,20,5959,11,274,81,523,1267,9,721,92,1452,4692
280.257,6,29,7392,13,158,23354,267,1317,16,603,18679,2036,6075
125.136,6,42,10751,15,147,8937,267,1791,27,357,4812,2840,8960
1.303,6,41,9980,21,440,65,1360,4404,20,433,59,1360,5576
0.476,17,3,451,2,39,472,39,134,1,289,0,289,317
5.414,6,15,3217,5,92,1353,92,348,10,579,546,1448,2869
112.922,6,45,8870,16,139,4085,267,1761,29,282,4032,1460,7109
0.911,17,11,4537,5,432,227,1350,2300,6,344,80,1350,2237
1783.145,6,105,8416,68,65,26614,65,4930,37,59,49529,59,3486
0.318,6,27,9042,13,247,26,624,1672,14,947,23,1438,7370
6.829,1,4,343,4,57,2276,67,343,0,0,0,0,0
280.519,6,29,7392,13,158,23376,267,1317,16,603,18696,2036,6075
9.926,6,84,24853,43,542,236,1152,19072,41,459,241,1179,5781
125.05,6,26,7356,6,154,14229,267,712,20,364,6580,1460,6644
2.587,6,20,3833,11,234,258,564,1504,9,463,298,1343,2329
14.157,6,31,5904,15,154,997,722,1883,16,398,933,2026,4021
1782.218,6,383,33744,213,109,8406,469,16734,170,124,10545,1933,17010
0.902,6,26,8380,14,266,57,540,1924,12,1192,66,3151,6456
5.464,6,41,7349,21,218,273,314,3463,20,440,273,1152,3886
236.635,1,6,864,6,116,47327,207,864,0,0,0,0,0
1749.365,6,98,7390,63,38,28215,205,4476,35,33,51439,98,2914
1747.074,1,76,6384,0,0,0,0,0,76,56,23294,56,6384
1783.511,6,106,8388,68,64,26619,64,4896,38,58,48199,58,3492
19.756,6,51,26552,24,493,858,1440,4577,27,907,710,1440,21975
1796.807,17,449,39928,404,35,4458,288,25708,45,288,40021,288,14220
1797.985,6,366,24603,213,87,8481,469,14136,153,69,11828,69,10467
96.952,17,4,1344,4,308,32317,308,1344,0,0,0,0,0
0.538,17,19,11522,9,665,65,1350,6244,10,499,54,1350,5278
1.357,6,11,1727,7,100,226,100,384,4,589,363,1152,1343
1770.695,6,97,9012,64,65,28106,65,5408,33,59,55324,59,3604
1788.381,6,367,25650,214,99,8396,469,15045,153,69,11765,69,10605
0.047,17,4,284,2,32,31,32,120,2,54,31,60,164
1790.131,17,180,11520,180,36,10000,36,11520,0,0,0,0,0
0.084,17,2,152,1,48,0,48,76,1,48,0,48,76
281.457,6,29,7392,12,158,25587,267,1277,17,678,17590,2045,6115
1798.343,17,453,40168,406,35,4440,288,25812,47,277,38287,288,14356
1763.602,6,196,17792,118,75,15073,205,9921,78,51,22899,108,7871
0.792,6,20,5984,11,282,79,548,1292,9,721,89,1452,4692
76.303,17,18,2764,9,48,9536,48,684,9,203,9536,308,2080
1786.527,1,96,5376,96,28,18805,28,5376,0,0,0,0,0
253.24,17,37,2812,37,48,7034,48,2812,0,0,0,0,0
1.847,6,10,1687,6,100,369,100,344,4,1179,524,1179,1343
1.681,6,47,18474,27,841,64,1360,12898,20,476,77,2715,5576
1784.05,6,131,9304,75,70,24108,208,6165,56,31,32431,31,3139
1798.747,17,178,13884,178,50,10162,50,13884,0,0,0,0,0
0.012,6,2,80,1,0,0,0,40,1,0,0,0,40
0.011,17,2,330,1,30,0,30,58,1,244,0,244,272
0.09,17,2,180,1,30,0,30,58,1,94,0,94,122
55.733,6,146,90860,77,1210,733,1408,62158,69,1004,815,3450,28702
1796.333,17,142,11360,71,48,25661,48,5396,71,56,25661,56,5964
1799.449,6,405,35222,228,118,7927,1189,17649,177,127,10224,1420,17573
1785.351,17,138,11040,69,48,26255,48,5244,69,56,26255,56,5796
1784.367,17,83,3480,82,14,22029,14,3444,1,8,0,8,36
0.013,6,11,5495,2,112,0,112,192,9,823,0,1460,5303
286.659,6,27,2913,14,324,22047,585,1385,13,282,23885,580,1528
52.496,6,22,7212,8,341,7499,722,1436,14,458,4017,1408,5776
0.151,6,46,21774,27,1046,5,1420,16793,19,467,7,1883,4981
4.225,6,39,7269,20,218,222,314,3423,19,513,220,1179,3846
0.399,6,12,1653,6,288,79,288,548,6,426,43,434,1105
1750.626,17,12,498,11,14,175062,14,462,1,8,0,8,36
0.121,17,2,180,1,30,0,30,58,1,94,0,94,122
25.286,6,29,7257,14,155,1945,267,1346,15,482,1805,1997,5911
169.002,1,2,112,2,28,169002,28,112,0,0,0,0,0
0.749,6,28,6080,14,150,57,267,1615,14,650,51,1420,4465
1792.125,1,112,6272,112,28,16145,28,6272,0,0,0,0,0
285.018,1,4,224,4,28,95006,28,224,0,0,0,0,0
216.943,6,38,5870,22,304,10330,304,4508,16,83,14461,83,1362
1790.086,6,357,22491,208,69,8647,69,12460,149,69,12052,69,10031
0.191,17,4,588,2,48,183,48,152,2,190,182,308,436
202.91,6,47,9178,21,129,6324,267,2275,26,325,8105,1926,6903
0.454,6,13,1693,6,288,89,288,548,7,426,41,434,1145
0.802,6,38,8391,19,271,44,738,1877,19,441,36,1360,6514
0.247,6,25,7216,13,155,20,267,1301,12,678,20,3436,5915
0.001,17,6,2117,6,324,0,354,2117,0,0,0,0,0
1.427,6,38,8254,19,321,79,1164,2718,19,433,69,1360,5536
1738.395,6,87,6322,58,31,30498,31,3915,29,31,62085,31,2407
32.146,6,222,212237,76,140,428,344,4374,146,1410,221,2836,207863
263.248,17,4,352,2,60,263247,60,176,2,60,263247,60,176
316.184,17,7,2382,7,312,52697,326,2382,0,0,0,0,0
280.248,6,29,7392,14,158,21557,267,1357,15,678,20015,3436,6035
1681.381,1,18,1008,18,28,98904,28,1008,0,0,0,0,0
0.852,6,20,5948,11,281,85,544,1288,9,716,96,1420,4660
40.004,1,18,1872,0,0,0,0,0,18,76,2353,76,1872
0.628,6,12,1653,6,288,118,288,548,6,426,89,434,1105
101.28,17,4,352,2,60,101279,60,176,2,60,101279,60,176
0.019,17,2,251,1,36,0,36,64,1,159,0,159,187
295.895,1,4,224,4,28,98631,28,224,0,0,0,0,0
84.718,6,84,12470,45,304,1925,304,8524,39,83,2228,83,3946
301.463,6,60,26949,34,1082,9135,1440,20878,26,358,369,1440,6071
0.425,6,27,9076,13,247,35,624,1672,14,833,31,1438,7404
1740.505,17,26,6110,26,207,69620,207,6110,0,0,0,0,0
1787.235,6,104,8376,68,65,26675,65,4930,36,59,51060,59,3446
177.933,6,24,10921,11,367,80,783,1574,13,1101,14816,1360,9347
4.559,6,23,4586,13,226,379,597,1817,10,448,486,1408,2769
1782.561,6,194,17766,127,83,14147,965,10185,67,73,27000,256,7581
0.048,17,2,323,1,55,0,55,83,1,212,0,212,240
1.182,6,59,18554,35,374,34,1360,10441,24,595,45,1360,8113
1685.785,1,7,392,7,28,280964,28,392,0,0,0,0,0
191.181,17,4,352,2,60,191180,60,176,2,60,191179,60,176
1.172,6,14,2787,8,221,167,517,1322,6,381,233,499,1465
200.461,17,4,352,2,60,200460,60,176,2,60,200460,60,176
0.799,6,10,1687,7,100,133,100,384,3,1179,271,1179,1303
0.024,17,4,284,2,32,0,32,120,2,54,1,60,164
86.884,17,4,824,2,48,86876,48,152,2,308,86879,308,672
1.969,17,22,5709,22,231,93,389,5709,0,0,0,0,0
17.167,6,64,23127,35,784,504,1360,17134,29,400,602,1360,5993
5.761,6,16,1993,8,370,821,444,1434,8,231,821,231,559
1794.976,17,447,39864,402,35,4476,288,25644,45,288,40020,288,14220
1632.7,17,32,1338,31,14,54423,14,1302,1,8,0,8,36
10.767,6,20,4442,11,275,1076,275,998,9,768,749,1440,3444
886.285,1,8,448,8,28,126612,28,448,0,0,0,0,0
0.076,17,2,334,1,39,0,39,67,1,239,0,239,267
96.387,6,23,6145,13,220,8032,516,1405,10,619,10700,1452,4740
1753.746,1,71,5964,71,56,25053,56,5964,0,0,0,0,0
3.493,17,5,340,5,40,873,40,340,0,0,0,0,0
61.581,17,4,5496,4,1346,20527,1346,5496,0,0,0,0,0
1776.38,6,180,15480,120,69,14927,69,8940,60,69,30103,69,6540
300.697,6,38,8282,20,244,15826,630,1808,18,441,501,1360,6474
11.602,6,31,8912,14,158,892,267,1357,17,687,720,1400,7555
1.6,6,66,47873,41,1242,40,1408,40668,25,1179,59,3819,7205
1795.715,6,358,22669,209,69,8633,69,12500,149,69,12133,69,10169
377.382,6,23,1535,16,177,25158,177,1053,7,110,10416,110,482
4.175,6,23,4478,12,213,379,597,1689,11,441,399,1402,2789
0.305,6,26,9042,13,257,25,669,1714,13,949,24,2804,7328
20.833,6,21,3182,12,183,1893,517,1561,9,381,2603,499,1621
99.571,6,66,32848,35,776,1844,1360,8517,31,1049,3313,3057,24331
1786.691,6,104,8444,68,66,26667,66,4964,36,60,51045,60,3480
0.061,17,2,557,2,250,61,255,557,0,0,0,0,0
1681.413,17,12,498,11,14,168141,14,462,1,8,0,8,36
1774.176,1,62,5208,62,56,29084,56,5208,0,0,0,0,0
1787.308,6,106,8524,70,66,25903,66,5044,36,60,51062,60,3480
0.417,6,43,19322,25,998,17,1380,14034,18,506,22,1923,5288
1795.948,6,356,22520,208,69,8676,69,12460,148,69,12217,69,10060
8.725,1,9,756,9,56,1090,56,756,0,0,0,0,0
1776.851,6,181,15589,120,69,14931,69,8940,61,69,29605,69,6649
1787.142,1,66,5544,66,56,27494,56,5544,0,0,0,0,0
280.16,6,30,7432,14,158,21550,267,1357,16,603,18676,2800,6075
0.058,6,4,239,2,0,36,0,104,2,31,0,31,135
60.899,17,3,228,3,48,30449,48,228,0,0,0,0,0
0.034,17,2,167,1,39,0,39,67,1,72,0,72,100
1791.121,1,136,7616,136,28,13267,28,7616,0,0,0,0,0
374.977,6,23,1511,14,177,28844,177,925,9,110,9255,110,586
0.609,17,4,624,2,64,590,64,184,2,192,591,192,440
0.024,17,2,263,1,36,0,36,64,1,171,0,171,199
1.367,6,48,19328,27,900,52,1360,13712,21,476,59,2715,5616
143.546,17,4,352,2,60,143545,60,176,2,60,143545,60,176
1795.858,1,250,14000,250,28,7212,28,14000,0,0,0,0,0
0.142,6,9,1340,5,145,35,145,349,4,827,44,827,991
0.237,6,14,4606,7,125,39,125,509,7,931,39,1448,4097
91.465,17,4,240,2,32,91464,32,120,2,32,91464,32,120
280.382,6,29,7392,13,158,23365,267,1317,16,603,18688,1400,6075
3.677,6,22,8010,12,326,327,517,1949,10,924,398,2448,6061
3.91,17,2,176,2,60,3910,60,176,0,0,0,0,0
877.294,1,33,3916,33,90,27415,107,3916,0,0,0,0,0
4.446,6,39,7269,20,218,234,314,3423,19,513,233,1179,3846
1774.777,1,58,4872,0,0,0,0,0,58,56,31136,56,4872
4.512,6,49,24173,23,545,205,1418,6109,26,879,179,1418,18064
19.248,6,3006,2700036,1856,1373,10,1408,2635572,1150,776,16,1408,64464
1263.338,2,12,384,12,8,114848,8,384,0,0,0,0,0
40.732,6,43,8682,21,345,448,720,1955,22,389,1932,2720,6727
33.649,6,34,5460,17,180,2103,721,1974,17,288,2089,2026,3486
698.84,6,83,6415,49,65,14559,65,4170,34,59,21172,59,2245
1799.202,1,16,896,16,28,119946,28,896,0,0,0,0,0
19.899,17,46,19287,21,393,993,1350,8856,25,389,827,1350,10431
30.723,17,18,1584,9,48,3839,48,684,9,72,3839,72,900
4.255,6,40,7309,20,218,223,314,3423,20,440,210,1152,3886
4.194,6,37,7189,19,218,233,314,3383,18,513,232,1179,3806
1792.925,6,194,16971,102,115,17751,208,12299,92,31,19699,31,4672
0.722,17,27,20766,17,1063,42,1350,18554,10,193,74,1350,2212
1798.698,17,447,39296,404,35,4463,288,25708,43,288,41919,288,13588
249.298,17,2,672,2,308,249298,308,672,0,0,0,0,0
1734.618,1,122,6832,122,28,14335,28,6832,0,0,0,0,0
0.69,6,147,105883,86,1311,8,1420,99222,61,420,11,1420,6661
33.868,6,29,4991,14,180,2605,722,1808,15,342,2405,1448,3183
1740.903,17,30,31170,30,1011,60031,1011,31170,0,0,0,0,0
17.794,6,58,14864,30,255,613,1386,5124,28,453,648,1440,9740
220.563,6,32,8952,14,158,16966,267,1357,18,624,12970,1400,7595
10.16,6,1646,1393525,983,1362,10,1380,1362763,663,383,15,1380,30762
1.725,6,9,482,4,0,575,0,204,5,7,369,7,278
378.827,6,18,1239,14,177,29140,177,913,4,110,20066,110,326
0.054,17,8,2446,8,277,7,316,2446,0,0,0,0,0
0.006,17,2,362,1,61,0,61,89,1,245,0,245,273
1.959,17,3,468,3,128,979,128,468,0,0,0,0,0
8.784,17,4,352,2,60,8783,60,176,2,60,8783,60,176
235.882,2,2,64,2,8,235882,8,64,0,0,0,0,0
0.008,6,19,11429,12,125,0,125,805,7,2563,1,4460,10624
1799.91,17,449,39644,405,35,4455,288,25740,44,288,40948,288,13904
2.185,6,32,5951,17,108,136,267,1446,15,650,150,1420,4505
230.046,6,21,5908,12,569,20910,1244,3479,9,327,28753,1282,2429
0.98,17,25,14710,13,835,81,1350,11224,12,262,81,1350,3486
5.167,6,44,8353,21,227,258,314,4022,23,486,222,1179,4331
17.898,6,35,11810,18,534,1052,824,3618,17,730,1108,1448,8192
1790.084,6,105,8444,64,65,26596,65,4640,41,54,44749,59,3804
160.465,17,38,14744,38,360,4336,360,14744,0,0,0,0,0
1794.627,1,58,4872,58,56,31484,56,4872,0,0,0,0,0
0.341,6,27,9094,13,252,28,646,1694,14,833,24,1438,7400
247.796,6,15,1496,7,190,379,190,570,8,247,35398,462,926
19.473,6,28,7217,13,155,1622,267,1306,15,482,1390,1997,5911
255.419,17,4,352,2,60,255418,60,176,2,60,255417,60,176
68.837,1,4,224,4,28,22945,28,224,0,0,0,0,0
75.905,6,31,7613,12,155,28,267,1266,19,398,4216,3417,6347
0.27,6,21,5865,12,181,24,537,1526,9,772,32,2181,4339
1.826,17,6,462,3,33,912,33,183,3,65,912,65,279
15.892,17,18,12509,11,919,1581,1350,10426,7,269,2635,1350,2083
0.049,17,2,1366,2,655,49,655,1366,0,0,0,0,0
1643.044,1,8,448,8,28,234720,28,448,0,0,0,0,0
0.356,17,8,2750,8,315,50,354,2750,0,0,0,0,0
1786.998,6,102,8364,68,66,26671,66,4964,34,60,54147,60,3400
61.637,6,13,532,7,0,10272,0,284,6,0,12296,0,248
0.001,6,2,433,1,0,0,0,40,1,341,0,341,393
563.555,6,63,3990,36,46,16101,208,2600,27,31,21635,31,1390
0.538,17,4,334,2,39,21,39,134,2,72,522,72,200
0.15,1,2,112,2,28,150,28,112,0,0,0,0,0
1.674,6,49,18692,26,917,66,1460,12996,23,433,67,1460,5696
60.107,6,8,432,5,0,15026,0,268,3,0,30021,0,164
86.431,17,7,532,7,48,14405,48,532,0,0,0,0,0
2.061,6,11,1731,7,100,343,100,384,4,1179,600,1179,1347
1.28,6,37,8214,19,321,71,1164,2718,18,476,65,2715,5496
300.696,6,36,8486,19,315,16705,882,2053,17,478,529,2128,6433
0.474,6,26,7751,16,339,31,949,3017,10,721,50,1460,4734
1761.617,17,168,14098,156,30,11365,37,9090,12,389,154715,463,5008
161.084,17,4,530,2,36,161079,36,128,2,173,161080,187,402
0.724,17,18,8601,9,392,86,1350,3787,9,506,86,1350,4814
252.79,2,3,96,3,8,126395,8,96,0,0,0,0,0
135.657,6,24,9301,11,532,162,1257,2080,13,955,11288,2720,7221
755.608,2,5,160,5,8,188902,8,160,0,0,0,0,0
1773.846,6,180,15480,120,69,14906,69,8940,60,69,30058,69,6540
9.863,2,4,128,4,8,3287,8,128,0,0,0,0,0
60.854,17,5,380,5,48,15213,48,380,0,0,0,0,0
1.844,6,24,5755,13,158,153,370,1315,11,799,183,1420,4440
1796.091,17,448,39896,403,35,4467,288,25676,45,288,40020,288,14220
316.048,6,86,19996,44,286,7349,1360,10381,42,377,7704,4649,9615
93.979,6,17,2341,10,324,10442,585,1177,7,396,15618,580,1164
1798.378,1,345,28980,345,56,5227,56,28980,0,0,0,0,0
0.828,17,12,6370,6,615,165,1350,3860,6,390,85,1350,2510
1082.888,2,11,352,11,8,108288,8,352,0,0,0,0,0
307.711,6,8,475,6,31,61542,31,333,2,31,299570,31,142
1771.499,1,58,4872,58,56,31078,56,4872,0,0,0,0,0
1783.568,17,140,11200,70,48,25848,48,5320,70,56,25848,56,5880
0.144,6,10,1495,5,507,35,507,727,5,556,35,556,768
34.081,6,31,5117,15,154,2434,721,1882,16,399,2256,2026,3235
0.312,17,2,198,1,39,0,39,67,1,103,0,103,131
1783.255,17,83,3480,82,14,22015,14,3444,1,8,0,8,36
226.928,17,4,352,2,60,226927,60,176,2,60,226927,60,176
0.217,6,2,92,1,0,0,0,52,1,0,0,0,40
1774.956,6,180,15480,120,69,14915,69,8940,60,69,30078,69,6540
0.513,17,3,451,2,39,255,39,134,1,289,0,289,317
0.351,6,10,968,5,256,85,256,460,5,304,85,304,508
185.114,17,4,352,2,60,185112,60,176,2,60,185113,60,176
1744.591,1,56,4704,56,56,31719,56,4704,0,0,0,0,0
173.854,6,23,12037,12,549,59,1360,2708,11,1775,17371,3934,9329
4.24,17,30,11360,11,332,424,1350,3961,19,361,181,1350,7399
82.323,17,4,352,2,60,82322,60,176,2,60,82322,60,176
10.773,6,20,7130,11,275,1077,275,998,9,1440,722,1440,6132
142.355,17,4,352,2,60,142354,60,176,2,60,142354,60,176
12.84,6,12,5538,4,106,4280,106,274,8,822,1809,1460,5264
3.048,17,4,624,4,128,1016,128,624,0,0,0,0,0
1775.847,17,140,11200,70,48,25736,48,5320,70,56,25736,56,5880
1.394,6,19,3781,10,234,154,564,1452,9,463,152,1343,2329
65.301,2,2,64,2,8,65301,8,64,0,0,0,0,0
1787.011,6,105,8550,69,66,26279,66,5070,36,60,51052,60,3480
1.378,6,47,19230,27,895,53,1360,13654,20,476,63,2715,5576
337.435,6,70,45853,43,1172,8034,1408,36307,27,903,2417,2816,9546
257.622,17,4,284,2,32,257577,32,120,2,54,257606,60,164
16.677,17,4,352,2,60,16676,60,176,2,60,16676,60,176
1790.511,1,342,28728,342,56,5250,56,28728,0,0,0,0,0
1.941,6,24,6045,13,108,161,147,959,11,927,163,1608,5086
1790.45,1,214,22684,214,78,8405,78,22684,0,0,0,0,0
237.41,17,4,1312,4,300,79136,308,1312,0,0,0,0,0
38.548,6,44,11311,23,184,1752,794,2246,21,547,1888,1642,9065
15.26,17,17,5064,8,317,2175,1350,2767,9,227,1903,1350,2297
10.776,6,18,5610,10,275,1197,275,958,8,1440,820,1440,4652
6.387,6,69,25105,35,915,187,1440,14335,34,521,178,1440,10770
0.877,6,24,6555,13,334,72,1009,2195,11,783,87,1420,4360
0.564,6,153,94968,81,131,7,232,3769,72,1338,7,1430,91199
1738.56,6,91,6604,59,31,29975,31,3998,32,31,56082,31,2606
2.893,17,3,201,3,39,1446,39,201,0,0,0,0,0
1779.68,1,342,28728,342,56,5219,56,28728,0,0,0,0,0
377.357,6,18,1242,14,180,29027,180,916,4,110,20088,110,326
3.04,17,4,624,4,128,1013,128,624,0,0,0,0,0
183.008,17,4,240,2,32,183007,32,120,2,32,183007,32,120
0.355,17,8,2774,8,318,50,357,2774,0,0,0,0,0
1772.062,6,180,15480,120,69,14891,69,8940,60,69,30033,69,6540
23.322,6,14,2242,8,210,3331,210,844,6,545,4663,904,1398
1.389,6,51,20222,27,955,53,1460,14486,24,433,52,1460,5736
1.303,6,25,9552,14,350,100,1041,1992,11,1015,105,1460,7560
366.011,6,25,1651,17,177,22875,177,1117,8,110,9168,110,534
22.589,17,4,352,2,60,22588,60,176,2,60,22588,60,176
1319.527,6,111,11946,61,71,21989,722,5295,50,109,26925,2026,6651
5.754,6,57,33019,32,1281,185,1460,24383,25,689,79,1460,8636
6.163,17,4,460,2,40,6002,40,136,2,134,0,134,324
3.651,17,5,290,5,30,912,30,290,0,0,0,0,0
18.067,17,4,1344,4,308,6022,308,1344,0,0,0,0,0
601.589,2,7,224,7,8,100264,8,224,0,0,0,0,0
10.904,6,102,32699,51,603,218,1152,26177,51,447,213,1179,6522
0.962,6,23,6457,13,322,79,951,2137,10,979,106,1791,4320
2.327,17,22,7649,11,432,229,1350,5065,11,206,229,1350,2584
0.086,17,4,284,2,32,47,32,120,2,54,40,60,164
0.023,17,4,284,2,32,0,32,120,2,54,2,60,164
1772.499,6,205,22439,131,75,13634,267,10097,74,133,24277,1997,12342
130.23,6,22,10202,12,433,71,990,1823,10,1327,14454,3928,8379
1773.318,6,242,17965,121,69,14777,69,8980,121,34,14777,64,8985
1719.439,17,12,498,11,14,171943,14,462,1,8,0,8,36
3.024,6,6,458,4,105,1005,105,374,2,0,3015,0,84
0.678,6,22,9661,12,386,61,844,1720,10,1254,56,4080,7941
0.25,6,10,1380,5,145,62,145,349,5,827,59,827,1031
15.797,6,2625,2525297,1745,1371,8,1408,2474873,880,931,17,2801,50424
275.441,17,4,352,2,60,275440,60,176,2,60,275439,60,176
1.663,17,24,10043,11,394,159,1350,4649,13,386,132,1350,5394
0.079,17,2,279,1,36,0,36,64,1,187,0,187,215
0.245,17,2,677,1,300,0,300,328,1,321,0,321,349
6.897,17,2,234,1,41,0,41,69,1,137,0,137,165
249.085,17,4,352,2,60,249084,60,176,2,60,249084,60,176
1770.677,6,103,9514,66,66,27241,66,5610,37,60,49181,60,3904
5.2,6,17,2188,8,120,742,197,930,9,445,650,799,1258
374.673,6,18,1242,14,180,28821,180,916,4,110,20068,110,326
38.05,1,44,4576,0,0,0,0,0,44,76,884,76,4576
1741.347,17,29,6699,29,203,62190,203,6699,0,0,0,0,0
0.01,17,2,319,1,32,0,32,60,1,231,0,231,259
1.747,6,27,10209,16,290,116,602,1514,11,1031,158,1420,8695
1749.166,6,95,7203,63,38,28212,205,4476,32,33,56411,98,2727
280.22,6,27,7312,12,158,25474,267,1277,15,678,20013,2800,6035
1.725,6,14,2351,8,188,246,245,700,6,703,290,1152,1651
0.878,6,24,6624,13,340,73,1045,2227,11,988,87,1737,4397
1780.992,6,122,13863,78,81,23129,518,6054,44,151,41416,1420,7809
2.265,6,13,2311,8,188,323,245,700,5,1407,499,1407,1611
300.391,6,30,11569,17,269,18774,731,1993,13,1111,20030,2816,9576
7.301,6,1514,1428129,983,1377,7,1408,1395853,531,931,13,2801,32276
240.172,6,49,15808,26,724,9606,1402,12945,23,237,10916,580,2863
6.385,6,1764,1620384,1106,1386,5,1408,1581504,658,776,9,1408,38880
420.284,2,4,128,4,8,140094,8,128,0,0,0,0,0
7.367,6,8,448,4,0,2410,0,240,4,0,2410,0,208
20.414,6,25,4706,15,176,1458,517,2035,10,428,2266,499,2671
0.553,6,22,7345,14,334,42,663,2085,8,967,73,1946,5260
1770.52,6,99,9306,66,66,27238,66,5610,33,60,55325,60,3696
62.198,17,4,352,2,60,62196,60,176,2,60,62197,60,176
0.134,17,2,602,1,46,0,46,74,1,500,0,500,528
1681.334,1,15,840,15,28,120095,28,840,0,0,0,0,0
1799.446,6,356,22520,208,69,8692,69,12460,148,69,12240,69,10060
496.909,6,158,75653,90,825,22,1460,59777,68,365,7414,1638,15876
66.936,17,4,240,2,32,66935,32,120,2,32,66935,32,120
1797.813,17,448,39896,403,35,4472,288,25676,45,288,40020,288,14220
1751.269,6,96,7286,63,38,28246,205,4476,33,33,54717,98,2810
76.117,6,39,9660,15,327,5436,1189,2575,24,305,3308,1420,7085
0.368,6,2,92,1,0,0,0,40,1,0,0,0,52
619.044,6,94,21007,42,297,15098,1360,9750,52,254,12135,4649,11257
1533.889,6,301,19147,175,69,8815,69,10588,126,69,12270,69,8559
1787.814,6,3903,3941271,1337,126,1338,339,83051,2566,1492,697,4224,3858220
38.883,17,44,6468,22,48,1849,48,1672,22,190,1849,308,4796
1772.078,6,180,15480,120,69,14891,69,8940,60,69,30032,69,6540
245.633,6,247,202191,159,1302,1554,1368,186708,88,641,1818,2519,15483
1771.943,1,56,4704,0,0,0,0,0,56,56,32217,56,4704
1787.089,6,117,13763,75,81,24149,504,5920,42,162,43585,1452,7843
19.138,17,30,13158,13,516,1592,1350,7078,17,329,1194,1350,6080
0.079,17,4,368,2,32,79,32,120,2,96,41,96,248
177.881,6,25,9968,12,549,69,1440,2709,13,961,14812,1440,7259
127.864,6,72,47478,44,1193,2973,1408,39290,28,960,2280,3847,8188
1787.26,6,102,8228,68,64,26675,64,4896,34,58,54155,58,3332
244.953,6,49,6466,27,304,9421,304,4452,22,83,11567,83,2014
1783.809,6,370,25839,214,99,8374,469,15114,156,69,11508,69,10725
114.499,6,24,10168,12,549,60,1360,2709,12,1161,10397,2574,7459
93.929,17,9,684,9,48,11741,48,684,0,0,0,0,0
0.108,1,2,112,2,28,108,28,112,0,0,0,0,0
162.374,17,4,240,2,32,162373,32,120,2,32,162373,32,120
10.975,6,18,4266,10,275,1219,275,958,8,992,886,1440,3308
1777.494,17,73,3060,72,14,25035,14,3024,1,8,0,8,36
299.917,6,6,364,4,31,99972,31,222,2,31,299535,31,142
280.65,6,31,7472,13,158,23387,267,1317,18,543,16505,1380,6155
95.133,6,41,10488,16,159,6341,267,1762,25,406,3963,1997,8726
8.941,6,1339,1165229,827,1360,10,1380,1140507,512,421,17,2760,24722
1681.584,17,16,1265,8,30,240220,37,471,8,71,240219,136,794
0.028,6,4,270,2,31,0,31,135,2,31,0,31,135
364.917,6,39,5136,22,302,17377,302,3568,17,83,22806,83,1568
601.568,2,10,320,10,8,66840,8,320,0,0,0,0,0
300.67,6,45,8867,23,266,13666,720,2078,22,346,609,2128,6789
3.131,17,17,7282,8,531,441,1350,4479,9,283,386,1350,2803
0.127,6,2,116,1,0,0,0,64,1,0,0,0,52
48.814,6,17,700,9,0,6100,0,364,8,0,6972,0,336
1.134,6,25,8962,14,208,87,475,1426,11,1012,92,1360,7536
0.195,17,5,1757,5,323,48,354,1757,0,0,0,0,0
1740.521,17,30,31680,30,1028,60017,1028,31680,0,0,0,0,0
0.904,6,11,1727,7,100,150,100,384,4,589,214,1152,1343
0.049,17,2,216,1,34,0,34,62,1,126,0,126,154
0.007,17,2,366,1,33,0,33,61,1,277,0,277,305
12.275,6,32,9090,14,158,944,267,1357,18,637,698,3436,7733
1784.356,17,282,57601,282,176,6350,422,57601,0,0,0,0,0
1773.077,6,180,15480,120,69,14899,69,8940,60,69,30049,69,6540
1793.278,6,127,16398,80,155,22697,817,10367,47,89,38981,350,6031
1762.595,1,8,448,8,28,251799,28,448,0,0,0,0,0
0.065,17,2,476,1,39,0,39,67,1,381,0,381,409
1795.339,17,445,39232,402,35,4477,288,25644,43,288,41924,288,13588
352.474,17,6,528,3,60,176236,60,264,3,60,176236,60,264
0.149,17,3,3140,3,1018,74,1438,3140,0,0,0,0,0
13.914,6,8,664,8,31,1987,31,664,0,0,0,0,0
0.183,1,2,112,2,28,183,28,112,0,0,0,0,0
930.185,1,18,1008,18,28,54716,28,1008,0,0,0,0,0
2.45,17,2,204,1,34,0,34,62,1,114,0,114,142
0.453,17,2,146,1,37,0,37,65,1,53,0,53,81
0.292,17,2,172,1,50,0,50,78,1,66,0,66,94
1744.033,6,95,7203,63,38,28129,205,4476,32,33,56247,98,2727
280.65,6,29,7392,13,158,23387,267,1317,16,543,18704,1400,6075
264.4,2,3,96,3,8,132200,8,96,0,0,0,0,0
1784.048,6,104,8376,68,65,26627,65,4930,36,59,50970,59,3446
1746.534,6,96,7286,63,38,28169,205,4476,33,33,54565,98,2810
2.421,17,4,288,2,36,2327,36,128,2,52,2294,52,160
1784.563,6,183,15807,122,69,14748,69,9158,61,69,29731,69,6649
0.01,17,2,189,1,37,0,37,65,1,96,0,96,124
14.345,6,12,1355,7,284,2390,517,940,5,147,3583,147,415
0.021,17,2,422,1,72,0,72,100,1,294,0,294,322
29.345,17,15,7805,8,655,4192,1350,5471,7,305,48,1350,2334
0.389,6,10,968,5,256,93,256,460,5,304,93,304,508
18.5,6,2961,2859959,1976,1371,9,1408,2804075,985,776,18,1408,55884
1773.773,17,140,11200,70,48,25706,48,5320,70,56,25706,56,5880
243.325,6,69,47602,45,1164,5530,1408,39619,24,961,2678,3847,7983
280.297,6,30,7432,13,158,23358,267,1317,17,543,17515,1400,6115
69.536,6,46,9068,24,401,584,889,2280,22,393,3304,4848,6788
0.033,6,2,80,2,0,0,0,80,0,0,0,0,0
1679.56,17,12,498,11,14,167956,14,462,1,8,0,8,36
1786.471,6,102,8296,68,65,26663,65,4930,34,59,54132,59,3366
122.894,17,4,352,2,60,122893,60,176,2,60,122893,60,176
1.262,6,10,1687,7,100,210,100,384,3,1179,507,1179,1303
0.832,6,24,6636,13,347,68,1075,2262,11,786,82,1420,4374
159.902,6,21,3568,6,92,81,92,412,15,197,11409,1408,3156
1.73,6,25,8711,15,276,123,561,1433,10,982,172,1420,7278
1366.019,6,169,13186,62,74,21901,350,6344,107,49,12886,143,6842
0.015,17,4,288,2,33,9,33,122,2,55,7,61,166
1021.43,1,7,934,7,105,170238,207,934,0,0,0,0,0
814.174,6,194,22435,94,167,8159,1189,9805,100,156,8223,1420,12630
34.339,17,10,760,10,48,3815,48,760,0,0,0,0,0
0.182,17,2,256,1,49,0,49,77,1,151,0,151,179
9.2,6,14,2082,4,106,3066,106,274,10,230,994,512,1808
0.162,1,2,112,2,28,162,28,112,0,0,0,0,0
1773.188,6,181,15589,120,69,14900,69,8940,61,69,29549,69,6649
3.069,17,4,624,4,128,1023,128,624,0,0,0,0,0
0.852,17,2,138,1,33,0,33,61,1,49,0,49,77
0.493,6,3,120,1,0,0,0,40,2,0,493,0,80
1780.133,17,140,11200,70,48,25798,48,5320,70,56,25798,56,5880
91.134,17,4,1344,4,308,30378,308,1344,0,0,0,0,0
5.036,17,4,288,2,36,5002,36,128,2,52,5003,52,160
371.039,6,25,1651,17,177,23189,177,1117,8,110,9224,110,534
1780.263,17,295,82574,295,251,6055,422,82574,0,0,0,0,0
242.219,17,4,558,2,36,242214,36,128,2,187,242214,187,430
6.862,17,3,1008,3,308,3431,308,1008,0,0,0,0,0
3.217,17,20,5190,20,231,169,389,5190,0,0,0,0,0
0.174,17,2,186,1,41,0,41,69,1,89,0,89,117
1.886,6,10,924,5,283,426,283,551,5,105,426,105,373
280.545,6,30,7432,13,158,23378,267,1317,17,603,17528,2076,6115
0.108,6,9,1339,5,145,27,145,349,4,826,29,826,990
0.167,17,2,255,1,43,0,43,71,1,156,0,156,184
0.346,17,2,148,1,32,0,32,60,1,60,0,60,88
300.205,6,29,11725,17,593,18762,1408,4454,12,1106,21835,2816,7271
203.349,17,4,352,2,60,203348,60,176,2,60,203347,60,176
4.581,6,76,26554,38,908,123,1440,15289,38,481,110,1440,11265
1786.464,17,83,3480,82,14,22055,14,3444,1,8,0,8,36
5.016,17,4,288,2,36,5001,36,128,2,52,5000,52,160
1783.81,6,356,22589,207,69,8659,69,12420,149,69,12052,69,10169
1795.824,17,447,39864,402,35,4478,288,25644,45,288,40021,288,14220
4.536,6,65,38434,39,1164,119,1380,33104,26,383,179,1380,5330
65.171,6,36,8479,18,410,516,882,2006,18,478,3824,2128,6473
101.486,6,29,7392,13,158,8457,267,1317,16,603,6763,2036,6075
1788.964,6,115,12503,75,82,24175,516,6064,40,127,45862,1452,6439
161.374,6,32,7267,19,155,8965,267,1718,13,836,13446,2045,5549
300.952,6,24,9331,13,382,25065,1193,2126,11,964,30078,1360,7205
300.76,6,38,8271,20,241,15829,619,1797,18,441,504,1460,6474
42.335,17,46,6644,23,48,1922,48,1748,23,184,1920,308,4896
30.134,6,16,4324,5,100,1719,100,308,11,509,2987,1152,4016
19.357,6,39,9582,16,245,1290,335,3343,23,483,868,1179,6239
1.274,6,31,9322,16,209,84,653,1897,15,828,88,1368,7425
1795.85,17,449,39928,404,35,4456,288,25708,45,288,40013,288,14220
0.45,6,12,1653,6,288,88,288,548,6,426,49,434,1105
0.349,6,12,1653,6,288,69,288,548,6,426,38,434,1105
0.378,17,2,152,1,48,0,48,76,1,48,0,48,76
3.036,17,4,296,4,46,1012,46,296,0,0,0,0,0
186.826,6,32,8952,14,158,14371,267,1357,18,624,10977,1400,7595
414.468,17,4,1328,4,304,138156,308,1328,0,0,0,0,0
1756.053,1,8,848,8,78,250864,78,848,0,0,0,0,0
4.97,17,4,352,2,60,4969,60,176,2,60,4969,60,176
0.879,6,13,1175,7,146,145,146,430,6,250,174,499,745
1.373,6,41,8429,21,320,68,1162,2808,20,400,62,1460,5621
3.98,6,3,802,1,0,0,0,40,2,341,3968,341,762
1787.104,6,102,8364,68,66,26673,66,4964,34,60,54149,60,3400
0.05,6,13,3514,7,75,8,75,447,6,1373,10,1448,3067
1.272,17,30,17931,17,841,79,1350,14785,13,214,77,1350,3146
1795.937,17,445,38948,402,35,4478,288,25360,43,288,41929,288,13588
299.766,1,4,224,4,28,99922,28,224,0,0,0,0,0
208.746,17,4,352,2,60,208745,60,176,2,60,208744,60,176
1785.283,6,102,8364,68,66,26646,66,4964,34,60,54096,60,3400
0.236,6,9,1340,5,145,59,145,349,4,827,29,827,991
80.532,6,6,455,1,0,0,0,40,5,31,20128,31,415
609.245,1,14,784,14,28,46865,28,784,0,0,0,0,0
23.523,6,32,8861,15,303,1680,722,2728,17,778,1457,2760,6133
136.104,6,94,63627,55,1233,2520,1368,54692,39,747,1654,1368,8935
0.362,6,10,968,5,256,89,256,460,5,304,88,304,508
90.083,17,4,352,2,60,90081,60,176,2,60,90082,60,176
1783.296,17,73,3060,72,14,25116,14,3024,1,8,0,8,36
137.241,17,4,240,2,32,137240,32,120,2,32,137240,32,120
3.37,17,25,13157,13,558,278,1350,7618,12,433,303,1350,5539
0.015,1,2,112,2,28,15,28,112,0,0,0,0,0
0.132,17,2,128,1,28,0,28,56,1,44,0,44,72
1773.045,6,180,15480,120,69,14899,69,8940,60,69,30044,69,6540
20.488,6,9,577,0,0,0,0,0,9,31,2561,31,577
0.533,17,2,167,1,39,0,39,67,1,72,0,72,100
840.668,17,8,2196,4,30,280219,30,232,4,463,280219,463,1964
170.385,6,139,112101,91,1323,1893,1448,100035,48,735,2886,3807,12066
5.744,6,44,7469,23,201,261,314,3543,21,513,274,1179,3926
0.275,6,22,7333,12,334,24,663,1969,10,806,29,1402,5364
5.019,17,4,558,2,36,5007,36,128,2,187,5009,187,430
0.025,6,16,6004,8,88,3,88,452,8,1305,3,1880,5552
20.602,6,18,2515,10,189,2289,517,1298,8,264,2936,499,1217
1798.112,6,376,26217,217,98,8324,469,15372,159,69,11379,69,10845
0.29,17,2,180,1,30,0,30,58,1,94,0,94,122
1787.134,6,371,25879,216,99,8312,469,15194,155,69,11604,69,10685
300.249,6,32,17726,17,254,18765,672,1910,15,1502,17158,7040,15816
3.553,6,2,88,2,0,0,0,88,0,0,0,0,0
114.186,17,4,240,2,32,114185,32,120,2,32,114185,32,120
278.609,6,147,102596,86,1210,3277,1408,51788,61,1905,722,9856,50808
23.192,6,4518,3754970,2053,348,1,348,110764,2465,1427,9,5632,3644206
20.993,6,9,392,4,0,6997,0,172,5,0,1128,0,220
638.973,6,121,7600,69,69,8597,69,4140,52,69,12528,69,3460
86.752,6,25,9783,12,653,73,1460,3126,13,875,7214,1460,6657
280.394,6,30,7432,13,158,23366,267,1317,17,603,17522,2760,6115
370.844,6,21,1422,15,180,26488,180,992,6,110,12274,110,430
1786.493,6,104,8444,68,66,26664,66,4964,36,60,51040,60,3480
0.38,6,27,8920,13,227,31,547,1592,14,941,28,1408,7328
0.016,17,2,152,1,48,0,48,76,1,48,0,48,76
119.611,6,50,13612,27,806,769,1360,7599,23,338,5429,2667,6013
1.243,6,46,18994,27,881,47,1360,13458,19,476,59,2715,5536
1689.095,1,126,7056,126,28,13512,28,7056,0,0,0,0,0
26.189,17,4,352,2,60,26188,60,176,2,60,26188,60,176
0.049,1,5,2880,5,548,12,548,2880,0,0,0,0,0
280.196,6,28,7352,13,158,23349,267,1317,15,678,20012,2045,6035
1786.774,6,103,8401,69,65,26276,65,5035,34,59,54140,59,3366
211.89,6,51,9433,18,114,12463,267,1989,33,218,6621,1460,7444
240.531,6,41,8775,20,570,12658,1418,5613,21,257,12026,586,3162
0.32,17,2,172,1,50,0,50,78,1,66,0,66,94
1.145,6,22,5442,13,125,94,212,1026,9,810,142,1731,4416
10.457,6,92,28389,47,527,227,1152,21409,45,431,231,1179,6980
1.21,6,24,8004,12,164,93,267,1288,12,1014,93,2423,6716
386.324,6,18,1242,14,180,29717,180,916,4,110,20107,110,326
0.583,17,2,677,1,300,0,300,328,1,321,0,321,349
2.044,17,6,460,3,40,1010,41,206,3,56,1007,57,254
3.383,6,2,88,2,0,0,0,88,0,0,0,0,0
782.079,2,8,256,8,8,111725,8,256,0,0,0,0,0
300.733,6,41,8772,21,315,15036,882,2157,20,386,447,1440,6615
295.51,1,4,224,4,28,98503,28,224,0,0,0,0,0
254.454,17,4,352,2,60,254453,60,176,2,60,254453,60,176
1781.803,6,81,4706,40,36,45686,36,2116,41,458,44544,458,2590
0.406,6,7,295,4,0,135,0,164,3,7,108,7,131
629.729,2,4,128,4,8,209909,8,128,0,0,0,0,0
0.023,6,17,9031,10,126,2,126,654,7,2001,3,4944,8377
140.526,17,4,352,2,60,140525,60,176,2,60,140524,60,176
10.84,17,15,17706,15,1152,774,1449,17706,0,0,0,0,0
1797.229,17,448,39896,403,35,4470,288,25676,45,288,40018,288,14220
62.671,6,13,1006,7,180,10445,180,576,6,110,12261,110,430
1798.338,17,448,39896,403,35,4473,288,25676,45,288,40018,288,14220
1768.819,6,99,9240,66,65,27212,65,5577,33,59,55271,59,3663
125.173,1,3,168,3,28,62586,28,168,0,0,0,0,0
300.616,6,40,8703,22,315,14315,882,2185,18,445,498,2128,6518
1.312,6,48,19697,27,926,50,1460,14081,21,433,56,1460,5616
6.364,6,762,592023,426,1349,14,1380,574281,336,383,18,1380,17742
248.251,17,10,3360,10,308,27583,308,3360,0,0,0,0,0
11.97,6,1908,1653693,1154,1378,10,1420,1619312,754,467,15,1883,34381
0.068,17,4,588,2,48,58,48,152,2,190,56,308,436
1779.705,6,354,22509,206,69,8681,69,12380,148,69,12106,69,10129
9.443,2,2,64,2,8,9443,8,64,0,0,0,0,0
1.292,17,3,1167,3,361,646,361,1167,0,0,0,0,0
0.288,6,21,4415,12,165,26,456,1446,9,415,33,888,2969
134.839,6,25,6757,12,181,12258,267,1212,13,717,11235,2036,5545
1.74,6,29,8303,15,225,111,561,1985,14,820,119,1440,6318
1792.431,6,356,22520,208,69,8659,69,12460,148,69,12192,69,10060
280.488,6,30,7432,14,158,21576,267,1357,16,678,18691,3456,6075
68.632,6,51,14779,26,970,404,1360,8884,25,325,2852,1360,5895
1.214,6,44,18040,26,882,48,1360,12544,18,529,61,4075,5496
1.62,6,64,47877,41,1246,40,1408,40776,23,982,64,2411,7101
159.631,17,4,352,2,60,159630,60,176,2,60,159630,60,176
1779.733,17,140,11200,70,48,25793,48,5320,70,56,25793,56,5880
0.017,6,6,8508,1,0,0,0,40,5,1641,3,2736,8468
3.079,17,3,228,2,48,2903,48,152,1,48,0,48,76
101.099,6,85,59830,54,1211,1907,1448,50052,31,741,3362,2359,9778
0.126,17,2,378,1,30,0,30,58,1,292,0,292,320
852.278,6,1446,1341915,535,172,1596,939,35253,911,1431,936,4254,1306662
1795.732,17,364,50052,179,190,10088,1350,39169,185,30,9757,60,10883
0.025,17,2,550,2,247,25,247,550,0,0,0,0,0
5.008,17,2,128,2,36,5008,36,128,0,0,0,0,0
16.798,6,13,1103,6,275,3359,275,523,7,96,1984,96,580
250.817,6,180,69334,96,679,2638,1440,52813,84,386,3020,1698,16521
280.229,6,29,7392,13,158,23352,267,1317,16,603,18678,1400,6075
1798.838,17,142,11360,71,48,25697,48,5396,71,56,25697,56,5964
1747.153,1,79,6636,0,0,0,0,0,79,56,22399,56,6636
91.443,6,26,7339,7,155,1166,267,1066,19,367,5079,1452,6273
0.025,17,4,1116,2,32,13,32,120,2,470,12,470,996
30.237,6,18,792,7,0,2997,0,308,11,0,3022,0,484
1745.374,6,96,7255,62,38,28612,205,4424,34,33,52877,98,2831
1682.389,17,14,1036,7,30,280392,30,406,7,62,280392,62,630
0.3,17,2,154,1,33,0,33,61,1,65,0,65,93
254.213,6,11,676,4,106,84733,106,274,7,90,42365,90,402
12.217,17,20,4325,10,47,1355,47,750,10,329,1356,341,3575
1770.931,6,101,9410,66,66,27245,66,5610,35,60,52083,60,3800
1.567,6,2,111,1,0,0,0,40,1,31,0,31,71
0.117,17,4,368,2,32,117,32,120,2,96,73,96,248
252.76,1,2,261,2,102,252760,117,261,0,0,0,0,0
136.068,6,4,2162,2,1197,198,1197,1277,2,805,135875,805,885
0.467,6,12,1653,6,288,89,288,548,6,426,49,434,1105
3.778,6,643,539444,378,1351,9,1368,521000,265,776,13,1473,18444
0.318,6,26,8990,13,247,26,624,1672,13,947,26,1408,7318
1.306,6,48,16109,25,781,54,1360,10413,23,433,51,1360,5696
0.427,6,14,3386,7,294,71,581,972,7,1021,69,1021,2414
0.828,6,15,2224,7,288,109,288,620,8,424,92,434,1604
0.018,6,2,116,1,0,0,0,52,1,0,0,0,64
1.019,6,25,9003,14,264,78,700,1651,11,1150,84,2570,7352
703.413,6,42,3733,25,324,29308,585,1977,17,282,15248,580,1756
57.351,17,4,300,2,47,57350,47,150,2,47,57350,47,150
240.36,6,43,8416,22,449,11444,1418,5648,21,208,12017,580,2768
0.022,6,11,3653,6,171,3,171,491,5,1447,4,2676,3162
1783.158,1,120,6720,120,28,14984,28,6720,0,0,0,0,0
1.73,6,5,200,4,0,576,0,160,1,0,0,0,40
1772.181,6,180,15480,120,69,14892,69,8940,60,69,30036,69,6540
0.287,6,22,4467,11,165,28,456,1394,11,498,26,888,3073
1732.337,6,64,4744,40,33,44418,33,2752,24,31,75305,31,1992
1799.843,17,444,39768,399,36,4522,288,25548,45,288,40020,288,14220
0.993,17,2,677,1,300,0,300,328,1,321,0,321,349
95.831,6,44,9812,19,290,3580,1189,2804,25,400,3991,3377,7008
40.302,2,2,64,2,8,40302,8,64,0,0,0,0,0
1792.435,6,416,24920,208,69,8659,69,12460,208,34,8659,64,12460
1.22,6,24,8004,11,164,103,267,1236,13,869,86,1448,6768
20.66,17,4,824,2,48,20641,48,152,2,308,20639,308,672
0.163,6,10,1671,6,552,32,948,1348,4,159,54,159,323
280.276,6,31,7472,14,158,21559,267,1357,17,543,17513,1400,6115
0.0,17,3,999,3,305,0,334,999,0,0,0,0,0
1790.601,1,110,6160,110,28,16427,28,6160,0,0,0,0,0
36.371,1,3,385,3,100,18185,105,385,0,0,0,0,0
36.562,6,4698,4488015,3025,1404,12,1448,4396295,1673,776,21,1448,91720
27.236,6,26,12455,12,486,2476,1440,2615,14,1010,2029,1440,9840
417.718,6,630,280267,319,238,1313,238,18588,311,799,581,1408,261679
280.534,6,30,7432,13,158,23377,267,1317,17,603,17528,2760,6115
0.024,6,3,120,1,0,0,0,40,2,0,19,0,80
1786.245,6,367,25581,214,99,8386,469,15045,153,69,11751,69,10536
25.908,6,35,8260,17,175,1619,721,2087,18,681,1511,2840,6173
1798.64,6,460,26680,252,69,7165,69,14220,208,34,8688,64,12460
2.851,6,2,88,2,0,0,0,88,0,0,0,0,0
23.069,6,43,12481,23,833,415,1360,6834,20,402,1204,2667,5647
105.493,6,30,7432,13,158,8791,267,1317,17,543,6588,1400,6115
9.98,6,84,24581,43,550,237,1152,18800,41,459,242,1179,5781
476.969,6,41,2645,20,56,16587,208,1588,21,31,23840,31,1057
407.237,1,120,10080,120,56,3422,56,10080,0,0,0,0,0
1756.201,6,79,4198,40,26,45029,26,2132,39,26,46214,26,2066
2.16,17,2,348,1,39,0,39,67,1,253,0,253,281
2.911,6,26,6678,14,332,223,1001,2227,12,661,263,1420,4451
1793.775,17,87,3648,86,14,21103,14,3612,1,8,0,8,36
1.032,17,4,934,2,40,1021,40,136,2,371,1022,379,798
262.796,17,3,228,3,48,131398,48,228,0,0,0,0,0
8.735,6,18,2877,9,137,1091,267,913,9,400,1058,1179,1964
1755.816,1,101,5656,101,28,17558,28,5656,0,0,0,0,0
253.957,6,31,8912,14,158,19535,267,1357,17,687,15869,1781,7555
1682.641,17,14,1036,7,30,280433,30,406,7,62,280435,62,630
1637.386,17,144,12507,132,30,12499,37,7705,12,372,148852,463,4802
79.061,6,23,11278,12,433,77,990,1823,11,1286,7891,3928,9455
0.559,6,108,87189,58,131,9,232,2849,50,1871,11,5680,84340
1150.028,6,13,1348,13,69,95835,69,1348,0,0,0,0,0
1787.449,6,102,8296,68,65,26678,65,4930,34,59,54160,59,3366
0.422,6,10,1669,6,551,84,947,1346,4,159,140,159,323
40.576,2,4,128,4,8,13525,8,128,0,0,0,0,0
1715.87,1,8,848,8,78,245124,78,848,0,0,0,0,0
0.052,17,4,284,2,32,18,32,120,2,54,37,60,164
1737.084,1,65,5460,65,56,27141,56,5460,0,0,0,0,0
1788.086,6,363,25352,211,100,8514,469,14856,152,69,11839,69,10496
0.011,6,7,414,3,31,5,31,175,4,31,0,31,239
1797.246,1,59,4956,59,56,30987,56,4956,0,0,0,0,0
154.885,6,25,9345,12,420,82,925,1784,13,781,12894,1460,7561
1786.897,6,102,8296,68,65,26670,65,4930,34,59,54146,59,3366
281.052,6,29,7392,13,158,23421,267,1317,16,603,18726,2036,6075
1.405,6,25,8056,12,164,108,267,1288,13,869,99,1368,6768
138.449,6,48,31601,29,781,45,1360,5879,19,1919,7684,5440,25722
1770.862,6,102,9779,68,70,26430,234,5948,34,60,53659,83,3831
0.128,17,4,284,2,32,116,32,120,2,54,116,60,164
0.182,17,2,184,1,32,0,32,60,1,96,0,96,124
181.217,6,21,9138,12,304,80,597,1425,9,1468,22631,4441,7713
300.785,6,51,10444,26,400,12031,811,3145,25,314,782,2128,7299
1744.682,2,30,960,30,8,60161,8,960,0,0,0,0,0
1740.438,17,30,6930,30,203,60015,203,6930,0,0,0,0,0
1791.38,17,144,11520,72,48,25230,48,5472,72,56,25230,56,6048
5.14,6,592,543155,388,1336,12,1368,527883,204,776,24,1473,15272
5.061,6,39,7269,20,218,266,314,3423,19,440,266,1152,3846
0.09,6,4,208,0,0,0,0,0,4,0,0,0,208
31.545,17,19,6517,9,428,3939,1350,4108,10,212,3501,1350,2409
105.247,6,117,87352,72,1283,1482,1448,76897,45,675,2387,1448,10455
1774.468,6,236,18193,127,69,14083,69,9427,109,42,16430,69,8766
1759.733,6,24,3624,16,241,117315,241,2568,8,92,251351,92,1056
0.214,6,11,912,6,181,42,181,489,5,77,49,134,423
159.135,6,29,14097,17,819,114,1360,6446,12,1193,14456,4428,7651
661.728,2,6,192,6,8,132345,8,192,0,0,0,0,0
7.894,6,14,1247,7,222,1313,222,728,7,231,1313,231,519
1741.197,6,87,6322,58,31,30547,31,3915,29,31,62183,31,2407
682.347,17,60,5625,54,30,12874,37,3153,6,384,124139,463,2472
280.471,6,30,7432,13,158,23372,267,1317,17,603,17527,2076,6115
240.185,6,51,15488,27,697,9237,1402,12565,24,208,10442,580,2923
0.308,17,8,2766,8,317,44,356,2766,0,0,0,0,0
1.549,17,30,15439,17,582,94,1350,10379,13,361,126,1350,5060
0.15,6,9,1339,5,145,37,145,349,4,826,37,826,990
1793.531,6,356,22520,208,69,8664,69,12460,148,69,12200,69,10060
1793.252,6,304,54959,191,316,9438,316,40936,113,83,16011,83,14023
277.141,1,4,395,4,70,92380,88,395,0,0,0,0,0
1764.23,2,15,480,15,8,126016,8,480,0,0,0,0,0
1800.0,6,234,19960,87,75,20581,314,8847,147,68,12328,1062,11113
300.726,6,36,8500,20,318,15827,928,2107,16,521,567,3488,6393
280.225,6,25,7094,11,181,28022,267,1168,14,595,21554,1400,5926
1.335,17,27,16820,12,489,119,1350,6213,15,679,93,1350,10607
1.836,6,27,8849,16,286,122,590,1502,11,862,164,1380,7347
777.017,2,6,192,6,8,155403,8,192,0,0,0,0,0
1793.64,17,177,11328,177,36,10191,36,11328,0,0,0,0,0
40.728,6,52,10635,26,533,637,910,3327,26,329,1623,2720,7308
1774.753,6,180,15480,120,69,14913,69,8940,60,69,30079,69,6540
414.905,2,9,288,9,8,51863,8,288,0,0,0,0,0
1740.83,17,28,29512,28,1026,64475,1026,29512,0,0,0,0,0
1798.528,6,356,22520,208,69,8688,69,12460,148,69,12234,69,10060
1744.449,6,103,8084,67,45,26431,205,4954,36,34,49833,98,3130
0.595,17,2,225,1,37,0,37,65,1,132,0,132,160
135.735,6,19,4567,11,189,13573,516,1390,8,570,16962,1452,3177
361.525,6,50,15358,32,532,11662,1360,9836,18,435,511,2667,5522
0.252,17,11,4628,5,432,63,1350,2301,6,359,38,1350,2327
8.553,6,67,20166,35,562,251,1152,15459,32,489,267,1179,4707
164.611,6,22,900,8,0,7074,0,324,14,0,12661,0,576
0.316,17,12,4389,12,337,28,360,4389,0,0,0,0,0
1772.155,6,180,15480,120,69,14892,69,8940,60,69,30035,69,6540
240.604,6,140,82248,69,559,3538,1408,8183,71,1192,3437,2816,74065
1796.949,17,448,39896,403,35,4470,288,25676,45,288,40018,288,14220
280.609,17,4,296,2,30,280564,30,116,2,62,280450,62,180
110.05,17,4,288,2,36,110050,36,128,2,52,110049,52,160
1.202,6,29,5851,15,111,85,267,1386,14,650,86,1420,4465
1796.203,17,449,39928,404,35,4457,288,25708,45,288,40015,288,14220
1785.861,6,365,25432,213,100,8423,469,14936,152,69,11826,69,10496
1155.51,17,20,6688,20,306,60816,308,6688,0,0,0,0,0
1789.186,17,87,3648,86,14,21049,14,3612,1,8,0,8,36
130.263,1,10,560,10,28,14473,28,560,0,0,0,0,0
1681.887,17,14,1036,7,30,280308,30,406,7,62,280307,62,630
1.236,6,48,19717,27,927,47,1360,14101,21,476,53,2715,5616
240.239,6,53,17886,28,796,8897,1418,15009,25,196,10009,580,2877
0.497,17,3,451,2,39,271,39,134,1,289,0,289,317
1787.181,6,107,8969,70,70,25901,294,5270,37,63,49639,247,3699
1.917,6,27,8851,16,286,127,591,1503,11,863,170,1380,7348
0.509,1,2,112,2,28,509,28,112,0,0,0,0,0
240.709,2,3,96,3,8,120354,8,96,0,0,0,0,0
0.041,17,2,588,1,39,0,39,67,1,493,0,493,521
217.62,6,9,515,5,43,54405,43,299,4,0,72434,0,216
121.267,6,27,8752,14,158,9328,267,1357,13,1145,10100,4845,7395
0.094,6,9,1002,5,213,23,213,417,4,421,25,421,585
0.191,1,2,112,2,28,191,28,112,0,0,0,0,0
1792.802,1,339,28476,339,56,5304,56,28476,0,0,0,0,0
1.128,6,10,3600,4,171,365,171,387,6,964,224,1448,3213
1207.775,6,249,15549,140,69,8688,69,8429,109,57,11182,69,7120
285.113,6,21,1509,11,330,28510,330,910,10,83,31678,83,599
1.3,17,3,451,2,39,895,39,134,1,289,0,289,317
16.358,17,34,14115,17,614,1020,1350,10928,17,159,1020,1350,3187
220.72,6,44,20505,24,1004,2071,1360,12118,20,582,11607,1360,8387
376.281,1,36,3816,36,78,10750,78,3816,0,0,0,0,0
0.279,17,15,7454,7,506,46,1350,3742,8,436,30,1350,3712
193.089,6,90,67015,41,529,4827,1448,4271,49,1504,2509,4344,62744
1791.317,6,355,22480,207,69,8695,69,12420,148,69,12185,69,10060
0.591,6,29,7519,17,305,36,1086,2825,12,701,52,1728,4694
0.944,17,2,134,2,39,944,39,134,0,0,0,0,0
1798.258,1,59,4956,0,0,0,0,0,59,56,31004,56,4956
271.114,17,12,4032,12,308,24646,308,4032,0,0,0,0,0
1741.209,1,56,4704,56,56,31658,56,4704,0,0,0,0,0
0.009,6,2,80,1,0,0,0,40,1,0,0,0,40
15.903,17,19,10835,11,748,1586,1350,8538,8,259,2266,1350,2297
300.796,6,45,14445,25,866,12533,1360,8843,20,399,454,1360,5602
36.252,6,28,5520,16,199,2416,517,2246,12,440,3294,499,3274
1746.286,1,59,4956,0,0,0,0,0,59,56,30108,56,4956
0.467,6,26,7751,16,339,31,949,3017,10,721,50,1420,4734
2.883,17,3,222,3,46,1441,46,222,0,0,0,0,0
1740.532,17,30,31680,30,1028,60018,1028,31680,0,0,0,0,0
34.709,17,20,1520,20,48,1826,48,1520,0,0,0,0,0
225.061,6,30,6779,15,204,16075,517,2013,15,663,16064,2877,4766
600.094,17,24,1824,24,48,26091,48,1824,0,0,0,0,0
1793.363,17,180,14040,180,50,10018,50,14040,0,0,0,0,0
1622.751,1,7,392,7,28,270458,28,392,0,0,0,0,0
0.385,6,13,1693,7,288,63,288,588,6,426,43,434,1105
1788.876,17,140,11200,70,48,25925,48,5320,70,56,25925,56,5880
0.391,6,21,7217,12,318,34,599,1905,9,967,47,1471,5312
273.039,17,4,352,2,60,273038,60,176,2,60,273037,60,176
9.981,17,4,390,2,44,9974,44,144,2,95,9973,95,246
0.021,17,2,198,1,39,0,39,67,1,103,0,103,131
1446.591,6,75,6007,46,65,26473,65,3335,29,54,51660,59,2672
0.027,17,8,2454,8,278,3,317,2454,0,0,0,0,0
1.955,6,3,168,1,0,0,0,52,2,0,57,0,116
1741.514,17,30,7050,30,207,60052,207,7050,0,0,0,0,0
338.276,6,144,32654,85,340,4027,1368,13963,59,306,5832,1328,18691
1762.976,6,118,9111,72,44,24830,205,5301,46,34,39000,98,3810
1.167,6,24,8016,12,164,90,267,1300,12,1014,90,2411,6716
0.242,6,46,21429,26,1096,9,1420,16408,20,467,12,1883,5021
1783.356,17,83,3480,82,14,22016,14,3444,1,8,0,8,36
0.272,17,2,334,1,32,0,32,60,1,246,0,246,274
53.429,6,28,7217,13,155,4452,267,1306,15,482,3815,2840,5911
14.841,17,28,9166,12,468,1349,1350,5963,16,172,980,1350,3203
175.215,17,2,72,1,8,0,8,36,1,8,0,8,36
165.073,6,29,7392,13,158,13756,267,1317,16,603,10996,2236,6075
0.066,17,2,383,1,33,0,33,61,1,294,0,294,322
121.798,6,24,10706,13,721,106,1308,3436,11,974,12159,2720,7270
1681.461,17,14,3815,7,30,280241,30,406,7,459,280241,463,3409
1750.588,17,12,498,11,14,175058,14,462,1,8,0,8,36
27.662,6,3937,3828995,2643,1373,10,1408,3756995,1294,931,21,2801,72000
19.792,17,35,14217,16,597,1317,1350,10004,19,193,1097,1350,4213
1799.701,6,364,24992,212,94,8529,469,14496,152,69,11918,69,10496
1775.538,17,138,11040,69,48,26110,48,5244,69,56,26110,56,5796
1783.814,6,371,25879,213,98,8414,469,15143,158,69,11361,69,10736
1.021,6,39,27639,18,213,60,517,1784,21,1547,50,4206,25855
1744.313,6,95,7234,62,38,28595,205,4424,33,33,54495,98,2810
318.638,6,79,17323,41,273,7965,739,4309,38,425,678,1440,13014
260.59,6,57,7425,26,129,10415,722,2911,31,138,8679,1408,4514
1770.773,6,106,9748,67,66,26829,66,5728,39,60,46596,60,4020
1741.025,6,87,6322,58,31,30544,31,3915,29,31,62179,31,2407
1793.502,17,142,11360,71,48,25621,48,5396,71,56,25621,56,5964
1787.414,6,103,8395,68,65,26677,65,4930,35,59,52566,59,3465
0.208,6,43,40672,15,218,14,517,1662,28,1564,6,2876,39010
61.685,17,24,8754,24,336,2681,359,8754,0,0,0,0,0
240.232,6,52,18014,28,814,8897,1418,15305,24,207,10444,580,2709
1786.852,17,140,11200,70,48,25896,48,5320,70,56,25896,56,5880
1.003,6,23,6508,13,332,82,1002,2188,10,979,110,1731,4320
257.557,6,28,5176,12,189,12696,516,1430,16,258,17164,1452,3746
0.161,6,25,7216,13,155,13,267,1301,12,775,13,4836,5915
401.395,17,10,880,5,48,100346,48,380,5,72,100346,72,500
15.385,6,10,3437,5,189,3846,189,409,5,1408,3803,2720,3028
0.271,17,2,476,1,39,0,39,67,1,381,0,381,409
309.929,6,18,6352,2,112,240,112,200,16,393,20661,1420,6152
0.335,6,10,1671,6,552,66,948,1348,4,159,107,159,323
19.74,17,29,7973,12,258,1791,1350,3441,17,238,1231,1350,4532
240.268,6,55,18817,29,843,8580,1418,15863,26,177,9610,580,2954
0.205,17,8,2438,8,276,29,315,2438,0,0,0,0,0
11.921,6,146,44819,69,729,175,1418,36460,77,117,156,1325,8359
1.171,6,59,18086,29,707,41,1360,8977,30,438,39,1360,9109
1770.647,6,99,9240,66,65,27240,65,5577,33,59,55329,59,3663
1731.591,17,17,6394,17,348,108224,1437,6394,0,0,0,0,0
0.005,17,2,396,1,49,0,49,77,1,291,0,291,319
1794.015,6,193,25112,107,304,16924,304,17224,86,83,21105,83,7888
36.038,17,11,836,11,48,3603,48,836,0,0,0,0,0
0.345,6,27,8914,14,231,26,563,1660,13,938,28,1448,7254
1605.174,6,21,3171,14,241,123474,241,2247,7,92,267498,92,924
1744.657,6,95,7203,63,38,28139,205,4476,32,33,56266,98,2727
11.725,6,1877,1610158,1131,1369,10,1420,1576088,746,421,15,1883,34070
300.969,6,48,13126,24,884,13085,1460,7240,24,307,653,1460,5886
238.078,6,244,38225,132,304,1817,304,26580,112,83,2133,83,11645
3.024,6,25,8056,12,164,225,267,1288,13,869,210,1448,6768
1.317,17,2,216,1,49,0,49,77,1,111,0,111,139
1745.428,6,95,7203,63,38,28152,205,4476,32,33,56294,98,2727
0.041,17,2,144,1,36,0,36,64,1,52,0,52,80
0.524,6,22,7342,12,335,47,668,1974,10,1210,57,1906,5368
1798.054,6,356,22520,208,69,8686,69,12460,148,69,12231,69,10060
1.516,6,19,3781,10,234,168,564,1452,9,463,166,1343,2329
306.513,6,29,6345,13,286,25542,1314,2245,16,345,20432,1460,4100
1741.363,6,87,6322,58,31,30550,31,3915,29,31,62191,31,2407
1786.811,6,104,8308,68,64,26668,64,4896,36,58,51049,58,3412
1798.191,6,356,22520,208,69,8686,69,12460,148,69,12232,69,10060
0.227,6,10,1327,5,299,41,299,567,5,246,35,459,760
1.569,2,3,96,3,8,784,8,96,0,0,0,0,0
1772.868,6,180,15480,120,69,14898,69,8940,60,69,30041,69,6540
1786.358,6,104,8444,68,66,26662,66,4964,36,60,51036,60,3480
1772.122,6,180,15480,120,69,14891,69,8940,60,69,30034,69,6540
0.502,17,3,451,2,39,54,39,134,1,289,0,289,317
284.202,6,37,12179,16,176,18946,267,1704,21,740,14207,1400,10475
1794.688,6,355,22480,207,69,8712,69,12420,148,69,12208,69,10060
0.764,6,512,544698,165,151,4,287,9217,347,1508,1,2876,535481
243.323,2,7,224,7,8,40553,8,224,0,0,0,0,0
0.057,17,2,185,1,45,0,45,73,1,84,0,84,112
1.11,6,24,8028,12,164,85,267,1312,12,1014,85,2816,6716
9.364,6,10,436,4,0,3121,0,172,6,0,1707,0,264
90.267,6,145,109616,90,1283,1014,1408,95838,55,681,1667,1408,13778
625.313,17,50,4000,25,48,26051,48,1900,25,56,26053,56,2100
4.94,6,41,7349,21,218,247,314,3463,20,440,246,1152,3886
278.305,17,1175,217330,782,161,356,172,147806,393,148,708,172,69524
3.333,17,5,340,5,40,833,40,340,0,0,0,0,0
31.659,6,7,396,1,0,0,0,60,6,0,6299,0,336
0.09,6,7,423,4,43,18,43,259,3,0,34,0,164
1.341,6,51,18902,28,922,49,1460,13161,23,400,52,1460,5741
5.87,6,513,448582,324,1320,17,1368,434090,189,776,30,1473,14492
1786.536,6,102,8228,68,64,26664,64,4896,34,58,54134,58,3332
21.264,6,3320,2950961,1957,1416,10,1448,2863805,1363,776,15,1448,87156
1797.68,1,345,28980,345,56,5225,56,28980,0,0,0,0,0
24.988,17,4,352,2,60,24986,60,176,2,60,24987,60,176
3.32,6,24,8852,13,373,276,851,1643,11,966,323,1420,7209
1770.8,1,58,4872,58,56,31066,56,4872,0,0,0,0,0
1.221,6,10,1687,7,100,203,100,384,3,1179,485,1179,1303
0.054,17,2,176,1,48,0,48,76,1,72,0,72,100
240.711,6,58,21535,30,779,8300,1418,14815,28,525,8914,1418,6720
16.274,17,6,528,3,48,8133,48,228,3,72,8132,72,300
1775.81,17,140,11200,70,48,25736,48,5320,70,56,25736,56,5880
8.321,6,1765,1687674,1157,1383,7,1408,1651394,608,931,13,2816,36280
1798.267,6,128,12523,78,62,23354,722,6421,50,87,36692,1408,6102
0.05,17,2,142,1,35,0,35,63,1,51,0,51,79
159.959,6,30,7432,13,158,13329,267,1317,17,543,9991,1400,6115
8.345,6,1640,1537932,1055,1385,7,1408,1502832,585,931,14,2801,35100
55.235,6,535,246460,276,825,200,1152,230579,259,394,213,1152,15881
1406.141,1,7,392,7,28,234356,28,392,0,0,0,0,0
1744.335,6,95,7203,63,38,28134,205,4476,32,33,56262,98,2727
1796.489,6,106,8586,71,64,25664,64,5272,35,58,50956,58,3314
1.29,6,50,19932,28,874,47,1360,14276,22,476,53,2715,5656
339.339,17,8,2656,8,304,48477,308,2656,0,0,0,0,0
403.062,6,18,1242,14,180,31004,180,916,4,110,20149,110,326
6.657,6,31,8888,13,155,554,267,1306,18,489,391,1997,7582
156.254,17,11,836,11,48,15625,48,836,0,0,0,0,0
301.009,6,22,9207,13,382,25069,1193,2082,9,1350,37604,3639,7125
1.48,6,25,8056,12,164,116,267,1288,13,869,107,1368,6768
20.156,6,24,6232,14,117,1550,159,1337,10,727,2238,1418,4895
84.452,6,23,9823,12,410,50,922,1742,11,1089,8433,4080,8081
0.63,6,14,1745,7,288,75,288,600,7,426,73,434,1145
1787.902,6,376,26148,216,98,8315,469,15332,160,69,11244,69,10816
0.133,17,2,904,2,424,133,548,904,0,0,0,0,0
1744.333,6,95,7203,63,38,28134,205,4476,32,33,56261,98,2727
481.26,2,7,224,7,8,80210,8,224,0,0,0,0,0
3.937,17,5,295,5,31,984,31,295,0,0,0,0,0
1.41,6,5,637,3,241,705,241,373,2,92,366,92,264
370.182,6,38,7646,27,118,14237,267,2181,11,836,20,3436,5465
0.245,17,2,154,1,33,0,33,61,1,65,0,65,93
1786.792,6,102,8364,68,66,26668,66,4964,34,60,54141,60,3400
1.052,17,3,286,2,46,1000,46,148,1,110,0,110,138
34.979,17,44,6468,22,48,1662,48,1672,22,190,1662,308,4796
3.005,17,4,244,4,33,1001,33,244,0,0,0,0,0
1751.384,6,95,7203,63,38,28248,205,4476,32,33,56483,98,2727
1772.631,6,180,15480,120,69,14896,69,8940,60,69,30038,69,6540
65.567,6,73,48621,45,1190,1490,1408,40431,28,960,2282,3847,8190
1.405,6,50,19263,27,889,54,1360,13567,23,433,55,1360,5696
1731.364,17,328,63025,328,164,5294,385,63025,0,0,0,0,0
125.493,6,22,8510,11,313,81,632,1413,11,949,12535,1440,7097
10.793,6,18,5610,10,275,1199,275,958,8,1440,831,1440,4652
1.203,6,25,8056,12,164,91,267,1288,13,869,85,1440,6768
1799.938,1,16,896,16,28,119995,28,896,0,0,0,0,0
280.357,6,30,7432,13,158,23363,267,1317,17,543,17518,1400,6115
1739.977,6,89,6426,58,31,30525,31,3915,31,31,57998,31,2511
1798.447,17,142,11360,71,48,25692,48,5396,71,56,25692,56,5964
1680.592,1,14,784,14,28,129276,28,784,0,0,0,0,0
1789.953,6,355,22480,207,69,8689,69,12420,148,69,12176,69,10060
0.919,6,7,295,4,0,306,0,164,3,7,361,7,131
252.296,2,2,64,2,8,252296,8,64,0,0,0,0,0
0.255,17,3,451,2,39,23,39,134,1,289,0,289,317
41.388,6,14,2242,8,210,5912,210,844,6,545,8277,904,1398
1796.348,1,59,4956,59,56,30971,56,4956,0,0,0,0,0
9.413,6,52,9609,26,233,376,314,4781,26,472,366,1179,4828
280.382,6,29,7392,13,158,23365,267,1317,16,603,18684,1400,6075
301.011,6,53,24596,26,957,12040,1408,12859,27,573,1456,3534,11737
1779.639,17,72,3018,71,14,25423,14,2982,1,8,0,8,36
191.981,6,4,574,4,103,63993,138,574,0,0,0,0,0
258.304,1,6,336,6,28,51660,28,336,0,0,0,0,0
195.354,6,2,80,2,0,0,0,80,0,0,0,0,0
1.141,17,3,1167,3,361,570,361,1167,0,0,0,0,0
275.094,6,28,8014,10,220,6351,516,1285,18,400,16176,1452,6729
126.637,6,50,28623,31,1071,4221,1408,20900,19,961,3415,3847,7723
15.522,6,6,288,1,0,0,0,48,5,0,3867,0,240
1775.982,17,73,3060,72,14,25013,14,3024,1,8,0,8,36
1786.763,6,104,8308,68,64,26668,64,4896,36,58,51047,58,3412
1740.753,17,29,30624,29,1028,62169,1028,30624,0,0,0,0,0
1740.678,17,28,29483,28,1024,64469,1028,29483,0,0,0,0,0
426.525,6,907,427989,462,852,924,1119,408755,445,357,960,1179,19234
1793.821,1,261,14616,261,28,6899,28,14616,0,0,0,0,0
1789.175,17,83,3480,82,14,22088,14,3444,1,8,0,8,36
72.239,2,6,192,6,8,14447,8,192,0,0,0,0,0
8.612,6,24,4626,13,226,717,597,1805,11,448,837,1408,2821
1739.156,6,101,7308,64,31,27605,31,4356,37,31,48309,31,2952
1789.945,6,373,28304,217,127,8286,469,17372,156,69,11548,69,10932
0.601,6,10,924,5,283,101,283,551,5,105,101,105,373
70.606,6,19,7234,9,267,8825,501,1165,10,809,7819,1420,6069
1771.429,6,99,9306,66,66,27252,66,5610,33,60,55353,60,3696
1.201,6,33,12216,18,525,70,1360,3402,15,745,72,1360,8814
300.719,6,49,29829,26,190,12028,444,2181,23,1555,11098,5197,27648
0.044,17,2,220,1,50,0,50,78,1,114,0,114,142
11.879,6,1911,1640349,1159,1362,10,1380,1604104,752,511,15,1923,36245
1738.287,1,60,5040,0,0,0,0,0,60,56,29462,56,5040
5.97,6,5,220,5,0,0,0,220,0,0,0,0,0
0.036,17,2,912,1,308,0,308,336,1,548,0,548,576
13.914,6,27,4866,13,154,1141,722,1766,14,394,1056,1408,3100
1797.992,17,448,39896,403,35,4472,288,25676,45,288,40023,288,14220
1771.442,6,207,14214,77,46,23308,46,6070,130,46,13730,46,8144
207.834,6,26,3866,18,173,12225,196,2340,8,398,3387,419,1526
371.266,6,26,1703,17,177,23204,177,1117,9,110,8618,110,586
2.387,6,13,2311,8,188,341,245,700,5,1407,534,1407,1611
7.985,17,417,396760,307,1184,26,1350,372088,110,196,57,1350,24672
0.014,17,2,376,1,60,0,60,88,1,260,0,260,288
18.793,6,29,5032,17,211,1138,211,2417,12,665,1707,904,2615
1795.977,6,327,25318,160,259,11184,515,10469,167,38,10740,76,14849
0.582,6,58,28398,33,1084,18,1380,23048,25,425,22,1923,5350
1745.039,6,210,15841,79,66,21987,313,7466,131,48,13423,78,8375
0.188,1,2,673,2,308,188,327,673,0,0,0,0,0
138.921,6,46,21602,26,592,5556,1402,4939,20,1301,7310,2804,16663
166.437,6,20,2199,12,302,15130,302,1526,8,83,23589,83,673
1797.472,1,72,6048,0,0,0,0,0,72,56,25316,56,6048
1796.119,6,356,22520,208,69,8676,69,12460,148,69,12218,69,10060
232.101,17,6,456,6,48,46420,48,456,0,0,0,0,0
0.158,6,9,1148,5,145,39,145,349,4,635,40,635,799
64.907,6,11,452,5,0,6157,0,204,6,0,12978,0,248
0.333,6,21,5000,10,137,37,267,1092,11,692,31,1467,3908
2.642,17,4,1568,4,364,880,364,1568,0,0,0,0,0
11.766,6,1853,1614722,1140,1363,10,1380,1581960,713,421,16,1923,32762
697.465,6,92,13859,44,150,16220,721,6136,48,305,11644,1440,7723
128.415,2,4,128,4,8,42805,8,128,0,0,0,0,0
722.744,6,655,553598,422,1351,1716,1408,513799,233,522,2711,2816,39799
1714.145,6,102,8079,66,65,26371,65,4720,36,58,48973,59,3359
1.683,6,13,2311,8,188,240,245,700,5,1407,357,1407,1611
1777.925,17,142,11360,71,48,25398,48,5396,71,56,25398,56,5964
61.85,6,65,46298,43,1167,1472,1408,38422,22,960,2934,3847,7876
1786.86,6,102,8296,68,65,26669,65,4930,34,59,54143,59,3366
0.009,17,2,215,1,39,0,39,67,1,120,0,120,148
36.93,6,4665,4437983,2983,1408,12,1448,4345831,1682,776,21,1448,92152
11.782,6,19,4362,11,275,1178,275,998,8,1010,1537,2840,3364
280.437,6,29,7392,13,158,23369,267,1317,16,603,18692,2760,6075
1795.151,17,80,3354,79,14,23014,14,3318,1,8,0,8,36
37.44,17,11,836,11,48,3744,48,836,0,0,0,0,0
421.187,2,4,128,4,8,140395,8,128,0,0,0,0,0
0.683,17,4,560,2,64,443,64,184,2,160,460,160,376
0.319,17,2,157,1,31,0,31,59,1,70,0,70,98
48.49,6,27,7312,13,158,4040,267,1317,14,775,3727,4836,5995
288.664,17,4,352,2,60,288663,60,176,2,60,288663,60,176
251.945,2,3,96,3,8,125972,8,96,0,0,0,0,0
1684.484,2,26,832,26,8,67379,8,832,0,0,0,0,0
1680.458,17,13,534,11,14,168027,14,462,2,8,1679990,8,72
2.164,6,13,2311,8,188,309,245,700,5,1407,475,1407,1611
0.274,17,2,154,1,33,0,33,61,1,65,0,65,93
5.046,17,3,208,2,36,5019,36,128,1,52,0,52,80
0.004,17,3,853,1,137,0,137,165,2,316,2,316,688
43.34,17,4,352,2,60,43339,60,176,2,60,43339,60,176
0.219,17,2,679,2,311,219,331,679,0,0,0,0,0
1.587,6,51,19823,29,920,56,1360,14122,22,437,65,2715,5701
1782.147,6,395,24128,209,69,8568,69,12500,186,42,9633,69,11628
1590.63,6,96,5748,55,27,29456,27,3238,41,27,39764,27,2510
1772.638,6,180,15480,120,69,14896,69,8940,60,69,30042,69,6540
0.024,6,17,4062,10,75,2,75,603,7,617,3,1000,3459
1.422,6,50,20471,27,975,54,1460,14775,23,433,55,1460,5696
1797.869,17,449,39928,404,35,4461,288,25708,45,288,40016,288,14220
27.665,6,31,7677,12,155,2515,267,1266,19,376,1536,3417,6411
1798.659,17,509,44820,404,35,4463,288,25752,105,153,16930,308,19068
80.349,6,25,9783,12,653,77,1460,3126,13,875,6680,1460,6657
0.015,17,2,334,1,32,0,32,60,1,246,0,246,274
1.284,6,24,8004,12,164,96,267,1288,12,1014,99,2331,6716
99.043,17,2,642,1,300,0,300,328,1,286,0,286,314
5.484,6,14,5730,9,290,685,517,1057,5,1468,980,2423,4673
8.063,6,921,863100,603,1356,13,1368,838270,318,679,24,1368,24830
280.3,6,30,7432,13,158,23358,267,1317,17,543,17514,1300,6115
0.234,6,10,1568,5,121,58,121,389,5,911,58,911,1179
1796.295,6,400,34746,227,118,7948,1189,17609,173,132,10441,1460,17137
0.071,6,12,2081,6,324,14,585,969,6,396,12,580,1112
282.85,6,30,7699,14,176,21757,267,1624,16,678,18853,2800,6075
0.018,17,4,350,2,34,9,34,124,2,85,10,91,226
1682.733,17,14,1036,7,30,280445,30,406,7,62,280448,62,630
0.132,6,16,6197,8,128,18,128,552,8,1044,18,1448,5645
0.03,17,4,308,2,38,0,38,132,2,60,0,66,176
91.2,6,11,806,11,26,9120,26,806,0,0,0,0,0
1.449,6,47,19259,27,897,55,1360,13683,20,476,66,2720,5576
0.102,17,2,158,1,34,0,34,62,1,68,0,68,96
1791.643,17,144,11520,72,48,25234,48,5472,72,56,25234,56,6048
377.96,2,3,96,3,8,188980,8,96,0,0,0,0,0
94.955,6,860,433521,484,829,196,1152,411564,376,406,252,1179,21957
34.216,17,10,760,10,48,3801,48,760,0,0,0,0,0
1792.794,17,83,3480,82,14,22133,14,3444,1,8,0,8,36
1785.58,6,103,8395,68,65,26650,65,4930,35,59,52514,59,3465
280.49,6,30,7432,13,158,23374,267,1317,17,603,17523,2760,6115
1799.689,17,450,39960,405,35,4454,288,25740,45,288,40019,288,14220
0.26,6,25,6032,12,164,23,453,1442,13,558,20,1408,4590
3.519,17,2,656,2,300,3519,300,656,0,0,0,0,0
5.885,6,38,7229,20,218,309,314,3423,18,513,326,1179,3806
30.348,6,110,75939,50,121,619,235,3298,60,1264,514,1440,72641
1785.832,6,116,12394,76,81,23811,501,5990,40,126,45788,1420,6404
39.433,6,72,23668,32,467,1272,1448,8232,40,392,1002,1448,15436
1755.99,6,105,6270,60,27,29762,27,3525,45,27,39907,27,2745
0.576,17,4,588,2,48,566,48,152,2,190,564,308,436
5.009,17,4,558,2,36,5004,36,128,2,187,5004,187,430
1.055,6,27,8506,14,275,68,583,1967,13,1201,72,3151,6539
58.154,6,10,648,10,31,6461,31,648,0,0,0,0,0
0.164,17,2,632,1,288,0,288,316,1,288,0,288,316
167.91,6,1106,533880,587,842,286,1152,507258,519,418,323,1179,26622
1795.285,17,80,3354,79,14,23016,14,3318,1,8,0,8,36
149.445,6,26,9497,13,815,2137,1360,6259,13,541,12442,856,3238
1682.813,17,14,1036,7,30,280461,30,406,7,62,280458,62,630
58.964,1,4,224,4,28,19654,28,224,0,0,0,0,0
1729.251,6,60,4400,40,33,44339,33,2740,20,31,90999,31,1660
1285.653,1,20,1120,20,28,67665,28,1120,0,0,0,0,0
0.079,1,2,112,2,28,79,28,112,0,0,0,0,0
1792.79,1,342,28728,342,56,5257,56,28728,0,0,0,0,0
1793.65,1,276,15456,276,28,6522,28,15456,0,0,0,0,0
637.946,6,109,16910,58,112,11192,721,6139,51,396,12755,1414,10771
1772.218,6,180,15480,120,69,14892,69,8940,60,69,30029,69,6540
76.854,6,29,7697,11,451,110,565,2839,18,301,4519,1448,4858
1773.507,6,180,15480,120,69,14903,69,8940,60,69,30053,69,6540
1786.83,6,106,8388,68,64,26669,64,4896,38,58,48290,58,3492
300.154,6,46,18218,22,1032,14285,1360,12270,24,292,13042,2667,5948
1.191,6,15,1291,8,222,167,222,772,7,231,195,231,519
0.06,6,10,1495,5,507,14,507,727,5,556,14,556,768
396.685,17,6,528,3,60,198342,60,264,3,60,198341,60,264
158.047,6,29,6751,11,189,10995,516,1392,18,309,9291,1452,5359
0.054,17,2,360,1,128,0,128,156,1,176,0,176,204
0.374,17,8,2758,8,316,53,355,2758,0,0,0,0,0
14.367,6,44,6680,22,256,683,256,5492,22,304,683,304,1188
1744.994,6,95,7203,63,38,28145,205,4476,32,33,56280,98,2727
0.067,17,2,298,1,45,0,45,73,1,197,0,197,225
0.396,6,7,371,4,0,132,0,204,3,7,100,7,167
0.403,6,14,1733,7,288,62,288,588,7,284,37,434,1145
1798.75,6,382,26995,219,103,8251,469,15990,163,69,11103,69,11005
0.251,6,14,4044,8,88,35,88,452,6,1670,50,1880,3592
1786.557,6,355,22480,207,69,8672,69,12420,148,69,12153,69,10060
1765.592,1,134,7504,134,28,13275,28,7504,0,0,0,0,0
1789.757,17,134,10720,67,48,27117,48,5092,67,56,27117,56,5628
129.204,6,28,8588,15,258,4719,486,1419,13,1106,10754,3061,7169
0.034,6,2,116,2,0,0,0,116,0,0,0,0,0
42.167,17,24,2112,12,48,3832,48,912,12,72,3832,72,1200
0.091,17,4,420,2,33,0,33,122,2,121,74,145,298
7.177,6,4,160,2,0,7168,0,80,2,0,7168,0,80
0.734,17,4,947,2,33,730,37,123,2,384,726,463,824
0.004,6,2,92,1,0,0,0,52,1,0,0,0,40
104.515,6,32,8952,14,158,8039,267,1357,18,624,6138,1400,7595
128.533,6,20,6468,9,275,16066,275,639,11,672,12745,1414,5829
1771.175,1,58,4872,58,56,31073,56,4872,0,0,0,0,0
167.235,6,67,48765,45,1196,3800,1408,39478,22,1016,2935,4224,9287
299.679,1,4,326,4,53,99893,78,326,0,0,0,0,0
284.383,17,6,360,3,32,142191,32,180,3,32,142191,32,180
29.971,17,18,1584,9,48,3745,48,684,9,72,3745,72,900
1797.659,6,365,33385,180,332,10042,841,12532,185,64,9767,1550,20853
0.229,17,2,152,1,48,0,48,76,1,48,0,48,76
278.733,1,4,326,4,53,92911,78,326,0,0,0,0,0
0.041,6,12,3704,6,171,8,171,491,6,964,8,1448,3213
176.532,6,9,528,2,112,176520,112,200,7,0,29419,0,328
1781.765,6,471,27184,262,69,6826,69,14620,209,34,8566,64,12564
1072.15,17,28,9322,28,304,39709,308,9322,0,0,0,0,0
1782.117,17,76,3186,75,14,24082,14,3150,1,8,0,8,36
269.583,17,4,240,2,32,269581,32,120,2,32,269582,32,120
132.169,1,6,336,6,28,26433,28,336,0,0,0,0,0
147.453,6,37,20314,18,702,46,1460,4979,19,1040,8184,1460,15335
0.017,17,4,344,2,47,11,47,150,2,69,8,75,194
368.7,6,23,1535,16,177,24580,177,1053,7,110,10373,110,482
280.437,6,30,7432,13,158,23369,267,1317,17,603,17523,2760,6115
2.594,6,54,13954,25,549,108,1429,4876,29,416,86,1460,9078
325.925,17,5,610,5,94,81481,94,610,0,0,0,0,0
366.372,6,21,1419,15,177,26169,177,989,6,110,12231,110,430
1787.158,6,117,13862,75,82,24150,501,5983,42,163,43586,1420,7879
1788.221,17,83,3480,82,14,22076,14,3444,1,8,0,8,36
573.077,1,6,336,6,28,114615,28,336,0,0,0,0,0
3.928,6,38,9467,20,450,206,766,2633,18,469,223,3488,6834
1748.916,6,97,7307,63,38,28208,205,4476,34,33,52985,98,2831
58.037,17,4,240,2,32,58036,32,120,2,32,58035,32,120
4.202,6,38,7245,19,218,233,314,3383,19,516,219,1179,3862
240.232,6,55,17950,28,786,8897,1418,14829,27,213,9239,580,3121
180.805,6,18,7842,10,353,95,750,1587,8,971,25808,2736,6255
1786.723,6,105,8475,68,65,26667,65,4930,37,59,49627,59,3545
240.264,6,55,15246,29,703,8579,1418,12066,26,227,9610,580,3180
0.011,17,2,146,1,37,0,37,65,1,53,0,53,81
1729.567,17,176,31686,176,152,9883,422,31686,0,0,0,0,0
61.348,6,36,15837,22,794,2921,1408,9111,14,748,4699,2439,6726
13.476,17,10,1310,5,39,3361,39,335,5,167,3361,167,975
61.616,6,38,8281,13,140,5133,267,1513,25,303,2566,1460,6768
23.48,6,22,6820,6,154,4696,267,712,16,455,1555,1420,6108
0.126,6,9,1002,5,213,31,213,417,4,421,39,421,585
190.088,6,29,7392,13,158,15840,267,1317,16,603,12670,2036,6075
4.239,6,41,7349,20,218,223,314,3423,21,440,199,1152,3926
1720.543,17,12,498,11,14,172054,14,462,1,8,0,8,36
1.922,17,4,518,3,39,704,39,201,1,289,0,289,317
1787.096,6,102,8296,68,65,26673,65,4930,34,59,54149,59,3366
1.277,6,49,19654,27,920,49,1360,13998,22,433,52,1360,5656
24.651,6,38,9413,22,102,1173,320,1866,16,689,161,2720,7547
1681.399,17,14,3755,7,30,280231,30,406,7,450,280231,463,3349
1.36,6,47,19290,27,900,52,1360,13714,20,476,62,2715,5576
1799.296,17,142,11360,71,48,25704,48,5396,71,56,25704,56,5964
1797.729,1,58,4872,0,0,0,0,0,58,56,31539,56,4872
23.872,6,15,3339,5,131,5968,131,335,10,2600,2648,2600,3004
33.735,6,9,372,7,0,5622,0,284,2,0,1039,0,88
1.291,6,12,1767,8,100,184,100,424,4,589,347,1152,1343
1771.956,6,180,15480,120,69,14890,69,8940,60,69,30031,69,6540
1753.695,6,96,7286,63,38,28285,205,4476,33,33,54792,98,2810
1.447,6,31,6013,14,123,111,267,1428,17,650,80,1380,4585
69.363,6,45,10209,22,533,727,910,3083,23,364,3147,2128,7126
0.213,17,2,172,1,50,0,50,78,1,66,0,66,94
6.183,6,27,7183,13,156,515,267,1312,14,530,474,3417,5871
66.232,6,3272,2868024,2127,1270,31,1368,2803820,1145,776,57,1473,64204
1799.837,17,142,11360,71,48,25711,48,5396,71,56,25711,56,5964
225.962,17,8,2710,8,310,32280,326,2710,0,0,0,0,0
0.199,17,2,1920,2,932,199,932,1920,0,0,0,0,0
1689.149,17,16,1265,8,30,241304,37,471,8,71,241304,136,794
422.179,6,8,475,6,31,84435,31,333,2,31,299519,31,142
249.496,17,4,352,2,60,249495,60,176,2,60,249495,60,176
1792.005,6,356,22520,208,69,8657,69,12460,148,69,12190,69,10060
924.288,6,21,19494,3,174,3726,174,298,18,1420,54364,1420,19196
31.999,17,4,352,2,60,31998,60,176,2,60,31998,60,176
0.163,1,2,163,2,53,163,78,163,0,0,0,0,0
0.977,6,28,8313,15,266,57,608,2232,13,924,66,1772,6081
0.261,17,3,234,2,39,205,39,134,1,72,0,72,100
0.01,17,2,379,1,29,0,29,57,1,294,0,294,322
0.905,6,10,1687,7,100,150,100,384,3,1179,321,1179,1303
0.041,17,4,865,2,47,31,47,150,2,329,27,341,715
0.892,17,2,694,2,319,892,354,694,0,0,0,0,0
1797.531,6,356,22520,208,69,8683,69,12460,148,69,12228,69,10060
1789.369,17,83,3480,82,14,22090,14,3444,1,8,0,8,36
247.868,17,4,352,2,60,247867,60,176,2,60,247867,60,176
9.458,6,9,527,5,43,2364,43,311,4,0,3149,0,216
1772.495,6,240,17880,120,69,14894,69,8940,120,34,14894,64,8940
1795.308,17,448,39896,403,35,4465,288,25676,45,288,40019,288,14220
240.295,6,53,19699,28,859,8898,1418,16935,25,208,10011,580,2764
1.27,6,10,1687,7,100,211,100,384,3,1179,511,1179,1303
0.017,17,2,403,1,65,0,65,93,1,282,0,282,310
0.218,6,6,4825,5,1131,8,1368,4785,1,0,0,0,40
0.063,17,2,152,1,48,0,48,76,1,48,0,48,76
18.996,17,31,21621,15,704,1354,1350,10989,16,636,1264,1350,10632
0.155,6,12,3462,6,75,31,75,395,6,1373,30,1448,3067
38.769,17,22,1936,11,48,3874,48,836,11,72,3871,72,1100
25.211,17,3,228,3,48,12605,48,228,0,0,0,0,0
0.161,6,28,7336,13,155,13,267,1301,15,543,11,1400,6035
75.774,6,911,798380,610,1333,52,1360,777948,301,178,252,1360,20432
0.462,6,12,1653,6,288,86,288,548,6,426,52,434,1105
278.693,1,10,1060,10,78,30965,78,1060,0,0,0,0,0
0.016,6,6,897,3,483,4,483,639,3,102,4,102,258
0.177,6,3,453,2,241,177,241,321,1,92,0,92,132
1785.855,6,354,22440,206,69,8711,69,12380,148,69,12148,69,10060
1.5,6,45,18104,26,882,60,1360,12568,19,476,72,2715,5536
280.209,6,29,7392,14,158,21554,267,1357,15,678,20011,4200,6035
0.065,1,2,112,2,28,65,28,112,0,0,0,0,0
69.421,6,30,8629,13,155,5785,267,1306,17,510,4330,1997,7323
9.967,2,2,64,2,8,9967,8,64,0,0,0,0,0
0.557,6,11,1419,5,145,139,145,349,6,826,70,826,1070
48.828,17,4,352,2,60,48827,60,176,2,60,48827,60,176
84.986,6,21,6014,11,216,8498,503,1310,10,614,9416,1420,4704
33.666,6,30,5042,15,154,2404,722,1859,15,399,2391,2026,3183
0.005,17,3,370,2,34,0,34,124,1,218,0,218,246
15.121,6,6,328,4,0,5040,0,216,2,0,15088,0,112
1791.506,6,410,38365,231,136,7789,1221,19081,179,144,10064,2760,19284
15.273,6,6,288,1,0,0,0,48,5,0,3815,0,240
1793.253,17,179,11456,179,36,10074,36,11456,0,0,0,0,0
41.866,6,51,13348,24,1005,673,1460,7082,27,272,1603,1460,6266
57.323,6,15,2849,6,322,11464,581,977,9,457,7160,580,1872
0.979,17,2,677,1,300,0,300,328,1,321,0,321,349
0.167,6,43,19679,25,1055,6,1420,14738,18,467,9,1883,4941
22.304,17,6,528,3,60,11151,60,264,3,60,11151,60,264
17.194,6,7,435,0,0,0,0,0,7,31,2865,31,435
0.006,17,2,463,1,44,0,44,72,1,363,0,363,391
13.092,6,14,1025,7,222,2179,222,506,7,231,2179,231,519
0.038,6,12,3462,6,75,7,75,395,6,1373,7,1448,3067
2.304,6,13,2311,8,188,329,245,700,5,1407,509,1407,1611
61.308,6,35,15923,22,809,2919,1408,9249,13,855,5087,3847,6674
2.044,6,12,1304,6,256,406,256,756,6,304,406,304,548
12.329,6,1984,1701531,1200,1364,10,1380,1665917,784,421,15,1923,35614
1143.019,2,13,416,13,8,95251,8,416,0,0,0,0,0
51.153,6,27,7177,13,155,4262,267,1306,14,530,3933,3417,5871
0.09,6,11,818,6,185,17,185,505,5,45,22,45,313
1513.14,2,12,384,12,8,137558,8,384,0,0,0,0,0
2.296,6,53,19661,27,909,88,1440,13845,26,433,83,1440,5816
10.907,6,2533,2404778,1649,1381,6,1408,2354146,884,776,12,1408,50632
0.48,6,26,8890,13,232,40,569,1614,13,941,37,1438,7276
0.182,6,5,200,3,0,1,0,120,2,0,0,0,80
31.662,6,7,308,1,0,0,0,44,6,0,6291,0,264
3.446,17,2,656,2,300,3446,300,656,0,0,0,0,0
1786.303,6,106,8584,69,66,26269,66,5004,37,60,49610,60,3580
0.122,1,2,112,2,28,122,28,112,0,0,0,0,0
206.137,17,4,352,2,60,206136,60,176,2,60,206136,60,176
280.276,17,4,296,2,30,280263,30,116,2,62,280263,62,180
1.139,17,4,240,2,32,1138,32,120,2,32,1138,32,120
1.141,17,20,8661,10,352,123,1350,3805,10,457,123,1350,4856
0.157,17,2,410,1,46,0,46,74,1,308,0,308,336
61.468,6,25,9972,12,479,69,1360,2473,13,995,5109,1360,7499
0.332,6,3,168,1,0,0,0,52,2,0,213,0,116
1721.679,1,8,848,8,78,245954,78,848,0,0,0,0,0
36.786,17,44,6468,22,48,1748,48,1672,22,190,1748,308,4796
0.016,6,2,350,1,0,0,0,40,1,258,0,258,310
0.421,17,8,2750,8,315,60,354,2750,0,0,0,0,0
60.064,17,28,2295,26,30,2402,37,1515,2,362,363,419,780
1797.951,17,448,39896,403,35,4472,288,25676,45,288,40022,288,14220
10.589,6,20,4442,11,275,1058,275,998,9,768,698,1440,3444
0.25,17,2,742,2,343,250,354,742,0,0,0,0,0
1.407,6,51,22956,30,947,48,1360,17340,21,476,60,2715,5616
0.322,6,26,9068,13,266,26,705,1750,13,947,26,2804,7318
1.374,6,51,19882,29,926,49,1460,14181,22,400,56,1460,5701
350.365,17,10,880,5,48,87588,48,380,5,72,87588,72,500
280.232,6,27,7312,12,158,25475,267,1277,15,603,20015,1400,6035
2.831,17,2,122,2,33,2831,33,122,0,0,0,0,0
0.009,17,2,378,1,39,0,39,67,1,283,0,283,311
0.915,6,10,1687,7,100,152,100,384,3,1179,325,1179,1303
9.483,6,77,24285,40,550,243,1152,18664,37,459,255,1179,5621
1.29,17,6,1202,3,36,643,36,192,3,308,643,318,1010
657.225,2,6,192,6,8,131445,8,192,0,0,0,0,0
1.454,6,50,21137,28,955,53,1460,15481,22,476,59,2615,5656
721.929,2,6,192,6,8,144385,8,192,0,0,0,0,0
10.529,6,2059,1894543,1266,1416,8,1448,1848631,793,776,13,1448,45912
224.972,17,4,352,2,60,224970,60,176,2,60,224971,60,176
61.922,17,8,1176,4,48,20637,48,304,4,190,20636,308,872
2.615,17,2,140,1,34,0,34,62,1,50,0,50,78
0.095,17,2,167,1,39,0,39,67,1,72,0,72,100
611.149,6,11,657,8,31,87307,31,444,3,31,299527,31,213
15.926,17,14,5407,7,423,2649,1350,3160,7,293,2648,1350,2247
0.441,6,26,7927,16,364,29,1125,3193,10,721,47,1420,4734
62.485,6,7798,7481719,5210,1359,11,1408,7342467,2588,931,24,2801,139252
1772.624,6,180,15480,120,69,14896,69,8940,60,69,30036,69,6540
12.072,6,8,432,4,0,4021,0,228,4,0,4021,0,204
1.4,6,51,21665,28,987,51,1440,15969,23,433,54,1440,5696
63.392,6,63,28372,34,755,78,1460,10460,29,881,2259,1778,17912
274.311,6,30,8153,17,261,17144,467,1725,13,574,5543,2688,6428
1082.858,2,14,448,14,8,83296,8,448,0,0,0,0,0
0.987,6,20,9096,11,499,98,1193,1971,9,1125,92,2279,7125
382.363,6,18,1242,14,180,29412,180,916,4,110,20063,110,326
1794.211,17,144,11520,72,48,25270,48,5472,72,56,25270,56,6048
1.218,6,11,1727,7,100,203,100,384,4,589,317,1152,1343
117.569,6,39,8342,15,130,4847,267,1524,24,292,5111,1420,6818
101.346,6,22,8182,11,201,93,290,1076,11,950,10120,1460,7106
3.171,6,74,63248,47,778,68,1360,7358,27,2739,116,9520,55890
373.423,6,18,1242,14,180,28724,180,916,4,110,20077,110,326
107.567,6,26,6797,12,181,9778,267,1212,14,627,8270,1400,5585
1790.773,17,140,11200,70,48,25953,48,5320,70,56,25953,56,5880
1743.172,6,95,7203,63,38,28115,205,4476,32,33,56225,98,2727
1.935,6,50,19630,26,915,77,1440,13894,24,433,74,1440,5736
1797.398,17,448,39896,403,35,4471,288,25676,45,288,40017,288,14220
1785.546,17,51,2139,50,13,36439,14,2095,1,16,0,16,44
28.629,6,18,3520,9,413,3578,413,1246,9,239,3555,269,2274
1784.317,6,356,22520,208,69,8619,69,12460,148,69,12138,69,10060
0.063,17,2,2386,2,1165,63,1165,2386,0,0,0,0,0
0.135,6,7,364,0,0,0,0,0,7,0,0,0,364
0.033,6,13,3514,7,75,5,75,447,6,1373,6,1448,3067
1796.177,17,142,11360,71,48,25659,48,5396,71,56,25659,56,5964
1.95,6,22,6353,13,309,162,887,2073,9,1305,243,3151,4280
1793.581,17,321,50985,321,130,5604,363,50985,0,0,0,0,0
1798.186,17,449,39928,404,35,4462,288,25708,45,288,40019,288,14220
9.989,17,4,744,2,34,9978,34,124,2,282,9979,282,620
1773.397,6,180,15480,120,69,14902,69,8940,60,69,30049,69,6540
1772.489,6,180,15480,120,69,14894,69,8940,60,69,30034,69,6540
1795.392,17,447,39864,402,35,4477,288,25644,45,288,40018,288,14220
280.176,6,28,7352,13,158,23348,267,1317,15,678,20012,3436,6035
1748.157,6,95,7203,63,38,28196,205,4476,32,33,56377,98,2727
1744.591,2,28,896,28,8,64614,8,896,0,0,0,0,0
0.02,17,2,152,1,48,0,48,76,1,48,0,48,76
360.686,2,3,96,3,8,180343,8,96,0,0,0,0,0
159.328,6,37,9572,12,152,14483,267,1404,25,358,6638,1460,8168
5.155,6,41,13634,23,222,225,540,2364,18,1169,292,3151,11270
0.032,17,2,554,1,30,0,30,58,1,468,0,468,496
57.089,6,32,7765,11,155,13,267,1226,21,334,2854,1997,6539
9.458,6,1620,1495287,1028,1378,9,1408,1459827,592,931,15,2801,35460
300.725,6,35,10133,15,201,21480,486,1438,20,563,4921,1460,8695
12.123,17,20,1420,10,32,1346,32,600,10,54,1346,60,820
0.055,6,10,1806,6,619,10,1079,1483,4,159,17,159,323
2.207,6,12,6338,6,1188,29,1188,1464,6,926,441,1460,4874
0.514,17,4,768,2,39,501,39,134,2,289,18,289,634
1788.545,6,107,8645,70,65,25920,65,5075,37,59,49678,84,3570
240.352,6,46,9020,24,519,10449,1402,5946,22,213,11445,618,3074
1793.842,1,276,15456,276,28,6523,28,15456,0,0,0,0,0
2.895,17,3,174,3,30,1447,30,174,0,0,0,0,0
0.152,17,2,184,1,32,0,32,60,1,96,0,96,124
1791.379,6,362,22898,210,69,8571,69,12678,152,69,11861,69,10220
11.92,17,10,2105,5,47,2976,47,375,5,318,2976,318,1730
4.195,17,4,352,4,60,1398,60,352,0,0,0,0,0
1795.335,17,448,39896,403,35,4466,288,25676,45,288,40018,288,14220
1789.166,6,240,35580,150,302,12007,302,25920,90,83,20102,83,9660
11.654,6,27,7177,13,155,971,267,1306,14,530,895,3417,5871
0.007,6,2,84,1,0,0,0,40,1,0,0,0,44
0.005,17,2,425,1,48,0,48,76,1,321,0,321,349
66.885,6,24,9996,12,660,71,1360,3154,12,1270,6065,3595,6842
1.877,6,31,5939,17,111,117,267,1470,14,780,124,1460,4469
16.943,17,17,6610,8,479,2415,1350,4060,9,255,2113,1350,2550
3.104,17,5,738,4,32,1028,32,240,1,470,0,470,498
1.167,6,204,155086,118,1332,9,1420,147343,86,427,13,1420,7743
1740.786,17,29,30624,29,1028,62170,1028,30624,0,0,0,0,0
1.353,6,47,19223,27,895,52,1360,13647,20,433,62,1360,5576
4.891,6,39,7269,21,218,244,314,3463,18,513,272,1179,3806
369.821,6,25,1651,17,177,23113,177,1117,8,110,9227,110,534
0.037,1,2,163,2,53,37,78,163,0,0,0,0,0
1782.405,17,140,11200,70,48,25831,48,5320,70,56,25831,56,5880
151.669,6,31,4791,19,302,8426,302,3412,12,83,13786,83,1379
5.976,6,160,135752,95,145,63,230,5868,65,2073,93,14080,129884
11.588,6,25,8473,13,275,965,275,1078,12,986,756,1440,7395
1796.1,6,196,17290,103,114,17608,208,12609,93,31,19518,31,4681
1.29,6,50,20186,30,887,44,1360,14565,20,437,58,2715,5621
1789.392,17,142,11360,71,48,25562,48,5396,71,56,25562,56,5964
57.879,17,3,228,3,48,28939,48,228,0,0,0,0,0
1786.45,6,102,8364,68,66,26663,66,4964,34,60,54132,60,3400
38.883,17,44,6468,22,48,1851,48,1672,22,190,1851,308,4796
51.23,6,9,360,9,0,0,0,360,0,0,0,0,0
125.464,6,13,3291,5,92,31366,92,348,8,420,17895,1408,2943
0.96,17,2,122,2,33,960,33,122,0,0,0,0,0
0.988,6,23,6461,13,323,81,955,2141,10,979,109,1731,4320
1.131,17,2,182,1,34,0,34,62,1,92,0,92,120
1633.617,1,8,448,8,28,233373,28,448,0,0,0,0,0
1766.811,1,58,4872,0,0,0,0,0,58,56,30996,56,4872
758.408,6,46,3620,31,44,25274,205,2409,15,36,54159,98,1211
296.793,6,44,7954,18,142,11079,516,1865,26,229,11868,1452,6089
2.316,6,14,2351,8,188,330,245,700,6,703,410,1152,1651
1096.486,17,216,16416,216,48,5099,48,16416,0,0,0,0,0
226.871,6,19,1401,12,64,20624,64,800,7,53,37797,58,601
3.984,17,2,116,2,30,3984,30,116,0,0,0,0,0
22.016,17,4,558,2,36,22011,36,128,2,187,22011,187,430
1786.16,6,102,8228,68,64,26659,64,4896,34,58,54123,58,3332
73.156,6,27,5318,9,341,9144,722,1487,18,222,4289,1408,3831
75.71,6,25,9005,7,154,12618,267,752,18,537,4440,1942,8253
1792.878,1,278,15568,278,28,6472,28,15568,0,0,0,0,0
180.48,2,4,128,4,8,60160,8,128,0,0,0,0,0
1.384,6,47,19155,26,890,55,1440,13539,21,433,59,1440,5616
1795.812,1,128,13568,128,78,14140,78,13568,0,0,0,0,0
4.881,6,23,3867,13,288,391,288,884,10,639,522,853,2983
10.735,6,85,25170,44,568,249,1152,19389,41,413,262,1152,5781
78.099,6,19,4321,9,251,9740,722,1480,10,2329,8658,2329,2841
1790.142,1,133,7448,133,28,13561,28,7448,0,0,0,0,0
33.298,6,54,23353,29,1164,325,1440,17502,25,372,1379,1440,5851
280.03,6,30,7432,13,158,23335,267,1317,17,543,17498,1400,6115
0.039,17,2,253,1,49,0,49,77,1,148,0,148,176
5.994,6,43,8329,21,227,299,314,4022,22,489,273,1179,4307
5.137,6,7,412,3,0,2482,0,164,4,0,1655,0,248
1.223,6,25,8056,12,164,94,267,1288,13,869,86,1408,6768
0.084,6,33,19125,17,127,5,127,1019,16,1438,5,2896,18106
1752.32,6,95,7203,63,38,28263,205,4476,32,33,56518,98,2727
2.863,17,2,144,1,36,0,36,64,1,52,0,52,80
1.32,6,49,18666,27,847,50,1360,13010,22,433,54,1360,5656
1769.914,6,99,9306,66,66,27229,66,5610,33,60,55306,60,3696
0.0,6,2,185,2,105,0,105,185,0,0,0,0,0
1.871,6,10,924,5,283,424,283,551,5,105,424,105,373
2.871,17,3,222,3,46,1435,46,222,0,0,0,0,0
1787.902,6,380,24639,218,74,8239,469,13881,162,69,11104,69,10758
0.343,6,27,8920,13,227,28,547,1592,14,941,25,1408,7328
3.261,17,2,376,1,39,0,39,67,1,281,0,281,309
1796.727,6,288,37858,118,157,15355,1460,18897,170,139,10630,1460,18961
1788.835,17,85,3552,82,14,22084,14,3444,3,8,22005,8,108
1799.697,1,56,4704,56,56,32721,56,4704,0,0,0,0,0
1791.15,17,87,3648,86,14,21072,14,3612,1,8,0,8,36
1789.342,6,360,23163,206,69,8728,69,12380,154,69,11694,69,10783
9.364,17,9,684,9,48,1170,48,684,0,0,0,0,0
102.067,17,4,352,2,60,102066,60,176,2,60,102066,60,176
300.665,6,36,8359,20,283,15824,786,1965,16,522,565,2720,6394
6.062,17,5,320,5,36,1515,36,320,0,0,0,0,0
1700.583,17,13,534,11,14,170040,14,462,2,8,1700407,8,72
0.028,17,4,284,2,32,0,32,120,2,54,13,60,164
369.752,6,21,1419,15,177,26410,177,989,6,110,12239,110,430
0.027,6,3,206,1,0,0,0,40,2,31,0,31,166
1771.684,6,160,12592,96,66,18649,66,7272,64,62,28119,120,5320
1.014,17,2,925,1,548,0,548,576,1,321,0,321,349
1799.651,17,450,39448,405,34,4454,288,25476,45,282,40021,288,13972
0.747,6,62,29573,37,1017,20,1380,20947,25,630,29,3303,8626
1796.568,6,246,22720,122,130,14847,208,16489,124,31,14604,31,6231
1733.284,1,128,13568,128,78,13647,78,13568,0,0,0,0,0
0.028,17,2,180,1,30,0,30,58,1,94,0,94,122
1799.035,17,142,11360,71,48,25700,48,5396,71,56,25700,56,5964
240.069,6,31,27500,23,179,10912,179,1383,8,5138,34287,11264,26117
46.248,17,4,304,4,48,15416,48,304,0,0,0,0,0
1560.494,1,14,784,14,28,120038,28,784,0,0,0,0,0
1795.724,2,24,768,24,8,78074,8,768,0,0,0,0,0
482.591,6,51,6939,25,120,12220,501,2325,26,178,19300,1420,4614
280.373,6,29,7392,13,158,23364,267,1317,16,603,18688,2800,6075
0.828,17,3,404,2,64,801,64,184,1,192,0,192,220
31.175,17,9,684,9,48,3896,48,684,0,0,0,0,0
50.198,6,25,7097,12,155,4563,267,1266,13,589,4182,3426,5831
0.709,6,23,5715,13,158,58,370,1315,10,999,77,1731,4400
0.247,17,2,157,1,31,0,31,59,1,70,0,70,98
300.645,6,37,8431,19,291,16702,786,1957,18,441,500,1440,6474
1.129,6,22,9165,13,367,94,521,1774,9,1152,108,2816,7391
315.906,6,115,35101,60,495,5354,1360,23780,55,314,5847,3289,11321
1787.256,6,102,8296,68,65,26675,65,4930,34,59,54156,59,3366
14.023,6,24,6993,13,275,1168,275,1078,11,910,900,1440,5915
1798.855,17,449,39928,404,35,4463,288,25708,45,288,40021,288,14220
1771.308,6,101,9344,66,65,27250,65,5577,35,59,52094,59,3767
0.481,17,2,384,1,39,0,39,67,1,289,0,289,317
54.287,6,36,8360,18,378,506,786,1886,18,478,3186,2720,6474
0.432,6,22,5040,11,137,43,267,1132,11,692,40,1467,3908
1787.928,6,360,22749,209,69,8595,69,12569,151,69,11919,69,10180
372.884,1,4,240,4,32,124294,32,240,0,0,0,0,0
1706.588,6,187,20269,101,91,17065,721,10664,86,227,14859,1440,9605
88.185,17,2,672,2,308,88185,308,672,0,0,0,0,0
1795.325,17,448,39896,403,35,4465,288,25676,45,288,40019,288,14220
1681.23,17,16,4241,8,30,240175,37,471,8,443,240175,463,3770
240.695,6,11,3413,11,270,24069,383,3413,0,0,0,0,0
5.025,17,4,288,2,36,5006,36,128,2,52,5006,52,160
258.491,6,151,60117,73,736,583,1152,50773,78,388,3353,1179,9344
0.104,6,9,1338,5,549,26,549,753,4,421,29,421,585
17.992,17,4,352,2,60,17991,60,176,2,60,17990,60,176
646.462,6,45,3549,24,52,28107,205,1828,21,34,32310,98,1721
1788.313,6,356,22520,208,69,8639,69,12460,148,69,12165,69,10060
1790.019,17,142,11360,71,48,25571,48,5396,71,56,25571,56,5964
1686.18,17,14,1036,7,30,281026,30,406,7,62,281024,62,630
199.382,17,4,352,2,60,199381,60,176,2,60,199381,60,176
1681.299,17,14,1045,7,30,280213,30,406,7,63,280212,71,639
4.396,6,38,7229,19,218,244,314,3383,19,440,229,1152,3846
1770.528,6,99,9240,66,65,27238,65,5577,33,59,55325,59,3663
0.256,17,4,288,2,36,224,36,128,2,52,35,52,160
1799.938,6,356,22520,208,69,8695,69,12460,148,69,12244,69,10060
1789.369,1,128,7168,128,28,14089,28,7168,0,0,0,0,0
1798.079,17,448,39612,404,35,4461,288,25708,44,288,40948,288,13904
1208.764,17,181,13756,181,48,6715,48,13756,0,0,0,0,0
822.56,6,13159,10635629,6146,410,133,426,355598,7013,1418,110,7040,10280031
9.946,6,133,107029,52,164,195,232,2578,81,1367,121,1430,104451
240.214,6,42,7873,21,163,12010,517,2246,21,503,12010,1502,5627
251.815,2,3,96,3,8,125907,8,96,0,0,0,0,0
76.057,6,14,1043,5,177,19014,177,457,9,110,8668,110,586
57.359,17,25,2872,18,53,3374,288,1468,7,172,7885,288,1404
23.509,17,6,764,3,48,11747,48,228,3,150,11747,308,536
0.467,6,12,1304,6,256,87,256,756,6,304,87,304,548
20.173,6,18,3026,10,229,2241,517,1457,8,381,2880,499,1569
1745.41,6,145,9103,79,49,22377,208,5564,66,31,26846,31,3539
0.005,17,8,2446,8,277,0,316,2446,0,0,0,0,0
2.63,6,17,10679,4,112,876,112,280,13,986,198,1933,10399
430.212,6,1211,1367556,604,187,713,930,39129,607,2224,709,8448,1328427
23.316,17,2,160,2,52,23316,52,160,0,0,0,0,0
285.439,6,44,11611,20,158,15023,267,1597,24,565,12408,1400,10014
1772.218,6,180,15480,120,69,14892,69,8940,60,69,30033,69,6540
108.051,6,34,7866,13,155,9004,267,1306,21,357,5395,3417,6560
39.406,17,22,1672,22,48,1876,48,1672,0,0,0,0,0
6.704,6,65,20438,34,554,203,1152,15771,31,427,215,1152,4667
1781.322,17,142,11360,71,48,25446,48,5396,71,56,25446,56,5964
0.922,6,24,6420,13,299,76,842,2023,11,988,91,1791,4397
1795.696,1,280,15680,280,28,6436,28,15680,0,0,0,0,0
12.502,17,17,8084,8,666,1782,1350,5557,9,252,1558,1350,2527
1778.329,17,73,3060,72,14,25046,14,3024,1,8,0,8,36
0.29,17,2,195,1,44,0,44,72,1,95,0,95,123
1785.865,6,373,26359,216,104,8306,469,15663,157,69,11447,69,10696
19.289,6,3009,2897935,2008,1367,9,1408,2841219,1001,931,19,2801,56716
86.989,6,68,46450,44,1166,2023,1408,38468,24,960,2677,3847,7982
0.447,17,4,288,2,36,414,36,128,2,52,418,52,160
0.079,6,13,3514,7,75,13,75,447,6,1373,15,1448,3067
0.012,17,2,311,1,35,0,35,63,1,220,0,220,248
0.318,6,26,8991,13,252,26,647,1692,13,945,25,1438,7299
1796.246,17,446,39548,402,35,4479,288,25644,44,288,40948,288,13904
180.715,6,236,386320,82,219,2231,703,5805,154,2551,1181,7010,380515
317.056,6,82,20006,43,288,7548,1360,10419,39,364,8339,1360,9587
1.03,17,4,314,2,31,999,31,118,2,70,999,70,196
0.097,17,5,696,3,60,37,60,264,2,188,79,188,432
30.259,6,60,13230,27,126,1163,517,3448,33,474,943,1368,9782
285.784,6,47,5908,24,332,12425,332,3972,23,83,12861,83,1936
300.322,6,48,29593,22,190,14301,444,1913,26,1253,9609,1461,27680
280.009,6,29,7392,13,158,23334,267,1317,16,603,18666,2800,6075
9.157,6,86,26941,44,559,212,1152,20779,42,407,217,1152,6162
39.911,6,20,4448,11,271,3991,515,1259,9,565,4903,1452,3189
102.015,6,922,451795,502,837,203,1152,428792,420,413,242,1179,23003
20.822,6,16,2358,9,210,2602,210,908,7,545,3469,904,1450
0.38,17,2,136,1,32,0,32,60,1,48,0,48,76
1.497,6,51,21310,28,964,55,1460,15614,23,433,59,1460,5696
1799.986,17,142,11360,71,48,25714,48,5396,71,56,25714,56,5964
75.885,6,26,12876,12,493,208,1165,2003,14,1144,5824,1460,10873
4.321,6,38,7229,19,218,240,314,3383,19,513,225,1179,3846
1730.203,6,60,4381,39,33,45531,33,2688,21,31,86500,31,1693
0.209,6,9,1346,5,145,52,145,349,4,833,65,833,997
1772.088,6,180,15480,120,69,14891,69,8940,60,69,30034,69,6540
199.232,17,4,352,2,60,199231,60,176,2,60,199231,60,176
0.813,6,27,5927,13,156,67,267,1462,14,650,57,1420,4465
1799.636,1,46,2576,46,28,39991,28,2576,0,0,0,0,0
1.261,6,41,11378,22,547,60,1360,5842,19,433,59,1360,5536
0.604,6,10,1992,5,288,144,288,508,5,424,78,434,1484
14.71,6,10,636,4,106,4903,106,274,6,90,2911,90,362
0.455,17,3,664,2,146,455,288,348,1,288,0,288,316
280.44,6,30,7432,13,158,23370,267,1317,17,678,17524,2760,6115
240.187,6,53,18430,28,825,8895,1402,15505,25,202,10007,580,2925
280.266,6,29,7392,14,158,21558,267,1357,15,678,20016,3436,6035
1744.935,6,102,7874,65,40,27264,205,4674,37,36,48456,149,3200
1.125,6,16,2894,8,411,160,585,1646,8,396,155,580,1248
0.144,6,46,22244,27,1077,5,1420,17263,19,467,7,1883,4981
9.275,6,28,5533,13,245,772,383,2488,15,487,639,1179,3045
1797.71,17,140,11200,70,48,26053,48,5320,70,56,26053,56,5880
1741.42,1,58,4872,58,56,30551,56,4872,0,0,0,0,0
1796.43,17,448,39896,403,35,4468,288,25676,45,288,40020,288,14220
0.668,17,16,6124,7,424,111,1350,3170,9,300,49,1350,2954
1.186,6,23,7952,12,164,92,267,1288,11,1216,101,3819,6664
23.846,17,2,677,1,300,0,300,328,1,321,0,321,349
0.389,17,4,1314,4,300,129,332,1314,0,0,0,0,0
125.32,6,2,199,2,47,125320,64,199,0,0,0,0,0
240.184,6,32,3891,16,181,16011,595,1930,16,224,16011,580,1961
1799.731,17,449,39928,404,35,4465,288,25708,45,288,40016,288,14220
1786.432,6,102,8296,68,65,26663,65,4930,34,59,54131,59,3366
1783.161,17,83,3480,82,14,22014,14,3444,1,8,0,8,36
316.806,6,67,47132,44,1190,7367,1408,39201,23,961,2799,3847,7931
280.533,6,29,7392,13,158,23377,267,1317,16,678,18697,3456,6075
25.25,6,31,6286,17,286,1578,1314,2405,14,414,209,1380,3881
0.889,17,2,683,1,306,0,306,334,1,321,0,321,349
0.025,17,2,243,1,53,0,53,81,1,134,0,134,162
104.658,6,22,9409,11,158,10465,191,917,11,1128,10446,1440,8492
0.07,17,2,146,1,37,0,37,65,1,53,0,53,81
70.405,6,29,7395,13,155,5867,267,1306,16,453,4693,3417,6089
38.196,17,11,836,11,48,3819,48,836,0,0,0,0,0
0.223,6,23,4494,11,165,22,456,1394,12,493,19,888,3100
1787.794,6,122,14516,80,84,22630,498,6426,42,160,43602,1420,8090
282.803,6,83,13775,34,106,8569,267,4138,49,294,5891,2006,9637
5.103,6,34,6169,18,206,300,314,2784,16,548,323,1179,3385
11.777,6,1872,1627407,1133,1382,10,1420,1593626,739,467,15,1883,33781
1794.489,17,144,11520,72,48,25274,48,5472,72,56,25274,56,6048
1786.871,6,102,8364,68,66,26669,66,4964,34,60,54144,60,3400
0.113,17,2,199,1,42,0,42,70,1,101,0,101,129
0.569,6,6,402,1,0,0,0,40,5,26,138,26,362
8.009,2,2,64,2,8,8009,8,64,0,0,0,0,0
0.527,17,3,451,2,39,427,39,134,1,289,0,289,317
1786.347,6,115,9123,70,65,25889,65,5140,45,59,40595,59,3983
1787.461,6,102,8228,68,64,26678,64,4896,34,58,54163,58,3332
0.213,6,46,22555,27,1098,8,1420,17574,19,467,11,2840,4981
212.83,17,4,352,2,60,212829,60,176,2,60,212829,60,176
4.388,1,5,420,5,56,1097,56,420,0,0,0,0,0
271.583,17,98,25382,98,231,2799,388,25382,0,0,0,0,0
1.724,6,33,12228,18,525,101,1360,3414,15,820,109,1380,8814
14.683,17,3,228,3,48,7341,48,228,0,0,0,0,0
0.055,17,2,322,1,36,0,36,64,1,230,0,230,258
1774.425,6,182,15698,120,69,14911,69,8940,62,69,29083,69,6758
1.26,6,44,10157,23,440,57,1360,4496,21,437,54,2715,5661
92.377,6,15,1657,9,177,11547,177,1007,6,110,18419,110,650
1795.362,17,449,39928,404,35,4454,288,25708,45,288,40016,288,14220
1741.477,17,30,20190,30,645,60050,645,20190,0,0,0,0,0
0.074,17,2,194,1,61,0,61,89,1,77,0,77,105
2.88,17,2,124,2,34,2880,34,124,0,0,0,0,0
0.005,17,2,335,1,48,0,48,76,1,231,0,231,259
280.22,6,28,7352,13,158,23351,267,1317,15,678,20010,3436,6035
0.34,17,2,178,1,29,0,29,57,1,93,0,93,121
0.501,6,22,7345,13,334,41,663,2021,9,1209,58,1946,5324
14.787,17,6,456,6,48,2957,48,456,0,0,0,0,0
1693.089,1,8,448,8,28,241869,28,448,0,0,0,0,0
33.746,6,30,5042,15,154,2410,722,1860,15,399,2396,2026,3182
0.002,6,3,120,2,0,2,0,80,1,0,0,0,40
427.623,17,13,4368,13,308,35635,308,4368,0,0,0,0,0
1799.836,1,73,6132,73,56,24997,56,6132,0,0,0,0,0
104.438,6,30,8344,14,326,8030,517,2053,16,778,6959,1418,6291
273.592,1,6,336,6,28,54718,28,336,0,0,0,0,0
1168.023,6,90,9972,53,77,22461,721,4781,37,112,30215,1448,5191
0.254,6,9,1002,5,213,63,213,417,4,421,71,421,585
4.149,17,4,304,4,48,1383,48,304,0,0,0,0,0
0.027,6,13,3876,7,124,4,124,496,6,1530,5,1612,3380
1785.527,6,83,4420,42,26,43549,26,2236,41,26,44601,26,2184
1786.513,6,102,8296,68,65,26664,65,4930,34,59,54134,59,3366
0.03,17,2,362,1,32,0,32,60,1,274,0,274,302
882.074,2,7,224,7,8,147012,8,224,0,0,0,0,0
1775.009,1,58,4872,58,56,31140,56,4872,0,0,0,0,0
12.527,6,2288,2165446,1442,1422,8,1448,2116754,846,776,14,1448,48692
772.277,17,14,1064,14,48,59405,48,1064,0,0,0,0,0
307.32,17,6,528,3,60,153659,60,264,3,60,153659,60,264
1773.611,6,180,15480,120,69,14904,69,8940,60,69,30053,69,6540
0.076,6,9,1343,5,145,19,145,349,4,830,15,830,994
187.557,6,23,7582,7,267,396,502,1086,16,450,12497,1420,6496
1738.78,6,92,6668,60,31,29470,31,4062,32,31,56089,31,2606
0.507,17,2,144,1,36,0,36,64,1,52,0,52,80
0.085,17,4,588,2,48,76,48,152,2,190,76,308,436
0.002,17,2,550,2,247,2,247,550,0,0,0,0,0
8.236,6,14,1251,6,222,1645,222,688,8,231,1175,231,563
8.925,6,4,240,4,0,0,0,240,0,0,0,0,0
118.303,17,4,240,2,32,118302,32,120,2,32,118301,32,120
162.366,17,6,528,3,48,81177,48,228,3,72,81177,72,300
0.975,6,26,9657,14,306,75,866,1817,12,1469,73,3930,7840
0.007,17,2,152,1,48,0,48,76,1,48,0,48,76
1772.121,6,180,15480,120,69,14891,69,8940,60,69,30032,69,6540
1745.953,6,97,7307,63,38,28160,205,4476,34,33,52897,98,2831
0.324,6,6,264,6,0,0,0,264,0,0,0,0,0
0.325,6,27,9086,13,262,27,690,1735,14,945,24,1408,7351
4.988,17,4,558,2,36,4982,36,128,2,187,4982,187,430
1751.459,6,95,7203,63,38,28249,205,4476,32,33,56486,98,2727
1771.921,6,103,9448,66,65,27260,65,5577,37,59,49216,59,3871
0.141,17,2,672,2,308,141,308,672,0,0,0,0,0
0.003,6,4,208,0,0,0,0,0,4,0,0,0,208
0.836,6,20,9166,10,121,92,121,649,10,1141,92,1448,8517
9.85,2,2,64,2,8,9850,8,64,0,0,0,0,0
497.589,6,53,7274,30,111,14061,722,3245,23,188,22609,1408,4029
0.344,17,14,7750,7,747,57,1350,5425,7,304,45,1350,2325
124.156,6,35,7975,13,155,10346,267,1306,22,340,5911,3417,6669
1798.505,17,448,39896,403,35,4473,288,25676,45,288,40018,288,14220
0.09,6,3,136,2,0,90,0,88,1,0,0,0,48
300.799,6,35,15718,20,195,15831,431,1888,15,1304,4941,4754,13830
121.9,1,14,784,14,28,9376,28,784,0,0,0,0,0
0.022,17,4,420,2,33,16,33,122,2,121,11,145,298
375.91,6,18,1242,14,180,28916,180,916,4,110,20059,110,326
0.02,17,2,224,1,52,0,52,80,1,116,0,116,144
4.699,6,29,5026,15,195,335,293,2169,14,458,342,1179,2857
5.016,17,4,288,2,36,4999,36,128,2,52,4997,52,160
0.779,17,12,5930,6,584,155,1350,3677,6,347,121,1350,2253
101.803,6,34,24827,19,884,31,1360,6109,15,1810,7262,5440,18718
300.568,6,18,1227,6,177,60079,177,497,12,110,27308,110,730
1772.355,6,180,15480,120,69,14893,69,8940,60,69,30036,69,6540
1729.922,6,64,4694,42,33,42193,33,2868,22,31,82358,31,1826
1608.969,6,51,13548,30,400,55481,1460,6048,21,443,80438,1934,7500
0.527,17,3,234,2,39,30,39,134,1,72,0,72,100
1745.802,6,95,7203,63,38,28158,205,4476,32,33,56306,98,2727
240.284,6,43,8998,21,523,12013,1408,5808,22,226,11441,618,3190
0.08,6,10,1514,5,503,20,503,771,5,475,20,475,743
1783.809,6,364,25392,212,100,8453,469,14896,152,69,11813,69,10496
0.02,17,2,334,1,39,0,39,67,1,239,0,239,267
1770.832,6,101,9410,66,66,27243,66,5610,35,60,52080,60,3800
363.574,1,8,448,8,28,51939,28,448,0,0,0,0,0
1.459,6,40,9928,21,440,72,1360,4392,19,529,69,4075,5536
107.071,1,4,224,4,28,35690,28,224,0,0,0,0,0
0.399,6,6,324,4,0,133,0,216,2,0,204,0,108
1794.836,6,773,52517,386,31,4661,31,26375,387,31,4649,31,26142
21.384,17,17,6934,9,482,2669,1350,4590,8,265,3050,1350,2344
9.436,6,35,10507,19,418,524,611,2070,16,648,551,2148,8437
0.208,6,19,4286,11,165,20,456,1394,8,493,28,888,2892
280.225,6,29,7392,13,158,23352,267,1317,16,603,18678,1400,6075
0.051,6,2,100,1,0,0,0,60,1,0,0,0,40
156.791,6,49,13127,17,131,9799,267,1742,32,504,5053,1460,11385
1742.373,1,59,4956,59,56,30040,56,4956,0,0,0,0,0
280.533,6,31,7813,14,158,21579,267,1357,17,577,17532,2036,6456
280.526,6,29,7392,13,158,23377,267,1317,16,678,18694,2085,6075
1787.085,6,362,22898,210,69,8550,69,12678,152,69,11834,69,10220
1.361,6,51,19467,29,897,48,1460,13766,22,400,56,1460,5701
280.199,6,29,7392,13,158,23349,267,1317,16,603,18679,1400,6075
0.004,17,3,370,2,34,0,34,124,1,218,0,218,246
0.147,6,2,92,1,0,0,0,52,1,0,0,0,40
15.215,6,24,6993,13,275,1267,275,1078,11,910,1020,1440,5915
31.289,6,41,9714,20,289,1646,721,3417,21,681,1513,2840,6297
5.371,6,42,7405,22,218,255,314,3503,20,516,269,1179,3902
144.461,17,4,300,2,47,144459,47,150,2,47,144460,47,150
5.202,17,5,320,5,36,1300,36,320,0,0,0,0,0
1797.9,6,248,24228,152,75,11906,267,11006,96,135,18925,3417,13222
281.619,6,32,7512,14,158,21663,267,1357,18,603,16565,2236,6155
0.92,6,15,2638,8,288,131,288,640,7,568,98,853,1998
1.717,6,38,8266,19,321,95,1164,2718,19,476,83,2715,5548
16.005,17,20,5586,10,303,1775,1350,3312,10,199,1774,1350,2274
15.828,17,20,2940,10,48,1757,48,760,10,190,1757,308,2180
540.471,2,5,160,5,8,135117,8,160,0,0,0,0,0
475.466,1,3,168,3,28,237733,28,168,0,0,0,0,0
0.824,6,32,7846,18,399,48,1360,2784,14,449,49,1360,5062
31.553,6,7,308,1,0,0,0,44,6,0,5868,0,264
0.486,17,3,451,2,39,243,39,134,1,289,0,289,317
1781.753,17,140,11200,70,48,25822,48,5320,70,56,25822,56,5880
1740.938,17,30,20190,30,645,60032,645,20190,0,0,0,0,0
132.902,1,5,666,5,105,33225,173,666,0,0,0,0,0
0.555,6,23,8691,10,278,61,813,1664,13,906,45,2816,7027
1797.53,6,1487,2162705,438,125,4113,334,28441,1049,2130,1715,11216,2134264
0.436,6,4,298,2,69,1,69,149,2,69,436,69,149
57.915,6,33,8016,20,151,3048,318,1967,13,894,4825,3077,6049
1772.008,6,180,15480,120,69,14890,69,8940,60,69,30032,69,6540
37.968,17,57,31263,27,542,1458,1350,15403,30,500,1307,1350,15860
299.627,6,6,364,4,31,99875,31,222,2,31,299611,31,142
1775.978,6,104,8376,68,65,26507,65,4930,36,59,50739,59,3446
808.869,1,26,1456,26,28,32354,28,1456,0,0,0,0,0
0.007,17,2,560,1,44,0,44,72,1,460,0,460,488
1778.047,17,73,3060,72,14,25042,14,3024,1,8,0,8,36
0.936,6,10,1687,7,100,156,100,384,3,1179,332,1179,1303
1783.933,6,102,8296,68,65,26625,65,4930,34,59,54056,59,3366
1797.333,6,368,25759,214,99,8438,469,15045,154,69,11745,69,10714
0.068,17,4,284,2,32,31,32,120,2,54,39,60,164
5.892,6,41,7365,23,218,267,314,3543,18,516,330,1179,3822
1.589,17,42,18455,22,670,75,1350,15372,20,126,78,1350,3083
240.166,6,51,14810,27,664,9236,1402,12036,24,189,10441,580,2774
77.484,17,17800,11809413,13815,772,5,1108,11052911,3985,161,19,744,756502
42.784,17,4,1344,4,308,14261,308,1344,0,0,0,0,0
4.092,17,5,340,5,40,1023,40,340,0,0,0,0,0
1740.587,17,30,31170,30,1011,60020,1011,31170,0,0,0,0,0
1769.675,6,102,9473,67,65,26813,65,5694,35,59,52045,59,3779
252.231,6,47,14062,30,354,8697,1360,6910,17,717,15753,3494,7152
280.417,6,29,7392,13,158,23368,267,1317,16,603,18693,2800,6075
1775.728,6,300,29050,125,68,14319,659,10708,175,108,10204,2720,18342
7.68,6,33,8167,16,333,50,685,1672,17,446,469,3488,6495
16.409,6,26,4766,12,153,1491,293,1558,14,440,1241,1179,3208
0.048,17,2,251,1,36,0,36,64,1,159,0,159,187
21.704,17,4,824,2,48,21690,48,152,2,308,21690,308,672
1794.698,17,144,11520,72,48,25277,48,5472,72,56,25277,56,6048
0.393,6,9,3635,3,227,107,227,367,6,1005,42,1460,3268
185.257,1,19,1064,19,28,10292,28,1064,0,0,0,0,0
1789.385,6,427,46016,213,152,8439,208,36495,214,31,8400,31,9521
33.804,6,31,5095,15,154,2414,722,1859,16,342,2240,1448,3236
1790.105,6,320,82472,192,716,9372,723,55842,128,156,14095,269,26630
0.5,17,8,2758,8,316,71,355,2758,0,0,0,0,0
1740.471,17,29,6815,29,207,62159,207,6815,0,0,0,0,0
10.595,17,4,532,2,41,10582,41,138,2,169,10581,169,394
281.242,6,29,7392,13,158,23436,267,1317,16,603,18748,2036,6075
1796.414,17,395,116367,395,266,4559,422,116367,0,0,0,0,0
74.509,6,116,92952,78,1250,967,1408,82855,38,811,2007,3847,10097
2.569,17,2,677,1,300,0,300,328,1,321,0,321,349
146.301,6,23,1675,17,43,9143,43,1315,6,0,29259,0,360
88.717,17,4,1344,4,308,29572,308,1344,0,0,0,0,0
289.778,6,30,7432,13,158,24148,267,1317,17,603,18106,2076,6115
1772.343,6,180,15480,120,69,14893,69,8940,60,69,30032,69,6540
1796.954,17,449,39928,404,35,4458,288,25708,45,288,40011,288,14220
76.124,17,8,704,4,48,25372,48,304,4,72,25371,72,400
1.051,6,9,1002,5,213,262,213,417,4,421,217,421,585
1797.486,1,342,28728,342,56,5271,56,28728,0,0,0,0,0
1.298,6,48,19611,27,920,49,1360,13995,21,476,56,2715,5616
1753.977,6,184,11305,92,47,19274,208,6695,92,31,19271,31,4610
1.609,17,2,170,1,37,0,37,65,1,77,0,77,105
0.017,17,2,438,1,33,0,33,61,1,349,0,349,377
1799.276,1,16,896,16,28,119951,28,896,0,0,0,0,0
4.499,6,8,440,5,0,1124,0,268,3,0,2214,0,172
0.128,17,2,251,1,36,0,36,64,1,159,0,159,187
1783.332,17,83,3480,82,14,22016,14,3444,1,8,0,8,36
1772.683,6,180,15480,120,69,14896,69,8940,60,69,30037,69,6540
369.798,6,27,1767,18,177,21752,177,1181,9,110,8923,110,586
185.454,6,28,6519,11,217,6308,502,1312,17,323,11585,1420,5207
11.431,6,27,11433,13,275,952,275,1078,14,1087,796,1440,10355
300.831,6,75,55717,46,1296,6685,1440,47782,29,913,1115,1440,7935
264.53,17,4,352,2,60,264529,60,176,2,60,264529,60,176
1795.449,17,448,39896,403,35,4466,288,25676,45,288,40021,288,14220
0.012,6,2,287,2,103,12,138,287,0,0,0,0,0
522.659,6,9,546,6,31,104531,31,333,3,31,261324,31,213
25.804,6,47,13098,22,186,1228,722,2562,25,733,1066,1380,10536
0.062,17,4,588,2,48,53,48,152,2,190,51,308,436
1783.813,6,347,22022,203,69,8830,69,12191,144,69,12474,69,9831
25.885,6,38,8578,18,410,510,882,1994,20,444,1354,2720,6584
0.382,6,6,324,4,0,127,0,216,2,0,192,0,108
6.251,17,4,588,2,48,6244,48,152,2,190,6241,308,436
1511.776,2,12,384,12,8,137434,8,384,0,0,0,0,0
0.005,6,2,149,1,0,0,0,40,1,69,0,69,109
0.488,6,24,6041,13,108,40,147,959,11,773,47,1608,5082
0.583,6,27,9155,13,282,48,769,1814,14,943,41,1368,7341
1770.746,1,58,4872,0,0,0,0,0,58,56,31065,56,4872
1775.814,6,181,15589,120,69,14922,69,8940,61,69,29575,69,6649
35.67,17,6,1236,3,48,17742,48,228,3,308,17677,308,1008
1.44,6,48,18739,26,867,57,1188,13492,22,341,64,524,5247
1624.789,1,8,448,8,28,232112,28,448,0,0,0,0,0
1681.313,1,15,840,15,28,120093,28,840,0,0,0,0,0
0.443,17,2,152,1,48,0,48,76,1,48,0,48,76
1783.81,6,366,25003,213,94,8414,469,14536,153,69,11735,69,10467
240.191,6,33,10169,17,624,15011,1418,7753,16,197,16011,580,2416
1773.025,6,180,15480,120,69,14899,69,8940,60,69,30049,69,6540
240.247,6,54,19471,29,839,8579,1418,16630,25,191,10009,580,2841
0.409,6,8,768,4,226,133,226,442,4,110,73,110,326
21.944,1,4,224,4,28,7314,28,224,0,0,0,0,0
1784.468,6,106,8456,68,65,26633,65,4930,38,59,48225,59,3526
11.44,6,27,11355,13,275,953,275,1078,14,1078,804,1414,10277
1.033,17,2,312,2,128,1033,128,312,0,0,0,0,0
11.248,6,1820,1551321,1094,1363,10,1380,1518039,726,421,15,1923,33282
1783.905,6,106,8456,68,65,26625,65,4930,38,59,48211,59,3526
148.103,6,25,11058,12,433,72,990,1823,13,967,12331,1460,9235
2.534,17,22,7399,9,336,316,1350,3282,13,288,138,1350,4117
1794.755,1,184,10304,184,28,9807,28,10304,0,0,0,0,0
14.123,17,4,352,2,60,14122,60,176,2,60,14122,60,176
0.41,17,17,7523,8,533,58,1350,4492,9,308,44,1350,3031
1742.513,6,94,7151,62,38,28565,205,4424,32,33,56200,98,2727
7.42,6,6,312,6,0,0,0,312,0,0,0,0,0
1745.479,6,95,7203,63,38,28152,205,4476,32,33,56292,98,2727
240.211,6,57,20833,31,857,8006,1418,17915,26,194,9608,580,2918
0.254,6,9,1343,5,145,63,145,349,4,830,32,830,994
62.309,6,74,52846,47,1207,1354,1368,44706,27,961,2387,3887,8140
191.284,6,10,562,3,106,95630,106,234,7,0,31879,0,328
4.684,6,37,7189,19,218,260,314,3383,18,513,260,1179,3806
29.298,6,3341,3174767,2128,1410,13,1448,3102563,1213,776,24,1448,72204
5.405,6,35,8321,18,175,307,721,2126,17,612,326,2840,6195
1771.602,6,99,9240,66,65,27255,65,5577,33,59,55358,59,3663
0.528,6,22,7255,12,318,48,600,1906,10,964,52,1471,5349
1785.787,17,87,3648,86,14,21009,14,3612,1,8,0,8,36
1795.986,17,448,39896,403,35,4467,288,25676,45,288,40019,288,14220
133.672,17,4,352,2,60,133671,60,176,2,60,133670,60,176
474.476,6,49,8264,22,127,16256,516,2155,27,228,18245,1452,6109
165.984,6,30,9745,16,514,55,954,2779,14,639,12757,4080,6966
0.634,17,15,8505,8,706,90,1350,5872,7,348,96,1350,2633
1795.938,6,365,24494,212,87,8511,469,14096,153,69,11812,69,10398
3.226,17,35,29851,18,819,189,1350,15255,17,830,179,1350,14596
280.471,6,30,7432,13,158,23372,267,1317,17,543,17516,1400,6115
1780.458,6,115,6900,64,26,28259,26,3782,51,26,35607,26,3118
0.277,17,2,152,1,48,0,48,76,1,48,0,48,76
378.149,2,3,96,3,8,189074,8,96,0,0,0,0,0
0.123,6,9,1346,5,145,30,145,349,4,833,36,833,997
2.465,6,29,6175,15,338,176,1314,2294,14,368,188,1420,3881
0.033,6,10,583,5,43,8,43,311,5,0,7,0,272
241.355,6,52,7558,21,259,12065,585,3954,31,178,8044,580,3604
21.842,6,27,6387,15,117,1560,159,1389,12,727,1984,1418,4998
0.209,17,2,157,1,31,0,31,59,1,70,0,70,98
0.401,6,29,7521,17,306,24,1088,2827,12,701,35,1728,4694
1777.426,17,140,11200,70,48,25759,48,5320,70,56,25759,56,5880
0.378,17,8,2750,8,315,54,354,2750,0,0,0,0,0
1794.827,17,300,64899,300,188,6002,361,64899,0,0,0,0,0
0.552,6,27,7296,13,155,46,267,1301,14,543,36,1400,5995
0.83,17,2,178,1,29,0,29,57,1,93,0,93,121
0.981,17,4,580,2,40,949,40,136,2,194,937,194,444
0.015,17,2,409,1,58,0,58,86,1,295,0,295,323
299.504,6,6,364,4,31,99834,31,222,2,31,299497,31,142
1739.219,6,126,9145,70,31,25206,31,4885,56,31,31621,31,4260
74.901,6,17,700,8,0,5149,0,324,9,0,9361,0,376
0.911,6,10,1687,7,100,151,100,384,3,1179,312,1179,1303
1787.872,6,102,8228,68,64,26684,64,4896,34,58,54175,58,3332
1786.35,6,104,8444,68,66,26661,66,4964,36,60,51035,60,3480
20.185,17,3,234,3,50,10092,50,234,0,0,0,0,0
1772.803,6,180,15480,120,69,14897,69,8940,60,69,30043,69,6540
17.661,17,17,6496,8,484,2518,1350,4096,9,238,2203,1350,2400
1769.143,6,33,4903,21,241,88457,241,3503,12,92,160813,92,1400
1682.709,17,14,1036,7,30,280440,30,406,7,62,280441,62,630
10.992,6,20,4402,11,275,1099,275,998,9,758,776,1420,3404
280.215,6,27,7312,12,158,25474,267,1277,15,678,20012,2045,6035
1780.664,17,139,11116,70,48,25806,48,5320,69,56,26186,56,5796
782.012,2,7,224,7,8,130335,8,224,0,0,0,0,0
0.012,17,2,435,1,44,0,44,72,1,335,0,335,363
0.423,6,21,7203,11,318,40,600,1854,10,1205,45,1851,5349
4.078,17,5,290,5,30,1019,30,290,0,0,0,0,0
13.824,17,50,14564,22,283,656,1350,6862,28,247,510,1350,7702
1263.362,2,12,384,12,8,114851,8,384,0,0,0,0,0
1750.476,17,12,498,11,14,175047,14,462,1,8,0,8,36
5.17,6,39,7269,19,218,287,314,3383,20,513,257,1179,3886
0.035,6,3,802,1,0,0,0,40,2,341,10,341,762
49.313,6,6914,8120722,3086,688,15,1368,179181,3828,2029,12,15048,7941541
36.438,6,12,496,6,0,7284,0,244,6,0,7284,0,252
1796.1,6,246,40545,121,932,14967,1418,28833,125,51,14484,84,11712
10.002,17,3,433,2,37,9989,37,130,1,275,0,275,303
249.361,6,39,15532,20,1319,13123,1418,14243,19,293,13852,293,1289
0.004,17,2,351,1,33,0,33,61,1,262,0,262,290
32.422,6,44,9012,23,151,1465,721,2746,21,677,1612,1414,6266
5.002,17,4,288,2,36,5002,36,128,2,52,5002,52,160
4.002,1,5,420,5,56,1000,56,420,0,0,0,0,0
1790.553,6,395,24485,215,69,8367,69,12809,180,49,10002,69,11676
15.729,17,12,6110,6,619,3132,1350,3885,6,342,3135,1350,2225
1057.199,2,13,416,13,8,88099,8,416,0,0,0,0,0
150.42,17,101,22717,67,40,2279,41,4595,34,505,4508,505,18122
1032.63,17,8,330,7,14,172105,14,294,1,8,0,8,36
87.399,6,36,8455,18,410,517,882,1982,18,478,5132,2720,6473
96.281,6,34,7871,13,155,8023,267,1306,21,357,4813,3417,6565
388.678,17,8,2688,8,308,55525,308,2688,0,0,0,0,0
75.293,6,32,5333,16,148,5019,722,2019,16,413,5006,1408,3314
61.281,6,13,1272,7,180,10213,180,732,6,110,12172,110,540
1787.905,6,358,22669,209,69,8595,69,12569,149,69,12080,69,10100
560.532,17,6,444,3,30,280260,30,174,3,62,280258,62,270
1.273,6,11,1727,7,100,212,100,384,4,589,336,1152,1343
23.421,17,43,12365,17,262,1462,1350,4933,26,257,935,1350,7432
175.262,17,2,72,1,8,0,8,36,1,8,0,8,36
8.723,6,1107,968016,637,1433,13,1448,936388,470,776,18,1448,31628
1770.908,6,103,9448,66,65,27244,65,5577,37,59,49188,59,3871
2.765,6,14,2351,8,188,395,245,700,6,703,502,1152,1651
1.431,6,50,20858,28,936,53,1440,15202,22,433,59,1440,5656
5.34,6,8385,9098814,2562,170,2,170,139434,5823,1487,0,7040,8959380
371.028,6,23,1511,14,177,28540,177,925,9,110,9876,110,586
37.7,6,45,8801,22,371,806,766,2097,23,481,1707,3488,6704
1.952,17,23,6722,9,252,244,1350,2524,14,271,123,1350,4198
51.168,1,4,224,4,28,17056,28,224,0,0,0,0,0
1797.103,6,367,25650,214,99,8437,469,15045,153,69,11822,69,10605
1796.115,17,449,39928,404,35,4456,288,25708,45,288,40016,288,14220
8.055,2,2,64,2,8,8055,8,64,0,0,0,0,0
190.024,6,55,8705,34,304,5758,304,6332,21,83,9458,83,2373
4.608,6,37,7189,19,218,256,314,3383,18,513,254,1179,3806
381.07,6,18,1242,14,180,29313,180,916,4,110,20060,110,326
211.679,6,32,8952,14,158,16283,267,1357,18,624,12448,1400,7595
1749.578,17,12,498,11,14,174957,14,462,1,8,0,8,36
1786.218,6,106,8586,70,65,25887,65,5140,36,59,51028,59,3446
113.493,6,63,14283,29,444,4053,1402,10432,34,111,3322,580,3851
0.162,6,6,328,4,0,54,0,216,2,0,103,0,112
0.016,17,2,162,1,36,0,36,64,1,70,0,70,98
0.213,17,11,5150,5,468,53,1350,2482,6,416,30,1350,2668
19.479,6,3089,2941423,1975,1410,9,1448,2878819,1114,776,17,1448,62604
5.212,1,3,168,3,28,2606,28,168,0,0,0,0,0
490.788,1,7,921,7,103,81798,176,921,0,0,0,0,0
1.043,6,732,1095057,126,550,8,1396,8762,606,1752,1,6980,1086295
0.172,6,24,7678,12,178,15,340,1345,12,1140,15,1648,6333
96.602,6,888,444160,489,841,197,1152,423393,399,436,242,1179,20767
598.159,17,44,3504,24,48,26006,48,1824,20,56,26081,56,1680
280.296,6,28,7352,12,158,25481,267,1277,16,603,18680,1400,6075
15.024,17,4,4400,4,1072,5008,1072,4400,0,0,0,0,0
240.243,6,59,19642,29,833,8579,1418,16523,30,193,8283,580,3119
0.588,6,14,1745,7,288,69,288,600,7,426,70,434,1145
1795.838,6,356,22520,208,69,8675,69,12460,148,69,12216,69,10060
166.548,6,29,7392,13,158,13879,267,1317,16,603,11100,2036,6075
0.443,6,10,968,5,256,107,256,460,5,304,107,304,508
240.351,6,31,8912,14,158,18488,267,1357,17,687,15017,1781,7555
27.441,17,3,228,3,48,13720,48,228,0,0,0,0,0
2.198,17,30,6868,13,235,180,1350,3431,17,174,135,1350,3437
9.642,17,34,10292,17,266,600,1350,5004,17,283,600,1350,5288
6.289,6,1388,1243467,854,1377,7,1408,1211035,534,931,11,2816,32432
53.936,17,3,992,3,302,26968,308,992,0,0,0,0,0
0.043,6,7,7928,1,0,0,0,40,6,1262,0,1438,7888
38.06,17,22,1672,22,48,1812,48,1672,0,0,0,0,0
0.498,17,3,451,2,39,9,39,134,1,289,0,289,317
1747.252,6,96,7286,63,38,28181,205,4476,33,33,54592,98,2810
301.824,6,66,36935,35,479,8877,1306,3780,31,1212,1299,2474,33155
11.347,6,92,27149,46,558,252,1152,20827,46,407,246,1152,6322
1786.865,6,119,14049,76,83,23824,516,6038,43,161,42541,1452,8011
0.82,6,28,10734,15,554,58,1448,3558,13,721,66,1448,7176
1747.938,6,95,7203,63,38,28192,205,4476,32,33,56375,98,2727
4.373,6,37,7189,19,218,242,314,3383,18,513,241,1179,3806
1783.328,6,122,14415,77,82,23464,516,6144,45,153,40527,1452,8271
2.515,6,16,2280,9,322,314,580,1108,7,396,395,580,1172
319.29,6,9,710,6,106,63858,106,566,3,0,1517,0,144
10.701,6,20,4442,11,275,1070,275,998,9,768,740,1440,3444
1744.104,6,139,8655,77,45,22948,208,5276,62,31,28588,31,3379
1788.312,17,83,3480,82,14,22077,14,3444,1,8,0,8,36
1788.044,6,359,24999,203,94,8851,469,14067,156,69,11533,69,10932
0.02,17,2,172,1,50,0,50,78,1,66,0,66,94
252.036,2,4,128,4,8,84012,8,128,0,0,0,0,0
0.052,6,12,3702,6,170,6,170,490,6,964,8,1448,3212
251.152,6,55,33314,34,1128,7610,1448,25467,21,749,3070,1448,7847
155.674,17,4,304,2,48,155672,64,152,2,48,155673,64,152
25.493,17,47,16304,23,484,1157,1350,11788,24,160,1106,1350,4516
0.249,6,22,4467,11,165,24,456,1394,11,498,24,888,3073
1795.955,17,444,38916,402,35,4478,288,25644,42,288,42946,288,13272
1754.985,6,98,7421,64,38,27856,205,4528,34,33,53175,98,2893
3.18,17,4,644,2,33,2010,33,122,2,233,0,233,522
1764.018,2,15,480,15,8,126001,8,480,0,0,0,0,0
1781.726,6,110,13982,53,141,34263,517,3803,57,653,31815,2414,10179
2.478,17,4,518,3,39,978,39,201,1,289,0,289,317
0.54,17,2,167,1,39,0,39,67,1,72,0,72,100
0.037,6,7,423,4,43,3,43,259,3,0,16,0,164
254.62,6,6,280,2,0,254620,0,88,4,0,2351,0,192
1591.928,1,8,848,8,78,227418,78,848,0,0,0,0,0
61.849,6,74,47776,43,1199,1472,1448,39434,31,746,2053,1448,8342
1.451,6,40,9928,21,440,72,1360,4392,19,476,70,2715,5536
0.373,6,10,968,5,256,89,256,460,5,304,89,304,508
504.619,2,4,128,4,8,168206,8,128,0,0,0,0,0
1772.293,6,180,15480,120,69,14893,69,8940,60,69,30031,69,6540
1761.72,1,110,6160,110,28,16162,28,6160,0,0,0,0,0
1797.533,17,448,39896,403,35,4471,288,25676,45,288,40016,288,14220
0.366,17,3,1170,3,362,183,362,1170,0,0,0,0,0
2.891,17,402,413725,85,160,34,1350,16001,317,1226,9,1350,397724
31.926,6,100,72147,48,120,679,283,2929,52,1385,625,2816,69218
176.462,6,20,8238,11,525,81,1236,2047,9,1163,22035,3151,6191
6.285,2,2,64,2,8,6285,8,64,0,0,0,0,0
1740.888,6,87,6322,58,31,30541,31,3915,29,31,62174,31,2407
1695.947,6,36,8745,22,346,80688,1192,4036,14,345,130457,1591,4709
126.368,2,2,64,2,8,126368,8,64,0,0,0,0,0
7.846,17,4,1344,4,308,2615,308,1344,0,0,0,0,0
28.677,6,21,10050,10,275,3186,275,958,11,1440,2706,1440,9092
1756.845,6,4095,3956337,1377,147,1276,924,80008,2718,1412,646,2836,3876329
452.61,6,79,4954,46,69,10057,69,2737,33,69,14144,69,2217
2.633,6,30,10428,18,373,154,851,1843,12,1012,231,1420,8585
280.42,6,30,7432,13,158,23368,267,1317,17,543,17513,1400,6115
1789.289,17,142,11360,71,48,25561,48,5396,71,56,25561,56,5964
176.095,17,4,530,2,36,176090,36,128,2,173,176089,187,402
5.251,6,39,7269,21,218,262,314,3463,18,513,292,1179,3806
1784.17,6,417,24981,208,69,8619,69,12460,209,34,8577,48,12521
100.019,6,19,1319,13,43,8334,43,959,6,0,20003,0,360
11.664,6,1857,1611668,1121,1383,10,1420,1578007,736,467,15,1883,33661
0.856,6,3,151,1,0,0,0,40,2,31,1,31,111
0.817,6,30,9070,18,554,48,1360,4088,12,561,57,2744,4982
153.867,17,4,1344,4,308,51289,308,1344,0,0,0,0,0
0.155,6,9,1338,5,549,38,549,753,4,421,43,421,585
0.13,17,4,1201,4,272,43,294,1201,0,0,0,0,0
132.907,6,38,8500,13,159,11075,267,1642,25,292,5533,1460,6858
39.549,17,22,1936,11,48,3954,48,836,11,72,3954,72,1100
1799.611,17,450,39448,405,34,4454,288,25476,45,282,40018,288,13972
69.056,6,35,8415,18,410,521,882,1982,17,574,4305,4848,6433
0.231,6,4,1037,2,0,231,0,104,2,853,24,853,933
271.839,6,28,7352,12,158,24712,267,1277,16,603,18118,1400,6075
0.06,17,2,237,1,72,0,72,100,1,109,0,109,137
280.252,6,27,7312,12,158,25477,267,1277,15,678,20014,2045,6035
20.679,6,20,3130,12,183,1879,517,1561,8,381,2949,499,1569
317.032,6,72,19536,35,384,9324,1360,9891,37,339,8802,1360,9645
280.423,6,30,7432,13,158,23368,267,1317,17,603,17524,2076,6115
3.159,2,2,64,2,8,3159,8,64,0,0,0,0,0
313.996,6,28,6515,11,216,5629,501,1310,17,322,19619,1420,5205
300.588,6,44,8904,22,286,14313,766,2116,22,346,606,2720,6788
15.322,6,23,6565,10,133,1702,267,941,13,637,1266,1460,5624
0.15,17,8,2446,8,277,21,316,2446,0,0,0,0,0
0.02,6,2,80,1,0,0,0,40,1,0,0,0,40
377.065,6,23,1535,16,177,25137,177,1053,7,110,10413,110,482
0.0,6,2,166,0,0,0,0,0,2,31,0,31,166
316.026,17,8,2756,8,316,45146,376,2756,0,0,0,0,0
1.902,17,2,148,2,46,1902,46,148,0,0,0,0,0
243.65,6,32,8952,14,158,18742,267,1357,18,624,14329,1400,7595
31.186,17,36,5292,18,48,1833,48,1368,18,190,1833,308,3924
325.912,6,148,93666,80,914,4125,1438,21539,68,1370,3951,2392,72127
280.537,6,30,7432,13,158,23378,267,1317,17,603,17531,2760,6115
300.913,6,43,14360,24,867,13083,1460,8798,19,435,482,2567,5562
1.056,17,6,420,3,32,524,32,180,3,52,523,60,240
1.289,6,50,19008,29,867,46,1360,13347,21,437,56,2715,5661
1134.051,2,8,256,8,8,162007,8,256,0,0,0,0,0
0.253,6,3,156,1,0,0,0,52,2,0,71,0,104
11.34,6,19,6745,10,275,1260,275,958,9,1353,1386,1440,5787
1798.867,1,58,4872,58,56,31559,56,4872,0,0,0,0,0
0.044,17,4,420,2,33,1,33,122,2,121,10,145,298
0.008,17,2,904,1,300,0,300,328,1,548,0,548,576
36.983,17,22,1936,11,48,3697,48,836,11,72,3696,72,1100
21.795,6,7,388,4,0,7265,0,216,3,0,10840,0,172
1743.362,6,97,7307,63,38,28118,205,4476,34,33,52817,98,2831
4.427,17,29,10824,12,447,402,1350,5705,17,273,206,1350,5119
1791.55,17,180,14040,180,50,10008,50,14040,0,0,0,0,0
0.245,6,44,37544,20,180,12,250,1590,24,1577,6,4344,35954
20.268,6,17,2316,10,189,2252,517,1298,7,323,3371,499,1018
359.479,17,155,40275,69,471,5286,1350,34482,86,39,4133,336,5793
1799.468,1,57,4788,0,0,0,0,0,57,56,32133,56,4788
788.574,17,41,1721,39,13,20751,14,1633,2,16,4999,16,88
1793.496,6,445,33920,230,93,7831,1189,15108,215,79,8380,1420,18812
300.783,6,14,1306,8,177,42944,177,778,6,110,60122,110,528
63.441,6,31,8981,14,158,4880,267,1357,17,694,3953,2036,7624
0.153,6,10,1371,5,126,38,126,394,5,356,38,380,977
0.036,17,3,244,2,32,0,32,120,1,96,0,96,124
90.147,6,28,7599,6,165,2502,267,909,22,322,4292,1420,6690
0.053,17,2,306,1,33,0,33,61,1,217,0,217,245
68.51,6,27,7177,13,155,5709,267,1306,14,530,5269,3417,5871
0.205,6,28,7336,13,155,17,267,1301,15,543,13,1400,6035
254.793,17,6,528,3,60,127395,60,264,3,60,127395,60,264
1769.598,6,99,9306,66,66,27224,66,5610,33,60,55297,60,3696
0.012,17,2,586,1,46,0,46,74,1,484,0,484,512
286.198,6,36,8706,19,290,15899,517,1625,17,775,17886,1418,7081
1756.193,6,106,6322,60,27,29765,27,3525,46,27,39025,27,2797
0.057,17,2,188,1,33,0,33,61,1,99,0,99,127
129.976,17,4,240,2,32,129975,32,120,2,32,129975,32,120
6.004,17,4,712,2,43,5999,43,142,2,257,5999,265,570
1741.494,1,15,840,15,28,124392,28,840,0,0,0,0,0
363.128,6,18,1242,14,180,27932,180,916,4,110,20054,110,326
1793.623,6,377,26326,217,97,8303,469,15441,160,69,11280,69,10885
240.112,6,42,5349,22,235,11433,752,2815,20,165,12637,487,2534
0.57,6,23,7406,13,335,47,668,2026,10,1210,58,1946,5380
5.968,17,31,18912,12,450,542,1350,5742,19,665,274,1350,13170
0.627,17,6,2117,6,324,125,354,2117,0,0,0,0,0
1772.319,6,182,15629,121,69,14769,69,8980,61,69,29530,69,6649
122.118,6,29,8832,14,158,9393,267,1357,15,858,8718,3436,7475
93.879,6,91,61781,55,662,1737,1007,9488,36,1626,2681,2939,52293
8.697,6,1627,1495372,1028,1377,8,1408,1459560,599,931,14,2816,35812
1745.83,6,97,7307,63,38,28158,205,4476,34,33,52892,98,2831
1786.101,6,102,8364,68,66,26658,66,4964,34,60,54121,60,3400
17.425,17,14,6337,7,560,2899,1350,4116,7,289,2899,1350,2221
0.018,17,2,152,1,48,0,48,76,1,48,0,48,76
1772.692,6,180,15480,120,69,14896,69,8940,60,69,30037,69,6540
1.241,17,3,1173,3,363,620,363,1173,0,0,0,0,0
1.312,6,48,19075,27,881,50,1360,13459,21,476,56,2715,5616
129.376,6,20,4508,11,211,12937,722,1625,9,803,16146,2329,2883
30.558,6,25,5988,14,217,2350,502,1432,11,586,3046,1420,4556
3.916,17,5,290,5,30,979,30,290,0,0,0,0,0
240.251,6,32,13129,16,705,16016,1408,4381,16,878,16016,1578,8748
1.397,6,39,9888,20,502,73,1460,4352,19,433,66,1460,5536
285.081,1,4,326,4,53,95027,78,326,0,0,0,0,0
1786.73,6,104,8308,68,64,26667,64,4896,36,58,51047,58,3412
240.283,6,46,12872,23,512,10921,1402,5813,23,585,10921,2426,7059
1681.335,17,14,1045,7,30,280219,30,406,7,63,280218,71,639
1783.721,17,83,3480,82,14,22021,14,3444,1,8,0,8,36
11.231,6,14,3739,6,275,2246,275,523,8,1440,1326,1440,3216
0.158,6,2,80,1,0,0,0,40,1,0,0,0,40
61.678,6,63,41393,39,1161,1623,1448,33393,24,749,2671,1448,8000
157.327,17,4,352,2,60,157326,60,176,2,60,157325,60,176
53.902,6,27,7177,13,155,4491,267,1306,14,530,4145,3417,5871
1799.189,6,364,25910,212,98,8526,981,14582,152,82,11914,485,11328
63.629,6,8017,7688431,5352,1359,11,1408,7545187,2665,776,23,1408,143244
280.238,6,27,7312,13,158,23353,267,1317,14,775,21553,4836,5995
1777.815,6,104,8444,68,66,26534,66,4964,36,60,50791,60,3480
0.0,17,1,1033,1,1005,0,1005,1033,0,0,0,0,0
1796.351,17,769,46366,769,32,2338,37,46366,0,0,0,0,0
209.021,17,4,240,2,32,209020,32,120,2,32,209020,32,120
1.332,6,47,19619,27,923,51,1360,14043,20,529,60,4075,5576
0.061,6,14,3448,8,106,8,106,530,6,866,10,1448,2918
39.14,6,22,6956,7,154,6523,267,752,15,559,2784,4837,6204
1782.306,6,365,25432,213,100,8407,469,14936,152,69,11803,69,10496
1165.775,6,119,10211,79,69,14945,69,5920,40,69,29891,69,4291
5.023,17,4,558,2,36,5009,36,128,2,187,5009,187,430
1783.062,6,114,9083,72,65,25113,65,5220,42,59,43487,59,3863
195.888,17,4,240,2,32,195887,32,120,2,32,195887,32,120
121.935,6,121,89054,74,1286,1670,1448,78496,47,675,1903,1448,10558
16.13,6,23,4854,10,309,1792,722,1752,13,342,1328,1448,3102
3.822,6,33,6660,16,159,254,267,2075,17,650,229,1452,4585
315.514,6,8,506,8,31,45073,31,506,0,0,0,0,0
1794.228,17,180,11520,180,36,10023,36,11520,0,0,0,0,0
4.932,17,13,11405,5,573,1233,1350,3009,8,1021,588,1350,8396
87.227,1,57,1596,57,0,0,0,1596,0,0,0,0,0
1788.447,17,760,45844,760,32,2356,37,45844,0,0,0,0,0
240.197,6,54,17707,29,791,8578,1418,14970,25,178,10007,580,2737
1796.03,17,448,39384,403,35,4467,288,25412,45,282,40019,288,13972
0.222,6,3,199,1,31,0,31,83,2,0,222,0,116
90.872,6,9,515,5,43,22718,43,299,4,0,30270,0,216
38.718,17,4,240,2,32,38717,32,120,2,32,38717,32,120
0.937,6,12,3434,6,125,187,125,445,6,889,187,1448,2989
12.861,6,30,7432,13,158,1071,267,1317,17,543,800,1400,6115
121.107,6,17,10535,4,188,283,245,540,13,1052,10072,1152,9995
0.464,6,22,7300,12,325,41,626,1932,10,806,50,1448,5368
38.103,17,22,1936,11,48,3809,48,836,11,72,3809,72,1100
15.732,17,20,8044,10,529,1743,1350,5573,10,219,1743,1350,2471
0.011,6,23,13189,12,125,1,125,793,11,1688,1,3012,12396
1401.29,17,12,3294,6,30,280255,30,348,6,463,280255,463,2946
10.774,6,18,4266,10,275,1197,275,958,8,992,856,1440,3308
9.939,17,4,834,2,44,9934,44,144,2,317,9934,317,690
1752.014,6,99,7650,65,40,27375,205,4678,34,35,53083,108,2972
280.8,6,28,7352,13,158,23400,267,1317,15,678,20049,2800,6035
315.011,6,415,354178,271,1328,1166,1360,341784,144,236,160,1360,12394
3.69,6,33,6129,17,206,230,314,2744,16,456,228,1152,3385
14.751,6,22,5962,11,275,1475,275,998,11,902,1206,1440,4964
3.491,17,2,656,2,300,3491,300,656,0,0,0,0,0
1.458,6,24,8004,12,164,114,267,1288,12,1014,113,2491,6716
1726.424,17,359,59667,359,138,4822,363,59667,0,0,0,0,0
1623.22,1,7,392,7,28,270536,28,392,0,0,0,0,0
0.366,6,14,1733,7,288,57,288,588,7,284,33,434,1145
1770.021,6,124,11410,76,66,23600,66,6466,48,60,37658,60,4944
0.047,17,2,588,1,39,0,39,67,1,493,0,493,521
202.806,17,4,352,2,60,202805,60,176,2,60,202805,60,176
0.023,6,18,6108,10,88,2,88,556,8,1305,3,1880,5552
1770.356,6,99,9240,66,65,27236,65,5577,33,59,55320,59,3663
5.083,6,39,7269,19,218,282,314,3383,20,513,251,1179,3886
6.242,1,4,424,4,78,2080,78,424,0,0,0,0,0
8.227,17,6,528,3,48,4107,48,228,3,72,4107,72,300
7.041,6,528,467696,337,1323,20,1368,453100,191,776,35,2736,14596
1779.287,17,140,11200,70,48,25786,48,5320,70,56,25786,56,5880
6.988,6,567,488436,355,1309,19,1368,472748,212,931,32,2736,15688
1786.985,6,106,8320,68,63,26671,63,4862,38,57,48294,57,3458
1795.926,1,100,10600,100,78,18140,78,10600,0,0,0,0,0
24.029,6,9,488,5,0,6007,0,280,4,0,2325,0,208
0.044,17,2,279,1,36,0,36,64,1,187,0,187,215
9.514,6,69,25562,34,958,288,1440,14883,35,543,270,1440,10679
201.14,6,31,9493,15,441,14367,1380,3438,16,745,13408,1380,6055
1799.091,17,448,39896,403,35,4475,288,25676,45,288,40017,288,14220
192.835,17,4,304,4,48,64278,48,304,0,0,0,0,0
1.236,6,51,21423,29,910,44,1360,15767,22,476,50,2720,5656
280.209,6,28,7352,13,158,23350,267,1317,15,678,20011,2045,6035
0.505,6,2,1175,1,0,0,0,40,1,1095,0,1095,1135
201.341,1,42,3528,42,56,4910,56,3528,0,0,0,0,0
14.689,6,1830,1694975,1187,1374,12,1380,1662109,643,421,22,1923,32866
280.289,6,28,7352,12,158,25480,267,1277,16,603,18684,1400,6075
1795.989,17,448,39612,404,35,4456,288,25708,44,288,40952,288,13904
0.014,17,2,553,1,36,0,36,64,1,461,0,461,489
1782.826,1,59,4956,59,56,30738,56,4956,0,0,0,0,0
3.868,17,4,244,4,33,1289,33,244,0,0,0,0,0
0.009,17,2,362,1,53,0,53,81,1,253,0,253,281
299.529,6,6,364,4,31,99843,31,222,2,31,299515,31,142
858.039,6,108,8117,41,68,20701,293,3838,67,48,13000,78,4279
1.898,17,20,5180,20,231,99,388,5180,0,0,0,0,0
3.177,6,12,507,7,0,529,0,288,5,7,751,7,219
1.651,6,73,53626,44,1291,38,1440,46213,29,842,52,1440,7413
1740.024,17,28,1596,28,29,64445,29,1596,0,0,0,0,0
280.461,6,30,7432,13,158,23371,267,1317,17,603,17526,2760,6115
240.203,6,55,20072,29,830,8578,1418,17300,26,176,9607,580,2772
1733.243,6,65,4705,41,33,43331,33,2825,24,31,75349,31,1880
1782.292,6,106,8644,70,66,25830,66,5044,36,60,50919,60,3600
23.591,6,16,2358,10,210,2619,210,960,6,545,4717,904,1398
218.739,17,4,240,2,32,218738,32,120,2,32,218738,32,120
1211.268,6,105,10846,57,74,21629,721,4988,48,93,24102,1448,5858
454.191,6,83,5661,42,69,11077,69,2715,41,68,11354,69,2946
1771.93,6,102,9396,66,65,27260,65,5577,36,59,50624,59,3819
1794.007,17,80,3354,79,14,23000,14,3318,1,8,0,8,36
280.194,6,30,7432,13,158,23349,267,1317,17,543,17510,1300,6115
179.561,6,69,11731,28,190,4562,1189,3600,41,270,4486,1460,8131
842.289,2,8,256,8,8,120327,8,256,0,0,0,0,0
1787.677,6,4456,4244780,1658,128,1078,332,106607,2798,1464,639,5608,4138173
40.201,6,39,8610,16,333,56,685,1720,23,331,1819,3488,6890
252.699,2,2,64,2,8,252699,8,64,0,0,0,0,0
290.861,6,76,15836,37,789,8079,1418,11489,39,88,7653,580,4347
1.371,6,2,80,1,0,0,0,40,1,0,0,0,40
2.055,17,20,5180,20,231,108,388,5180,0,0,0,0,0
1788.776,6,111,9132,64,66,28393,66,4672,47,60,38877,60,4460
29.282,2,2,64,2,8,29282,8,64,0,0,0,0,0
378.803,2,3,96,3,8,189401,8,96,0,0,0,0,0
2.086,6,30,10405,18,367,122,833,1825,12,1012,181,1420,8580
286.034,17,4,240,2,32,286033,32,120,2,32,286033,32,120
280.214,6,30,7432,13,158,23351,267,1317,17,543,17510,1400,6115
1.578,6,48,19257,27,894,60,1360,13641,21,476,68,2715,5616
1729.22,6,62,4504,40,33,44338,33,2740,22,31,82334,31,1764
153.805,17,4,352,2,60,153804,60,176,2,60,153804,60,176
1770.359,1,58,4872,58,56,31058,56,4872,0,0,0,0,0
2.983,17,2,154,1,33,0,33,61,1,65,0,65,93
3.438,6,25,9733,14,386,264,844,1752,11,1254,330,4080,7981
302.743,6,35,6511,18,286,17808,1314,2445,17,307,18920,1420,4066
71.457,6,150,133413,97,430,744,647,6462,53,2483,1317,9856,126951
280.042,6,31,7472,14,158,21541,267,1357,17,543,17499,1400,6115
1771.138,6,107,9804,68,65,26434,65,5758,39,59,46606,59,4046
280.241,6,29,7392,13,158,23353,267,1317,16,603,18677,2036,6075
1681.672,17,14,1036,7,30,280273,30,406,7,62,280271,62,630
1798.543,17,449,39928,404,35,4462,288,25708,45,288,40019,288,14220
360.33,6,71,18696,45,514,8186,628,13662,26,184,14406,195,5034
0.142,17,2,194,1,61,0,61,89,1,77,0,77,105
0.938,6,28,8160,15,222,54,540,1964,13,944,63,1591,6196
121.157,6,43,9850,21,631,492,1360,4075,22,348,5760,2667,5775
26.012,6,38,8557,18,191,1530,721,2253,20,550,1318,1414,6304
280.007,6,28,7352,13,158,23333,267,1317,15,678,20000,2045,6035
0.047,6,11,819,6,186,8,186,506,5,45,10,45,313
0.198,6,43,19382,25,1032,8,1420,14441,18,467,11,1883,4941
60.47,6,13,6248,7,174,10078,174,458,6,1386,323,1452,5790
1784.558,6,104,8376,68,65,26635,65,4930,36,59,50984,59,3446
0.013,17,2,491,1,29,0,29,57,1,406,0,406,434
1789.223,17,140,11200,70,48,25930,48,5320,70,56,25930,56,5880
0.081,17,2,166,1,39,0,39,67,1,71,0,71,99
66.996,6,27,7177,13,155,5583,267,1306,14,530,5152,2840,5871
7.813,6,21,4374,12,213,710,597,1689,9,552,952,1767,2685
26.821,6,22,4442,11,324,2682,585,1878,11,488,2662,580,2564
3.928,17,5,295,5,31,982,31,295,0,0,0,0,0
1666.298,1,7,392,7,28,277716,28,392,0,0,0,0,0
265.405,17,30,2640,15,48,18956,48,1140,15,72,18956,72,1500
0.136,6,10,1380,6,145,27,145,389,4,827,43,827,991
1787.91,6,366,23196,212,69,8473,69,12896,154,69,11685,69,10300
1770.623,6,99,9306,66,66,27240,66,5610,33,60,55329,60,3696
1740.029,6,89,6457,59,31,30000,31,3998,30,31,60000,31,2459
0.357,6,2,80,1,0,0,0,40,1,0,0,0,40
1785.318,1,147,8232,147,28,12228,28,8232,0,0,0,0,0
368.451,6,14,926,8,106,52634,106,646,6,0,73687,0,280
0.386,6,28,9150,13,261,32,683,1728,15,829,27,1408,7422
0.002,6,2,1488,1,0,0,0,40,1,1396,0,1396,1448
142.194,6,25,9470,13,519,56,948,2664,12,789,12916,4080,6806
0.492,6,24,7458,13,335,41,668,2026,11,968,46,1946,5432
215.124,6,30,8872,14,158,16548,267,1357,16,763,14340,3436,7515
0.025,17,2,186,1,29,0,29,57,1,101,0,101,129
0.465,6,23,7394,13,335,38,668,2026,10,1210,50,1906,5368
0.411,6,13,1693,7,288,64,288,588,6,426,46,434,1105
18.767,17,4,824,2,48,18754,48,152,2,308,18751,308,672
31.626,6,6,360,0,0,0,0,0,6,0,0,0,360
1628.299,1,31,3286,31,78,54276,78,3286,0,0,0,0,0
1794.544,1,57,4788,0,0,0,0,0,57,56,32045,56,4788
9.962,6,97,33080,51,617,199,1152,26758,46,447,215,1179,6322
0.039,17,2,283,1,31,0,31,59,1,196,0,196,224
0.498,17,3,451,2,39,304,39,134,1,289,0,289,317
1785.818,1,58,4872,0,0,0,0,0,58,56,31330,56,4872
3.09,17,4,304,2,48,3067,48,152,2,48,3070,48,152
6.743,6,24,5754,13,158,559,370,1315,11,998,671,1691,4439
4.575,6,38,7229,20,218,240,314,3423,18,513,253,1179,3806
0.115,17,2,162,1,45,0,45,73,1,61,0,61,89
0.942,6,10,1687,7,100,157,100,384,3,1179,338,1179,1303
1741.257,17,30,31680,30,1028,60043,1028,31680,0,0,0,0,0
56.524,6,24,1759,18,43,3324,43,1399,6,0,6200,0,360
40.311,2,4,128,4,8,13437,8,128,0,0,0,0,0
1787.166,6,102,8296,68,65,26674,65,4930,34,59,54153,59,3366
1794.582,17,144,11520,72,48,25275,48,5472,72,56,25275,56,6048
604.6,1,21,1176,21,28,30230,28,1176,0,0,0,0,0
30.185,17,45,10774,19,219,1675,1350,4696,26,205,1206,1350,6078
54.064,6,30,7432,13,158,4505,267,1317,17,603,3374,2076,6115
61.597,6,36,15843,22,796,2933,1368,9117,14,748,4716,2519,6726
0.027,17,2,167,1,31,0,31,59,1,80,0,80,108
1.021,17,4,644,2,33,1010,33,122,2,233,1,233,522
1795.958,17,449,39928,404,35,4456,288,25708,45,288,40016,288,14220
1783.654,6,284,36615,115,145,15645,1360,17294,169,147,10616,2720,19321
1797.558,1,248,13888,248,28,7277,28,13888,0,0,0,0,0
0.058,6,20,9188,10,127,6,127,655,10,1143,6,1448,8533
1700.709,17,13,534,11,14,170053,14,462,2,8,1700530,8,72
2.998,17,4,232,4,30,999,30,232,0,0,0,0,0
3.203,17,25,8800,10,354,355,1350,3829,15,303,121,1350,4971
19.298,6,376,311388,221,1345,87,1368,298142,155,749,123,1368,13246
1775.114,6,180,15480,120,69,14916,69,8940,60,69,30085,69,6540
105.735,6,25,9903,12,410,54,922,1742,13,847,8800,1360,8161
319.852,6,27,6463,12,220,5010,516,1366,15,374,22838,1452,5097
280.194,6,29,7392,13,158,23349,267,1317,16,603,18677,2036,6075
124.098,1,3,641,3,185,62049,351,641,0,0,0,0,0
0.031,17,2,157,1,31,0,31,59,1,70,0,70,98
3.985,17,4,244,4,33,1328,33,244,0,0,0,0,0
113.04,17,4,352,2,60,113038,60,176,2,60,113039,60,176
0.317,17,2,169,1,34,0,34,62,1,79,0,79,107
401.357,17,56,4634,52,30,7868,37,3030,4,373,113873,463,1604
0.122,17,8,2446,8,277,17,316,2446,0,0,0,0,0
23.183,6,18,1407,10,222,2574,222,848,8,231,3310,231,559
0.072,6,9,1002,5,213,18,213,417,4,421,17,421,585
0.119,17,2,245,1,32,0,32,60,1,157,0,157,185
105.84,6,23,8040,12,377,61,796,1699,11,841,10571,2720,6341
1786.391,6,104,8435,69,65,26270,65,4970,35,59,52538,59,3465
0.082,17,4,350,2,34,1,34,124,2,85,31,91,226
1775.052,6,180,15480,120,69,14916,69,8940,60,69,30080,69,6540
1793.428,17,142,11360,71,48,25620,48,5396,71,56,25620,56,5964
280.508,6,29,7392,13,158,23375,267,1317,16,678,18696,2760,6075
1782.731,6,354,22440,207,69,8654,69,12420,147,69,12210,69,10020
1638.825,2,11,352,11,8,163882,8,352,0,0,0,0,0
1744.726,2,16,512,16,8,116315,8,512,0,0,0,0,0
5.363,17,18,7541,9,522,666,1350,4954,9,259,666,1350,2587
1.048,17,5,716,3,64,523,64,276,2,192,926,192,440
1116.697,17,100,7600,100,48,11279,48,7600,0,0,0,0,0
5.101,17,73,51377,28,277,188,1350,8546,45,923,114,1350,42831
1786.787,6,106,8456,68,65,26668,65,4930,38,59,48289,59,3526
1785.654,6,103,8464,68,66,26651,66,4964,35,60,52516,60,3500
1246.296,6,120,7492,59,49,21484,208,4277,61,31,20768,31,3215
52.602,17,8,704,4,48,17531,48,304,4,72,17531,72,400
0.905,17,7,2445,7,321,150,355,2445,0,0,0,0,0
1.498,6,24,8004,12,164,116,267,1288,12,1014,116,2491,6716
0.945,17,28,16195,15,714,65,1350,11133,13,361,76,1350,5062
20.419,6,21,3182,12,183,1856,517,1561,9,381,2551,499,1621
1787.905,6,375,28522,218,126,8239,469,17481,157,69,11460,69,11041
1662.422,1,8,448,8,28,237488,28,448,0,0,0,0,0
1800.0,6,220,18866,81,74,22499,335,8365,139,69,13043,1062,10501
62.034,6,37,9714,19,254,3443,517,2304,18,497,3646,2736,7410
31.86,6,6,360,0,0,0,0,0,6,0,0,0,360
1744.185,6,95,7203,63,38,28132,205,4476,32,33,56252,98,2727
51.307,6,20,4349,11,301,5130,517,2089,9,594,6399,1049,2260
1789.574,6,356,22520,208,69,8645,69,12460,148,69,12173,69,10060
1681.278,17,14,3827,7,30,280212,30,406,7,460,280212,463,3421
0.059,17,2,214,1,39,0,39,67,1,119,0,119,147
82.642,17,4,352,2,60,82641,60,176,2,60,82641,60,176
0.049,17,4,284,2,32,36,32,120,2,54,36,60,164
20.433,6,25,6284,14,117,1571,159,1337,11,727,2042,1418,4947
1788.295,6,359,22709,209,69,8597,69,12569,150,69,12001,69,10140
1766.491,6,220,21057,110,79,16206,721,10217,110,178,16204,1440,10840
1.458,6,49,19138,27,883,56,1440,13482,22,433,60,1440,5656
1681.826,17,14,1036,7,30,280298,30,406,7,62,280299,62,630
20.119,6,22,5469,12,107,1829,159,1074,10,966,2234,1668,4395
504.049,2,4,128,4,8,168016,8,128,0,0,0,0,0
0.613,6,20,7196,13,325,51,626,1984,7,1210,96,1946,5212
64.165,6,25,10609,12,380,100,832,1665,13,934,5335,1460,8944
70.825,6,23,10009,12,531,57,1360,2637,11,1384,7069,3934,7372
816.583,6,158,11610,77,75,10744,86,4486,81,39,10207,63,7124
0.75,6,25,8769,11,265,74,764,1679,14,794,57,1408,7090
1740.66,17,29,6815,29,207,62166,207,6815,0,0,0,0,0
3.149,6,16,2087,9,279,393,279,1301,7,191,456,272,786
0.43,17,25,16677,15,762,28,1350,11863,10,453,44,1350,4814
363.883,6,56,15189,34,504,11026,1360,9507,22,435,519,2667,5682
1789.299,17,142,11360,71,48,25561,48,5396,71,56,25561,56,5964
0.891,17,4,368,2,32,890,32,120,2,96,0,96,248
0.036,17,2,214,1,39,0,39,67,1,119,0,119,147
4.726,6,38,7229,19,218,262,314,3383,19,513,248,1179,3846
17.048,17,29,22120,16,792,1134,1350,13126,13,663,1417,1350,8994
0.034,17,2,672,2,308,34,308,672,0,0,0,0,0
0.42,6,10,767,5,186,104,186,454,5,45,104,45,313
0.534,6,3,168,2,0,284,0,116,1,0,0,0,52
280.557,6,29,7392,13,158,23379,267,1317,16,603,18700,2076,6075
1771.594,6,101,9344,66,65,27255,65,5577,35,59,52102,59,3767
1781.792,6,365,25432,213,100,8404,469,14936,152,69,11799,69,10496
0.341,6,3,182,2,31,341,31,111,1,31,0,31,71
167.725,6,9,515,5,43,41931,43,299,4,0,55887,0,216
1791.974,1,76,6384,76,56,23892,56,6384,0,0,0,0,0
1792.005,6,362,22898,210,69,8574,69,12678,152,69,11865,69,10220
1.297,17,6,552,3,32,501,32,180,3,96,503,96,372
3.077,17,29,19632,15,756,217,1350,11774,14,533,234,1350,7858
240.199,6,54,17347,29,763,8578,1408,14496,25,192,10008,580,2851
280.05,6,28,7352,12,158,25459,267,1277,16,603,18665,1400,6075
1786.227,6,356,22520,208,69,8629,69,12460,148,69,12149,69,10060
1700.395,17,12,498,11,14,170039,14,462,1,8,0,8,36
3.681,6,32,8952,15,158,262,267,1397,17,687,226,1781,7555
1652.586,1,8,448,8,28,236083,28,448,0,0,0,0,0
1765.006,6,73,27502,38,241,47702,241,3785,35,637,51906,1634,23717
1682.83,17,14,1036,7,30,280461,30,406,7,62,280462,62,630
0.022,17,2,554,1,30,0,30,58,1,468,0,468,496
0.072,6,9,1346,5,145,18,145,349,4,833,15,833,997
1795.921,6,197,19195,127,99,14253,469,11565,70,69,26020,69,7630
1775.033,17,140,11200,70,48,25724,48,5320,70,56,25724,56,5880
504.632,2,4,128,4,8,168210,8,128,0,0,0,0,0
62.305,6,52,31010,32,1077,2009,1448,23215,20,749,3264,1448,7795
373.658,6,25,1651,17,177,23353,177,1117,8,110,9231,110,534
230.846,6,122,89589,76,1251,3077,1408,79075,46,737,1617,2439,10514
1.305,17,21,14534,8,448,186,1350,3810,13,796,72,1350,10724
300.805,6,35,16512,20,195,15831,431,1864,15,1260,4763,2804,14648
123.295,6,58,37953,38,1127,3332,1408,30171,20,841,3233,2439,7782
1787.45,6,102,8228,68,64,26678,64,4896,34,58,54161,58,3332
116.967,17,4,352,2,60,116966,60,176,2,60,116966,60,176
599.039,6,10,586,6,31,119807,31,333,4,31,199675,31,253
1786.873,6,356,22520,208,69,8632,69,12460,148,69,12155,69,10060
245.369,17,4,240,2,32,245368,32,120,2,32,245368,32,120
195.314,17,4,352,2,60,195312,60,176,2,60,195313,60,176
1783.325,17,84,3516,82,14,22013,14,3444,2,8,1783131,8,72
0.475,6,26,8890,13,232,39,569,1614,13,941,37,1438,7276
53.96,6,121,49819,63,921,870,1360,36665,58,428,943,1360,13154
0.458,17,10,3607,10,332,50,359,3607,0,0,0,0,0
1745.147,6,95,7203,63,38,28147,205,4476,32,33,56283,98,2727
11.52,2,4,128,4,8,3840,8,128,0,0,0,0,0
1739.302,6,87,6322,58,31,30514,31,3915,29,31,62117,31,2407
1787.504,6,104,8376,68,65,26679,65,4930,36,59,51063,59,3446
1796.443,6,84,4960,43,32,42771,36,2334,41,241,44909,456,2626
1795.019,6,240,46440,150,483,12047,483,36780,90,83,20168,83,9660
43.222,17,4,240,2,32,43221,32,120,2,32,43221,32,120
1084.94,6,101,9106,57,64,19373,66,4819,44,59,25176,60,4287
0.128,6,101,140107,42,281,3,872,3882,59,2465,2,7040,136225
0.047,6,2,111,1,0,0,0,40,1,31,0,31,71
1783.241,17,83,3480,82,14,22015,14,3444,1,8,0,8,36
206.023,17,4,352,2,60,206022,60,176,2,60,206022,60,176
0.34,17,13,5399,6,481,66,1350,3058,7,306,49,1350,2341
138.072,17,4,530,2,36,138068,36,128,2,173,138068,187,402
1636.683,6,114,7292,66,45,25179,208,4845,48,31,21312,31,2447
0.153,6,9,1242,5,453,38,453,657,4,421,47,421,585
1795.933,17,448,39612,404,35,4456,288,25708,44,288,40953,288,13904
1793.645,17,288,63815,288,193,6249,356,63815,0,0,0,0,0
3.009,17,2,1430,2,687,3009,687,1430,0,0,0,0,0
1741.354,6,87,6322,58,31,30550,31,3915,29,31,62190,31,2407
3.03,17,8,688,4,47,1009,47,300,4,69,1008,75,388
25.201,6,9,500,5,0,6300,0,268,4,0,8394,0,232
1795.21,17,449,39928,404,35,4454,288,25708,45,288,40017,288,14220
15.252,6,27,4867,13,154,1252,722,1767,14,394,1134,1448,3100
1.895,17,2,144,1,36,0,36,64,1,52,0,52,80
240.219,6,54,19309,29,825,8578,1418,16375,25,203,10008,580,2934
16.241,6,2439,2281626,1584,1365,10,1408,2232502,855,931,18,2816,49124
33.49,6,31,5140,15,180,2392,722,1859,16,305,2220,2026,3281
0.774,6,29,12068,14,476,59,1360,2499,15,895,45,2720,9569
3.141,17,2,334,1,39,0,39,67,1,239,0,239,267
8.238,6,19,9695,9,275,1029,275,643,10,1440,816,1440,9052
175.015,17,42,2344,19,25,9723,29,1011,23,29,7927,40,1333
270.346,17,4,240,2,32,270339,32,120,2,32,270345,32,120
75.886,6,31,7613,12,155,30,267,1266,19,398,4215,3417,6347
1771.426,6,99,9240,66,65,27252,65,5577,33,59,55353,59,3663
1629.868,1,8,448,8,28,232838,28,448,0,0,0,0,0
5.508,6,40,7325,21,218,275,314,3463,19,516,291,1179,3862
67.262,6,41,10146,20,727,563,1360,4504,21,435,3354,2667,5642
8.215,17,6,456,6,48,1643,48,456,0,0,0,0,0
0.958,6,23,6595,13,350,79,1088,2275,10,979,105,1731,4320
2.113,6,49,19272,28,954,78,1460,13611,21,437,91,2615,5661
3.551,6,2,88,2,0,0,0,88,0,0,0,0,0
1796.767,6,367,25650,214,99,8435,469,15045,153,69,11818,69,10605
280.347,6,28,7352,12,158,25486,267,1277,16,543,18682,1400,6075
759.79,17,10,2594,5,31,189946,37,297,5,431,189946,463,2297
1758.426,6,117,9096,72,44,24766,205,5338,45,34,39959,98,3758
15.991,6,6,2105,0,0,0,0,0,6,373,3198,373,2105
119.909,17,4,240,2,32,119908,32,120,2,32,119908,32,120
26.307,17,4,240,2,32,26306,32,120,2,32,26307,32,120
585.671,6,67,9360,33,95,18300,517,2834,34,295,17746,1418,6526
372.246,6,18,1242,14,180,28634,180,916,4,110,20065,110,326
27.18,17,6,2016,6,308,5436,308,2016,0,0,0,0,0
240.216,6,53,17449,28,777,8896,1402,14680,25,182,10008,580,2769
1772.219,6,180,15480,120,69,14892,69,8940,60,69,30034,69,6540
1.98,17,2,122,2,33,1980,33,122,0,0,0,0,0
125.495,6,14,3189,5,92,31373,92,348,9,338,15654,1448,2841
1.278,6,45,15946,25,778,53,1360,10370,20,433,58,1360,5576
0.506,17,3,451,2,39,217,39,134,1,289,0,289,317
1773.29,6,180,15480,120,69,14901,69,8940,60,69,30049,69,6540
17.46,6,13,5668,4,106,5820,106,274,9,718,2174,1452,5394
1783.459,1,58,4872,58,56,31288,56,4872,0,0,0,0,0
8.876,6,41,9980,21,310,443,464,2138,20,468,402,1374,7842
0.357,17,4,368,2,32,303,32,120,2,96,0,96,248
661.773,2,6,192,6,8,132354,8,192,0,0,0,0,0
1787.23,6,117,13660,75,79,24151,500,5883,42,160,43589,1420,7777
1772.435,6,180,15480,120,69,14894,69,8940,60,69,30035,69,6540
3.998,17,2,656,2,300,3998,300,656,0,0,0,0,0
100.541,6,24,9533,7,341,16756,722,1385,17,518,6269,1448,8148
143.269,17,14,1232,7,48,23875,48,532,7,72,23875,72,700
0.517,6,20,7238,12,335,46,668,1974,8,1210,72,1906,5264
1796.658,17,448,39896,403,35,4469,288,25676,45,288,40017,288,14220
1795.979,1,58,4872,58,56,31508,56,4872,0,0,0,0,0
1788.73,17,87,3648,86,14,21043,14,3612,1,8,0,8,36
1739.196,6,87,6322,58,31,30512,31,3915,29,31,62113,31,2407
1791.521,17,140,11200,70,48,25963,48,5320,70,56,25963,56,5880
1596.958,1,9,504,9,28,199619,28,504,0,0,0,0,0
1710.251,6,173,14988,110,69,14880,69,8195,63,68,27584,69,6793
1793.905,17,140,11200,70,48,25998,48,5320,70,56,25998,56,5880
1784.705,6,381,30722,197,75,9105,267,13013,184,104,9752,1452,17709
48.19,17,6,390,3,37,24094,47,195,3,37,24094,47,195
0.007,17,2,453,1,36,0,36,64,1,361,0,361,389
6.694,6,573,466010,336,1315,19,1368,449022,237,776,27,2736,16988
1741.63,6,87,6322,58,31,30554,31,3915,29,31,62200,31,2407
36.099,17,44,6468,22,48,1717,48,1672,22,190,1718,308,4796
1788.931,17,425,53945,197,174,9126,1350,39962,228,33,7880,88,13983
1.224,6,6,248,4,0,408,0,164,2,0,193,0,84
84.257,17,4,352,2,60,84256,60,176,2,60,84256,60,176
1785.866,6,368,25621,214,99,8384,469,15045,154,69,11672,69,10576
1.374,6,38,9848,20,502,72,1440,4352,18,433,70,1440,5496
2.868,6,16,7059,9,498,358,721,1360,7,1805,323,2828,5699
0.316,17,2,152,1,48,0,48,76,1,48,0,48,76
0.688,6,23,6395,13,310,56,889,2075,10,979,75,1731,4320
1750.997,17,12,498,11,14,175099,14,462,1,8,0,8,36
5.0,17,4,288,2,36,4983,36,128,2,52,4984,52,160
14.613,6,31,7813,13,158,1217,267,1317,18,524,849,1400,6496
146.347,1,3,168,3,28,73173,28,168,0,0,0,0,0
8.67,6,7,320,3,0,4335,0,128,4,0,2411,0,192
1787.255,6,104,8376,68,65,26675,65,4930,36,59,51061,59,3446
8.369,6,14,1247,7,222,1393,222,728,7,231,1393,231,519
1.463,6,30,6427,15,164,104,267,1922,15,780,92,1460,4505
1792.728,1,318,26712,318,56,5655,56,26712,0,0,0,0,0
0.084,6,9,1340,5,145,21,145,349,4,827,26,827,991
1786.586,6,102,8364,68,66,26665,66,4964,34,60,54136,60,3400
1774.065,6,180,15480,120,69,14908,69,8940,60,69,30065,69,6540
280.534,6,29,7392,13,158,23377,267,1317,16,603,18695,2076,6075
1.311,6,27,8160,13,164,93,267,1340,14,869,86,1448,6820
0.009,17,2,304,1,37,0,37,65,1,211,0,211,239
0.878,17,4,560,2,64,863,64,184,2,160,862,160,376
0.741,17,4,284,2,32,352,32,120,2,54,390,60,164
84.895,6,41,16016,22,676,104,1421,7664,19,583,4708,1440,8352
178.438,6,71,12975,31,283,4303,1189,5221,40,323,4569,1460,7754
0.063,17,4,314,2,31,0,31,118,2,70,39,70,196
1774.871,17,138,11040,69,48,26100,48,5244,69,56,26100,56,5796
1767.315,17,168,14050,156,30,11402,37,9090,12,385,155056,463,4960
0.294,6,26,9014,13,247,24,624,1696,13,947,24,1408,7318
1681.556,17,14,1036,7,30,280257,30,406,7,62,280257,62,630
1742.546,6,95,7203,63,38,28105,205,4476,32,33,56197,98,2727
1783.241,6,154,15568,82,86,22013,722,7554,72,76,25113,1408,8014
12.407,6,1967,1713679,1194,1380,10,1420,1678526,773,420,16,1420,35153
272.641,17,2,244,2,94,272641,94,244,0,0,0,0,0
0.434,6,10,968,5,256,105,256,460,5,304,105,304,508
5.63,6,43,7429,22,218,268,314,3503,21,440,268,1152,3926
1386.934,2,11,352,11,8,138693,8,352,0,0,0,0,0
1771.952,6,106,9823,69,65,26058,65,5822,37,59,49218,59,4001
21.959,6,25,4712,13,181,1829,293,1791,12,487,1786,1179,2921
0.002,6,3,213,1,0,0,0,40,2,69,0,69,173
2.148,6,20,3833,11,234,214,564,1504,9,463,245,1343,2329
0.577,17,8,2758,8,316,82,355,2758,0,0,0,0,0
0.127,1,2,112,2,28,127,28,112,0,0,0,0,0
7.944,6,70,20766,36,559,226,1152,15979,34,489,232,1179,4787
180.226,17,4,382,2,31,180211,34,119,2,103,180212,114,263
1.429,6,416,407334,149,342,9,343,11560,267,1441,5,2896,395774
1788.052,6,103,8268,68,64,26687,64,4896,35,58,52587,58,3372
97.781,17,4,240,2,32,97780,32,120,2,32,97780,32,120
1.429,6,47,19115,26,955,57,1460,13499,21,433,61,1460,5616
6.431,17,4,240,2,32,6430,32,120,2,32,6430,32,120
1.651,6,25,8711,15,276,117,561,1433,10,982,164,1420,7278
73.0,17,2,122,2,33,73000,33,122,0,0,0,0,0
1.172,17,4,566,2,31,1161,31,118,2,196,1146,196,448
0.054,6,7,426,3,31,27,31,175,4,31,4,31,251
317.043,6,74,19495,37,364,8806,1360,9896,37,337,8802,1360,9599
280.26,6,30,7432,13,158,23355,267,1317,17,603,17513,2800,6115
367.076,6,18,1242,14,180,28236,180,916,4,110,20067,110,326
70.877,6,23,11278,12,433,67,990,1823,11,1286,7075,3928,9455
18.976,6,21,4528,11,211,1897,722,1624,10,793,2083,1408,2904
1771.539,6,99,9240,66,65,27254,65,5577,33,59,55358,59,3663
170.177,17,8,2688,8,308,24311,308,2688,0,0,0,0,0
1779.757,1,339,28476,339,56,5265,56,28476,0,0,0,0,0
0.055,17,4,420,2,33,0,33,122,2,121,43,145,298
0.087,6,10,1671,6,552,17,948,1348,4,159,28,159,323
0.685,17,3,1167,3,361,342,361,1167,0,0,0,0,0
1.323,6,47,19249,27,897,50,1360,13673,20,476,60,2720,5576
1383.681,2,13,416,13,8,115306,8,416,0,0,0,0,0
1783.809,6,364,24454,212,88,8454,469,14027,152,69,11813,69,10427
0.388,6,25,7711,16,339,25,949,3017,9,721,46,1420,4694
772.089,6,65,5539,37,65,20569,65,2910,28,68,28592,149,2629
13.638,17,4,352,2,60,13637,60,176,2,60,13637,60,176
0.026,17,2,144,1,36,0,36,64,1,52,0,52,80
0.307,1,2,112,2,28,307,28,112,0,0,0,0,0
0.472,6,12,1653,6,288,87,288,548,6,426,50,434,1105
1771.731,6,275,35865,111,147,16105,1360,16860,164,149,10868,4662,19005
5.018,17,4,558,2,36,5014,36,128,2,187,5012,187,430
1.388,6,52,21405,29,907,49,1360,15709,23,433,54,1360,5696
280.194,6,29,7392,13,158,23349,267,1317,16,603,18676,2236,6075
170.997,17,4,352,2,60,170996,60,176,2,60,170996,60,176
0.051,6,15,4060,8,88,7,88,428,7,1113,8,1460,3632
1.44,6,47,19488,27,914,55,1360,13912,20,476,65,2715,5576
370.832,6,18,1242,14,180,28525,180,916,4,110,20070,110,326
1790.659,17,87,3648,86,14,21066,14,3612,1,8,0,8,36
0.093,17,5,373,3,31,15,31,177,2,70,32,70,196
1677.459,1,8,448,8,28,239637,28,448,0,0,0,0,0
4.212,17,5,290,5,30,1053,30,290,0,0,0,0,0
9.52,17,4,824,2,48,9506,48,152,2,308,9502,308,672
1654.463,1,8,448,8,28,236351,28,448,0,0,0,0,0
266.796,17,4,352,2,60,266795,60,176,2,60,266795,60,176
12.847,6,92,26461,48,538,273,1152,20219,44,447,292,1179,6242
1780.36,17,134,10720,67,48,26975,48,5092,67,56,26975,56,5628
1773.189,6,180,15480,120,69,14900,69,8940,60,69,30048,69,6540
3.466,17,8,2036,4,32,1153,32,240,4,421,1154,470,1796
2.105,6,23,5973,12,108,191,147,919,11,768,208,1581,5054
1680.153,1,15,870,15,30,120010,30,870,0,0,0,0,0
0.06,17,2,148,1,30,0,30,58,1,62,0,62,90
0.945,6,10,1687,7,100,157,100,384,3,1179,345,1179,1303
240.194,6,54,18140,29,797,8578,1402,15070,25,220,10007,580,3070
1.664,6,52,22151,28,1013,61,1460,16355,24,476,63,2615,5796
100.366,6,21,8291,11,525,83,1237,2060,10,969,11132,1791,6231
10.06,17,3,211,2,37,10008,37,130,1,53,0,53,81
1741.268,1,50,5300,50,78,35536,78,5300,0,0,0,0,0
1740.515,6,87,6322,58,31,30535,31,3915,29,31,62161,31,2407
1786.26,6,99,8052,66,65,27480,65,4785,33,59,55817,59,3267
128.725,6,27,7184,5,156,32181,267,678,22,350,6128,1460,6506
66.023,6,30,16636,17,1011,4126,1448,8986,13,870,5487,1448,7650
139.976,6,20,9440,11,537,88,1306,2120,9,1389,17474,4080,7320
0.111,17,2,245,1,32,0,32,60,1,157,0,157,185
1781.647,17,75,3141,73,13,24742,14,3061,2,12,1781447,16,80
1791.055,6,5192,4437864,2287,125,783,330,139971,2905,1463,616,4224,4297893
11.854,6,1829,1635603,1110,1420,10,1432,1602622,719,420,16,1432,32981
1686.775,17,12,498,11,14,168677,14,462,1,8,0,8,36
1796.403,17,448,39896,403,35,4468,288,25676,45,288,40017,288,14220
0.252,17,3,451,2,39,225,39,134,1,289,0,289,317
1770.547,1,58,4872,0,0,0,0,0,58,56,31062,56,4872
1770.077,6,99,9240,66,65,27231,65,5577,33,59,55312,59,3663
0.761,6,15,5772,9,290,95,517,1045,6,1101,106,1418,4727
50.446,6,27,7177,13,155,4203,267,1306,14,530,3879,3417,5871
4.89,6,38,7245,19,218,271,314,3383,19,516,256,1179,3862
240.117,6,44,7882,23,139,10914,346,2050,21,473,12005,2800,5832
7.265,6,1521,1407558,962,1386,7,1408,1373826,559,931,12,2816,33732
6.182,6,40,7325,21,218,309,314,3463,19,516,328,1179,3862
1797.004,17,142,11360,71,48,25671,48,5396,71,56,25671,56,5964
2.787,6,2,88,2,0,0,0,88,0,0,0,0,0
0.234,17,7,2368,7,310,39,354,2368,0,0,0,0,0
2.482,6,13,2311,8,188,354,245,700,5,1407,552,1407,1611
1682.801,1,7,392,7,28,280466,28,392,0,0,0,0,0
40.507,6,44,8765,21,345,651,720,1967,23,366,1834,2128,6798
90.953,6,25,11777,12,746,58,1460,3497,13,1106,7568,1460,8280
1788.82,17,87,3648,86,14,21044,14,3612,1,8,0,8,36
16.388,17,28,17516,15,772,1168,1350,12002,13,396,1363,1350,5514
1798.061,17,450,39960,405,35,4450,288,25740,45,288,40023,288,14220
283.16,6,30,7432,13,158,23596,267,1317,17,543,17694,1400,6115
1789.912,17,144,11520,72,48,25209,48,5472,72,56,25209,56,6048
60.884,6,45,13957,20,155,3204,457,1967,25,645,2455,1702,11990
1778.931,6,242,45401,119,866,15075,1408,33053,123,62,14581,580,12348
367.139,6,27,1767,18,177,21596,177,1181,9,110,8554,110,586
280.228,17,4,1098,2,30,280214,30,116,2,463,280216,463,982
0.26,17,2,384,1,39,0,39,67,1,289,0,289,317
1796.775,17,142,11360,71,48,25667,48,5396,71,56,25667,56,5964
0.535,6,23,7406,13,335,44,668,2026,10,1210,54,1946,5380
257.874,6,15,1200,4,321,33,321,537,11,83,25786,83,663
1794.091,17,80,3354,79,14,23001,14,3318,1,8,0,8,36
2.118,6,10,1687,7,100,353,100,384,3,1179,931,1179,1303
2.993,17,3,1021,2,308,2000,308,672,1,321,0,321,349
0.502,6,5,453,3,245,127,245,369,2,0,256,0,84
1792.687,6,356,22520,208,69,8660,69,12460,148,69,12194,69,10060
0.978,6,12,1653,6,288,192,288,548,6,426,100,434,1105
1789.263,1,8,448,8,28,255609,28,448,0,0,0,0,0
1370.546,17,2638,1460940,1468,796,934,1350,1210263,1170,186,1172,1350,250677
64.093,6,17,692,8,0,8440,0,324,9,0,8010,0,368
0.312,17,2,186,1,41,0,41,69,1,89,0,89,117
1.246,6,45,17520,26,839,49,1360,11984,19,476,60,2715,5536
18.404,17,4,352,2,48,18390,48,152,2,72,18392,72,200
41.914,17,24,1824,24,48,1822,48,1824,0,0,0,0,0
561.621,17,8,2196,4,30,187183,30,232,4,463,187205,463,1964
1681.7,17,14,1036,7,30,280281,30,406,7,62,280281,62,630
1720.491,17,12,498,11,14,172049,14,462,1,8,0,8,36
0.248,17,2,387,1,39,0,39,67,1,292,0,292,320
1771.966,6,180,15480,120,69,14890,69,8940,60,69,30031,69,6540
4.959,6,35,6225,18,206,291,314,2784,17,551,293,1179,3441
302.079,1,4,326,4,53,100693,78,326,0,0,0,0,0
1.59,6,48,18201,26,882,63,1360,12545,22,433,66,1360,5656
0.137,6,11,913,6,182,27,182,490,5,77,17,134,423
15.159,17,20,7629,9,483,1891,1350,4600,11,247,1512,1350,3029
0.899,6,10,1687,7,100,149,100,384,3,1179,319,1179,1303
2.887,6,8,320,2,0,309,0,80,6,0,577,0,240
1.263,6,44,10145,23,440,57,1360,4484,21,400,54,1360,5661
104.772,17,2,122,2,33,104772,33,122,0,0,0,0,0
4.26,6,54,15007,28,547,157,1429,5589,26,522,159,4906,9418
1729.78,6,77,13810,49,111,36037,1440,5131,28,288,64059,1440,8679
0.513,6,7,295,4,0,171,0,164,3,7,109,7,131
2.504,6,14,2351,8,188,357,245,700,6,703,447,1152,1651
1799.426,1,345,28980,345,56,5230,56,28980,0,0,0,0,0
8.197,6,1928,1790105,1224,1384,6,1408,1748833,704,776,11,1408,41272
0.551,17,2,384,1,39,0,39,67,1,289,0,289,317
3.491,17,5,295,5,31,872,31,295,0,0,0,0,0
3.405,17,5,340,5,40,851,40,340,0,0,0,0,0
34.274,6,20,4449,12,272,3115,516,1300,8,565,4855,1452,3149
3.243,17,2,778,2,361,3243,361,778,0,0,0,0,0
18.801,17,43,14090,22,453,893,1350,10592,21,138,938,1350,3498
22.508,6,22,4348,9,138,1411,174,916,13,363,1867,1452,3432
240.376,6,43,9042,21,521,12017,1418,5790,22,233,11445,618,3252
0.05,6,14,5639,8,134,7,134,474,6,2456,9,3453,5165
1.752,17,20,5180,20,231,92,388,5180,0,0,0,0,0
12.639,6,1719,1575648,1103,1375,11,1432,1545673,616,475,20,1871,29975
7.118,6,1234,1066032,703,1428,9,1448,1030600,531,776,13,1448,35432
4.297,17,4,352,2,60,4296,60,176,2,60,4296,60,176
1725.169,1,68,3808,68,28,25748,28,3808,0,0,0,0,0
102.471,17,4,352,2,60,102470,60,176,2,60,102470,60,176
181.263,17,4,1344,4,308,60421,308,1344,0,0,0,0,0
22.932,6,26,6994,16,124,1528,159,1600,10,811,2544,1675,5394
154.437,6,30,7432,13,158,12869,267,1317,17,543,9650,1400,6115
3.938,17,5,1165,5,205,984,205,1165,0,0,0,0,0
1787.884,6,356,22520,208,69,8637,69,12460,148,69,12162,69,10060
1682.573,17,14,1036,7,30,280420,30,406,7,62,280421,62,630
369.724,6,18,1239,14,177,28440,177,913,4,110,20059,110,326
152.574,17,4,352,2,60,152573,60,176,2,60,152573,60,176
1.647,17,17,13064,9,659,205,1350,6184,8,832,119,1350,6880
0.008,6,2,133,1,0,0,0,40,1,53,0,53,93
1741.234,6,98,7097,62,31,28544,31,4209,36,31,49749,31,2888
132.716,6,42,11883,13,320,2052,1189,2768,29,331,4739,1420,9115
175.634,6,34,11792,16,158,11708,267,1437,18,963,10270,3456,10355
280.212,6,28,7352,12,158,25473,267,1277,16,603,18680,1400,6075
896.723,17,54,18441,54,313,16919,548,18441,0,0,0,0,0
25.311,17,26,11148,12,647,2295,1350,8100,14,189,1941,1350,3048
2.953,2,3,96,3,8,1476,8,96,0,0,0,0,0
1763.672,2,14,448,14,8,135667,8,448,0,0,0,0,0
0.015,6,2,80,1,0,0,0,40,1,0,0,0,40
1740.449,1,15,840,15,28,124317,28,840,0,0,0,0,0
0.01,17,2,294,1,36,0,36,64,1,202,0,202,230
14.975,6,9,527,5,43,3743,43,311,4,0,4986,0,216
1.334,17,6,552,3,32,666,32,180,3,96,642,96,372
8.546,6,32,10086,18,298,502,560,2541,14,994,642,2720,7545
0.575,6,10,1386,5,145,143,145,349,5,833,81,833,1037
115.911,6,23,1675,17,43,7244,43,1315,6,0,23180,0,360
0.395,17,2,167,1,39,0,39,67,1,72,0,72,100
216.964,6,50,9279,20,108,11418,267,2000,30,252,7481,1452,7279
1283.515,6,133,11599,84,70,15463,138,6396,49,69,26739,69,5203
1773.207,6,117,13596,76,84,23642,472,7098,41,117,44328,1408,6498
0.503,6,23,7428,14,273,38,663,2104,9,1209,56,1946,5324
10.278,6,12,945,6,222,2053,222,466,6,231,2053,231,479
1772.004,6,180,15480,120,69,14890,69,8940,60,69,30033,69,6540
111.234,17,6,2016,6,308,22246,308,2016,0,0,0,0,0
5.013,17,4,530,2,36,5003,36,128,2,173,5003,187,402
220.934,6,28,7352,12,158,20084,267,1277,16,678,14725,2085,6075
1.529,6,40,8391,21,321,76,1164,2810,19,480,74,4075,5581
1792.249,1,341,28644,341,56,5271,56,28644,0,0,0,0,0
28.586,17,27,8104,13,358,2379,1350,5024,14,192,2196,1350,3080
17.509,17,35,13627,17,551,1092,1350,9848,18,181,1028,1350,3779
15.703,6,780,694556,486,1353,31,1368,672404,294,931,52,2736,22152
1777.202,6,191,18990,126,98,14217,981,11142,65,80,27761,485,7848
0.0,1,2,112,2,28,0,28,112,0,0,0,0,0
155.094,17,14,1120,7,48,25846,48,532,7,56,25846,56,588
140.765,6,24,10282,12,433,90,990,1823,12,995,12782,1390,8459
5.011,17,4,530,2,36,5005,36,128,2,173,5006,187,402
1535.138,17,44,3694,44,55,35700,355,3694,0,0,0,0,0
533.841,17,3,211,3,42,266920,47,211,0,0,0,0,0
1771.046,6,99,9240,66,65,27246,65,5577,33,59,55342,59,3663
1.386,6,48,19159,27,887,53,1360,13543,21,476,60,2715,5616
1.401,6,38,8360,19,338,77,1270,2824,19,433,67,1440,5536
1.277,6,43,10117,23,440,58,1360,4496,20,437,58,2715,5621
17.27,6,23,6937,10,159,1918,267,887,13,788,443,1420,6050
0.413,6,13,1182,7,146,65,146,430,6,254,77,506,752
1.103,6,23,7952,12,164,85,267,1288,11,1216,93,3819,6664
67.196,6,8429,8232702,5439,1433,12,1448,8068478,2990,776,22,1448,164224
93.088,2,3,96,3,8,46544,8,96,0,0,0,0,0
0.645,6,24,6041,12,108,58,147,919,12,927,54,1608,5122
1681.77,17,14,1036,7,30,280287,30,406,7,62,280289,62,630
4.671,6,40,7309,21,218,233,314,3463,19,440,244,1152,3846
0.372,6,12,1653,6,288,71,288,548,6,426,38,434,1105
0.01,17,2,391,1,29,0,29,57,1,306,0,306,334
1.628,6,40,11374,22,547,77,1360,5878,18,476,83,2715,5496
242.273,6,31,8912,14,158,18636,267,1357,17,687,15140,1781,7555
5.299,17,22,7996,10,425,588,1350,4536,12,260,441,1350,3460
1.985,6,15,3491,6,288,362,288,560,9,639,226,853,2931
11.093,6,1762,1527343,1061,1384,10,1420,1495082,701,467,15,1883,32261
1777.836,1,58,4872,58,56,31190,56,4872,0,0,0,0,0
0.483,17,2,384,1,39,0,39,67,1,289,0,289,317
1740.602,17,30,7050,30,207,60020,207,7050,0,0,0,0,0
0.327,6,3,160,2,0,327,0,100,1,0,0,0,60
1777.141,17,140,11200,70,48,25755,48,5320,70,56,25755,56,5880
15.031,17,23,8075,10,463,1666,1350,4918,13,214,1250,1350,3157
1745.557,6,95,7203,63,38,28154,205,4476,32,33,56295,98,2727
1760.75,6,209,21734,108,81,16455,721,9783,101,207,17603,1414,11951
2.262,6,14,2351,8,188,323,245,700,6,703,397,1152,1651
12.26,17,10,690,5,33,3063,33,305,5,49,3063,49,385
0.017,6,16,6004,8,88,2,88,452,8,1305,2,1880,5552
63.99,6,11,1583,11,127,6399,127,1583,0,0,0,0,0
2.313,6,15,3636,7,150,385,174,584,8,681,300,1452,3052
1795.44,17,449,39928,404,35,4455,288,25708,45,288,40018,288,14220
1772.119,6,180,15480,120,69,14891,69,8940,60,69,30030,69,6540
0.505,17,2,204,1,34,0,34,62,1,114,0,114,142
1.407,6,37,8214,19,321,78,1164,2718,18,476,70,2715,5496
482.765,2,11,352,11,8,48276,8,352,0,0,0,0,0
655.363,6,128,8087,73,69,8444,69,4438,55,69,12136,69,3649
14.218,6,2426,2340665,1614,1374,8,1408,2293777,812,931,17,2801,46888
1.0,17,4,566,2,31,987,31,118,2,196,981,196,448
1771.031,6,105,9618,66,66,27246,66,5610,39,60,46603,60,4008
97.057,1,8,448,8,28,13865,28,448,0,0,0,0,0
1.371,6,49,19275,27,893,52,1360,13619,22,433,56,1360,5656
3.922,17,12,2571,6,45,781,45,438,6,327,773,339,2133
1.531,6,11,975,6,304,306,304,624,5,83,377,83,351
280.433,6,31,7472,13,158,23369,267,1317,18,603,16494,2076,6155
1800.0,6,211,16244,78,68,22986,295,7650,133,48,13636,78,8594
280.226,6,29,7392,14,158,21555,267,1357,15,678,20012,3436,6035
30.344,17,8,704,4,48,10112,48,304,4,72,10111,72,400
0.313,6,208,195130,134,194,2,230,8127,74,2543,3,8448,187003
1.059,17,4,580,2,40,1027,40,136,2,194,797,194,444
1.007,6,10,1687,7,100,167,100,384,3,1179,363,1179,1303
5.04,17,4,288,2,36,4996,36,128,2,52,4997,52,160
280.197,6,30,7432,13,158,23349,267,1317,17,543,17511,1400,6115
3.043,17,3,468,3,128,1521,128,468,0,0,0,0,0
240.687,6,45,10076,22,541,11460,1418,7113,23,219,10939,580,2963
1740.471,17,28,6580,28,207,64461,207,6580,0,0,0,0,0
1787.847,17,87,3648,86,14,21033,14,3612,1,8,0,8,36
0.069,6,10,766,5,185,13,185,453,5,45,15,45,313
1785.859,6,365,25501,213,99,8423,469,15005,152,69,11826,69,10496
15.38,17,15,7672,8,670,2179,1350,5588,7,269,2548,1350,2084
232.158,17,5,370,5,46,58039,46,370,0,0,0,0,0
280.472,6,27,7312,12,158,25497,267,1277,15,678,20029,2085,6035
33.457,6,33,5398,17,180,2091,721,2010,16,319,2217,2026,3388
0.605,6,24,7461,13,334,50,663,2045,11,806,56,1368,5416
1663.171,6,187,12954,67,46,25199,46,5394,120,46,13976,46,7560
132.881,6,21,9221,11,514,80,1236,2014,10,1132,14745,2720,7207
1763.877,2,15,480,15,8,125991,8,480,0,0,0,0,0
1783.81,6,373,26028,216,99,8296,469,15125,157,69,11434,69,10903
660.681,2,5,160,5,8,165170,8,160,0,0,0,0,0
0.073,17,2,144,1,36,0,36,64,1,52,0,52,80
6.251,6,1463,1333182,910,1386,6,1408,1299762,553,931,11,2801,33420
192.09,6,11,854,4,112,64030,112,280,7,90,31987,90,574
1797.71,6,436,28410,218,99,8284,469,15205,218,34,8284,64,13205
0.026,17,2,210,1,40,0,40,68,1,114,0,114,142
84.016,6,20,10080,11,433,60,990,1771,9,1587,10487,3928,8309
247.397,17,4,352,2,60,247396,60,176,2,60,247395,60,176
1774.458,6,180,15480,120,69,14911,69,8940,60,69,30073,69,6540
12.404,6,99,29823,51,562,248,1152,23421,48,407,258,1152,6402
1760.889,1,58,4872,58,56,30892,56,4872,0,0,0,0,0
256.928,6,27,6921,13,229,170,498,1672,14,425,19757,2642,5249
4.734,6,39,7285,19,218,263,314,3383,20,516,235,1179,3902
1786.86,6,104,8444,68,66,26669,66,4964,36,60,51050,60,3480
0.432,6,21,7217,12,318,37,599,1905,9,967,52,1471,5312
1798.608,6,373,25559,215,92,8404,469,14823,158,69,11454,69,10736
0.003,6,2,88,1,0,0,0,40,1,0,0,0,48
1796.174,17,448,39896,403,35,4468,288,25676,45,288,40021,288,14220
1.354,6,48,18711,27,855,52,1360,13095,21,433,58,1360,5616
120.982,6,22,10189,11,433,59,990,1771,11,1138,12086,2568,8418
18.939,6,1652,1506937,988,1439,18,1448,1463597,664,776,28,1448,43340
280.35,6,28,7352,13,158,23362,267,1317,15,678,20022,2045,6035
579.837,6,56,8816,33,102,18119,501,2970,23,289,26352,1420,5846
12.533,17,3,984,3,300,6266,300,984,0,0,0,0,0
106.184,6,26,12919,14,549,56,1360,2800,12,1604,9641,3934,10119
1745.493,6,104,7671,62,38,28614,205,4424,42,33,42565,98,3247
2.855,17,4,518,3,39,789,39,201,1,289,0,289,317
15.163,17,15,8896,6,645,3026,1350,4043,9,511,1891,1350,4853
0.09,6,12,3462,6,75,17,75,395,6,1373,17,1448,3067
0.02,17,4,344,2,47,0,47,150,2,69,1,75,194
31.889,6,9,396,2,0,3484,0,88,7,0,5301,0,308
1790.665,6,356,22520,208,69,8650,69,12460,148,69,12181,69,10060
61.804,6,36,8015,13,141,5150,267,1375,23,300,2801,1460,6640
1795.42,17,448,39896,403,35,4466,288,25676,45,288,40017,288,14220
0.495,6,23,6001,12,108,45,147,919,11,773,47,1608,5082
1771.758,6,99,9174,66,64,27257,64,5544,33,58,55364,58,3630
0.039,17,2,235,1,36,0,36,64,1,143,0,143,171
1750.771,6,171,10630,88,49,20123,208,6411,83,31,21347,31,4219
0.035,17,5,1320,3,60,10,60,264,2,500,21,500,1056
106.284,6,20,812,8,0,6868,0,324,12,0,9660,0,488
10.161,6,15,2126,8,211,1451,211,655,7,545,965,904,1471
105.322,17,4,352,2,60,105321,60,176,2,60,105321,60,176
54.047,6,19,780,10,0,6000,0,404,9,0,6749,0,376
0.329,6,20,4960,10,137,36,267,1092,10,692,34,1467,3868
0.731,6,631,639272,309,183,2,230,18313,322,1888,2,13032,620959
5.603,17,4,304,4,48,1867,48,304,0,0,0,0,0
195.438,2,4,128,4,8,65146,8,128,0,0,0,0,0
0.434,6,3,144,2,0,1,0,92,1,0,0,0,52
1786.551,6,106,8524,68,66,26664,66,4964,38,60,48282,60,3560
1790.509,1,82,8692,82,78,22105,78,8692,0,0,0,0,0
0.287,6,26,7256,12,155,26,267,1261,14,603,21,1400,5995
240.172,6,41,5441,20,225,12640,752,2853,21,184,12008,531,2588
0.162,17,2,167,1,39,0,39,67,1,72,0,72,100
1787.06,6,104,8376,68,65,26672,65,4930,36,59,51056,59,3446
0.037,17,6,912,3,60,6,60,264,3,188,7,188,648
1786.267,6,154,19574,92,302,19629,302,13852,62,83,29282,83,5722
1799.877,6,133,8322,74,46,24631,208,5063,59,31,29973,31,3259
0.118,17,4,1375,4,315,39,354,1375,0,0,0,0,0
0.882,6,10,1687,7,100,147,100,384,3,1179,313,1179,1303
1.708,6,32,8458,17,520,106,1418,5580,15,261,120,639,2878
163.219,17,4,352,2,60,163218,60,176,2,60,163218,60,176
13.681,6,9,3951,5,100,3420,100,304,4,1161,893,1179,3647
1785.674,6,369,26075,210,98,8543,469,15023,159,69,11298,69,11052
164.193,6,31,7472,13,158,13682,267,1317,18,603,9656,2760,6155
14.761,6,29,5015,14,154,1098,722,1819,15,344,1042,1448,3196
1792.349,1,312,26208,312,56,5763,56,26208,0,0,0,0,0
1.683,6,10,1687,7,100,280,100,384,3,1179,714,1179,1303
1771.054,6,105,9828,68,66,26433,66,5792,37,60,49193,60,4036
1790.487,6,382,23698,210,69,8566,69,12678,172,50,10470,69,11020
2.033,2,2,64,2,8,2033,8,64,0,0,0,0,0
1797.977,6,354,22302,207,69,8728,69,12351,147,69,12245,69,9951
0.178,17,2,268,1,54,0,54,82,1,158,0,158,186
1793.487,6,396,33453,224,93,8042,1189,15341,172,151,10488,1420,18112
1745.973,6,96,7255,62,38,28622,205,4424,34,33,52901,98,2831
38.002,17,20,1760,10,48,4221,48,760,10,72,4221,72,1000
421.097,2,4,128,4,8,140365,8,128,0,0,0,0,0
146.235,6,21,8784,11,310,87,619,1402,10,1161,16230,2720,7382
10.842,6,20,4402,11,275,1084,275,998,9,758,749,1420,3404
1.42,17,4,240,2,32,1419,32,120,2,32,1419,32,120
0.399,6,26,8868,13,227,33,547,1592,13,941,32,1438,7276
15.185,6,35,8570,17,247,949,335,3159,18,669,878,1179,5411
1799.239,17,455,40952,406,35,4442,288,25856,49,280,36935,308,15096
1746.448,1,8,848,8,78,249492,78,848,0,0,0,0,0
0.185,17,4,624,2,64,183,64,184,2,192,72,192,440
0.295,17,2,204,1,34,0,34,62,1,114,0,114,142
0.014,17,2,128,1,36,0,36,64,1,36,0,36,64
256.789,17,4,352,2,60,256788,60,176,2,60,256787,60,176
3.738,6,32,6089,17,206,233,314,2744,15,548,247,1179,3345
1557.517,1,56,3136,56,28,28318,28,3136,0,0,0,0,0
0.389,6,12,1653,6,288,72,288,548,6,426,45,434,1105
0.036,17,2,223,1,36,0,36,64,1,131,0,131,159
0.257,6,27,9085,13,257,21,667,1715,14,947,19,1408,7370
1785.888,6,373,26428,216,104,8306,469,15732,157,69,11445,69,10696
0.834,6,11,1727,7,100,139,100,384,4,589,190,1152,1343
5.01,17,4,542,2,36,5003,36,128,2,179,5005,187,414
280.445,6,30,7432,13,158,23370,267,1317,17,678,17524,2760,6115
28.728,6,36,8895,19,152,1596,454,1708,17,590,1592,1460,7187
1791.814,6,285,36576,116,140,15579,1360,17183,169,148,10664,4662,19393
0.296,6,3,136,2,0,296,0,88,1,0,0,0,48
1793.488,1,58,4872,58,56,31464,56,4872,0,0,0,0,0
19.674,6,17,2425,9,211,2457,211,922,8,545,2810,904,1503
0.017,17,2,529,1,45,0,45,73,1,428,0,428,456
22.812,6,3317,3107545,2145,1370,10,1408,3041937,1172,931,19,2816,65608
1787.113,17,1921,145972,1044,40,1713,41,71688,877,56,2040,57,74284
4.784,17,36,15506,20,489,249,1350,10342,16,294,316,1350,5164
1.282,6,39,11105,21,592,64,1360,5609,18,476,64,2715,5496
22.037,6,42,9779,20,289,1151,721,3411,22,548,1041,1440,6368
1788.753,1,276,15456,276,28,6504,28,15456,0,0,0,0,0
5.005,6,40,7309,20,218,263,314,3423,20,513,250,1179,3886
15.504,17,16,5003,7,360,2572,1350,2716,9,226,1928,1350,2287
7.63,6,1473,1544188,479,296,15,426,27874,994,1480,1,4206,1516314
1.376,6,48,18200,27,882,52,1360,12584,21,476,59,2720,5616
300.999,6,40,9942,20,433,15834,910,2998,20,408,15834,2128,6944
375.368,6,47,10597,30,290,12943,1460,5070,17,439,539,4027,5527
0.622,6,26,17418,16,708,41,1360,4214,10,2132,53,6247,13204
234.878,6,30,8872,14,158,18067,267,1357,16,763,15647,2045,7515
0.011,17,8,2454,8,278,1,317,2454,0,0,0,0,0
1.996,6,15,1899,9,100,249,100,468,6,589,346,1152,1431
0.5,6,8,335,4,0,166,0,164,4,7,77,7,171
4.454,6,8,460,4,0,1484,0,220,4,0,1000,0,240
112.332,6,26,12772,13,519,61,884,2629,13,1067,9350,2720,10143
3.982,6,2,88,2,0,0,0,88,0,0,0,0,0
1716.294,17,340,54483,340,132,5062,391,54483,0,0,0,0,0
33.767,6,31,5095,15,154,2411,722,1860,16,342,2237,1408,3235
117.434,6,122,32901,56,460,2135,1460,15209,66,385,1799,1642,17692
1769.65,6,103,9448,66,65,27225,65,5577,37,59,49154,59,3871
1745.643,6,95,7203,63,38,28155,205,4476,32,33,56298,98,2727
0.005,17,2,468,1,45,0,45,73,1,367,0,367,395
1769.02,1,58,4872,58,56,31035,56,4872,0,0,0,0,0
1787.091,6,107,8679,69,65,26280,65,5035,38,59,48295,59,3644
0.329,6,20,7238,12,335,29,668,1974,8,1210,45,1906,5264
0.282,17,6,2008,6,306,56,354,2008,0,0,0,0,0
421.361,2,4,128,4,8,140453,8,128,0,0,0,0,0
1679.623,17,12,498,11,14,167962,14,462,1,8,0,8,36
2.474,6,4,1561,1,991,0,991,1031,3,410,1237,410,530
129.497,6,56,20655,30,953,4459,1360,14584,26,358,5173,1360,6071
1772.701,6,180,15480,120,69,14896,69,8940,60,69,30040,69,6540
1623.935,6,164,14219,104,69,14880,69,7748,60,69,27524,69,6471
118.611,17,4,240,2,32,118610,32,120,2,32,118610,32,120
1.554,6,48,18688,26,920,62,1460,13032,22,433,62,1460,5656
1792.572,6,457,29044,244,69,7376,69,16315,213,69,8454,69,12729
0.524,17,24,15618,13,973,40,1350,13021,11,208,44,1350,2597
1741.907,6,87,6322,58,31,30559,31,3915,29,31,62210,31,2407
15.363,6,6,288,1,0,0,0,48,5,0,3837,0,240
188.598,6,10,3458,4,106,62859,106,274,6,978,37712,1460,3184
0.169,6,46,22026,27,1063,6,1414,17045,19,467,8,1889,4981
180.501,2,3,96,3,8,90250,8,96,0,0,0,0,0
1764.167,2,13,416,13,8,147013,8,416,0,0,0,0,0
8.485,1,8,936,8,89,1212,89,936,0,0,0,0,0
41.002,17,3,228,3,48,20501,48,228,0,0,0,0,0
196.954,6,29,6684,16,168,13130,516,1655,13,450,16405,1452,5029
0.049,17,2,241,1,29,0,29,57,1,156,0,156,184
0.015,6,3,120,1,0,0,0,40,2,0,13,0,80
0.311,6,14,2235,7,507,51,507,831,7,556,51,556,1404
0.855,6,28,6109,14,154,65,267,1644,14,650,58,1452,4465
1.276,6,15,1291,8,222,176,222,772,7,231,203,231,519
1786.837,6,102,8296,68,65,26669,65,4930,34,59,54142,59,3366
1.331,6,52,22502,29,975,47,1440,16806,23,433,51,1440,5696
368.7,6,27,1767,18,177,21688,177,1181,9,110,8627,110,586
1785.752,6,249,28112,100,67,18037,659,9424,149,167,12064,2720,18688
4.126,17,2,144,1,36,0,36,64,1,52,0,52,80
22.214,17,4,352,2,60,22212,60,176,2,60,22212,60,176
42.766,17,8,608,8,48,6109,48,608,0,0,0,0,0
23.323,6,3202,2983132,2064,1367,11,1408,2919292,1138,931,20,2801,63840
1798.753,1,260,14560,260,28,6944,28,14560,0,0,0,0,0
7.922,17,6,528,3,48,3955,48,228,3,72,3955,72,300
1793.476,6,356,22520,208,69,8664,69,12460,148,69,12197,69,10060
1784.25,6,122,12254,77,62,23476,722,6401,45,94,40546,1408,5853
23.443,17,49,14374,22,303,1115,1350,7296,27,234,900,1350,7078
29.39,17,4,352,2,60,29389,60,176,2,60,29389,60,176
1.775,6,47,18628,27,852,68,1360,13052,20,476,81,2715,5576
1788.428,1,60,5040,60,56,30312,56,5040,0,0,0,0,0
1741.651,6,87,6322,58,31,30555,31,3915,29,31,62201,31,2407
5.279,6,5,338,3,138,2639,138,258,2,0,1,0,80
1787.906,6,354,22440,207,69,8679,69,12420,147,69,12245,69,10020
0.117,6,12,965,6,182,23,182,490,6,77,20,134,475
14.647,6,29,8645,15,275,1046,275,1162,14,986,891,1440,7483
1787.145,6,104,8435,69,65,26281,65,4970,35,59,52559,59,3465
0.221,17,8,2750,8,315,31,354,2750,0,0,0,0,0
374.122,1,5,280,5,28,93530,28,280,0,0,0,0,0
1.181,6,25,8080,12,164,91,267,1312,13,869,83,1408,6768
1700.58,17,13,534,11,14,170041,14,462,2,8,1700410,8,72
0.062,17,4,284,2,32,15,32,120,2,54,49,60,164
1741.735,1,56,4704,0,0,0,0,0,56,56,31667,56,4704
2.275,6,2,142,1,0,0,0,40,1,62,0,62,102
240.123,6,45,7944,23,139,10914,346,2050,22,431,11434,1408,5894
0.058,6,2,80,1,0,0,0,40,1,0,0,0,40
21.392,17,48,15467,24,440,928,1350,11238,24,148,928,1350,4229
251.803,2,3,96,3,8,125901,8,96,0,0,0,0,0
253.774,17,4,352,2,60,253773,60,176,2,60,253773,60,176
240.334,6,43,8972,21,524,12016,1418,5817,22,222,11443,618,3155
1770.852,6,101,9278,66,64,27243,64,5544,35,58,52080,58,3734
1793.904,1,72,6048,72,56,25266,56,6048,0,0,0,0,0
6.063,6,41,7349,21,201,303,314,3463,20,440,305,1152,3886
1765.58,1,57,4788,57,56,31528,56,4788,0,0,0,0,0
2.21,17,4,314,2,31,2196,31,118,2,70,2195,70,196
1793.982,6,124,9773,63,38,28932,205,4476,61,36,29896,98,5297
2.648,6,11,988,5,283,614,283,563,6,105,491,105,425
4.984,6,39,7269,20,218,262,314,3423,19,513,262,1179,3846
1717.79,1,8,848,8,78,245398,78,848,0,0,0,0,0
69.227,17,4,240,2,32,69226,32,120,2,32,69226,32,120
0.111,6,47,49801,26,157,4,275,1988,21,2747,4,12618,47813
61.319,6,35,15729,22,790,2919,1448,9055,13,855,5088,3807,6674
2.751,17,4,610,3,39,618,39,201,1,381,0,381,409
0.263,6,4,1037,2,0,225,0,104,2,853,39,853,933
41.479,1,12,1248,0,0,0,0,0,12,76,3770,76,1248
32.939,17,18,1368,18,48,1937,48,1368,0,0,0,0,0
1679.782,17,13,534,11,14,167959,14,462,2,8,1679589,8,72
36.629,17,40,5880,20,48,1927,48,1520,20,190,1927,308,4360
0.399,6,10,1840,5,901,99,901,1169,5,403,99,403,671
204.123,17,4,352,2,60,204122,60,176,2,60,204121,60,176
1779.885,6,78,4108,39,26,46837,26,2054,39,26,46837,26,2054
2.896,17,4,272,2,32,2888,32,120,2,48,2888,48,152
150.571,6,81,51592,49,1188,3136,1448,41767,32,741,3180,2359,9825
360.916,2,3,96,3,8,180458,8,96,0,0,0,0,0
21.805,6,8,456,3,0,10902,0,164,5,0,4206,0,292
1795.505,17,447,39580,403,35,4466,288,25676,44,288,40949,288,13904
247.616,6,55,6715,23,183,11255,630,2892,32,142,7987,580,3823
1794.9,1,174,9744,174,28,10375,28,9744,0,0,0,0,0
366.822,6,27,1767,18,177,21577,177,1181,9,110,8952,110,586
1118.818,6,70,5609,46,66,24862,66,3358,24,58,48631,60,2251
5.615,6,38,7229,20,218,295,314,3423,18,513,314,1179,3806
70.647,6,8,332,4,0,23549,0,164,4,0,23542,0,168
0.395,6,26,8868,13,227,32,547,1592,13,941,30,1438,7276
1741.192,6,90,6552,59,31,30020,31,3998,31,31,58038,31,2554
15.486,6,17,5167,10,133,1720,159,927,7,967,2579,1675,4240
1770.259,6,101,9344,66,65,27234,65,5577,35,59,52063,59,3767
1.569,1,2,270,2,107,1569,121,270,0,0,0,0,0
223.451,1,8,448,8,28,31921,28,448,0,0,0,0,0
251.812,2,2,64,2,8,251812,8,64,0,0,0,0,0
1797.735,6,382,26595,219,97,8246,469,15590,163,69,11095,69,11005
23.365,6,31,8736,15,339,1668,721,2643,16,681,1545,1440,6093
0.016,17,2,516,1,60,0,60,88,1,400,0,400,428
36.189,17,638,66246,622,63,58,200,56776,16,563,0,598,9470
14.786,17,4,824,2,48,14764,48,152,2,308,14744,308,672
1789.065,17,320,76146,320,209,5608,422,76146,0,0,0,0,0
1744.613,2,30,960,30,8,60159,8,960,0,0,0,0,0
332.374,6,96,21167,51,254,6647,1360,11018,45,287,7451,4649,10149
1785.978,6,104,8504,69,66,26264,66,5004,35,60,52525,60,3500
1796.185,17,449,39928,404,35,4457,288,25708,45,288,40019,288,14220
9.688,6,40,7353,18,204,554,314,2974,22,435,449,1152,4379
1700.446,17,12,498,11,14,170044,14,462,1,8,0,8,36
87.895,6,60,14036,26,663,3515,1402,10037,34,143,2167,580,3999
0.012,17,2,399,1,34,0,34,62,1,309,0,309,337
260.281,1,2,220,2,82,260281,88,220,0,0,0,0,0
1798.452,1,234,13104,234,28,7718,28,13104,0,0,0,0,0
3.799,17,2,152,2,48,3799,48,152,0,0,0,0,0
1.288,6,46,18121,26,882,51,1360,12545,20,476,58,2715,5576
0.233,17,3,451,2,39,13,39,134,1,289,0,289,317
1780.147,1,65,5460,65,56,27814,56,5460,0,0,0,0,0
82.119,6,22,9128,11,295,77,578,1359,11,1219,8198,2569,7769
732.118,17,47,3572,47,48,15915,48,3572,0,0,0,0,0
3.11,17,3,186,3,34,1555,34,186,0,0,0,0,0
9.174,17,8,1792,4,46,3053,46,296,4,346,3053,346,1496
5.89,6,43,7429,24,201,256,314,3583,19,513,312,1179,3846
280.195,6,27,7312,13,158,23349,267,1317,14,775,21552,2800,5995
368.316,6,18,1242,14,180,28332,180,916,4,110,20062,110,326
294.59,17,4,352,2,60,294589,60,176,2,60,294589,60,176
0.91,6,27,9091,13,266,75,705,1750,14,943,66,1438,7341
0.284,17,2,154,1,33,0,33,61,1,65,0,65,93
778.781,6,86,11914,42,97,18989,722,4028,44,244,18106,2760,7886
0.089,1,10,840,10,56,9,56,840,0,0,0,0,0
60.672,6,28,6765,11,236,100,477,1390,17,335,3787,1452,5375
1740.499,1,15,840,15,28,124321,28,840,0,0,0,0,0
1421.337,17,169,12844,169,48,8460,48,12844,0,0,0,0,0
60.547,17,4,352,2,60,60546,60,176,2,60,60545,60,176
4.121,17,4,248,4,34,1373,34,248,0,0,0,0,0
7.436,6,26,8632,9,159,927,267,1167,17,564,463,1452,7465
0.023,17,2,401,1,34,0,34,62,1,311,0,311,339
231.155,17,4,558,2,36,231144,36,128,2,187,231149,187,430
38.527,17,22,1936,11,48,3848,48,836,11,72,3846,72,1100
5.457,6,39,7269,20,218,287,314,3423,19,513,287,1179,3846
280.314,6,28,7352,12,158,25483,267,1277,16,603,18680,1400,6075
1799.857,1,161,9016,161,28,11249,28,9016,0,0,0,0,0
0.063,6,9,1340,5,145,15,145,349,4,827,13,827,991
1785.169,6,157,14332,97,61,18595,205,7762,60,59,30253,170,6570
1756.228,6,97,7307,63,38,28326,205,4476,34,33,53213,98,2831
0.485,6,6,248,4,0,161,0,164,2,0,233,0,84
0.2,17,2,204,1,34,0,34,62,1,114,0,114,142
0.025,17,2,499,1,47,0,47,75,1,396,0,396,424
96.838,6,27,7312,13,158,8069,267,1317,14,678,7446,2045,5995
1785.733,6,278,34667,111,148,16232,1440,17419,167,128,10756,1702,17248
0.404,6,12,1653,6,288,76,288,548,6,426,44,434,1105
32.003,6,9,396,2,0,3483,0,88,7,0,5319,0,308
58.274,6,27,7177,13,155,4856,267,1306,14,530,4481,3417,5871
2.611,17,4,1560,4,362,870,362,1560,0,0,0,0,0
174.517,6,23,10009,12,531,67,1360,2637,11,1384,17437,3934,7372
200.245,17,4,352,2,60,200244,60,176,2,60,200243,60,176
175.198,17,2,72,1,8,0,8,36,1,8,0,8,36
2.093,6,24,5755,13,158,172,370,1315,11,999,207,1691,4440
1795.05,17,448,39896,403,35,4465,288,25676,45,288,40016,288,14220
1796.619,6,359,22709,209,69,8637,69,12569,150,69,12056,69,10140
137.903,6,20,2505,11,324,13790,585,1229,9,396,17232,580,1276
10.985,6,20,4350,11,275,1098,275,998,9,992,808,1440,3352
2.03,6,20,3833,11,234,203,564,1504,9,463,223,1343,2329
1623.463,1,7,392,7,28,270577,28,392,0,0,0,0,0
0.334,6,14,3448,8,106,47,106,530,6,866,66,1448,2918
240.201,6,53,18096,29,761,8578,1408,15215,24,203,10443,580,2881
35.853,6,45,13567,21,321,1792,721,3094,24,633,1537,1420,10473
7.004,17,27,14873,13,724,583,1350,9782,14,335,536,1350,5091
1772.915,6,180,15480,120,69,14898,69,8940,60,69,30042,69,6540
280.474,6,31,7472,13,158,23372,267,1317,18,603,16492,2076,6155
2.176,6,7,424,6,0,435,0,372,1,0,0,0,52
318.63,6,9,620,4,106,106210,106,380,5,0,3833,0,240
1681.38,1,19,2825,19,120,93410,320,2825,0,0,0,0,0
370.866,6,23,1538,16,180,24724,180,1056,7,110,10396,110,482
1771.919,6,180,15480,120,69,14890,69,8940,60,69,30031,69,6540
1.09,6,20,5932,11,289,109,568,1312,9,709,124,1380,4620
0.18,6,9,1002,5,213,45,213,417,4,421,48,421,585
0.098,6,10,1669,6,551,19,947,1346,4,159,32,159,323
64.763,6,18,1813,8,177,133,177,955,10,110,7176,110,858
239.387,17,12,1056,6,48,47875,48,456,6,72,47875,72,600
280.332,6,28,7352,12,158,25484,267,1277,16,603,18684,1400,6075
0.224,6,10,1188,5,145,56,145,349,5,635,40,635,839
1742.143,6,95,7203,63,38,28099,205,4476,32,33,56189,98,2727
1798.275,17,449,39928,404,35,4462,288,25708,45,288,40023,288,14220
204.152,17,6,1496,3,32,102073,37,181,3,410,102073,463,1315
1.336,17,2,154,1,33,0,33,61,1,65,0,65,93
299.535,6,6,364,4,31,99845,31,222,2,31,299509,31,142
3.503,17,4,240,2,32,3501,32,120,2,32,3501,32,120
1795.828,17,446,38752,403,35,4467,288,25412,43,282,41925,288,13340
180.51,2,4,128,4,8,60170,8,128,0,0,0,0,0
0.484,6,118,88635,63,131,7,232,3049,55,1737,8,4260,85586
13.262,6,1108,966822,689,1325,18,1368,938370,419,776,31,2736,28452
12.171,6,1834,1635873,1151,1368,10,1380,1603503,683,421,17,1923,32370
1787.267,6,104,8376,68,65,26675,65,4930,36,59,51060,59,3446
38.103,17,11,836,11,48,3810,48,836,0,0,0,0,0
1787.831,6,105,8348,68,64,26684,64,4896,37,58,49659,58,3452
240.211,6,54,17281,29,743,8578,1408,14160,25,226,10008,580,3121
8.159,6,24,9068,13,276,679,528,1382,11,1033,798,1440,7686
1797.549,17,180,14040,180,50,10042,50,14040,0,0,0,0,0
0.032,17,5,1000,3,60,10,60,264,2,340,21,340,736
19.541,17,19,5320,9,281,2429,1350,2786,10,225,2158,1350,2534
1792.871,17,66,2766,65,14,28013,14,2730,1,8,0,8,36
119.651,1,10,840,10,56,13294,56,840,0,0,0,0,0
685.643,1,22,1232,22,28,32649,28,1232,0,0,0,0,0
1.541,17,2,136,1,32,0,32,60,1,48,0,48,76
0.971,6,28,8484,14,266,63,540,1948,14,852,60,1360,6536
10.031,6,80,24970,40,550,257,1152,19229,40,459,250,1179,5741
151.108,17,8,2688,8,308,21586,308,2688,0,0,0,0,0
10.963,6,2,87,1,0,0,0,40,1,7,0,7,47
1781.258,1,58,4872,58,56,31250,56,4872,0,0,0,0,0
61.861,6,73,50256,45,1195,1405,1408,40658,28,903,2282,2816,9598
0.133,6,4,227,1,0,0,0,40,3,31,54,31,187
4.979,6,38,7229,19,218,276,314,3383,19,513,262,1179,3846
1189.677,6,239,16487,138,97,8683,469,9618,101,69,11896,69,6869
1789.391,17,142,11360,71,48,25562,48,5396,71,56,25562,56,5964
1793.671,17,87,3648,86,14,21102,14,3612,1,8,0,8,36
15.968,6,30,5078,16,154,1064,721,1947,14,399,1211,2118,3131
160.914,6,26,10123,15,557,11493,1398,2485,11,1176,16090,2816,7638
2.95,17,2,148,2,46,2950,46,148,0,0,0,0,0
1788.001,6,356,22520,208,69,8637,69,12460,148,69,12163,69,10060
2.375,6,13,2311,8,188,339,245,700,5,1407,531,1407,1611
1757.291,6,189,11567,94,47,18895,208,6837,95,31,18691,31,4730
12.242,17,10,690,5,33,3059,33,305,5,49,3058,49,385
2.05,17,51,38458,21,480,102,1350,10673,30,898,68,1350,27785
1.246,6,73,47454,44,1249,28,1360,41792,29,498,36,1384,5662
1681.381,17,14,1036,7,30,280228,30,406,7,62,280228,62,630
2.492,6,9,379,5,0,623,0,204,4,7,661,7,175
721.977,2,9,288,9,8,90247,8,288,0,0,0,0,0
0.272,17,2,476,1,39,0,39,67,1,381,0,381,409
182.147,1,10,560,10,28,20238,28,560,0,0,0,0,0
0.032,6,10,1823,6,108,6,108,428,4,1179,10,1179,1395
11.583,17,8,704,4,48,3858,48,304,4,72,3857,72,400
0.182,6,9,1339,5,145,45,145,349,4,826,46,826,990
1773.366,6,242,18008,121,69,14778,69,8980,121,34,14777,48,9028
253.575,6,61,14514,27,660,9752,1408,10722,34,144,7683,580,3792
1771.015,6,101,9344,66,65,27246,65,5577,35,59,52084,59,3767
1.932,6,7,295,4,0,644,0,164,3,7,452,7,131
1786.859,6,102,8296,68,65,26669,65,4930,34,59,54143,59,3366
1.22,6,16,2690,8,288,149,288,652,8,568,149,853,2038
1794.034,17,140,11200,70,48,26000,48,5320,70,56,26000,56,5880
17.063,1,20,2080,0,0,0,0,0,20,76,898,76,2080
33.728,6,34,5294,16,154,2248,721,1910,18,271,1971,1368,3384
200.992,17,6,528,3,60,100495,60,264,3,60,100495,60,264
267.845,6,32,8952,14,158,20603,267,1357,18,624,15753,1400,7595
72.735,6,23,9977,13,523,51,1360,2645,10,1384,8066,3934,7332
1750.521,17,12,498,11,14,175052,14,462,1,8,0,8,36
0.042,17,4,352,2,37,35,37,130,2,83,34,89,222
1799.422,17,142,11360,71,48,25705,48,5396,71,56,25705,56,5964
1786.698,6,102,8228,68,64,26667,64,4896,34,58,54139,58,3332
615.981,6,153,38301,76,472,8213,1360,24950,77,205,8102,2720,13351
0.051,17,5,738,3,60,14,60,264,2,209,28,230,474
0.343,6,27,9086,13,262,28,690,1735,14,945,24,1408,7351
300.683,6,41,8758,18,291,17679,787,1929,23,368,13661,3488,6829
0.126,6,11,1971,6,451,25,500,1222,5,481,31,481,749
280.575,6,30,7432,13,158,23381,267,1317,17,603,17526,2076,6115
33.426,6,32,5228,16,180,2228,721,1947,16,305,2215,2026,3281
11.21,6,99,33261,51,611,224,1152,26518,48,401,232,1152,6743
1799.676,1,58,4872,0,0,0,0,0,58,56,31573,56,4872
8.358,17,26,17892,13,625,696,1350,8490,13,695,613,1350,9402
2.464,6,14,2351,8,188,352,245,700,6,703,439,1152,1651
211.958,6,81,50040,46,1184,4710,1448,41497,35,746,1812,1448,8543
1763.324,6,149,9449,81,47,22041,208,5799,68,31,26313,31,3650
0.887,17,2,677,1,300,0,300,328,1,321,0,321,349
11.304,6,18,10653,7,304,1883,517,1013,11,1510,1130,2420,9640
0.017,17,2,459,1,40,0,40,68,1,363,0,363,391
0.006,6,2,483,1,391,0,391,443,1,0,0,0,40
174.528,17,4,352,2,60,174527,60,176,2,60,174526,60,176
14.702,1,4,224,4,28,4900,28,224,0,0,0,0,0
1794.297,17,80,3354,79,14,23003,14,3318,1,8,0,8,36
1772.159,6,180,15480,120,69,14892,69,8940,60,69,30032,69,6540
0.382,6,26,8903,13,234,31,575,1620,13,942,30,1448,7283
0.098,6,2,116,1,0,0,0,64,1,0,0,0,52
5.794,6,65,28252,35,1029,170,1360,22087,30,400,192,1360,6165
254.423,6,33,9061,14,158,19571,267,1357,19,578,14109,1400,7704
221.154,17,4,240,2,32,221153,32,120,2,32,221148,32,120
69.19,6,244,178852,116,1078,54,1440,18693,128,1336,543,1528,160159
153.839,6,37,15796,18,887,77,1360,6125,19,741,8536,1360,9671
1.342,6,29,8212,15,222,80,540,1976,14,944,84,1591,6236
1740.43,17,30,31620,30,1026,60014,1026,31620,0,0,0,0,0
7.492,6,6,340,2,0,7492,0,100,4,0,2401,0,240
1.395,6,41,10563,20,514,73,1440,4947,21,433,60,1440,5616
0.011,17,2,136,1,32,0,32,60,1,48,0,48,76
37.637,6,7,497,0,0,0,0,0,7,31,6272,31,497
1799.181,1,262,14672,262,28,6893,28,14672,0,0,0,0,0
300.598,6,36,8486,20,315,15820,882,2093,16,521,563,2720,6393
0.009,6,2,111,0,0,0,0,0,2,31,9,31,111
1746.725,6,96,7286,63,38,28172,205,4476,33,33,54575,98,2810
1783.61,6,416,24968,208,69,8616,69,12460,208,34,8616,69,12508
0.229,17,2,186,1,33,0,33,61,1,97,0,97,125
0.036,17,4,288,2,33,27,33,122,2,55,28,61,166
4.964,6,35,7584,19,350,275,1152,4615,16,465,313,1179,2969
84.237,6,28,10679,14,519,65,949,2682,14,742,6469,1460,7997
0.036,17,2,124,2,34,36,34,124,0,0,0,0,0
1771.004,1,58,4872,58,56,31070,56,4872,0,0,0,0,0
1.214,6,40,9928,21,440,60,1360,4392,19,476,58,2715,5536
499.541,1,12,672,12,28,45412,28,672,0,0,0,0,0
280.357,6,29,7392,13,158,23363,267,1317,16,603,18684,1400,6075
1.338,6,48,18966,26,941,53,1460,13310,22,433,54,1460,5656
1616.017,17,122,9760,61,48,26933,48,4636,61,56,26933,56,5124
2.918,6,23,5214,11,137,291,267,1132,12,514,264,1467,4082
1776.183,1,58,4872,0,0,0,0,0,58,56,31161,56,4872
1394.324,6,144,10990,80,93,17649,469,6291,64,69,10418,69,4699
2.034,17,23,6818,9,252,254,1350,2526,14,278,126,1350,4292
125.363,6,16,3249,8,92,17909,92,504,8,387,17883,1408,2745
619.189,6,81,6060,31,67,20635,313,2861,50,47,12633,78,3199
4.088,6,18,4809,9,290,511,517,1053,9,1088,356,1418,3756
299.156,6,90,61067,46,686,3615,1460,8748,44,1444,6951,2920,52319
170.448,17,4,352,2,60,170447,60,176,2,60,170447,60,176
6.045,6,1494,1364960,932,1386,6,1408,1331060,562,931,10,2816,33900
0.139,6,2,104,1,0,0,0,40,1,0,0,0,64
436.741,1,18,1512,18,56,25690,56,1512,0,0,0,0,0
156.658,17,25,1900,25,48,6527,48,1900,0,0,0,0,0
1770.474,6,99,9240,66,65,27238,65,5577,33,59,55324,59,3663
53.642,6,11,4106,11,321,5364,421,4106,0,0,0,0,0
1771.724,6,101,9344,66,65,27257,65,5577,35,59,52106,59,3767
0.295,6,27,7296,13,155,24,267,1301,14,603,17,2036,5995
0.032,6,9,1878,5,908,7,908,1176,4,486,8,486,702
0.345,6,27,9069,13,261,28,683,1728,14,943,26,1408,7341
541.399,2,7,224,7,8,90233,8,224,0,0,0,0,0
1773.314,6,203,22290,130,75,13746,267,10057,73,134,24625,1917,12233
110.171,6,50,13030,20,263,3534,1189,2913,30,445,3798,1420,10117
2.883,17,2,81,1,9,0,9,37,1,16,0,16,44
1.15,17,24,9250,12,328,101,1350,4276,12,386,101,1350,4974
0.034,17,2,263,1,36,0,36,64,1,171,0,171,199
1.435,6,40,11338,22,547,68,1360,5842,18,476,73,2720,5496
243.908,6,40,3103,16,67,16260,131,993,24,57,10599,276,2110
4.659,6,40,7309,21,218,232,314,3463,19,513,244,1179,3846
3.932,17,4,352,4,60,1310,60,352,0,0,0,0,0
10.753,6,18,5610,10,275,1194,275,958,8,1440,822,1440,4652
721.903,2,7,224,7,8,120317,8,224,0,0,0,0,0
278.141,17,4,352,2,60,278140,60,176,2,60,278140,60,176
240.4,6,46,9078,24,523,10451,1418,5971,22,217,11445,638,3107
10.209,6,887,776321,538,1397,19,1432,756762,349,475,29,1871,19559
8.985,6,29,6428,14,160,691,293,1846,15,568,622,1179,4582
1772.436,6,180,15480,120,69,14894,69,8940,60,69,30033,69,6540
4.084,17,5,295,5,31,1021,31,295,0,0,0,0,0
0.909,6,5,200,2,0,909,0,80,3,0,95,0,120
0.087,17,2,672,2,308,87,308,672,0,0,0,0,0
80.709,6,37,8791,13,216,340,469,2042,24,304,3508,1420,6749
1.089,17,3,233,2,39,1010,39,134,1,71,0,71,99
218.923,17,4,240,2,32,218922,32,120,2,32,218922,32,120
1770.574,6,99,9174,66,64,27239,64,5544,33,58,55326,58,3630
300.681,6,35,8328,19,286,16704,797,1936,16,521,568,2720,6392
21.702,6,1764,1434724,982,1368,21,1448,1385568,782,776,27,1448,49156
1769.595,1,128,7168,128,28,13933,28,7168,0,0,0,0,0
1401.406,17,12,888,6,30,280277,30,348,6,62,280275,62,540
0.398,6,26,13247,15,174,28,376,1473,11,1399,38,2936,11774
1782.437,17,83,3480,82,14,22005,14,3444,1,8,0,8,36
380.992,6,13,819,4,275,126997,275,439,9,0,14006,0,380
55.241,17,2,72,1,8,0,8,36,1,8,0,8,36
136.24,6,29,7252,12,206,12377,517,1456,17,701,8507,1368,5796
7.094,6,1619,1475398,1010,1382,6,1408,1439066,609,931,11,2801,36332
1.057,6,23,7952,12,164,81,267,1288,11,1216,89,3819,6664
10.189,6,38,8308,20,241,529,619,1834,18,478,591,1928,6474
1786.608,6,102,8364,68,66,26665,66,4964,34,60,54136,60,3400
0.608,6,28,9101,14,205,46,633,1761,14,941,44,1368,7340
1772.527,6,180,15480,120,69,14895,69,8940,60,69,30042,69,6540
33.727,6,31,5093,15,154,2409,722,1859,16,342,2235,1440,3234
21.197,6,37,15131,19,515,1177,1440,4682,18,1048,1173,1440,10449
1740.449,17,28,6580,28,207,64461,207,6580,0,0,0,0,0
39.308,6,25,4742,13,176,3275,722,1729,12,793,3152,1408,3013
0.722,1,30,840,30,0,0,0,840,0,0,0,0,0
20.852,17,30,2235,19,40,1157,41,1304,11,56,1500,57,931
0.012,17,2,245,1,32,0,32,60,1,157,0,157,185
299.535,6,7,404,4,31,99845,31,222,3,31,149763,31,182
87.023,6,24,9863,12,410,65,922,1742,12,953,7897,1696,8121
240.059,6,185,179676,66,238,3693,517,4634,119,1592,2034,5608,175042
504.115,2,4,128,4,8,168038,8,128,0,0,0,0,0
1.104,6,24,6416,13,299,92,838,2019,11,988,109,1731,4397
1790.849,1,58,4872,0,0,0,0,0,58,56,31418,56,4872
66.005,6,27,7177,13,155,5500,267,1306,14,530,5076,3417,5871
1792.417,17,86,3606,85,14,21338,14,3570,1,8,0,8,36
1704.19,6,273,18303,165,74,10391,138,10947,108,69,12085,69,7356
0.145,17,2,1920,2,932,145,932,1920,0,0,0,0,0
0.015,17,4,613,2,30,3,31,117,2,220,1,244,496
289.173,6,254,40971,144,304,2022,304,28980,110,83,2652,83,11991
0.393,6,45,17199,25,857,16,1380,12166,20,467,18,1923,5033
6.862,6,606,531899,383,1325,17,1368,515639,223,776,29,1473,16260
340.4,17,5,1694,5,310,85100,322,1694,0,0,0,0,0
1774.785,1,58,4872,0,0,0,0,0,58,56,31136,56,4872
0.231,17,2,2386,2,1165,231,1165,2386,0,0,0,0,0
0.358,1,2,112,2,28,358,28,112,0,0,0,0,0
240.304,6,46,9208,24,519,10447,1402,5934,22,235,11442,619,3274
1.32,6,50,19550,27,910,50,1460,13854,23,433,52,1460,5696
0.671,6,14,2181,8,324,95,585,1061,6,396,129,580,1120
1720.591,17,13,534,11,14,172041,14,462,2,8,1720409,8,72
0.352,17,2,304,1,60,0,60,88,1,188,0,188,216
1797.798,17,449,39928,404,35,4461,288,25708,45,288,40021,288,14220
1758.556,6,3836,3801012,1212,148,1452,972,70882,2624,1408,670,2836,3730130
1706.831,1,8,448,8,28,243833,28,448,0,0,0,0,0
0.343,17,8,2742,8,314,49,353,2742,0,0,0,0,0
128.443,6,7,379,3,0,64221,0,152,4,7,42751,7,227
300.969,6,43,15351,23,977,13680,1460,9749,20,399,457,1460,5602
1789.951,6,384,26675,219,97,8210,469,15659,165,69,10914,69,11016
1796.147,17,449,39928,404,35,4456,288,25708,45,288,40019,288,14220
1.078,6,2,120,2,0,0,0,120,0,0,0,0,0
280.517,6,28,7352,12,158,25501,267,1277,16,603,18698,1400,6075
1787.7,17,87,3648,86,14,21031,14,3612,1,8,0,8,36
0.581,17,2,160,2,52,581,52,160,0,0,0,0,0
37.892,17,22,1936,11,48,3788,48,836,11,72,3788,72,1100
1799.645,17,449,39928,404,35,4465,288,25708,45,288,40019,288,14220
280.222,6,26,7272,12,158,25474,267,1277,14,775,21552,3445,5995
301.808,6,106,90417,41,134,7545,192,2676,65,1405,3767,2876,87741
1768.847,1,58,4872,58,56,31032,56,4872,0,0,0,0,0
4.987,17,4,558,2,36,4982,36,128,2,187,4982,187,430
18.495,17,26,10906,13,581,1541,1350,7917,13,201,1461,1350,2989
1.663,17,22,10050,10,362,184,1350,3905,12,484,144,1350,6145
1679.139,1,8,448,8,28,239877,28,448,0,0,0,0,0
217.501,6,72,47074,44,1180,5058,1408,38886,28,960,2279,3847,8188
0.002,17,2,206,1,43,0,43,71,1,107,0,107,135
18.907,17,4,3633,4,880,6302,1444,3633,0,0,0,0,0
300.593,6,36,8338,19,278,16699,734,1905,17,478,528,1928,6433
327.587,1,8,1016,8,99,46798,222,1016,0,0,0,0,0
1784.451,6,369,23385,212,69,8457,69,12965,157,69,11438,69,10420
39.959,1,4,224,4,28,13319,28,224,0,0,0,0,0
24.514,6,3373,3038860,2107,1361,11,1408,2968364,1266,931,19,2801,70496
1.983,6,23,7952,12,164,160,267,1288,11,1216,178,3859,6664
63.5,17,11,3696,11,308,6350,308,3696,0,0,0,0,0
56.201,6,11,3836,11,296,5620,391,3836,0,0,0,0,0
1788.599,6,413,24800,207,69,8682,69,12420,206,35,8724,69,12380
0.422,17,2,304,1,60,0,60,88,1,188,0,188,216
28.767,6,41,8557,20,161,1514,721,2264,21,544,1278,1420,6293
1777.756,17,79,3312,78,14,23087,14,3276,1,8,0,8,36
704.148,17,11,2753,11,222,70414,370,2753,0,0,0,0,0
1784.224,1,345,28980,345,56,5186,56,28980,0,0,0,0,0
19.454,6,90,22967,45,417,442,1152,15582,45,429,436,1179,7385
22.295,17,23,6700,10,388,2473,1350,4169,13,166,1855,1350,2531
0.271,6,24,5987,12,164,24,453,1442,12,652,23,1448,4545
189.941,17,4,240,2,32,189940,32,120,2,32,189940,32,120
8.172,6,24,6812,7,156,1362,267,758,17,447,481,1420,6054
48.755,17,4,240,2,32,48753,32,120,2,32,48754,32,120
23.994,6,18,1407,9,222,2996,222,808,9,231,2996,231,599
1776.255,17,73,3060,72,14,25017,14,3024,1,8,0,8,36
1787.04,6,387,32159,216,95,8311,1189,15357,171,136,10511,1997,16802
8.353,6,1722,1573134,1082,1375,7,1408,1535190,640,931,12,2816,37944
1.861,17,48,36534,20,372,97,1350,8018,28,990,61,1350,28516
2.321,6,23,3545,12,167,211,293,1490,11,537,206,1179,2055
2.238,17,23,11024,10,380,248,1350,4087,13,505,125,1350,6937
5.294,6,15,2391,8,188,756,245,700,7,703,837,1152,1691
0.45,6,54,23154,30,981,15,1380,17940,24,421,18,1923,5214
34.789,17,11,836,11,48,3478,48,836,0,0,0,0,0
0.266,17,2,290,1,40,0,40,68,1,194,0,194,222
1.169,17,22,9454,10,532,129,1350,5603,12,292,82,1350,3851
1786.996,6,102,8364,68,66,26671,66,4964,34,60,54147,60,3400
45.426,6,13,3118,4,92,15142,92,296,9,1165,5649,1448,2822
0.023,17,2,550,2,247,23,247,550,0,0,0,0,0
1741.364,17,30,31680,30,1028,60047,1028,31680,0,0,0,0,0
1779.335,17,142,11360,71,48,25418,48,5396,71,56,25418,56,5964
1479.871,6,150,12900,97,69,15415,69,7192,53,69,28435,69,5708
240.48,6,11,720,5,112,60120,112,432,6,0,6313,0,288
123.629,6,63,41051,40,1149,3169,1408,33122,23,960,2794,3847,7929
4.278,6,39,7269,19,218,237,314,3383,20,513,211,1179,3886
1708.811,1,49,4116,49,56,35600,56,4116,0,0,0,0,0
1734.467,6,118,14236,77,85,22821,498,6243,41,162,43359,1420,7993
0.015,6,5,296,4,0,2,0,244,1,0,0,0,52
74.262,17,4,352,2,60,74261,60,176,2,60,74261,60,176
921.045,6,85,9418,47,84,20022,721,4313,38,111,22500,1448,5105
2.64,17,2,128,2,36,2640,36,128,0,0,0,0,0
0.417,6,54,23091,29,1048,14,1380,15926,25,511,15,1923,7165
1385.605,6,276,17457,160,69,8714,69,9643,116,69,12048,69,7814
129.854,6,128,98524,82,1306,1603,1448,86559,46,637,2628,1448,11965
132.529,17,4,352,2,60,132528,60,176,2,60,132528,60,176
1385.601,2,8,256,8,8,197943,8,256,0,0,0,0,0
361.454,6,47,10175,29,266,12909,1360,4653,18,399,509,1360,5522
1797.25,1,58,4872,0,0,0,0,0,58,56,31530,56,4872
3.47,17,5,290,5,30,867,30,290,0,0,0,0,0
1.094,6,24,8004,11,164,92,267,1236,13,869,77,1448,6768
1.302,6,50,21081,28,951,48,1360,15425,22,476,53,2715,5656
1780.629,17,140,11200,70,48,25806,48,5320,70,56,25806,56,5880
2.974,6,12,507,6,0,591,0,248,6,7,552,7,259
15.432,17,19,13733,12,946,1399,1350,11699,7,262,2565,1350,2034
1462.701,17,110,8784,57,48,26119,48,4332,53,56,26099,56,4452
0.035,17,2,162,1,36,0,36,64,1,70,0,70,98
0.031,17,4,1116,2,32,26,32,120,2,470,26,470,996
1.638,6,37,8006,19,349,90,1420,2510,18,477,95,1485,5496
9.822,6,84,25482,43,579,233,1152,19701,41,459,238,1179,5781
1756.737,6,102,7970,66,45,27026,205,4902,36,35,50180,98,3068
1763.552,2,15,480,15,8,125968,8,480,0,0,0,0,0
125.39,6,15,3196,7,92,20898,92,452,8,387,17885,1448,2744
1769.012,1,54,4536,0,0,0,0,0,54,56,33377,56,4536
0.756,6,10,1687,7,100,126,100,384,3,1179,255,1179,1303
1794.289,1,252,14112,252,28,7148,28,14112,0,0,0,0,0
0.255,17,3,265,2,39,0,39,134,1,103,0,103,131
1799.319,6,273,28742,159,105,11388,469,13834,114,123,15923,2840,14908
371.357,6,19,1303,14,177,28565,177,925,5,110,15164,110,378
1513.523,17,120,9600,60,48,25652,48,4560,60,56,25652,56,5040
16.121,6,16,1327,8,222,2301,222,768,8,231,2301,231,559
1744.703,2,24,768,24,8,75856,8,768,0,0,0,0,0
0.259,17,16,12179,8,997,35,1350,8207,8,468,31,1350,3972
62.252,6,29,7326,13,141,5187,267,1375,16,441,4139,1452,5951
601.612,2,6,192,6,8,120322,8,192,0,0,0,0,0
0.017,17,4,524,2,39,1,39,134,2,167,1,167,390
5.594,6,40,7309,21,218,279,314,3463,19,513,296,1179,3846
11.481,6,1809,1586584,1103,1385,10,1420,1554123,706,526,16,3303,32461
0.963,6,26,9892,14,350,74,1041,1992,12,1234,71,2570,7900
1797.202,1,55,4620,55,56,33281,56,4620,0,0,0,0,0
0.237,6,4,1037,2,0,218,0,104,2,853,20,853,933
1783.614,1,57,4788,0,0,0,0,0,57,56,31850,56,4788
1770.981,6,99,9306,66,66,27245,66,5610,33,60,55339,60,3696
42.119,17,24,2112,12,48,3828,48,912,12,72,3828,72,1200
1789.954,6,370,25770,214,99,8403,469,15114,156,69,11548,69,10656
1796.077,17,29,9512,29,300,64145,300,9512,0,0,0,0,0
36.68,17,16,2352,8,48,5238,48,608,8,190,5238,308,1744
2.01,17,3,201,3,39,1005,39,201,0,0,0,0,0
1770.75,6,99,9240,66,65,27242,65,5577,33,59,55333,59,3663
0.048,17,2,198,1,39,0,39,67,1,103,0,103,131
183.834,1,3,358,3,91,91917,105,358,0,0,0,0,0
3.498,17,5,290,5,30,874,30,290,0,0,0,0,0
0.319,6,30,9256,14,252,24,647,1756,16,831,21,1408,7500
1.607,6,50,18821,27,858,61,1360,13125,23,433,63,1360,5696
1745.802,6,95,7203,63,38,28158,205,4476,32,33,56302,98,2727
7.413,6,769,687171,463,1417,15,1448,666337,306,702,23,1448,20834
0.441,6,27,8949,13,227,36,547,1592,14,827,30,1438,7357
0.283,17,2,266,1,41,0,41,69,1,169,0,169,197
366.828,6,25,1651,17,177,22926,177,1117,8,110,9188,110,534
645.283,6,154,17118,78,131,7655,1189,6406,76,186,8603,1420,10712
1790.927,17,323,72822,323,197,5561,422,72822,0,0,0,0,0
83.628,6,55,20372,25,797,1173,1271,9775,30,426,2881,1420,10597
20.619,17,41,23488,24,675,896,1350,16895,17,359,1286,1350,6593
0.362,17,2,144,1,36,0,36,64,1,52,0,52,80
1797.33,17,448,39612,404,35,4459,288,25708,44,288,40949,288,13904
1770.322,6,99,9306,66,66,27235,66,5610,33,60,55309,60,3696
0.821,6,26,5887,13,156,68,267,1462,13,650,62,1420,4425
1751.099,6,98,7452,59,39,27995,205,4206,39,32,46077,98,3246
9.282,6,27,11505,15,283,663,582,1454,12,1063,826,1420,10051
554.887,1,11,616,11,28,55488,28,616,0,0,0,0,0
125.415,6,15,3197,8,92,17916,92,504,7,465,20870,2026,2693
1786.427,6,102,8364,68,66,26663,66,4964,34,60,54131,60,3400
0.237,17,2,152,1,48,0,48,76,1,48,0,48,76
1790.898,6,395,30453,222,75,8103,267,14220,173,134,10411,2077,16233
0.009,6,3,120,1,0,0,0,40,2,0,8,0,80
561.136,17,6,444,3,30,280528,30,174,3,62,280539,62,270
0.381,17,2,172,1,50,0,50,78,1,66,0,66,94
184.199,17,6,528,3,60,92099,60,264,3,60,92098,60,264
1783.348,17,83,3480,82,14,22016,14,3444,1,8,0,8,36
0.378,17,4,368,2,32,363,32,120,2,96,364,96,248
315.906,6,69,19810,38,345,8538,1360,10543,31,421,10525,4649,9267
0.995,6,24,9448,13,278,82,471,1677,11,1045,81,2264,7771
0.68,17,6,4318,3,909,340,1350,2812,3,474,295,1350,1506
11.063,6,15,2896,5,256,2763,256,972,10,304,1228,304,1924
0.012,6,10,859,6,181,2,181,489,4,77,3,133,370
120.29,2,3,96,3,8,60145,8,96,0,0,0,0,0
1786.577,17,87,3648,86,14,21018,14,3612,1,8,0,8,36
280.428,6,30,7432,13,158,23369,267,1317,17,678,17522,2760,6115
74.507,6,715,343738,383,832,195,1152,324953,332,392,224,1152,18785
280.017,6,27,7312,12,158,25456,267,1277,15,678,19998,2045,6035
240.285,6,43,6239,20,250,12646,582,2823,23,245,10921,598,3416
2.02,6,31,10043,17,684,126,1114,3673,14,626,154,1408,6370
1724.102,6,24,3624,16,241,114940,241,2568,8,92,246274,92,1056
1.165,6,25,8056,12,164,89,267,1288,13,869,82,1448,6768
1785.338,6,388,24973,221,69,8115,69,13808,167,69,10755,69,11165
0.515,17,3,451,2,39,240,39,134,1,289,0,289,317
280.028,6,30,7432,14,158,21540,267,1357,16,603,18666,2036,6075
1.901,6,26,8825,16,288,126,598,1510,10,987,188,1420,7315
24.286,6,29,7392,13,158,2023,267,1317,16,603,1617,1400,6075
1719.463,17,12,498,11,14,171946,14,462,1,8,0,8,36
6.793,6,66,24518,35,940,199,1460,13772,31,499,212,1460,10746
1159.703,1,122,12932,122,78,9584,78,12932,0,0,0,0,0
1792.353,6,242,60695,135,641,13374,1258,47730,107,127,16907,384,12965
1741.199,6,87,6322,58,31,30547,31,3915,29,31,62185,31,2407
91.904,6,31,7472,14,158,7069,267,1357,17,543,5742,1400,6115
125.487,6,32,8276,10,147,13942,267,1591,22,341,5975,3417,6685
1770.042,6,101,9410,66,66,27231,66,5610,35,60,52057,60,3800
1750.624,17,12,498,11,14,175062,14,462,1,8,0,8,36
203.174,6,213,166949,135,1304,1516,1408,150566,78,615,2486,2439,16383
0.085,6,9,1344,5,145,21,145,349,4,831,24,831,995
1786.248,6,150,19350,90,302,20070,302,13740,60,83,30275,83,5610
4.165,17,14,14097,5,836,1041,1350,4323,9,1058,377,1350,9774
0.103,1,2,112,2,28,103,28,112,0,0,0,0,0
0.991,17,2,782,2,363,991,363,782,0,0,0,0,0
0.195,6,22,4467,11,165,19,456,1394,11,498,18,888,3073
1797.113,17,449,39928,404,35,4459,288,25708,45,288,40022,288,14220
1738.481,6,87,6322,58,31,30499,31,3915,29,31,62088,31,2407
263.796,17,4,352,2,60,263795,60,176,2,60,263795,60,176
1237.649,17,15,5664,15,349,88403,548,5664,0,0,0,0,0
0.016,17,4,344,2,47,0,47,150,2,69,6,75,194
7.214,6,16,1331,8,222,1029,222,768,8,231,1028,231,563
1787.203,6,102,8296,68,65,26674,65,4930,34,59,54153,59,3366
1.387,6,50,19690,27,920,53,1460,13994,23,433,55,1460,5696
280.382,6,28,7352,13,158,23365,267,1317,15,603,20023,2076,6035
62.599,6,27,7177,13,155,5216,267,1306,14,530,4814,3417,5871
115.528,2,2,64,2,8,115528,8,64,0,0,0,0,0
20.136,6,22,5981,13,107,1678,159,1138,9,873,2515,2816,4843
0.738,6,15,1785,8,288,95,288,640,7,426,93,434,1145
240.305,6,48,9620,25,524,10012,1418,6037,23,237,10922,618,3583
1764.67,1,149,8344,149,28,11923,28,8344,0,0,0,0,0
125.099,1,16,896,16,28,8339,28,896,0,0,0,0,0
3.176,17,4,610,3,39,827,39,201,1,381,0,381,409
0.035,17,2,288,1,59,0,59,87,1,173,0,173,201
1799.873,17,449,39928,404,35,4466,288,25708,45,288,40016,288,14220
1.335,6,47,18954,26,943,53,1440,13338,21,433,57,1440,5616
1793.386,17,141,11276,71,48,25609,48,5396,70,56,25962,56,5880
1798.334,6,370,25839,215,99,8403,469,15154,155,69,11676,69,10685
550.396,17,19,798,19,14,30577,14,798,0,0,0,0,0
180.52,17,4,352,2,60,180518,60,176,2,60,180519,60,176
0.034,17,2,136,1,32,0,32,60,1,48,0,48,76
0.11,6,10,1495,5,507,27,507,727,5,556,27,556,768
12.236,17,20,3400,10,33,1359,33,610,10,251,1358,323,2790
1.37,6,48,18873,26,934,54,1460,13217,22,433,56,1460,5656
1770.167,6,481,179396,234,744,7596,1440,151557,247,195,7195,1440,27839
1.406,6,51,19535,27,906,54,1460,13799,24,433,52,1460,5736
24.987,6,40,8772,20,378,457,786,1990,20,426,1307,1360,6782
80.623,17,4,240,2,32,80622,32,120,2,32,80622,32,120
0.011,17,2,158,1,34,0,34,62,1,68,0,68,96
1782.797,17,83,3480,82,14,22009,14,3444,1,8,0,8,36
1128.906,17,10,2745,5,30,282220,30,290,5,463,282224,463,2455
238.953,1,5,420,5,56,59738,56,420,0,0,0,0,0
1.669,6,27,10125,16,276,111,560,1472,11,1026,149,1420,8653
1208.886,17,225,17100,225,48,5396,48,17100,0,0,0,0,0
467.702,17,118,10592,106,36,4454,288,6800,12,288,40015,288,3792
8.41,6,23,10842,11,275,841,275,723,12,1203,741,1420,10119
0.166,6,3,453,2,241,166,241,321,1,92,0,92,132
0.004,17,2,419,1,37,0,37,65,1,326,0,326,354
12.131,6,1899,1657762,1146,1391,10,1420,1623421,753,467,16,1883,34341
1.406,6,49,20881,28,940,52,1360,15265,21,433,60,1360,5616
1790.096,6,223,17959,135,69,13358,69,9747,88,69,20575,69,8212
0.185,17,2,279,1,36,0,36,64,1,187,0,187,215
1795.337,17,449,39928,404,35,4454,288,25708,45,288,40022,288,14220
1789.802,6,245,24812,98,67,18450,659,9278,147,126,12258,1638,15534
39.388,6,16,4886,10,290,4376,517,1109,6,1152,7875,1469,3777
123.741,6,34,7935,12,155,27,267,1266,22,340,5892,3417,6669
7.957,6,18,6767,9,275,994,275,643,9,1150,698,1414,6124
1395.461,6,104,10564,59,64,24057,722,4949,45,105,31711,2328,5615
243.536,1,14,616,14,16,18733,16,616,0,0,0,0,0
0.061,17,2,2754,2,1349,61,1349,2754,0,0,0,0,0
0.98,6,10,1687,7,100,163,100,384,3,1179,358,1179,1303
1700.664,17,12,498,11,14,170066,14,462,1,8,0,8,36
1794.06,6,365,23087,211,69,8543,69,12787,154,69,11725,69,10300
1788.37,6,356,22520,208,69,8639,69,12460,148,69,12165,69,10060
1787.801,17,73,3060,72,14,25180,14,3024,1,8,0,8,36
0.171,17,2,148,1,32,0,32,60,1,60,0,60,88
10.008,2,3,96,3,8,5004,8,96,0,0,0,0,0
1564.744,6,396,53465,194,171,8107,925,34838,202,219,7783,1414,18627
1771.211,6,109,10068,70,65,25669,65,6045,39,59,46607,59,4023
46.276,17,4,240,2,32,46274,32,120,2,32,46275,32,120
1798.231,17,448,39896,403,35,4473,288,25676,45,288,40017,288,14220
31.523,6,7,336,1,0,0,0,48,6,0,6302,0,288
0.292,1,6,624,0,0,0,0,0,6,76,58,76,624
0.53,6,6,248,4,0,176,0,164,2,0,289,0,84
6.594,6,602,528785,378,1331,16,1368,512473,224,665,28,1368,16312
1797.994,6,356,22520,208,69,8685,69,12460,148,69,12231,69,10060
74.588,6,88,28190,41,686,1860,1360,16882,47,460,1617,1360,11308
0.412,6,112,87824,61,131,6,232,2969,51,1800,8,4260,84855
0.947,17,19,7401,9,496,118,1350,4721,10,240,99,1350,2680
299.51,6,23,1292,12,31,27228,31,635,11,31,29949,31,657
1259.638,2,8,256,8,8,179948,8,256,0,0,0,0,0
1776.929,17,140,11200,70,48,25752,48,5320,70,56,25752,56,5880
5.766,17,12,852,6,32,1151,32,360,6,54,1151,60,492
0.606,17,4,624,2,64,284,64,184,2,192,273,192,440
51.121,6,43,23733,16,247,3399,692,2433,27,1345,1961,1440,21300
1651.65,1,8,848,8,78,235950,78,848,0,0,0,0,0
1744.757,2,26,832,26,8,69790,8,832,0,0,0,0,0
0.048,6,14,4044,8,88,6,88,452,6,1670,9,1880,3592
1792.968,17,180,14040,180,50,10016,50,14040,0,0,0,0,0
11.263,6,1841,1566602,1106,1361,10,1380,1532960,735,421,15,1923,33642
1791.29,6,356,22520,208,69,8653,69,12460,148,69,12185,69,10060
9.094,6,53,24003,29,1133,324,1360,18210,24,401,384,2667,5793
240.185,6,53,17346,28,759,8895,1408,14382,25,207,10007,580,2964
1681.464,17,14,3843,7,30,280242,30,406,7,463,280242,463,3437
0.06,17,2,214,1,39,0,39,67,1,119,0,119,147
7.332,6,5,220,1,0,0,0,44,4,0,2415,0,176
1773.3,6,181,15589,120,69,14901,69,8940,61,69,29548,69,6649
1105.956,1,16,1696,16,78,73730,78,1696,0,0,0,0,0
1781.892,17,44,14784,44,308,41439,308,14784,0,0,0,0,0
0.093,6,9,1346,5,145,23,145,349,4,833,23,833,997
117.254,6,125,97309,81,1271,1465,1408,86897,44,676,2418,1408,10412
2.149,6,30,6189,14,154,165,267,1644,16,650,131,1452,4545
1758.527,17,334,67131,334,172,5280,422,67131,0,0,0,0,0
131.521,6,18,3393,6,92,134,92,412,12,261,11938,1408,2981
35.408,17,40,5880,20,48,1862,48,1520,20,190,1862,308,4360
1799.604,17,142,11360,71,48,25708,48,5396,71,56,25708,56,5964
5.022,17,4,288,2,36,4998,36,128,2,52,5004,52,160
4.739,6,40,7309,20,218,249,314,3423,20,440,236,1152,3886
0.892,17,2,245,1,32,0,32,60,1,157,0,157,185
9.376,6,12,3074,6,92,1875,92,412,6,2330,1839,2330,2662
1750.472,6,110,9186,72,58,24654,205,5748,38,38,47300,98,3438
20.196,17,4,240,2,32,20195,32,120,2,32,20195,32,120
0.108,17,2,574,1,32,0,32,60,1,486,0,486,514
1741.482,6,95,6867,61,31,29024,31,4145,34,31,52771,31,2722
1691.659,1,7,392,7,28,281943,28,392,0,0,0,0,0
0.501,17,3,451,2,39,116,39,134,1,289,0,289,317
43.28,17,4,352,2,60,43279,60,176,2,60,43279,60,176
1770.246,1,58,4872,58,56,31056,56,4872,0,0,0,0,0
1.128,6,2651,2783259,831,183,1,230,45233,1820,1454,0,4344,2738026
240.631,6,41,9235,18,272,14153,681,2853,23,575,10931,1497,6382
5.846,6,892,791123,557,1348,10,1368,769039,335,931,16,2736,22084
0.01,6,2,80,1,0,0,0,40,1,0,0,0,40
4.805,17,5,320,5,36,1201,36,320,0,0,0,0,0
1792.184,17,29,9512,29,300,64006,300,9512,0,0,0,0,0
0.074,17,2,180,1,30,0,30,58,1,94,0,94,122
8.368,6,1793,1660087,1141,1377,7,1408,1621519,652,931,12,2801,38568
1765.13,1,55,4620,55,56,32687,56,4620,0,0,0,0,0
0.27,6,12,3705,6,171,53,171,491,6,964,53,1448,3214
1771.383,17,44,14784,44,308,41194,308,14784,0,0,0,0,0
0.047,17,2,574,1,32,0,32,60,1,486,0,486,514
31.466,6,7,308,1,0,0,0,44,6,0,6275,0,264
1790.127,1,58,4872,58,56,31405,56,4872,0,0,0,0,0
1744.841,2,30,960,30,8,60166,8,960,0,0,0,0,0
1743.252,6,96,7255,62,38,28577,205,4424,34,33,52818,98,2831
385.071,6,18,1242,14,180,29620,180,916,4,110,20069,110,326
8.369,6,14,2245,8,211,1192,211,846,6,545,1673,904,1399
51.612,17,4,240,2,32,51611,32,120,2,32,51611,32,120
15.867,17,19,12441,11,913,1580,1350,10358,8,232,2256,1350,2083
0.844,17,2,672,2,308,844,308,672,0,0,0,0,0
0.137,6,2,170,1,0,0,0,40,1,90,0,90,130
1781.35,6,106,8456,68,65,26587,65,4930,38,59,48142,59,3526
1796.824,17,412,138432,412,308,4371,308,138432,0,0,0,0,0
1785.844,6,102,8228,68,64,26654,64,4896,34,58,54113,58,3332
237.154,6,42,13426,27,387,9121,1360,6537,15,784,16926,3497,6889
0.001,6,2,111,1,0,0,0,40,1,31,0,31,71
374.649,6,18,1242,14,180,28819,180,916,4,110,20065,110,326
7.55,6,1733,1456560,949,1436,7,1448,1403530,784,792,9,1448,53030
194.992,6,14,784,6,0,38995,0,312,8,56,27846,56,472
1.361,17,2,152,1,48,0,48,76,1,48,0,48,76
99.695,6,30,14753,15,576,76,1360,3513,15,1180,7109,2720,11240
1772.853,1,59,4956,59,56,30566,56,4956,0,0,0,0,0
189.502,6,32,7929,11,131,18949,267,1502,21,348,9474,1460,6427
315.772,17,6,1968,6,300,63154,308,1968,0,0,0,0,0
8.768,1,9,756,0,0,0,0,0,9,56,1096,56,756
1793.392,1,58,4872,58,56,31463,56,4872,0,0,0,0,0
1742.992,6,95,7203,63,38,28112,205,4476,32,33,56213,98,2727
10.986,6,22,4526,12,275,998,275,1038,10,768,690,1440,3488
831.945,1,18,1908,18,78,48937,78,1908,0,0,0,0,0
35.727,17,3,228,3,48,17863,48,228,0,0,0,0,0
1795.905,17,443,39168,399,35,4512,288,25264,44,288,40957,288,13904
8.043,6,31,7472,14,158,618,267,1357,17,543,500,1400,6115
0.338,1,2,112,2,28,338,28,112,0,0,0,0,0
10.081,17,4,5484,4,1343,3360,1348,5484,0,0,0,0,0
14.219,6,15,1242,5,213,3554,213,417,10,421,1578,421,825
177.929,6,24,11528,12,541,81,1360,2709,12,1387,16163,3934,8819
0.329,6,26,8868,13,227,27,547,1592,13,941,26,1408,7276
0.25,6,2,1520,1,0,0,0,40,1,1440,0,1440,1480
267.132,6,73,47202,44,1182,6212,1448,38965,29,746,2201,1448,8237
0.85,6,43,26035,20,727,44,1360,3755,23,1186,32,1708,22280
83.412,17,4,1344,4,308,27804,308,1344,0,0,0,0,0
34.834,17,4,352,2,60,34833,60,176,2,60,34833,60,176
1787.098,6,103,8401,69,65,26280,65,5035,34,59,54150,59,3366
1783.585,1,336,28224,336,56,5324,56,28224,0,0,0,0,0
6.232,2,2,64,2,8,6232,8,64,0,0,0,0,0
1732.45,1,8,448,8,28,247492,28,448,0,0,0,0,0
1.509,6,50,21523,29,919,53,1360,15907,21,476,65,2715,5616
1745.253,6,95,7203,63,38,28149,205,4476,32,33,56290,98,2727
781.832,2,7,224,7,8,130305,8,224,0,0,0,0,0
1772.207,6,180,15480,120,69,14892,69,8940,60,69,30035,69,6540
1755.894,6,105,6240,60,26,29760,26,3510,45,26,39905,26,2730
0.008,17,2,375,1,44,0,44,72,1,275,0,275,303
15.356,6,15,6152,4,222,5074,222,402,11,1059,1522,4080,5750
21.914,6,14,1025,7,222,3650,222,506,7,231,3650,231,519
1656.202,1,7,392,7,28,276033,28,392,0,0,0,0,0
0.991,17,17,9427,9,741,123,1350,6929,8,284,119,1350,2498
1758.74,17,226,48687,226,187,7816,342,48687,0,0,0,0,0
2.025,17,3,222,3,46,1012,46,222,0,0,0,0,0
1.896,17,2,120,2,32,1896,32,120,0,0,0,0,0
126.628,6,33,7757,12,155,29,267,1266,21,352,6331,2840,6491
751.518,6,78,6708,52,69,14735,69,3874,26,69,30051,69,2834
8.345,6,42,9700,21,450,417,766,2685,21,362,380,1360,7015
1.186,17,2,152,1,48,0,48,76,1,48,0,48,76
0.036,6,16,6004,8,88,5,88,452,8,1305,5,1880,5552
1741.373,6,87,6322,58,31,30550,31,3915,29,31,62189,31,2407
1795.757,1,342,28728,342,56,5266,56,28728,0,0,0,0,0
4.058,17,5,300,5,32,1014,32,300,0,0,0,0,0
1649.12,1,8,848,8,78,235588,78,848,0,0,0,0,0
1795.407,17,140,11200,70,48,26020,48,5320,70,56,26020,56,5880
0.153,6,10,1380,6,145,30,145,389,4,827,46,827,991
843.083,6,9,1240,9,110,105385,110,1240,0,0,0,0,0
1743.635,6,95,7203,63,38,28123,205,4476,32,33,56233,98,2727
0.774,6,18,5172,10,150,86,174,704,8,828,97,1420,4468
32.233,6,26,8036,9,154,4029,267,832,17,651,2013,1420,7204
280.311,6,29,7392,13,158,23359,267,1317,16,603,18681,1400,6075
1797.544,6,375,26577,217,104,8321,469,15772,158,69,11448,69,10805
1.573,17,2,778,2,361,1573,361,778,0,0,0,0,0
0.241,6,9,1002,5,213,60,213,417,4,421,60,421,585
0.056,17,2,389,1,34,0,34,62,1,299,0,299,327
0.37,6,28,7048,17,244,23,656,2394,11,701,36,1728,4654
16.18,6,13,2133,8,324,2311,585,1073,5,396,3979,580,1060
1682.657,17,18,1494,9,31,210324,37,536,9,78,210324,136,958
281.462,6,58,8984,27,158,10825,267,1877,31,586,9379,2800,7107
1792.52,17,142,11360,71,48,25607,48,5396,71,56,25607,56,5964
0.015,6,3,160,2,0,15,0,100,1,0,0,0,60
2.989,17,3,1021,2,308,1992,308,672,1,321,0,321,349
915.171,6,112,9030,44,60,21283,148,2860,68,62,13656,414,6170
20.553,17,4,1344,4,308,6851,308,1344,0,0,0,0,0
0.06,17,4,284,2,32,0,32,120,2,54,7,60,164
1779.88,17,142,11360,71,48,25426,48,5396,71,56,25426,56,5964
188.584,17,8,2688,8,308,26940,308,2688,0,0,0,0,0
95.171,2,8,320,8,16,13595,16,320,0,0,0,0,0
1798.2,17,448,39612,404,35,4462,288,25708,44,288,40948,288,13904
1772.16,6,180,15480,120,69,14892,69,8940,60,69,30033,69,6540
1771.599,6,99,9240,66,65,27255,65,5577,33,59,55359,59,3663
0.78,6,10,924,5,283,137,283,551,5,105,138,105,373
369.383,6,18,1239,14,177,28414,177,913,4,110,20059,110,326
1790.725,6,280,33939,115,137,15706,1360,16451,165,132,10918,1942,17488
11.601,6,24,8413,13,275,966,275,1078,11,1147,838,2840,7335
61.289,6,37,15995,22,805,2918,1408,9217,15,665,4360,1408,6778
0.005,17,2,472,1,60,0,60,88,1,356,0,356,384
1793.651,17,179,13962,179,50,10076,50,13962,0,0,0,0,0
0.835,6,24,10049,12,648,75,1360,3106,12,921,56,1360,6943
80.018,17,4,304,4,48,26672,48,304,0,0,0,0,0
1794.124,17,87,3648,86,14,21107,14,3612,1,8,0,8,36
0.117,6,13,4282,7,111,19,111,483,6,1159,23,1863,3799
0.136,6,9,1339,5,145,34,145,349,4,826,42,826,990
1.586,17,4,792,3,60,4,60,264,1,500,0,500,528
0.225,17,2,152,1,48,0,48,76,1,48,0,48,76
0.787,6,11,1727,7,100,131,100,384,4,589,176,1152,1343
105.702,6,24,9749,13,531,56,1460,2677,11,1103,10556,2374,7072
0.111,6,7,423,4,43,23,43,259,3,0,25,0,164
1681.253,17,14,3815,7,30,280208,30,406,7,459,280208,463,3409
0.116,6,24,11177,15,125,8,186,1576,9,1520,13,4224,9601
1.081,6,25,9512,13,164,76,267,1388,12,1248,83,4224,8124
99.169,6,37,9783,13,155,2555,267,1306,24,395,4311,1997,8477
63.574,17,4,284,2,32,63566,32,120,2,54,63558,60,164
9.253,6,1505,1158331,684,343,13,343,41179,821,1313,11,1896,1117152
60.958,6,14,6258,7,275,10159,275,559,7,1353,10059,1380,5699
38.153,17,22,1936,11,48,3814,48,836,11,72,3814,72,1100
0.42,17,4,624,2,64,418,64,184,2,192,299,192,440
0.477,6,22,7354,13,335,39,668,2026,9,1210,54,1946,5328
1681.274,17,14,1036,7,30,280209,30,406,7,62,280209,62,630
3.806,17,10,785,5,31,943,31,295,5,70,940,70,490
0.306,6,27,9114,13,257,25,667,1715,14,951,22,2816,7399
0.17,6,46,21868,27,1052,6,1420,16887,19,467,9,1883,4981
962.529,2,9,288,9,8,120316,8,288,0,0,0,0,0
179.59,6,19,1622,3,106,89795,106,234,16,77,11960,90,1388
1.767,6,2,1500,1,0,0,0,40,1,1420,0,1420,1460
1.507,6,42,10008,21,440,75,1360,4392,21,433,65,1360,5616
315.648,6,20,2429,7,242,52607,517,1111,13,323,26303,499,1318
0.232,6,10,584,5,44,58,44,312,5,0,43,0,272
7.127,6,9,392,4,0,2375,0,172,5,0,1130,0,220
30.808,6,2359,2231767,1647,1284,18,1440,2189250,712,1097,43,1440,42517
1700.625,17,13,534,11,14,170044,14,462,2,8,1700440,8,72
129.044,6,26,7094,5,156,32261,267,678,21,348,6448,1460,6416
1.488,17,2,136,1,32,0,32,60,1,48,0,48,76
45.169,6,29,7257,14,155,3474,267,1346,15,482,3225,1997,5911
1788.517,17,87,3648,86,14,21041,14,3612,1,8,0,8,36
1798.042,1,143,8008,143,28,12662,28,8008,0,0,0,0,0
240.5,6,10,636,4,106,80166,106,274,6,90,48062,90,362
77.998,6,40,11152,12,327,6809,1189,2455,28,377,2888,1420,8697
1795.877,17,449,39928,404,35,4456,288,25708,45,288,40023,288,14220
0.882,6,51,13837,24,549,38,1429,4848,27,464,32,1986,8989
2.216,6,13,2311,8,188,316,245,700,5,1407,491,1407,1611
36.748,17,3,1022,3,312,18374,322,1022,0,0,0,0,0
44.164,17,15,7808,8,655,6309,1350,5466,7,306,2517,1350,2342
30.99,17,6,468,6,50,6198,50,468,0,0,0,0,0
9.004,6,31,8641,17,325,562,1408,3172,14,591,677,1469,5469
63.811,17,4,352,2,60,63810,60,176,2,60,63810,60,176
300.578,6,44,8854,22,315,14313,882,2221,22,441,552,1440,6633
14.695,6,2451,2294784,1586,1369,9,1408,2245140,865,931,16,2816,49644
0.136,17,2,152,1,48,0,48,76,1,48,0,48,76
1795.338,6,244,35804,152,302,11889,302,26032,92,83,19728,83,9772
1.371,6,50,18482,27,833,52,1360,12786,23,433,53,1360,5696
1787.5,17,87,3648,86,14,21029,14,3612,1,8,0,8,36
300.196,6,90,15059,44,317,6981,1408,7700,46,206,6670,1408,7359
1793.947,17,144,11520,72,48,25266,48,5472,72,56,25266,56,6048
0.284,6,21,5000,11,137,28,267,1132,10,692,30,1467,3868
61.711,17,6,528,3,48,30849,48,228,3,72,30848,72,300
0.009,17,2,441,1,40,0,40,68,1,345,0,345,373
1786.508,6,105,8294,68,63,26664,64,4869,37,57,49622,58,3425
12.521,6,72,21934,36,535,357,1152,15915,36,571,350,1179,6019
0.02,17,2,184,1,32,0,32,60,1,96,0,96,124
1789.266,6,370,23425,213,69,8439,69,12936,157,69,11469,69,10489
21.838,1,16,1344,16,56,1455,56,1344,0,0,0,0,0
1779.146,17,142,11464,71,49,25416,136,5484,71,56,25416,72,5980
0.838,17,2,144,1,36,0,36,64,1,52,0,52,80
0.971,6,33,12925,17,522,60,1460,3338,16,812,53,1460,9587
1795.379,17,449,39928,404,35,4455,288,25708,45,288,40017,288,14220
7.433,6,1381,1239255,850,1379,8,1408,1206979,531,931,13,2816,32276
0.909,6,10,1687,7,100,151,100,384,3,1179,322,1179,1303
12.823,1,7,392,7,28,2137,28,392,0,0,0,0,0
142.896,6,13,3212,3,92,7872,92,256,10,604,15831,1448,2956
5.019,17,4,558,2,36,5005,36,128,2,187,4997,187,430
1762.008,1,8,448,8,28,251715,28,448,0,0,0,0,0
21.662,6,9,527,5,43,5415,43,311,4,0,7219,0,216
1745.374,6,95,7203,63,38,28151,205,4476,32,33,56289,98,2727
68.219,6,22,9126,12,304,71,597,1425,10,1214,7561,3081,7701
1.301,6,50,19422,27,901,50,1460,13726,23,433,51,1460,5696
31.696,6,7,396,1,0,0,0,60,6,0,6301,0,336
1737.069,1,56,4704,56,56,31583,56,4704,0,0,0,0,0
2.379,6,6,340,3,0,1103,0,164,3,0,1103,0,176
1747.36,6,249,25557,127,151,13867,447,19623,122,31,14438,31,5934
300.91,6,57,20774,32,1043,9706,1440,14941,25,370,548,1440,5833
32.627,6,9,396,2,0,4147,0,88,7,0,5422,0,308
1.338,6,38,9848,20,502,70,1460,4352,18,433,66,1460,5496
240.426,6,58,18338,29,819,8584,1418,15451,29,171,8585,580,2887
1780.457,17,140,11200,70,48,25803,48,5320,70,56,25803,56,5880
5.939,6,23,7571,12,268,532,517,1450,11,924,586,2736,6121
37.133,6,8,440,5,0,9283,0,268,3,0,18560,0,172
2.912,17,6,870,3,40,1439,40,204,3,194,1438,194,666
4.286,6,23,8759,12,409,389,964,2270,11,982,407,1368,6489
1772.177,6,181,15520,120,69,14892,69,8940,61,69,29530,69,6580
15.21,6,13,3807,7,152,2535,267,742,6,705,2985,1179,3065
0.307,17,2,152,1,48,0,48,76,1,48,0,48,76
1.868,6,26,4948,15,207,133,519,1822,11,507,175,1448,3126
51.989,6,1490,1330801,997,1321,23,1360,1299378,493,160,105,1360,31423
0.013,6,2,149,1,0,0,0,40,1,69,0,69,109
1.365,6,50,18970,27,868,52,1360,13274,23,433,53,1360,5696
1790.6,17,140,11200,70,48,25950,48,5320,70,56,25950,56,5880
0.134,17,2,672,2,308,134,308,672,0,0,0,0,0
4.166,6,38,7229,19,218,231,314,3383,19,513,217,1179,3846
3.178,17,3,228,2,48,2904,48,152,1,48,0,48,76
5.005,17,4,288,2,36,5003,36,128,2,52,5004,52,160
17.179,17,32,13845,15,634,1225,1350,9933,17,202,1071,1350,3912
151.341,6,24,9206,12,304,74,597,1425,12,911,13742,1360,7781
0.109,17,2,2386,2,1165,109,1165,2386,0,0,0,0,0
0.879,6,10,1687,7,100,146,100,384,3,1179,316,1179,1303
1754.278,6,111,6628,62,26,28758,26,3652,49,26,36546,26,2976
1789.996,17,87,3648,86,14,21058,14,3612,1,8,0,8,36
1.147,6,27,9624,13,164,81,267,1396,14,936,74,1408,8228
1143.046,2,8,256,8,8,163292,8,256,0,0,0,0,0
1787.811,17,84,3522,83,14,21802,14,3486,1,8,0,8,36
63.948,17,4,352,2,60,63947,60,176,2,60,63947,60,176
1740.007,6,105,7602,66,31,26769,31,4503,39,31,45766,31,3099
282.271,6,30,7432,13,158,23522,267,1317,17,543,17640,1400,6115
8.651,6,2,1520,1,0,0,0,40,1,1440,0,1440,1480
300.722,6,43,8957,17,308,18786,889,1947,26,297,12023,1360,7010
0.147,6,9,1340,5,145,36,145,349,4,827,46,827,991
295.034,1,4,224,4,28,98344,28,224,0,0,0,0,0
0.038,6,7,759,3,69,18,69,189,4,205,6,341,570
0.056,6,15,4072,8,88,8,88,440,7,1670,9,1880,3632
1151.508,17,308,48527,148,191,7833,1350,32428,160,72,7241,1350,16099
162.024,6,21,8321,11,532,90,1257,2068,10,973,17983,2720,6253
1784.154,6,109,8624,69,64,26237,64,4936,40,58,45745,58,3688
97.492,6,30,7846,12,157,8862,267,1746,18,413,5734,1420,6100
1797.566,1,345,28980,345,56,5225,56,28980,0,0,0,0,0
10.615,6,2,1175,1,0,0,0,40,1,1095,0,1095,1135
0.302,17,8,2750,8,315,43,354,2750,0,0,0,0,0
0.485,6,22,7300,13,325,39,626,1984,9,968,59,1475,5316
2.039,17,4,1564,4,363,679,363,1564,0,0,0,0,0
0.176,6,23,7324,12,177,16,337,1342,11,1080,16,1588,5982
302.687,6,122,95257,75,1285,4090,1368,87483,47,562,698,1368,7774
5.075,17,6,590,5,30,903,30,290,1,272,0,272,300
19.151,17,4,824,2,48,19143,48,152,2,308,19143,308,672
1782.182,17,83,3480,82,14,22002,14,3444,1,8,0,8,36
152.003,6,29,7392,13,158,12666,267,1317,16,678,10123,3456,6075
1798.323,17,449,39928,404,35,4462,288,25708,45,288,40018,288,14220
79.875,6,17,1268,9,39,9982,39,507,8,49,11410,63,761
31.906,17,8,704,4,60,10634,60,352,4,60,10635,60,352
1795.972,1,246,13776,246,28,7330,28,13776,0,0,0,0,0
0.072,6,10,861,6,182,14,182,490,4,77,5,134,371
316.091,6,46,11752,28,143,11707,658,3599,18,927,18584,4649,8153
28.787,6,6,393,3,64,14393,64,184,3,44,14349,58,209
308.592,6,55,10330,27,148,8009,501,2271,28,288,11426,1420,8059
0.092,1,2,112,2,28,92,28,112,0,0,0,0,0
159.142,17,4,352,2,60,159141,60,176,2,60,159141,60,176
3.696,6,55,31745,29,846,132,1440,10519,26,1061,142,1440,21226
378.057,2,3,96,3,8,189028,8,96,0,0,0,0,0
0.169,17,2,2384,2,1164,169,1164,2384,0,0,0,0,0
316.954,6,117,36966,58,530,5560,1360,25163,59,248,5461,3289,11803
1778.068,17,138,11040,69,48,26147,48,5244,69,56,26147,56,5796
1798.256,6,371,25548,214,92,8442,469,14852,157,69,11526,69,10696
601.598,2,6,192,6,8,120319,8,192,0,0,0,0,0
1745.553,6,97,7307,63,38,28154,205,4476,34,33,52888,98,2831
1746.991,1,56,4704,56,56,31763,56,4704,0,0,0,0,0
44.157,2,3,96,3,8,22078,8,96,0,0,0,0,0
1772.493,6,180,15480,120,69,14894,69,8940,60,69,30035,69,6540
1671.283,6,101,8037,65,66,26113,66,4646,36,59,47747,60,3391
187.244,17,28,4588,14,48,14402,48,1064,14,223,14402,308,3524
1.247,6,48,19296,27,897,47,1360,13680,21,433,53,1360,5616
1.422,6,53,23888,30,997,49,1460,18192,23,433,55,1460,5696
3.516,1,2,208,2,76,3516,76,208,0,0,0,0,0
1.632,6,59,18074,29,707,58,1360,8965,30,438,55,1360,9109
1.034,6,23,6364,13,296,86,826,2007,10,988,112,1691,4357
1740.685,17,30,7050,30,207,60023,207,7050,0,0,0,0,0
1.371,17,28,31686,27,1144,52,1472,31646,1,12,0,12,40
4.458,6,32,6089,17,206,278,314,2744,15,548,299,1179,3345
76.501,17,8,640,4,48,25498,48,304,4,56,25498,56,336
0.343,6,20,7238,12,335,30,668,1974,8,1210,47,1906,5264
190.232,17,4,352,2,60,190231,60,176,2,60,190230,60,176
246.172,6,302,226436,173,1311,1431,1368,208289,129,641,1054,2736,18147
240.315,6,43,8760,21,519,12015,1402,5778,22,203,11443,618,2982
19.616,6,2839,2725907,1887,1368,10,1408,2671727,952,776,20,1408,54180
10.333,6,82,24485,41,533,258,1152,18704,41,459,251,1179,5781
21.341,6,16,1105,8,222,3047,222,546,8,231,3047,231,559
0.306,17,8,2750,8,315,43,354,2750,0,0,0,0,0
115.798,6,163,132839,107,1290,1092,1408,120415,56,731,2101,3847,12424
0.041,6,12,3462,6,75,8,75,395,6,1373,8,1448,3067
5.958,6,5,220,5,0,0,0,220,0,0,0,0,0
1799.187,1,56,4704,0,0,0,0,0,56,56,32712,56,4704
0.458,6,59,26481,33,1093,14,1380,17851,26,630,16,3303,8630
241.389,6,59,20583,31,787,8046,1408,17360,28,175,8940,580,3223
1793.286,17,87,3648,86,14,21097,14,3612,1,8,0,8,36
83.044,17,4,352,2,60,83043,60,176,2,60,83043,60,176
5.029,17,3,250,2,50,5008,50,156,1,66,0,66,94
1784.093,6,365,23087,211,69,8495,69,12787,154,69,11660,69,10300
1797.558,1,250,14000,250,28,7219,28,14000,0,0,0,0,0
246.648,1,6,336,6,28,49329,28,336,0,0,0,0,0
57.012,17,4,352,2,60,57011,60,176,2,60,57011,60,176
1.755,17,20,5190,20,231,92,389,5190,0,0,0,0,0
0.175,6,10,1378,5,145,43,145,349,5,825,28,825,1029
33.326,17,36,5292,18,48,1959,48,1368,18,190,1959,308,3924
1775.814,17,138,11040,69,48,26114,48,5244,69,56,26114,56,5796
144.54,6,17,6188,4,106,48180,106,274,13,489,12029,1420,5914
0.052,17,4,588,2,48,44,48,152,2,190,43,308,436
1500.281,17,236,45218,236,163,6384,353,45218,0,0,0,0,0
1770.542,6,110,10108,70,65,25660,65,5939,40,59,45396,59,4169
280.482,6,28,7352,13,158,23373,267,1317,15,603,20031,2076,6035
37.899,2,2,64,2,8,37899,8,64,0,0,0,0,0
1.622,6,51,19432,29,892,57,1360,13731,22,437,66,2715,5701
61.678,6,40,9772,15,162,78,267,1583,25,359,2569,1460,8189
0.096,6,10,2114,6,596,18,1033,1437,4,513,31,513,677
0.286,6,62,49070,39,200,7,255,2956,23,2138,12,5632,46114
1781.755,6,355,22480,207,69,8649,69,12420,148,69,12120,69,10060
20.129,6,21,5418,12,107,1829,159,1074,9,773,2515,1408,4344
30.143,6,25,7103,12,156,2740,267,1272,13,589,2511,3426,5831
0.099,6,12,1587,6,507,19,507,779,6,556,19,556,808
1705.826,1,60,3360,60,28,28912,28,3360,0,0,0,0,0
30.492,6,7,556,1,0,0,0,40,6,69,6060,69,516
0.054,6,4,208,0,0,0,0,0,4,0,0,0,208
1777.752,17,138,11040,69,48,26143,48,5244,69,56,26143,56,5796
0.341,6,24,5962,12,164,31,453,1442,12,777,30,2206,4520
10.101,17,4,704,2,37,10087,37,130,2,259,10086,275,574
20.415,17,32,16966,14,499,1567,1350,7379,18,504,1198,1350,9587
1654.98,1,18,1008,18,28,97351,28,1008,0,0,0,0,0
16.081,17,12,5228,6,490,3207,1350,3111,6,324,3207,1350,2117
81.361,6,22,900,10,0,6142,0,404,12,0,7395,0,496
4.034,17,5,736,4,60,1340,60,352,1,356,0,356,384
240.297,6,43,8836,22,197,11442,751,2533,21,520,12012,2381,6303
0.576,6,61,25721,34,998,17,1380,18431,27,515,20,1923,7290
111.017,6,591,447668,285,977,83,1360,26194,306,1377,363,8160,421474
564.052,6,23,1323,13,31,47004,31,675,10,31,62390,31,648
0.099,17,2,206,1,44,0,44,72,1,106,0,106,134
1754.771,6,97,7307,63,38,28302,205,4476,34,33,53167,98,2831
113.737,6,32,8952,14,158,8749,267,1357,18,624,6683,1400,7595
1796.214,17,140,11200,70,48,26031,48,5320,70,56,26031,56,5880
18.466,17,19,17040,19,868,1025,1451,17040,0,0,0,0,0
1772.47,6,180,15480,120,69,14894,69,8940,60,69,30033,69,6540
0.29,17,2,198,1,39,0,39,67,1,103,0,103,131
1788.184,6,354,22440,207,69,8680,69,12420,147,69,12247,69,10020
1798.635,17,273,56528,273,179,6612,422,56528,0,0,0,0,0
0.041,6,7,759,3,69,19,69,189,4,205,10,341,570
1740.466,17,29,19517,29,645,62159,645,19517,0,0,0,0,0
259.977,17,4,352,2,60,259976,60,176,2,60,259976,60,176
31.349,6,30,7432,13,158,2612,267,1317,17,543,1956,1400,6115
1772.028,6,180,15480,120,69,14890,69,8940,60,69,30031,69,6540
0.0,17,5,1752,5,322,0,353,1752,0,0,0,0,0
2.48,6,13,2311,8,188,354,245,700,5,1407,553,1407,1611
3.635,6,14,3143,8,49,519,92,511,6,579,40,1408,2632
94.513,17,6,528,3,60,47256,60,264,3,60,47256,60,264
94.167,2,3,96,3,8,47083,8,96,0,0,0,0,0
1759.818,1,8,448,8,28,251402,28,448,0,0,0,0,0
1785.86,6,372,27326,217,116,8267,469,16503,155,69,11596,69,10823
300.876,6,31,15602,17,537,18795,1360,3412,14,1452,23132,3713,12190
2.028,17,3,420,2,30,413,30,116,1,276,0,276,304
32.023,6,465,536867,112,99,288,285,6222,353,1472,90,4254,530645
187.593,6,29,3961,13,304,15632,304,2508,16,83,12433,83,1453
0.18,17,2,2732,2,1338,180,1338,2732,0,0,0,0,0
240.204,6,54,19398,29,834,8578,1408,16531,25,194,10008,580,2867
0.203,6,46,20948,26,1061,8,1420,15927,20,467,10,1883,5021
1772.958,6,183,15738,121,69,14774,69,8980,62,69,29060,69,6758
1654.006,6,189,13034,69,46,24323,46,5520,120,46,13897,46,7514
1775.968,17,73,3060,72,14,25013,14,3024,1,8,0,8,36
0.984,17,2,312,2,128,984,128,312,0,0,0,0,0
132.684,1,2,220,2,82,132684,88,220,0,0,0,0,0
240.69,6,41,8917,20,615,12666,1418,5969,21,231,12033,580,2948
367.015,6,18,1242,14,180,28231,180,916,4,110,20065,110,326
0.488,6,12,1653,6,288,93,288,548,6,426,50,434,1105
117.413,6,78,55440,47,814,51,1360,7683,31,1860,3909,5440,47757
21.01,6,31,11451,16,500,1400,1368,3342,15,913,1498,1571,8109
3.207,2,2,64,2,8,3207,8,64,0,0,0,0,0
0.152,17,2,290,1,40,0,40,68,1,194,0,194,222
281.574,17,4,240,2,32,281573,32,120,2,32,281573,32,120
121.613,6,45,7409,19,132,6747,722,2210,26,257,4857,2026,5199
1740.67,17,30,7050,30,207,60023,207,7050,0,0,0,0,0
0.31,17,2,154,1,33,0,33,61,1,65,0,65,93
1743.402,1,72,6048,0,0,0,0,0,72,56,24554,56,6048
1.274,6,37,8212,19,320,70,1162,2716,18,476,65,2715,5496
216.692,6,172,130910,107,1306,2044,1408,116594,65,642,2532,2439,14316
1.765,6,14,2351,8,188,252,245,700,6,703,298,1152,1651
5.909,6,40,7309,21,218,295,314,3463,19,513,313,1179,3846
2.907,6,42,30027,23,763,132,1360,6299,19,2295,154,6087,23728
61.871,6,40,20463,19,131,3437,134,1520,21,991,3086,1448,18943
1765.602,6,80,3680,40,0,45271,0,2080,40,0,45271,0,1600
291.979,6,33,6982,15,262,20852,517,1576,18,744,17172,1418,5406
1707.903,1,8,448,8,28,243986,28,448,0,0,0,0,0
0.01,17,2,150,1,33,0,33,61,1,61,0,61,89
366.911,6,18,1239,14,177,28223,177,913,4,110,20056,110,326
1794.444,6,356,22520,208,69,8668,69,12460,148,69,12207,69,10060
0.0,17,3,996,3,304,0,333,996,0,0,0,0,0
1684.509,2,16,512,16,8,112300,8,512,0,0,0,0,0
2.497,6,41,17081,22,511,118,1460,3535,19,911,118,1460,13546
240.459,6,60,18475,31,804,8012,1418,15311,29,183,8585,580,3164
4.623,6,38,7245,20,218,243,314,3423,18,516,256,1179,3822
1796.891,17,449,39928,404,35,4458,288,25708,45,288,40018,288,14220
1789.308,6,356,22589,207,69,8685,69,12420,149,69,12089,69,10169
86.735,17,44,6468,22,48,4129,48,1672,22,190,4129,308,4796
0.014,17,2,476,1,64,0,64,92,1,356,0,356,384
1796.053,17,142,11360,71,48,25657,48,5396,71,56,25657,56,5964
2.916,6,6,312,2,0,140,0,104,4,0,972,0,208
294.358,6,35,7078,17,262,18394,517,1680,18,744,17312,1418,5398
219.121,17,425,230613,232,803,948,1350,192836,193,167,1141,1350,37777
277.562,17,4,352,2,60,277558,60,176,2,60,277561,60,176
7.426,6,3,258,1,0,0,0,40,2,69,7424,69,218
540.028,17,20,6704,20,307,28422,308,6704,0,0,0,0,0
2.495,6,14,2351,8,188,356,245,700,6,703,446,1152,1651
2.271,6,3,1560,1,0,0,0,40,2,1440,2048,1440,1520
1773.927,6,181,15589,121,69,14782,69,9049,60,69,30065,69,6540
3.654,17,4,352,4,60,1218,60,352,0,0,0,0,0
5.039,17,3,208,2,36,5006,36,128,1,52,0,52,80
0.093,6,10,2103,6,591,18,1026,1426,4,513,30,513,677
1779.161,1,80,4480,80,28,22521,28,4480,0,0,0,0,0
1786.751,6,102,8364,68,66,26667,66,4964,34,60,54141,60,3400
47.378,2,2,64,2,8,47378,8,64,0,0,0,0,0
0.571,6,10,968,5,256,132,256,460,5,304,130,304,508
0.005,17,2,317,1,46,0,46,74,1,215,0,215,243
1787.13,6,102,8228,68,64,26673,64,4896,34,58,54152,58,3332
3.551,6,34,10829,18,552,208,1460,4081,16,609,222,1460,6748
190.627,6,8,458,5,106,47656,106,314,3,0,1509,0,144
316.414,1,12,1008,0,0,0,0,0,12,56,28764,56,1008
1.262,6,49,19930,28,875,46,1360,14314,21,476,54,2720,5616
0.045,17,2,211,1,45,0,45,73,1,110,0,110,138
1787.214,6,104,8504,69,66,26282,66,5004,35,60,52552,60,3500
8.731,17,36,8994,11,327,872,1350,3906,25,175,362,1350,5088
1799.93,17,449,39928,404,35,4466,288,25708,45,288,40017,288,14220
0.005,17,2,322,1,36,0,36,64,1,230,0,230,258
0.801,17,2,178,1,29,0,29,57,1,93,0,93,121
1771.995,6,203,22290,130,75,13736,267,10057,73,134,24610,2840,12233
1796.068,17,445,38664,403,35,4467,288,25392,42,288,42951,288,13272
1622.903,1,50,2800,50,28,33120,28,2800,0,0,0,0,0
1.716,17,2,136,1,32,0,32,60,1,48,0,48,76
240.136,6,38,5011,18,205,14125,517,2379,20,196,12638,851,2632
0.448,17,8,2750,8,315,64,354,2750,0,0,0,0,0
1791.546,6,105,6240,60,26,30365,26,3510,45,26,40715,26,2730
104.04,17,2,672,2,308,104040,308,672,0,0,0,0,0
1799.188,6,366,24603,213,87,8486,469,14136,153,69,11835,69,10467
1.624,6,25,8703,15,275,116,557,1429,10,981,162,1420,7274
42.521,17,12,912,12,48,3865,48,912,0,0,0,0,0
0.019,17,2,904,1,300,0,300,328,1,548,0,548,576
1787.04,6,105,8475,68,65,26672,65,4930,37,59,49636,59,3545
63.097,17,4,558,2,36,63093,36,128,2,187,63092,187,430
1779.734,17,142,11360,71,48,25424,48,5396,71,56,25424,56,5964
3.654,6,9,383,3,0,1827,0,124,6,7,693,7,259
0.508,17,3,451,2,39,3,39,134,1,289,0,289,317
280.005,6,32,7512,15,158,20000,267,1397,17,543,17499,1400,6115
2.695,6,2,88,2,0,0,0,88,0,0,0,0,0
0.839,6,20,5952,11,282,83,548,1292,9,716,94,1420,4660
1744.652,2,13,416,13,8,145387,8,416,0,0,0,0,0
1.208,6,23,6508,13,332,100,1002,2188,10,979,133,1731,4320
33.041,17,95,39452,51,642,660,1350,34199,44,91,767,1350,5253
1764.118,2,10,320,10,8,196013,8,320,0,0,0,0,0
280.226,6,28,7352,13,158,23352,267,1317,15,678,20010,3436,6035
36.761,17,22,1936,11,48,3673,48,836,11,72,3671,72,1100
1011.913,2,6,192,6,8,202382,8,192,0,0,0,0,0
1359.694,17,109,124369,109,1113,12589,1451,124369,0,0,0,0,0
1741.143,6,87,6322,58,31,30546,31,3915,29,31,62182,31,2407
1785.468,17,348,26448,348,48,5145,48,26448,0,0,0,0,0
0.112,6,13,3514,7,75,18,75,447,6,1373,22,1448,3067
0.048,17,5,696,3,60,14,60,264,2,188,26,188,432
33.803,6,34,5258,16,154,2253,722,1910,18,267,1977,2026,3348
0.998,6,12,1653,6,288,196,288,548,6,426,102,434,1105
1788.717,6,107,8624,69,66,26304,66,5004,38,60,48341,60,3620
1787.005,6,104,8444,68,66,26671,66,4964,36,60,51041,60,3480
0.015,6,3,120,2,0,15,0,80,1,0,0,0,40
328.781,1,4,224,4,28,109593,28,224,0,0,0,0,0
1.99,17,2,176,2,60,1990,60,176,0,0,0,0,0
4.505,6,13,2311,8,188,643,245,700,5,1407,1050,1407,1611
12.114,6,2070,1979085,1386,1354,8,1368,1938853,684,776,17,1473,40232
12.21,17,10,2105,5,47,3049,47,375,5,318,3049,318,1730
218.928,17,4,240,2,32,218927,32,120,2,32,218927,32,120
0.542,6,27,9062,13,206,45,639,1715,14,942,39,1368,7347
3.049,6,4,192,1,0,0,0,48,3,0,1518,0,144
0.019,17,3,1007,1,137,0,137,165,2,393,19,393,842
1795.031,6,356,22520,208,69,8671,69,12460,148,69,12208,69,10060
0.247,17,2,384,1,39,0,39,67,1,289,0,289,317
1785.855,6,373,26359,215,104,8345,469,15623,158,69,11374,69,10736
1.838,17,3,660,2,46,1000,46,148,1,484,0,484,512
9.542,6,18,2523,8,125,1363,245,700,10,703,1033,1152,1823
0.256,17,3,451,2,39,226,39,134,1,289,0,289,317
10.911,6,20,4442,11,275,1091,275,998,9,768,762,1440,3444
0.297,17,2,212,1,46,0,46,74,1,110,0,110,138
0.161,17,2,198,1,63,0,63,91,1,79,0,79,107
0.837,6,20,5966,11,287,83,562,1306,9,716,93,1420,4660
126.121,2,2,64,2,8,126121,8,64,0,0,0,0,0
240.189,6,54,18416,29,778,8577,1402,15533,25,196,10007,580,2883
1781.763,6,370,26170,214,105,8365,469,15514,156,69,11495,69,10656
2.88,17,2,312,2,128,2880,128,312,0,0,0,0,0
1.113,6,14,1745,7,288,162,288,600,7,426,156,434,1145
0.34,17,2,212,1,46,0,46,74,1,110,0,110,138
15.518,6,6,426,0,0,0,0,0,6,31,3103,31,426
0.195,17,2,2752,2,1348,195,1348,2752,0,0,0,0,0
1.071,6,23,6595,13,350,88,1088,2275,10,979,118,1731,4320
0.369,6,24,6064,12,181,33,537,1526,12,651,31,1448,4538
75.655,6,31,7613,12,155,28,267,1266,19,398,4202,3417,6347
280.502,6,30,7432,13,158,23375,267,1317,17,543,17525,1400,6115
113.814,6,93,66447,59,1243,1962,1408,56539,34,739,2218,2816,9908
1739.35,1,56,4704,56,56,31624,56,4704,0,0,0,0,0
818.052,17,11,836,11,48,81805,48,836,0,0,0,0,0
388.666,17,58,4408,58,48,6818,48,4408,0,0,0,0,0
280.035,6,28,7352,13,158,23336,267,1317,15,678,19999,3436,6035
0.531,17,3,451,2,39,466,39,134,1,289,0,289,317
131.657,6,40,9933,13,155,10971,267,1306,27,342,5062,1420,8627
1779.012,1,58,4872,0,0,0,0,0,58,56,31210,56,4872
1763.167,6,371,66219,244,302,7255,302,49540,127,83,13993,83,16679
0.52,6,20,7238,13,335,43,668,2026,7,1210,81,1946,5212
1789.974,17,87,3648,86,14,21058,14,3612,1,8,0,8,36
317.788,6,86,33840,44,717,7390,1360,23315,42,368,7746,2720,10525
1.663,17,24,9858,10,381,184,1350,4092,14,383,76,1350,5766
4.348,6,36,6249,18,206,255,314,2784,18,456,240,1152,3465
18.831,6,14,1025,7,222,3136,222,506,7,231,3136,231,519
1799.744,17,447,39580,403,35,4476,288,25676,44,288,40951,288,13904
1774.892,6,180,15480,120,69,14915,69,8940,60,69,30080,69,6540
13.799,6,8,460,3,0,6899,0,160,5,0,2071,0,300
0.095,17,2,602,1,46,0,46,74,1,500,0,500,528
0.204,17,2,237,1,72,0,72,100,1,109,0,109,137
36.879,6,184,79393,97,766,384,1152,71346,87,414,425,1179,8047
1773.185,6,180,15480,120,69,14900,69,8940,60,69,30045,69,6540
1788.71,1,247,26182,247,78,7271,78,26182,0,0,0,0,0
1741.427,6,92,6668,60,31,29515,31,4062,32,31,56174,31,2606
1.371,17,2,780,2,362,1371,362,780,0,0,0,0,0
1741.31,6,88,6398,58,31,30549,31,3908,30,31,60039,31,2490
0.15,6,10,1514,5,503,37,503,771,5,475,37,475,743
20.246,6,22,5470,13,107,1687,159,1126,9,967,2525,1709,4344
359.869,6,33,8196,22,399,17136,1360,6904,11,210,60,418,1292
1771.161,6,171,30239,100,322,17890,823,21336,71,104,25301,192,8903
10.783,6,1940,1788420,1228,1378,8,1408,1746732,712,931,14,2801,41688
1771.381,6,102,9396,66,65,27252,65,5577,36,59,50608,59,3819
10.109,6,9,527,5,43,2527,43,311,4,0,3368,0,216
1788.136,6,359,22709,209,69,8596,69,12569,150,69,12000,69,10140
1.601,6,47,19098,27,886,61,1360,13522,20,433,72,1360,5576
37.925,17,22,1936,11,48,3791,48,836,11,72,3791,72,1100
1.251,6,12,1304,6,256,248,256,756,6,304,248,304,548
35.286,17,22,1672,22,48,1680,48,1672,0,0,0,0,0
317.939,6,52,6050,29,158,11354,208,4975,23,31,14441,31,1075
300.834,6,36,8522,18,308,17686,889,1987,18,446,17687,3488,6535
17.2,6,9,520,3,0,8600,0,160,6,0,3078,0,360
0.006,17,2,350,1,33,0,33,61,1,261,0,261,289
33.846,6,31,5093,15,154,2417,721,1858,16,342,2241,1368,3235
0.242,17,12,4389,12,337,22,360,4389,0,0,0,0,0
1783.916,6,360,24156,210,88,8535,469,13878,150,69,11972,69,10278
1752.312,17,299,50034,299,139,5880,389,50034,0,0,0,0,0
1774.971,6,180,15480,120,69,14915,69,8940,60,69,30076,69,6540
0.177,17,2,196,1,62,0,62,90,1,78,0,78,106
15.482,17,14,6793,7,613,2569,1350,4489,7,301,2568,1350,2304
0.004,6,2,100,1,0,0,0,60,1,0,0,0,40
4.308,6,35,6225,18,206,253,314,2784,17,551,253,1179,3441
0.429,6,125,88054,56,131,7,232,2769,69,1309,6,1430,85285
22.957,6,8,3200,3,0,8565,0,120,5,1440,5547,1440,3080
1637.507,2,24,768,24,8,71195,8,768,0,0,0,0,0
206.355,17,4,352,2,60,206354,60,176,2,60,206354,60,176
0.091,17,2,167,1,39,0,39,67,1,72,0,72,100
0.554,17,2,204,1,34,0,34,62,1,114,0,114,142
1772.213,1,100,5600,100,28,17901,28,5600,0,0,0,0,0
300.415,6,60,45488,39,1289,7905,1448,39420,21,828,3069,1448,6068
1775.442,17,140,11200,70,48,25730,48,5320,70,56,25730,56,5880
1786.441,6,356,22520,208,69,8630,69,12460,148,69,12152,69,10060
1794.608,6,357,22629,208,69,8669,69,12460,149,69,12125,69,10169
1773.223,6,180,15480,120,69,14901,69,8940,60,69,30051,69,6540
14.14,17,3,1008,3,308,7070,308,1008,0,0,0,0,0
54.053,17,4,240,2,32,54052,32,120,2,32,54052,32,120
1787.034,6,150,19350,90,302,20078,302,13740,60,83,30288,83,5610
1796.835,17,443,39168,399,35,4514,288,25264,44,288,40950,288,13904
6.113,6,14,1247,7,222,1015,222,728,7,231,1016,231,519
1788.183,6,4951,4531315,1870,125,956,333,114864,3081,1414,580,2836,4416451
2.16,17,2,308,1,34,0,34,62,1,218,0,218,246
754.135,1,4,224,4,28,251378,28,224,0,0,0,0,0
781.548,6,55,3352,30,27,26949,27,1788,25,26,32562,27,1564
295.185,1,4,224,4,28,98395,28,224,0,0,0,0,0
1.657,6,25,8707,15,275,118,559,1431,10,981,165,1420,7276
1763.55,17,150,24498,150,135,11835,389,24498,0,0,0,0,0
0.151,6,10,1380,6,145,30,145,389,4,827,47,827,991
46.755,17,4,1008,4,224,15585,224,1008,0,0,0,0,0
3.728,17,4,240,4,32,1242,32,240,0,0,0,0,0
17.23,17,10,880,5,48,4304,48,380,5,72,4304,72,500
1.376,6,47,19221,26,895,55,1440,13605,21,433,59,1440,5616
5.308,6,39,7269,20,218,279,314,3423,19,513,281,1179,3846
0.063,17,2,372,1,39,0,39,67,1,277,0,277,305
0.359,6,3,182,2,31,359,31,111,1,31,0,31,71
1786.689,6,356,22520,208,69,8631,69,12460,148,69,12154,69,10060
1720.464,17,12,498,11,14,172046,14,462,1,8,0,8,36
0.315,17,2,154,1,33,0,33,61,1,65,0,65,93
0.924,6,11,1727,7,100,154,100,384,4,589,218,1152,1343
1746.85,1,8,848,8,78,249550,78,848,0,0,0,0,0
8.424,6,1768,1642423,1127,1380,7,1408,1604427,641,776,12,1408,37996
0.49,6,5,248,3,0,245,0,144,2,0,410,0,104
0.573,6,10,924,5,283,98,283,551,5,105,97,105,373
59.26,6,27,7177,13,155,4938,267,1306,14,530,4557,2840,5871
1782.413,17,354,58128,354,136,5049,391,58128,0,0,0,0,0
1749.565,17,12,498,11,14,174956,14,462,1,8,0,8,36
209.916,6,9,678,3,65,20538,65,185,6,50,41983,101,493
0.109,17,4,284,2,32,0,32,120,2,54,0,60,164
17.06,17,15,6596,8,539,2432,1350,4537,7,266,2837,1350,2059
1799.852,6,124,14091,81,81,22498,501,6194,43,162,42851,1420,7897
0.267,17,2,167,1,39,0,39,67,1,72,0,72,100
0.05,17,4,364,2,52,4,52,160,2,74,3,80,204
103.158,17,4,352,2,60,103157,60,176,2,60,103156,60,176
1789.825,6,357,22491,208,69,8646,69,12460,149,69,12080,69,10031
1670.0,1,7,742,7,78,278333,78,742,0,0,0,0,0
11.763,6,1861,1624855,1126,1389,10,1420,1591234,735,467,16,1883,33621
1795.274,17,80,3354,79,14,23016,14,3318,1,8,0,8,36
1.437,6,47,18361,26,897,57,1460,12745,21,476,62,2615,5616
46.075,17,4,240,2,32,46074,32,120,2,32,46074,32,120
280.499,6,28,7352,13,158,23374,267,1317,15,775,20032,4836,6035
1799.411,1,16,896,16,28,119960,28,896,0,0,0,0,0
0.237,6,14,3906,10,75,26,75,603,4,3087,79,3087,3303
421.125,2,3,96,3,8,210562,8,96,0,0,0,0,0
27.032,6,38,8481,18,161,1590,722,2177,20,687,1411,2760,6304
1795.096,17,87,3648,86,14,21118,14,3612,1,8,0,8,36
10.013,17,2,2144,2,1044,10013,1045,2144,0,0,0,0,0
95.49,6,21,8712,11,314,65,634,1415,10,1147,10596,2720,7297
1788.918,17,142,11360,71,48,25555,48,5396,71,56,25555,56,5964
1752.557,1,176,9856,176,28,10014,28,9856,0,0,0,0,0
1798.337,17,446,39832,401,35,4495,288,25612,45,288,40013,288,14220
0.963,6,29,8500,15,222,58,540,1964,14,852,60,1360,6536
0.793,6,2,111,1,0,0,0,40,1,31,0,31,71
0.02,17,2,312,1,40,0,40,68,1,216,0,216,244
1.191,6,30,6004,16,111,79,267,1539,14,650,81,1452,4465
129.982,6,52,14802,26,948,642,1360,8731,26,358,5192,1360,6071
1773.019,6,180,15480,120,69,14899,69,8940,60,69,30044,69,6540
8.886,6,46,14521,24,972,386,1360,8794,22,371,412,1360,5727
1799.081,1,64,5376,64,56,28556,56,5376,0,0,0,0,0
10.535,6,1781,1650628,1110,1409,9,1448,1611072,671,776,15,1448,39556
513.67,1,20,3716,20,157,27035,293,3716,0,0,0,0,0
1786.206,6,104,8444,68,66,26659,66,4964,36,60,51031,60,3480
1777.268,17,140,11200,70,48,25757,48,5320,70,56,25757,56,5880
262.781,17,4,240,2,32,262780,32,120,2,32,262780,32,120
15.412,17,2,660,2,302,15412,304,660,0,0,0,0,0
300.963,6,53,23295,30,1088,10378,1360,17573,23,399,399,1360,5722
265.282,6,80,12404,34,192,8038,1189,3866,46,247,5890,1420,8538
141.572,6,25,9110,12,654,83,1360,3129,13,778,11783,1360,5981
0.053,6,5,5630,4,1357,3,1360,5590,1,0,0,0,40
368.794,6,25,1651,17,177,23049,177,1117,8,110,9175,110,534
129.506,17,4,352,2,60,129505,60,176,2,60,129505,60,176
0.378,6,10,967,5,256,92,256,460,5,303,91,303,507
1792.015,6,356,22520,208,69,8657,69,12460,148,69,12190,69,10060
3.009,1,3,168,3,28,1504,28,168,0,0,0,0,0
8.618,6,1768,1499715,981,1430,8,1448,1444419,787,776,10,1448,55296
1786.401,6,104,8376,68,65,26662,65,4930,36,59,51036,59,3446
1780.505,6,102,8364,68,66,26574,66,4964,34,60,53948,60,3400
414.0,17,21,879,20,13,21789,14,835,1,16,0,16,44
1744.607,2,28,896,28,8,64615,8,896,0,0,0,0,0
34.914,6,36,8455,17,410,538,882,1942,19,478,1932,1928,6513
0.32,17,2,212,1,46,0,46,74,1,110,0,110,138
80.943,6,36,8338,17,371,553,797,1825,19,478,4487,2128,6513
1.209,17,4,624,2,64,958,64,184,2,192,952,192,440
1781.457,17,142,11360,71,48,25449,48,5396,71,56,25449,56,5964
240.239,6,57,20725,31,855,8007,1418,17868,26,187,9609,580,2857
280.227,6,27,7312,12,158,25475,267,1277,15,678,20013,2045,6035
1.432,6,24,8004,12,164,111,267,1288,12,1014,109,2491,6716
1202.564,2,8,256,8,8,171794,8,256,0,0,0,0,0
1785.759,17,87,3648,86,14,21008,14,3612,1,8,0,8,36
21.488,6,15,2850,7,592,3555,1460,2060,8,231,3031,231,790
0.558,17,14,6316,7,537,93,1350,3956,7,309,82,1350,2360
301.105,6,54,23306,31,1072,10036,1440,17355,23,358,405,1440,5951
1792.512,6,358,22807,210,69,8576,69,12747,148,69,12193,69,10060
162.608,6,41,9166,16,199,4695,721,2038,25,360,6768,2840,7128
0.171,6,46,20411,26,1023,6,1420,15390,20,467,8,1883,5021
1.843,6,39,15639,23,116,83,186,2252,16,965,121,1718,13387
1780.742,17,140,11200,70,48,25807,48,5320,70,56,25807,56,5880
0.04,6,3,120,2,0,40,0,80,1,0,0,0,40
245.019,17,4,352,2,60,245018,60,176,2,60,245018,60,176
206.682,17,4,352,2,48,206673,48,152,2,72,206672,72,200
281.661,6,30,7432,13,158,23471,267,1317,17,543,17585,1400,6115
20.346,6,33,10550,16,324,1356,721,2921,17,991,1235,1420,7629
1119.901,1,16,896,16,28,74660,28,896,0,0,0,0,0
1772.316,6,180,15480,120,69,14893,69,8940,60,69,30034,69,6540
2.074,17,28,13635,13,724,172,1350,9788,15,228,116,1350,3847
1143.029,2,19,608,19,8,63501,8,608,0,0,0,0,0
243.433,6,95,38447,46,927,5409,1402,30214,49,405,5071,1402,8233
1773.106,6,180,15480,120,69,14900,69,8940,60,69,30045,69,6540
79.573,17,4,240,2,32,79572,32,120,2,32,79572,32,120
0.394,6,24,7660,12,176,35,334,1339,12,948,33,1438,6321
1787.267,6,390,29954,222,75,8087,267,13982,168,133,10702,1460,15972
3.173,6,19,6263,9,268,391,517,1281,10,744,347,1418,4982
3.981,6,14,3168,8,49,568,92,523,6,1164,762,1408,2645
1.479,6,41,8429,21,320,73,1162,2808,20,400,67,1460,5621
5.252,6,47,8505,24,227,228,314,4142,23,491,227,1179,4363
147.633,17,4,1344,4,308,49211,308,1344,0,0,0,0,0
4.309,17,12,1032,6,47,860,47,450,6,69,860,75,582
373.692,6,17,1236,13,226,31141,226,910,4,110,20226,110,326
0.783,6,5,260,1,0,0,0,40,4,0,0,0,220
1.322,17,20,12761,9,631,165,1350,5936,11,592,128,1350,6825
8.496,6,4,160,0,0,0,0,0,4,0,0,0,160
2.222,1,10,280,10,0,0,0,280,0,0,0,0,0
1798.265,17,448,39896,403,35,4473,288,25676,45,288,40019,288,14220
0.299,6,87,89163,37,183,8,230,2481,50,1751,5,5608,86682
2.623,17,13,6351,6,623,523,1350,3910,7,320,431,1350,2441
1779.475,1,59,4956,59,56,30680,56,4956,0,0,0,0,0
99.86,6,9,515,5,43,24965,43,299,4,0,33283,0,216
0.287,6,26,8990,13,247,23,624,1672,13,947,23,1438,7318
4.007,6,31,16562,17,634,250,1360,3261,14,1591,274,3928,13301
358.975,1,4,224,4,28,119658,28,224,0,0,0,0,0
280.258,6,28,7352,13,158,23354,267,1317,15,678,20011,2800,6035
84.369,6,19,5583,12,266,7669,500,1284,7,803,141,1420,4299
1.003,6,109,87062,53,131,19,232,2649,56,1676,18,5680,84413
1740.22,6,87,6322,58,31,30530,31,3915,29,31,62150,31,2407
58.208,6,41,11168,15,374,1060,1189,3982,26,323,2327,1420,7186
1762.992,6,191,11771,95,47,18755,208,6846,96,31,18555,31,4925
4.855,17,2,154,1,33,0,33,61,1,65,0,65,93
2.314,6,13,2311,8,188,330,245,700,5,1407,515,1407,1611
1798.835,17,449,39928,404,35,4463,288,25708,45,288,40019,288,14220
1710.03,1,72,4032,72,28,24084,28,4032,0,0,0,0,0
1786.525,6,102,8364,68,66,26664,66,4964,34,60,54134,60,3400
140.036,6,50,11899,24,197,6088,666,3436,26,417,5516,1408,8463
2.177,6,9,527,5,43,544,43,311,4,0,722,0,216
0.139,17,4,284,2,32,88,32,120,2,54,53,60,164
250.789,6,512,645008,195,230,1292,906,14391,317,2026,779,9814,630617
1.264,17,27,14432,13,817,105,1350,10994,14,217,61,1350,3438
1765.331,17,170,14464,157,30,11316,37,9155,13,380,142206,463,5309
1750.538,17,12,498,11,14,175053,14,462,1,8,0,8,36
3.042,6,53,20808,27,925,117,1440,14992,26,433,112,1440,5816
11.222,6,21,6825,12,275,1020,275,1038,9,1353,777,1440,5787
5.027,17,3,257,2,37,5002,37,130,1,99,0,99,127
0.969,6,11,1727,7,100,161,100,384,4,589,233,1152,1343
1.155,6,23,7952,12,164,89,267,1288,11,1216,98,3819,6664
207.867,17,4,352,2,60,207866,60,176,2,60,207866,60,176
0.221,6,9,1148,5,145,55,145,349,4,635,53,635,799
0.271,6,22,5960,12,181,24,537,1526,10,558,27,1448,4434
1798.274,6,357,23130,209,76,8645,501,13001,148,69,12231,69,10129
26.131,6,38,8309,20,188,1375,721,2128,18,778,1526,1420,6181
1792.165,17,87,3648,86,14,21084,14,3612,1,8,0,8,36
1799.593,17,449,65877,211,189,8502,1350,45986,238,55,7593,1350,19891
1772.284,6,180,15480,120,69,14893,69,8940,60,69,30031,69,6540
0.479,17,4,314,2,31,462,31,118,2,70,456,70,196
1292.279,6,259,16570,145,69,8947,69,9112,114,69,11436,69,7458
0.046,17,2,396,1,40,0,40,68,1,300,0,300,328
0.008,17,4,420,2,33,2,33,122,2,121,0,145,298
40.151,17,24,1824,24,48,1745,48,1824,0,0,0,0,0
2.791,17,2,925,1,548,0,548,576,1,321,0,321,349
0.546,17,2,167,1,39,0,39,67,1,72,0,72,100
68.013,17,2,152,2,48,68013,48,152,0,0,0,0,0
1744.612,2,30,960,30,8,60159,8,960,0,0,0,0,0
8.775,6,14,1247,7,222,1460,222,728,7,231,1460,231,519
165.689,6,9,515,5,43,41422,43,299,4,0,55227,0,216
327.771,6,50,8437,25,115,12778,501,2390,25,265,13653,1420,6047
1.493,6,53,19234,29,874,53,1360,13453,24,400,57,1360,5781
0.166,6,14,6093,7,128,27,128,500,7,1305,26,1448,5593
551.866,17,4064,195072,2061,20,267,20,98928,2003,20,265,20,96144
6.003,17,6,519,5,31,992,31,295,1,196,0,196,224
1796.01,17,144,11520,72,48,25295,48,5472,72,56,25295,56,6048
1781.998,17,142,11360,71,48,25457,48,5396,71,56,25457,56,5964
0.694,6,28,6224,14,164,53,453,1570,14,651,50,2194,4654
7.454,6,46,8742,22,231,354,314,4355,24,427,312,1152,4387
1.078,6,15,2132,8,130,154,130,490,7,1326,179,1326,1642
342.14,6,51143,44450428,26313,785,13,1396,1488180,24830,1682,13,13960,42962248
0.046,6,3,136,2,0,46,0,88,1,0,0,0,48
126.154,2,2,64,2,8,126154,8,64,0,0,0,0,0
0.33,17,8,2750,8,315,47,354,2750,0,0,0,0,0
43.109,6,33,8958,14,327,115,1189,2535,19,471,2394,1420,6423
280.53,6,24,7054,11,181,28053,267,1168,13,670,23362,2076,5886
2.09,6,9,3188,4,174,696,174,338,5,1321,146,1420,2850
15.865,17,20,14405,12,995,1439,1350,12283,8,237,2262,1350,2122
1.029,17,2,503,1,40,0,40,68,1,407,0,407,435
240.371,6,44,8468,22,449,11445,1418,5648,22,208,11445,580,2820
1780.26,6,354,22509,206,69,8684,69,12380,148,69,12110,69,10129
0.545,17,2,152,1,48,0,48,76,1,48,0,48,76
0.044,6,10,912,5,121,11,121,389,5,259,11,259,523
1772.158,6,180,15480,120,69,14892,69,8940,60,69,30035,69,6540
3.248,17,4,1564,4,363,1082,363,1564,0,0,0,0,0
1.262,6,388,527225,113,515,11,1396,7944,275,1877,4,6980,519281
122.307,6,40,8387,17,131,7643,267,1742,23,336,5558,1997,6645
82.597,6,22,11238,12,433,70,990,1823,10,1500,9162,5288,9415
43.802,17,35,2641,20,40,2303,41,1371,15,56,3124,57,1270
252.173,2,2,64,2,8,252173,8,64,0,0,0,0,0
160.076,1,4,224,4,28,53358,28,224,0,0,0,0,0
1772.324,6,180,15480,120,69,14893,69,8940,60,69,30032,69,6540
0.957,17,2,144,1,36,0,36,64,1,52,0,52,80
0.133,6,37,15456,21,973,6,1420,10595,16,420,8,1420,4861
15.322,17,24,9997,10,390,1698,1350,4181,14,387,1176,1350,5816
1784.619,1,59,4956,59,56,30769,56,4956,0,0,0,0,0
1.937,17,3,1232,3,382,968,548,1232,0,0,0,0,0
1792.192,6,367,25650,214,99,8414,469,15045,153,69,11789,69,10605
1780.079,6,353,22400,206,69,8683,69,12380,147,69,12191,69,10020
426.662,6,71,11007,35,94,12548,267,3014,36,218,12190,1460,7993
1.983,6,59,18095,28,707,73,1360,8937,31,416,65,1360,9158
1.927,17,19,7501,9,495,240,1350,4715,10,250,207,1350,2786
1795.735,17,449,39928,404,35,4455,288,25708,45,288,40020,288,14220
1787.905,6,361,22927,209,69,8595,69,12707,152,69,11840,69,10220
87.064,6,758,351989,398,818,219,1152,332798,360,435,241,1179,19191
1771.788,6,103,9448,66,65,27258,65,5577,37,59,49213,59,3871
391.481,6,18,1242,14,180,30113,180,916,4,110,20080,110,326
66.541,6,17,2349,9,324,8317,585,1125,8,396,9319,580,1224
240.23,6,54,18059,29,760,8579,1418,15213,25,192,10009,580,2846
68.286,6,11,588,5,0,17071,0,268,6,0,13132,0,320
0.281,17,2,198,1,39,0,39,67,1,103,0,103,131
1797.216,17,448,39896,403,35,4470,288,25676,45,288,40019,288,14220
0.102,17,2,362,1,39,0,39,67,1,267,0,267,295
0.033,17,2,239,1,59,0,59,87,1,124,0,124,152
11.564,6,16,4735,9,290,1445,517,1057,7,1102,1880,1448,3678
6.435,6,1381,1206682,793,1433,7,1448,1168282,588,776,10,1448,38400
3.061,17,6,753,3,31,1526,31,177,3,164,1525,164,576
266.758,6,30,3153,15,324,19054,585,1461,15,226,17169,580,1692
15.27,17,5,380,5,48,3817,48,380,0,0,0,0,0
58.038,6,11,620,3,0,29019,0,164,8,0,8122,0,456
1787.442,6,102,8296,68,65,26678,65,4930,34,59,54160,59,3366
282.413,6,33,8303,14,158,21724,267,1357,19,515,15686,1400,6946
1778.105,17,79,3312,78,14,23092,14,3276,1,8,0,8,36
162.505,6,35,8606,17,326,10153,517,2209,18,777,9556,1418,6397
0.607,6,312,493490,153,183,3,230,8513,159,3036,3,11264,484977
0.662,6,117,88043,55,131,12,232,2729,62,1453,10,2877,85314
1746.668,6,134,13188,74,61,23926,722,6182,60,82,29597,1448,7006
49.705,6,27,7177,13,155,4142,267,1306,14,530,3822,3417,5871
0.083,17,2,279,1,36,0,36,64,1,187,0,187,215
0.22,6,21,5000,10,137,24,267,1092,11,692,21,1467,3908
357.509,6,46,10135,29,266,12768,1360,4653,17,435,538,2667,5482
1789.597,17,87,3648,86,14,21054,14,3612,1,8,0,8,36
90.211,6,32,5753,14,160,6939,501,1686,18,303,5300,1420,4067
165.334,6,24,8180,12,421,61,960,1799,12,736,15017,1360,6381
0.001,6,3,175,1,0,0,0,40,2,31,0,31,135
0.068,6,7,423,4,43,10,43,259,3,0,33,0,164
0.431,6,3,160,2,0,431,0,100,1,0,0,0,60
1790.857,6,787,53622,389,31,4615,31,26567,398,31,4510,31,27055
1.358,6,49,19453,27,906,52,1360,13797,22,476,55,2715,5656
10.9,6,1703,1507165,1046,1388,10,1420,1476640,657,467,16,1883,30525
0.08,17,2,150,1,39,0,39,67,1,55,0,55,83
1760.151,6,211,27672,113,304,15715,304,18772,98,83,18135,83,8900
234.549,6,3818,3825507,1322,386,177,426,77642,2496,1454,94,10066,3747865
1786.881,6,104,8308,68,64,26669,64,4896,36,58,51051,58,3412
0.579,6,14,1745,7,288,67,288,600,7,426,67,434,1145
10.743,6,20,4402,11,275,1074,275,998,9,758,745,1420,3404
366.236,6,25,1651,17,177,22889,177,1117,8,110,9170,110,534
1681.644,17,14,3815,7,30,280273,30,406,7,459,280273,463,3409
1039.103,17,204,15504,204,48,5118,48,15504,0,0,0,0,0
2.824,17,48,38510,20,438,148,1350,9339,28,1013,96,1350,29171
95.069,6,29,7392,13,158,7922,267,1317,16,603,6335,2036,6075
0.058,17,4,284,2,32,28,32,120,2,54,43,60,164
1784.463,17,203,52001,203,228,8833,422,52001,0,0,0,0,0
4.209,6,34,6169,17,206,263,314,2744,17,548,240,1179,3425
11.571,17,12,13719,12,1115,1051,1451,13719,0,0,0,0,0
1772.236,6,180,15480,120,69,14892,69,8940,60,69,30034,69,6540
77.203,17,5,1904,5,352,19300,548,1904,0,0,0,0,0
0.489,6,22,7368,13,337,40,674,2032,9,1212,55,1946,5336
11.864,6,21,6825,12,275,1078,275,1038,9,1353,856,1440,5787
231.589,1,2,120,2,32,231589,32,120,0,0,0,0,0
176.847,6,72,47709,45,1163,4019,1408,39571,27,960,2368,3847,8138
1.008,6,11,1727,7,100,168,100,384,4,589,247,1152,1343
661.825,2,8,256,8,8,94546,8,256,0,0,0,0,0
147.217,6,21143,20024111,13867,1364,10,1408,19641095,7276,931,20,2801,383016
0.549,17,3,543,2,39,453,39,134,1,381,0,381,409
240.279,6,54,19814,29,849,8581,1418,16808,25,212,10011,580,3006
31.427,6,27,8803,13,125,2618,125,907,14,1045,2340,1420,7896
1798.534,17,180,14040,180,50,10047,50,14040,0,0,0,0,0
0.171,6,2,92,1,0,0,0,40,1,0,0,0,52
1.644,6,16,1976,8,256,232,256,1348,8,304,232,304,628
0.035,6,10,1512,5,503,8,503,771,5,473,8,473,741
1785.016,17,73,3060,72,14,25141,14,3024,1,8,0,8,36
0.004,17,2,198,1,37,0,37,65,1,105,0,105,133
1794.869,17,497,167022,497,308,3618,329,167022,0,0,0,0,0
1741.337,1,76,6384,76,56,23217,56,6384,0,0,0,0,0
1744.586,2,29,928,29,8,62306,8,928,0,0,0,0,0
1787.46,6,102,8296,68,65,26678,65,4930,34,59,54161,59,3366
1746.273,6,97,7307,63,38,28165,205,4476,34,33,52909,98,2831
47.625,17,4,240,2,32,47624,32,120,2,32,47624,32,120
75.096,6,26,9524,15,441,5364,1360,2397,11,1335,7496,4432,7127
240.209,6,53,18053,28,808,8896,1402,15204,25,192,10008,580,2849
1764.329,2,14,448,14,8,135717,8,448,0,0,0,0,0
544.311,2,6,192,6,8,108862,8,192,0,0,0,0,0
894.064,6,84,9556,46,87,19868,722,4220,38,119,24148,2026,5336
604.892,6,100,35204,48,624,31,1360,24417,52,289,11857,3289,10787
534.957,2,4,128,4,8,178319,8,128,0,0,0,0,0
0.101,6,13,2121,7,324,16,585,1009,6,396,19,580,1112
1540.573,6,205,15190,102,69,15253,69,7530,103,34,15103,48,7660
0.052,17,4,364,2,52,0,52,160,2,74,16,80,204
1782.128,1,164,9184,164,28,10933,28,9184,0,0,0,0,0
1738.991,1,15,840,15,28,124213,28,840,0,0,0,0,0
1755.895,6,103,6154,59,26,30273,27,3467,44,26,40833,27,2687
0.966,6,10,1510,5,657,241,657,925,5,317,241,317,585
4.82,17,2,152,2,48,4820,48,152,0,0,0,0,0
228.868,17,36,2736,36,48,6539,48,2736,0,0,0,0,0
1743.113,6,96,7255,64,38,27668,205,4528,32,33,56223,98,2727
1773.9,6,181,15589,120,69,14906,69,8940,61,69,29559,69,6649
0.084,17,4,352,2,37,1,37,130,2,83,78,89,222
0.053,17,2,187,1,46,0,46,74,1,85,0,85,113
1786.601,6,102,8364,68,66,26665,66,4964,34,60,54136,60,3400
275.814,6,18,1614,3,106,137907,106,234,15,74,19697,90,1380
110.69,6,21,8321,11,532,85,1257,2068,10,973,12279,2720,6253
0.714,17,4,368,2,32,714,32,120,2,96,676,96,248
1792.738,17,180,11520,180,36,10015,36,11520,0,0,0,0,0
6.042,6,38,7229,20,218,318,314,3423,18,513,337,1179,3806
1787.214,6,102,8364,68,66,26674,66,4964,34,60,54152,60,3400
11.892,17,16,2352,8,48,1697,48,608,8,190,1697,308,1744
1798.973,6,373,26097,217,99,8328,469,15165,156,69,11605,69,10932
31.481,6,7,420,1,0,0,0,60,6,0,6262,0,360
1.072,6,10,1380,5,145,268,145,349,5,827,195,827,1031
0.621,6,27,7296,13,155,51,267,1301,14,603,41,2036,5995
0.074,17,2,144,1,36,0,36,64,1,52,0,52,80
1745.572,6,95,7203,63,38,28154,205,4476,32,33,56300,98,2727
62.961,6,13,5668,4,106,20987,106,274,9,718,7863,1452,5394
0.152,17,4,588,2,48,142,48,152,2,190,139,308,436
15.43,17,20,5676,9,286,1924,1350,2827,11,231,1539,1350,2849
1647.877,1,8,448,8,28,235411,28,448,0,0,0,0,0
0.208,6,4,160,2,0,143,0,80,2,0,204,0,80
1794.174,6,191,11855,96,50,18884,208,7094,95,31,19085,31,4761
364.581,6,25,1651,17,177,22786,177,1117,8,110,9160,110,534
31.754,17,6,360,3,32,15876,32,180,3,32,15876,32,180
1383.671,2,11,352,11,8,138367,8,352,0,0,0,0,0
1.22,6,23,7952,12,164,95,267,1288,11,1216,104,3819,6664
4.106,6,23,6478,11,268,406,517,1385,12,744,369,1418,5093
65.091,6,12,927,4,177,124,177,393,8,110,9272,110,534
6.769,6,45,8409,24,227,294,314,4142,21,489,321,1179,4267
24.594,6,2169,1914761,1334,1374,18,1380,1871131,835,421,29,1923,43630
1765.837,17,168,13946,156,30,11392,37,9090,12,376,154922,463,4856
1293.859,6,132,11352,88,69,14871,69,6556,44,69,30086,69,4796
2.237,6,6,340,3,0,1118,0,160,3,0,1009,0,180
0.07,17,8,2446,8,277,10,316,2446,0,0,0,0,0
0.545,6,27,8984,13,243,45,611,1656,14,941,38,1368,7328
15.659,6,7,304,2,0,15659,0,84,5,0,3852,0,220
0.528,6,23,4531,11,165,52,456,1394,12,498,43,888,3137
0.018,17,2,223,1,36,0,36,64,1,131,0,131,159
3.403,6,23,7468,11,268,336,517,1397,12,778,305,1418,6071
1796.286,17,449,39928,404,35,4457,288,25708,45,288,40009,288,14220
0.726,6,12,1304,6,256,142,256,756,6,304,141,304,548
85.988,17,10822,3905059,7209,466,11,1108,3561327,3613,67,23,744,343732
4.082,6,11,460,6,0,816,0,248,5,0,916,0,212
300.78,6,39,9832,22,571,14322,1360,4350,17,435,538,2720,5482
0.91,6,10,1687,7,100,151,100,384,3,1179,325,1179,1303
95.892,6,37,8600,19,410,501,882,2082,18,482,5631,3488,6518
0.074,17,2,376,1,39,0,39,67,1,281,0,281,309
40.103,6,3203,2996323,1963,1441,20,1448,2920423,1240,776,32,1448,75900
1795.744,2,20,640,20,8,94512,8,640,0,0,0,0,0
0.542,6,9,2006,5,739,135,1322,1683,4,159,180,159,323
280.007,6,31,7472,14,158,21539,267,1357,17,543,17500,1400,6115
0.311,6,23,7394,13,335,25,668,2026,10,968,33,1475,5368
154.85,6,99,68588,60,1256,2624,1408,58418,39,739,1872,2439,10170
0.005,17,2,390,1,30,0,30,58,1,304,0,304,332
1792.542,17,144,11520,72,48,25246,48,5472,72,56,25246,56,6048
0.031,17,2,664,1,308,0,308,336,1,300,0,300,328
342.894,6,86,17046,36,250,9796,1189,6450,50,245,6997,1420,10596
12.739,6,2000,1866157,1250,1413,10,1448,1822469,750,776,16,1448,43688
1788.219,17,301,70108,301,204,5960,422,70108,0,0,0,0,0
18.059,17,32,9557,15,363,1286,1350,5871,17,188,1125,1350,3686
44.069,6,30,8872,14,158,3389,267,1357,16,858,2928,3456,7515
6.251,6,45,8425,23,227,284,314,4102,22,429,285,1152,4323
1.956,17,3,468,3,128,978,128,468,0,0,0,0,0
1771.481,6,106,9799,67,65,26840,65,5694,39,59,46615,59,4105
0.443,17,2,152,1,48,0,48,76,1,48,0,48,76
756.27,2,6,192,6,8,151254,8,192,0,0,0,0,0
7.359,6,1740,1599671,1093,1385,6,1408,1561363,647,931,11,2801,38308
117.679,6,8,7232,0,0,0,0,0,8,1152,16811,1152,7232
1775.005,6,207,23921,132,89,13549,981,11118,75,137,23984,2077,12803
0.083,17,2,376,1,39,0,39,67,1,281,0,281,309
45.786,6,47,10116,23,635,720,1360,4199,24,309,1983,2667,5917
72.123,6,32,7584,13,155,6010,267,1306,19,393,4006,1420,6278
1704.562,1,8,448,8,28,243508,28,448,0,0,0,0,0
28.461,6,2820,2616981,1718,1438,16,1448,2551389,1102,776,25,1448,65592
1628.241,1,8,448,8,28,232605,28,448,0,0,0,0,0
240.287,6,459,401527,258,224,934,738,15616,201,1965,1201,5632,385911
280.292,6,30,7432,13,158,23357,267,1317,17,543,17513,1400,6115
2.492,6,32,6505,17,146,155,267,2000,15,650,173,1420,4505
4.675,6,39,7269,19,218,259,314,3383,20,513,232,1179,3886
1791.739,1,58,4872,58,56,31434,56,4872,0,0,0,0,0
1681.523,17,14,1036,7,30,280248,30,406,7,62,280247,62,630
1597.097,1,8,448,8,28,228156,28,448,0,0,0,0,0
6.612,6,14,2242,8,210,943,210,844,6,545,1320,904,1398
6.236,6,38,7245,19,218,346,314,3383,19,516,332,1179,3862
1798.856,1,58,4872,58,56,31558,56,4872,0,0,0,0,0
0.459,6,27,9064,13,252,38,646,1694,14,947,32,1438,7370
0.034,17,2,142,1,35,0,35,63,1,51,0,51,79
1771.75,6,101,9344,66,65,27257,65,5577,35,59,52106,59,3767
16.332,17,22,12407,11,521,1629,1350,6047,11,550,1629,1350,6360
22.549,6,3151,2985263,2015,1402,11,1448,2921527,1136,776,19,1448,63736
158.747,17,4,352,2,60,158746,60,176,2,60,158746,60,176
378.883,2,4,128,4,8,126294,8,128,0,0,0,0,0
0.916,6,15,6305,9,141,114,275,646,6,1805,142,2828,5659
1790.846,17,144,11520,72,48,25223,48,5472,72,56,25222,56,6048
1798.348,17,142,11360,71,48,25689,48,5396,71,56,25689,56,5964
0.111,6,15,4072,8,88,15,88,440,7,1670,18,1880,3632
1022.697,2,6,192,6,8,204539,8,192,0,0,0,0,0
1.619,6,44,15137,24,779,70,1360,9561,20,433,74,1360,5576
0.012,17,2,2178,2,1061,12,1061,2178,0,0,0,0,0
601.59,2,5,160,5,8,150397,8,160,0,0,0,0,0
377.709,2,3,96,3,8,188854,8,96,0,0,0,0,0
82.242,6,815,386345,432,832,190,1152,365179,383,389,214,1152,21166
0.047,6,4,220,2,0,47,0,104,2,0,44,0,116
17.05,17,5,380,5,48,4262,48,380,0,0,0,0,0
240.327,6,45,9100,23,523,10923,1418,5930,22,224,11443,617,3170
10.886,6,83,24541,42,550,265,1152,18760,41,459,265,1179,5781
1681.416,17,14,3815,7,30,280234,30,406,7,459,280233,463,3409
1795.123,17,447,39864,402,35,4476,288,25644,45,288,40016,288,14220
39.115,6,4,227,1,0,0,0,40,3,31,15470,31,187
0.015,17,2,460,1,39,0,39,67,1,365,0,365,393
1786.938,6,102,8296,68,65,26670,65,4930,34,59,54146,59,3366
1.008,17,3,215,2,33,1001,33,122,1,65,0,65,93
9.791,6,83,24941,42,546,238,1152,19160,41,459,238,1179,5781
283.363,6,31,7476,14,158,21797,267,1361,17,543,17514,1400,6115
1.311,17,6,936,3,64,648,64,276,3,192,645,192,660
1787.249,6,120,13822,76,162,23829,1289,9216,44,74,41562,267,4606
12.284,6,30,9683,15,422,863,1205,2478,15,802,863,2491,7205
0.253,6,2,149,1,0,0,0,40,1,69,0,69,109
240.264,6,56,18076,29,757,8580,1418,15159,27,215,9240,580,2917
301.584,6,54,22380,30,1094,10399,1460,16569,24,372,398,1460,5811
0.049,6,11,912,6,181,9,181,489,5,77,5,134,423
5.127,6,38,7229,19,218,284,314,3383,19,513,270,1179,3846
0.09,17,3,1015,3,310,45,354,1015,0,0,0,0,0
0.474,17,2,152,1,48,0,48,76,1,48,0,48,76
0.008,17,2,144,1,36,0,36,64,1,52,0,52,80
3.345,17,3,1167,3,361,1672,361,1167,0,0,0,0,0
31.115,17,18,1584,9,48,3887,48,684,9,72,3887,72,900
63.035,6,75,51844,47,1211,1370,1368,43651,28,841,2296,2519,8193
399.363,6,23,1499,14,177,30720,177,913,9,110,10215,110,586
1780.81,1,262,14672,262,28,6823,28,14672,0,0,0,0,0
1799.987,1,57,4788,0,0,0,0,0,57,56,32142,56,4788
240.256,6,53,19270,28,822,8898,1408,16271,25,211,10010,580,2999
183.4,6,98,64629,56,1220,3334,1368,55441,42,747,1540,1368,9188
0.211,6,25,7216,12,155,19,267,1261,13,678,16,2045,5955
1.582,6,50,19178,27,883,60,1360,13482,23,433,62,1360,5696
1787.078,6,106,8456,68,65,26672,65,4930,38,59,48295,59,3526
0.262,17,4,352,2,60,261,60,176,2,60,260,60,176
1774.74,6,182,15629,121,69,14789,69,8980,61,69,29576,69,6649
1786.561,6,103,8404,68,66,26665,66,4964,35,60,52543,60,3440
1.638,6,47,19609,27,921,63,1360,14033,20,476,75,2715,5576
0.016,17,2,624,1,64,0,64,92,1,504,0,504,532
10.392,17,3,3249,3,1055,5196,1055,3249,0,0,0,0,0
0.039,17,2,389,1,34,0,34,62,1,299,0,299,327
1781.144,1,342,28728,342,56,5223,56,28728,0,0,0,0,0
1.484,17,6,840,3,64,603,64,276,3,160,599,160,564
206.76,17,4,240,2,32,206759,32,120,2,32,206758,32,120
1779.894,17,140,11200,70,48,25795,48,5320,70,56,25795,56,5880
1785.104,17,85,3561,83,13,21767,14,3481,2,12,1784921,16,80
0.565,17,19,5893,8,368,77,1350,3173,11,219,53,1350,2720
5.609,6,691,563999,397,1344,14,1368,542283,294,776,18,1473,21716
73.595,1,6,336,6,28,14719,28,336,0,0,0,0,0
1783.305,1,342,28728,342,56,5229,56,28728,0,0,0,0,0
1797.306,17,448,39896,403,35,4470,288,25676,45,288,40021,288,14220
769.865,17,13,4264,13,300,64155,300,4264,0,0,0,0,0
1785.397,6,359,22709,209,69,8583,69,12569,150,69,11982,69,10140
0.167,6,9,1346,5,145,41,145,349,4,833,44,833,997
1746.822,6,95,7203,63,38,28174,205,4476,32,33,56337,98,2727
1576.043,17,20,6991,20,321,82949,1438,6991,0,0,0,0,0
0.0,6,1,83,0,0,0,0,0,1,31,0,31,83
5.194,17,4,352,2,48,5042,48,152,2,72,5050,72,200
560.509,17,6,1603,3,30,280248,30,174,3,448,280248,463,1429
19.578,6,21,4514,10,255,2175,722,1539,11,399,1938,1408,2975
1742.693,6,96,7255,62,38,28568,205,4424,34,33,52796,98,2831
1785.366,17,73,3060,72,14,25146,14,3024,1,8,0,8,36
80.665,6,41,8721,20,371,587,797,2005,21,418,4026,4848,6716
0.955,6,4,160,2,0,883,0,80,2,0,87,0,80
0.386,6,12,1653,6,288,70,288,548,6,426,44,434,1105
11.604,6,1863,1604969,1113,1386,10,1420,1570736,750,467,15,1883,34233
1741.372,17,30,31680,30,1028,60047,1028,31680,0,0,0,0,0
0.015,17,4,480,3,60,1,60,264,1,188,0,188,216
6.68,6,8,548,3,106,3340,106,234,5,90,1620,90,314
1.349,6,4,220,2,0,1349,0,92,2,0,12,0,128
1748.262,1,8,448,8,28,249751,28,448,0,0,0,0,0
1785.135,6,102,8296,68,65,26643,65,4930,34,59,54092,59,3366
11.527,6,23,5358,12,383,1047,885,2537,11,448,1135,1440,2821
0.32,6,9,527,5,43,80,43,311,4,0,104,0,216
18.193,6,30,5769,16,186,1212,314,2325,14,480,1377,1179,3444
241.732,6,437,395510,229,653,1060,1408,21481,208,1891,1167,8448,374029
1798.009,6,131,12714,80,61,22759,722,6556,51,85,35947,1448,6158
1775.021,6,182,15629,121,69,14791,69,8980,61,69,29581,69,6649
0.057,6,12,964,7,181,9,181,541,5,77,13,134,423
1795.901,6,125,8210,72,52,25294,208,5067,53,31,34532,31,3143
0.006,17,2,2750,2,1347,6,1347,2750,0,0,0,0,0
180.45,2,4,128,4,8,60150,8,128,0,0,0,0,0
1797.02,17,180,14040,180,50,10039,50,14040,0,0,0,0,0
325.165,6,31,6759,13,186,9103,501,1455,18,305,19122,1420,5304
300.922,6,40,11737,18,550,17691,1408,4245,22,397,14321,3594,7492
3.642,17,5,290,5,30,910,30,290,0,0,0,0,0
1.213,6,32,6507,15,164,86,267,1922,17,650,66,1452,4585
228.518,17,4,352,2,60,228517,60,176,2,60,228517,60,176
240.177,6,53,17859,28,790,8895,1408,14902,25,206,10007,580,2957
1769.569,1,58,4872,58,56,31045,56,4872,0,0,0,0,0
1772.068,6,99,9240,66,65,27262,65,5577,33,59,55370,59,3663
1773.21,6,180,15480,120,69,14900,69,8940,60,69,30045,69,6540
0.275,17,3,451,2,39,154,39,134,1,289,0,289,317
1.685,6,48,18679,27,853,64,1360,13063,21,433,73,1360,5616
1681.658,17,14,1036,7,30,280274,30,406,7,62,280274,62,630
125.665,2,2,64,2,8,125665,8,64,0,0,0,0,0
229.355,6,28,8792,13,158,19112,267,1317,15,858,16378,2045,7475
244.396,6,55,11028,26,536,9775,1408,6787,29,209,8728,580,4241
1789.086,1,58,4872,58,56,31387,56,4872,0,0,0,0,0
1799.118,1,345,28980,345,56,5229,56,28980,0,0,0,0,0
1740.465,17,29,6815,29,207,62159,207,6815,0,0,0,0,0
33.11,6,43,11035,21,868,452,1360,5260,22,348,1567,2720,5775
78.333,6,37,23995,19,840,47,1360,5871,18,1581,4599,5440,18124
1795.334,17,449,39928,404,35,4454,288,25708,45,288,40019,288,14220
1787.107,6,102,8364,68,66,26673,66,4964,34,60,54151,60,3400
0.598,6,25,6056,13,108,49,147,959,12,922,47,2603,5097
4.937,17,5,320,5,36,1234,36,320,0,0,0,0,0
3.896,6,203,197063,150,998,26,1360,18072,53,4019,72,16320,178991
0.261,17,3,451,2,39,243,39,134,1,289,0,289,317
11.592,6,25,8473,13,275,966,275,1078,12,986,763,1440,7395
0.131,17,2,154,1,33,0,33,61,1,65,0,65,93
1774.662,17,46,15456,46,308,39436,308,15456,0,0,0,0,0
1781.77,6,361,22858,210,69,8525,69,12678,151,69,11878,69,10180
60.251,2,2,64,2,8,60251,8,64,0,0,0,0,0
32.186,6,284,120941,145,784,223,1152,110931,139,404,231,1152,10010
360.951,2,3,96,3,8,180475,8,96,0,0,0,0,0
1798.892,6,361,24692,210,85,8607,1077,13617,151,79,11990,421,11075
0.348,17,2,412,1,33,0,33,61,1,323,0,323,351
0.865,17,4,368,2,32,639,32,120,2,96,641,96,248
4.76,6,41,7349,21,218,238,314,3463,20,440,237,1152,3886
1773.507,6,203,22290,130,75,13748,267,10057,73,134,24630,1917,12233
0.515,6,27,9157,13,268,42,710,1758,14,832,36,1368,7399
0.005,17,2,570,1,30,0,30,58,1,484,0,484,512
1786.827,6,106,8574,68,65,26669,65,4930,38,59,48290,59,3644
0.307,6,13,1749,7,253,51,500,878,6,275,61,500,871
172.626,6,24,10290,13,579,59,1360,2871,11,1161,17247,2720,7419
1750.998,17,128,10240,64,48,27793,48,4864,64,56,27793,56,5376
281.424,6,32,7922,16,143,18761,267,1506,16,641,18761,2800,6416
21.704,1,8,832,0,0,0,0,0,8,76,3100,76,832
302.526,6,42,18008,20,348,15915,619,3162,22,806,14399,3926,14846
8.851,6,12,945,6,222,1768,222,466,6,231,1768,231,479
5.034,17,394,415414,98,130,51,1350,15579,296,1322,16,1350,399835
1.304,6,48,18931,26,938,52,1460,13275,22,433,53,1460,5656
2.185,17,4,360,2,30,2082,30,116,2,94,2067,94,244
3.795,17,10,2418,5,30,945,30,290,5,397,946,468,2128
280.223,6,29,7392,14,158,21555,267,1357,15,678,20012,3536,6035
111.669,6,30,14484,16,512,335,1360,3785,14,1125,8580,2720,10699
113.301,2,2,64,2,8,113301,8,64,0,0,0,0,0
129.841,17,4,1344,4,308,43280,308,1344,0,0,0,0,0
0.163,6,28,7336,14,155,12,267,1341,14,603,11,2800,5995
9.032,17,80,52531,24,315,391,1350,8246,56,762,163,1350,44285
80.619,6,131,99599,82,1263,995,1368,88925,49,738,1674,2519,10674
21.023,6,1562,1361233,962,1366,21,1380,1332790,600,387,35,1923,28443
1798.016,1,226,12656,226,28,7991,28,12656,0,0,0,0,0
11.165,6,27,11355,13,275,930,275,1078,14,1078,794,1414,10277
1.599,17,49,26429,22,617,76,1350,14210,27,424,60,1350,12219
0.026,17,2,382,1,36,0,36,64,1,290,0,290,318
12.262,17,10,830,5,47,3064,47,375,5,63,3063,63,455
282.171,1,4,224,4,28,94057,28,224,0,0,0,0,0
67.687,6,18,2337,6,242,19,517,1059,12,323,6153,499,1278
16.784,17,19,13088,10,933,1860,1350,9618,9,357,2093,1350,3470
1792.84,17,179,11456,179,36,10072,36,11456,0,0,0,0,0
0.0,6,1,771,1,719,0,719,771,0,0,0,0,0
0.424,6,20,7151,12,318,38,600,1906,8,964,58,1471,5245
411.486,6,27,2087,17,64,25717,64,1192,10,55,45710,58,895
31.399,6,7,336,1,0,0,0,48,6,0,6276,0,288
368.209,1,15,420,15,0,0,0,420,0,0,0,0,0
280.353,6,30,7432,13,158,23362,267,1317,17,543,17514,1400,6115
1773.537,6,180,15480,120,69,14903,69,8940,60,69,30053,69,6540
0.048,17,2,216,1,45,0,45,73,1,115,0,115,143
15.272,17,20,8279,10,541,1693,1350,5691,10,230,1693,1350,2588
3.522,17,5,290,5,30,880,30,290,0,0,0,0,0
1794.131,17,80,3354,79,14,23001,14,3318,1,8,0,8,36
1786.04,6,357,22629,208,69,8628,69,12460,149,69,12067,69,10169
0.381,6,20,7151,13,318,31,600,1958,7,1205,60,1851,5193
1640.918,1,8,448,8,28,234416,28,448,0,0,0,0,0
293.025,17,4,352,2,60,293024,60,176,2,60,293024,60,176
575.233,17,9,2992,9,304,71904,308,2992,0,0,0,0,0
0.534,6,10,924,5,283,89,283,551,5,105,88,105,373
1599.294,6,24,3624,16,241,106619,241,2568,8,92,228445,92,1056
1669.196,1,7,392,7,28,278199,28,392,0,0,0,0,0
15.645,6,26,10876,9,154,1955,267,832,17,779,976,1420,10044
0.006,17,3,600,2,64,2,64,184,1,388,0,388,416
126.081,2,2,64,2,8,126081,8,64,0,0,0,0,0
117.73,6,99,75815,64,1275,1868,1448,65832,35,741,3456,2359,9983
0.013,17,4,352,2,37,8,37,130,2,83,6,89,222
1750.753,17,12,498,11,14,175075,14,462,1,8,0,8,36
5.036,17,4,288,2,36,5018,36,128,2,52,5021,52,160
1772.41,6,180,15480,120,69,14894,69,8940,60,69,30039,69,6540
0.092,17,2,136,1,32,0,32,60,1,48,0,48,76
3.623,6,50,20627,27,614,139,1360,6123,23,904,155,1360,14504
1800.0,6,225,21867,84,129,21405,1360,12666,141,50,12857,143,9201
1787.257,17,87,3648,86,14,21026,14,3612,1,8,0,8,36
1795.853,17,448,39896,403,35,4467,288,25676,45,288,40018,288,14220
278.895,17,4,352,2,60,278894,60,176,2,60,278894,60,176
1790.351,17,44,14784,44,308,41636,308,14784,0,0,0,0,0
0.336,6,27,8920,13,227,28,547,1592,14,941,25,1448,7328
1.278,6,24,8004,12,164,96,267,1288,12,1014,98,2896,6716
0.044,17,2,152,1,48,0,48,76,1,48,0,48,76
0.012,17,2,212,1,46,0,46,74,1,110,0,110,138
1680.654,17,12,498,11,14,168065,14,462,1,8,0,8,36
124.497,6,25,10208,12,549,87,1360,2709,13,995,10361,1360,7499
1790.086,6,356,22520,208,69,8647,69,12460,148,69,12177,69,10060
1768.176,17,170,14488,157,30,11334,37,9155,13,382,142200,463,5333
45.295,6,31,8912,14,158,3484,267,1357,17,687,2827,1781,7555
12.899,6,14,2245,8,211,1842,211,846,6,545,2573,904,1399
5.152,6,124,181412,46,283,114,880,4158,78,2340,66,7040,177254
1792.03,1,147,15582,147,78,12274,78,15582,0,0,0,0,0
104.24,2,7,288,7,17,17373,24,288,0,0,0,0,0
1766.449,1,8,448,8,28,252349,28,448,0,0,0,0,0
0.216,6,2,111,1,0,0,0,40,1,31,0,31,71
93.486,1,4,224,4,28,31162,28,224,0,0,0,0,0
34.925,6,23,4995,9,144,4365,293,1232,14,456,2665,1152,3763
1764.009,2,13,416,13,8,147000,8,416,0,0,0,0,0
28.908,6,41,8801,20,401,544,889,2084,21,391,1439,3488,6717
2.55,17,15,8374,8,705,364,1350,5871,7,329,416,1350,2503
1791.884,6,356,22520,208,69,8656,69,12460,148,69,12189,69,10060
3.25,17,4,1556,4,361,1083,361,1556,0,0,0,0,0
290.154,17,4,352,2,60,290153,60,176,2,60,290153,60,176
1787.575,6,104,8376,68,65,26680,65,4930,36,59,51069,59,3446
1764.696,2,15,480,15,8,126049,8,480,0,0,0,0,0
0.283,6,20,4960,10,137,31,267,1092,10,692,30,1467,3868
1302.033,6,68,4919,45,31,29591,31,3010,23,31,59175,31,1909
0.1,17,2,164,1,46,0,46,74,1,62,0,62,90
1.454,6,50,20186,27,955,55,1440,14490,23,433,58,1440,5696
1.984,17,4,352,2,60,1983,60,176,2,60,1982,60,176
842.214,2,9,288,9,8,105276,8,288,0,0,0,0,0
11.751,6,1878,1623353,1133,1378,10,1420,1589332,745,467,15,1883,34021
276.66,17,4,1344,4,308,92220,308,1344,0,0,0,0,0
1795.74,17,448,39896,403,35,4467,288,25676,45,288,40019,288,14220
1.265,6,51,19754,27,920,48,1360,14018,24,433,46,1360,5736
174.949,17,4,352,2,60,174948,60,176,2,60,174948,60,176
3.025,17,4,644,2,33,3010,33,122,2,233,1,233,522
61.309,6,37,16034,22,810,2919,1440,9255,15,665,4361,1440,6779
0.073,17,3,1054,3,323,36,354,1054,0,0,0,0,0
1787.006,6,102,8296,68,65,26671,65,4930,34,59,54147,59,3366
374.782,6,27,1767,18,177,22046,177,1181,9,110,8674,110,586
363.96,6,112,35080,54,834,5144,1268,23854,58,247,6383,1414,11226
1624.368,2,14,448,14,8,124951,8,448,0,0,0,0,0
0.991,17,2,685,1,308,0,308,336,1,321,0,321,349
1.471,6,11,1727,7,100,245,100,384,4,589,401,1152,1343
1746.404,6,154,16484,86,127,20545,205,11245,68,32,26058,33,5239
13.755,17,4,824,2,48,13738,48,152,2,308,13728,308,672
1766.638,1,63,5292,0,0,0,0,0,63,56,28494,56,5292
1681.912,1,15,840,15,28,120136,28,840,0,0,0,0,0
10.012,17,2,128,2,36,10012,36,128,0,0,0,0,0
67.236,6,29,7257,14,155,5172,267,1346,15,482,4802,2840,5911
51.98,6,18,3930,10,158,5775,174,878,8,681,7379,1452,3052
0.207,6,9,1346,5,145,51,145,349,4,833,63,833,997
721.931,2,5,160,5,8,180482,8,160,0,0,0,0,0
5.899,6,39,7269,21,218,294,314,3463,18,513,332,1179,3806
1680.697,17,13,534,11,14,168051,14,462,2,8,1680510,8,72
14.26,6,99,29932,51,565,285,1152,23546,48,446,273,1179,6386
1790.781,6,356,22520,208,69,8651,69,12460,148,69,12181,69,10060
40.472,6,27,7177,13,155,3372,267,1306,14,530,3112,3417,5871
0.036,6,4,298,1,0,0,0,40,3,69,0,69,258
11.71,6,1726,1604946,1132,1366,10,1432,1576655,594,427,19,1432,28291
1796.902,17,449,39928,404,35,4458,288,25708,45,288,40020,288,14220
3.153,6,6,336,3,0,1510,0,180,3,0,1510,0,156
279.962,17,18,3024,9,40,34993,40,612,9,240,34993,249,2412
1581.12,6,205,17488,78,75,20532,315,7798,127,72,12547,1062,9690
1792.741,6,393,24240,216,69,8338,69,12780,177,49,10185,69,11460
185.614,6,33,15262,19,857,10309,1343,9597,14,617,14275,1368,5665
147.553,6,22,3794,8,92,21079,92,504,14,232,11333,1408,3290
1772.992,6,180,15480,120,69,14899,69,8940,60,69,30046,69,6540
5.425,6,38,7245,20,218,285,314,3423,18,516,303,1179,3822
0.124,17,2,390,1,46,0,46,74,1,288,0,288,316
4.01,6,31,11675,17,808,250,1460,5560,14,791,294,1547,6115
74.987,17,17,18407,17,1054,4686,1061,18407,0,0,0,0,0
139.811,6,1053,497480,551,836,254,1152,470158,502,402,278,1179,27322
6.521,6,1615,1323949,859,1438,7,1448,1270677,756,776,8,1448,53272
1770.181,6,210,16146,78,68,22987,293,7638,132,48,13512,78,8508
0.06,17,2,181,1,32,0,32,60,1,93,0,93,121
2.066,17,30,12251,15,538,145,1350,8497,15,222,145,1350,3754
280.27,6,29,7392,13,158,23355,267,1317,16,603,18682,2236,6075
5.651,17,10,1830,5,36,1411,36,320,5,274,1411,318,1510
1773.395,6,181,15589,120,69,14902,69,8940,61,69,29551,69,6649
115.127,17,4,352,2,60,115126,60,176,2,60,115126,60,176
8.365,6,76,24549,39,560,220,1152,18928,37,459,225,1179,5621
368.977,6,25,1651,17,177,23061,177,1117,8,110,9214,110,534
1752.084,6,100,7866,66,45,26955,205,4902,34,35,53083,98,2964
1790.698,6,362,24981,211,94,8527,469,14456,151,69,11936,69,10525
1771.299,6,99,9306,66,66,27250,66,5610,33,60,55349,60,3696
16.833,6,844,717724,533,1272,31,1368,696888,311,776,53,2736,20836
1798.752,1,58,4872,58,56,31557,56,4872,0,0,0,0,0
0.156,6,12,3462,6,75,31,75,395,6,1373,31,1448,3067
59.685,6,406,419860,114,726,528,1408,16421,292,1386,205,2816,403439
0.181,17,2,144,1,36,0,36,64,1,52,0,52,80
3.477,6,26,8138,12,326,311,517,1949,14,779,263,1418,6189
1783.407,17,83,3480,82,14,22017,14,3444,1,8,0,8,36
793.153,6,94,6428,35,46,23328,46,2734,59,46,13672,46,3694
10.876,6,19,5912,9,272,1359,516,1180,10,618,1198,1452,4732
300.164,6,42,13650,23,892,13635,1360,8088,19,435,16666,2667,5562
1791.329,17,87,3648,86,14,21074,14,3612,1,8,0,8,36
768.984,17,112,8512,112,48,6927,48,8512,0,0,0,0,0
15.055,17,4,3100,4,747,5018,1451,3100,0,0,0,0,0
240.192,6,57,17357,29,746,8578,1408,14210,28,210,8895,580,3147
0.012,17,2,405,1,35,0,35,63,1,314,0,314,342
1794.25,1,276,15456,276,28,6524,28,15456,0,0,0,0,0
0.413,17,8,2750,8,315,59,354,2750,0,0,0,0,0
0.0,17,2,167,1,39,0,39,67,1,72,0,72,100
235.81,17,4,304,2,48,235809,64,152,2,48,235809,64,152
1770.234,6,106,9684,68,64,26421,64,5724,38,58,47841,58,3960
1790.749,17,178,13884,178,50,10117,50,13884,0,0,0,0,0
11.498,6,27,11433,13,275,958,275,1078,14,1087,856,1440,10355
1782.372,17,83,3480,82,14,22004,14,3444,1,8,0,8,36
10.943,6,104,35338,53,606,210,1152,28816,51,447,213,1179,6522
1112.705,17,218,16568,218,48,5127,48,16568,0,0,0,0,0
10.218,6,97,33043,49,616,212,1152,26625,48,449,211,1179,6418
10.757,6,28,8670,14,181,812,267,1826,14,1014,812,2491,6844
8.517,6,11,676,3,106,4255,106,234,8,90,1215,90,442
280.025,6,29,7392,13,158,23335,267,1317,16,603,18666,2036,6075
422.214,6,45,7921,21,134,16323,516,2050,24,245,18353,1452,5871
0.013,17,2,326,1,32,0,32,60,1,238,0,238,266
503.558,6,508,82634,290,304,1742,304,58444,218,83,2319,83,24190
1798.567,6,372,25519,215,93,8404,469,14754,157,69,11526,69,10765
4.031,17,8,747,4,32,1337,32,240,4,98,1337,107,507
377.212,6,18,1242,14,180,29016,180,916,4,110,20056,110,326
0.057,17,2,241,1,36,0,36,64,1,149,0,149,177
29.041,17,33,17552,13,455,2414,1350,6285,20,535,1524,1350,11267
1602.934,6,161,14025,102,70,15870,138,7737,59,68,27636,69,6288
18.955,6,948,803226,600,1326,31,1360,781403,348,187,49,1360,21823
0.215,17,2,2380,2,1162,215,1162,2380,0,0,0,0,0
17.804,6,21,5742,10,275,1978,275,962,11,1440,1500,1440,4780
0.652,6,9,1340,5,145,163,145,349,4,827,170,827,991
27.959,6,14,2257,7,211,4659,211,806,7,545,4658,904,1451
70.288,6,14,572,6,0,7218,0,244,8,0,10039,0,328
1787.121,6,108,7428,66,60,27494,208,4818,42,31,43578,31,2610
1743.125,6,95,7203,63,38,28114,205,4476,32,33,56219,98,2727
14.49,17,4,304,4,48,4830,48,304,0,0,0,0,0
1772.029,6,180,15480,120,69,14891,69,8940,60,69,30034,69,6540
1796.643,17,448,39896,403,35,4469,288,25676,45,288,40016,288,14220
3.039,17,31,14551,14,576,233,1350,8469,17,329,115,1350,6082
33.921,6,30,5055,15,154,2422,722,1871,15,400,2410,1408,3184
0.091,6,2,116,1,0,0,0,64,1,0,0,0,52
7.22,6,39,8396,20,254,380,673,1851,19,444,384,1360,6545
145.244,6,68,47130,44,1179,3377,1408,37738,24,1017,2678,4224,9392
62.571,6,13,772,3,106,31280,106,234,10,90,6951,90,538
11.696,6,1887,1617194,1140,1363,10,1380,1582796,747,421,15,1923,34398
79.061,6,27,5120,18,304,4650,304,4288,9,83,9831,83,832
280.527,6,30,7432,14,158,21579,267,1357,16,678,18693,3456,6075
1680.02,1,15,840,15,28,120001,28,840,0,0,0,0,0
880.815,1,44,2464,44,28,20484,28,2464,0,0,0,0,0
127.914,17,11,4473,11,378,12791,464,4473,0,0,0,0,0
1791.612,1,260,14560,260,28,6917,28,14560,0,0,0,0,0
0.993,17,2,677,1,300,0,300,328,1,321,0,321,349
1772.028,1,59,4956,59,56,30552,56,4956,0,0,0,0,0
0.043,17,4,284,2,32,24,32,120,2,54,20,60,164
6.12,6,11,3410,5,75,1529,75,343,6,1373,1017,1448,3067
0.365,17,3,1164,3,360,182,360,1164,0,0,0,0,0
20.406,6,37,8333,18,356,516,753,1820,19,441,1126,1460,6513
36.056,1,4,224,4,28,12018,28,224,0,0,0,0,0
1792.417,6,363,23007,210,69,8576,69,12678,153,69,11792,69,10329
0.013,17,2,412,1,48,0,48,76,1,308,0,308,336
0.044,17,2,574,1,32,0,32,60,1,486,0,486,514
243.964,6,15,1477,5,187,24,187,455,10,247,27104,462,1022
0.4,6,9,1145,5,279,100,279,547,4,191,67,272,598
0.74,6,4,253,2,31,740,31,111,2,31,360,31,142
40.454,17,15,1140,15,48,2889,48,1140,0,0,0,0,0
23.772,6,32,8055,15,188,1698,721,1922,17,681,1461,1420,6133
4.898,17,4,558,2,36,4887,36,128,2,187,4889,187,430
6.451,6,25,6245,14,232,475,517,1744,11,675,617,2840,4501
0.09,6,14,5045,7,170,12,170,554,7,1029,14,1448,4491
31.603,6,7,308,1,0,0,0,44,6,0,6300,0,264
1784.752,6,106,8456,68,65,26638,65,4930,38,59,48234,59,3526
1.708,17,3,1167,3,361,854,361,1167,0,0,0,0,0
1.018,6,30,13221,17,529,63,1360,3370,13,1164,70,3921,9851
50.575,6,27,9662,14,301,3890,595,1508,13,846,4197,1360,8154
1.953,6,6,1670,4,0,651,0,160,2,1430,1780,1430,1510
1785.853,6,361,22858,210,69,8544,69,12678,151,69,11905,69,10180
1778.127,17,73,3060,72,14,25044,14,3024,1,8,0,8,36
1.308,6,24,8004,12,164,101,267,1288,12,1014,101,2423,6716
1797.735,6,373,23614,214,69,8440,69,13114,159,69,11377,69,10500
54.686,6,61,20855,33,1110,390,1360,14764,28,309,2018,2667,6091
1662.683,1,7,392,7,28,277113,28,392,0,0,0,0,0
261.832,17,7,2604,7,344,43638,548,2604,0,0,0,0,0
292.131,6,293,246843,196,1319,1498,1408,225278,97,589,3040,3847,21565
1787.901,6,355,22480,207,69,8638,69,12420,148,69,12162,69,10060
0.083,6,31,19021,17,127,5,127,1019,14,1726,6,2896,18002
0.094,17,2,588,1,39,0,39,67,1,493,0,493,521
0.392,6,30,7390,18,281,23,918,2696,12,601,34,1420,4694
1785.817,6,155,20046,92,316,19624,316,14272,63,83,28803,83,5774
1637.376,2,12,384,12,8,148852,8,384,0,0,0,0,0
280.214,6,29,7392,13,158,23351,267,1317,16,603,18678,2800,6075
11.184,6,1708,1544519,1093,1362,10,1380,1515677,615,421,18,1923,28842
1789.952,6,372,25919,216,98,8325,469,15263,156,69,11548,69,10656
75.212,6,22,10189,11,433,56,990,1771,11,1138,7509,2568,8418
0.094,17,4,284,2,32,59,32,120,2,54,75,60,164
1796.194,17,142,11360,71,48,25659,48,5396,71,56,25659,56,5964
0.187,17,2,260,1,61,0,61,89,1,143,0,143,171
1791.911,6,355,22480,207,69,8698,69,12420,148,69,12189,69,10060
194.844,6,31,6806,16,168,12844,516,1655,15,378,13911,1452,5151
1773.779,6,180,15480,120,69,14905,69,8940,60,69,30059,69,6540
7.167,6,37,7209,18,218,421,314,3343,19,516,383,1179,3866
1786.588,6,104,8240,68,63,26665,63,4862,36,57,51042,57,3378
0.068,6,9,1339,5,145,17,145,349,4,826,20,826,990
1798.769,17,180,14040,180,50,10048,50,14040,0,0,0,0,0
300.705,6,35,8460,19,318,16705,928,2067,16,521,568,3488,6393
237.553,17,2,152,2,48,237553,48,152,0,0,0,0,0
109.761,17,4,272,2,40,109760,47,136,2,40,109760,47,136
240.264,6,59,16869,30,753,8284,1418,13622,29,216,8580,580,3247
1.364,6,50,19923,26,936,54,1460,14187,24,433,51,1460,5736
1.486,6,51,22517,29,979,53,1460,16861,22,476,61,2615,5656
259.047,17,4,352,2,60,259046,60,176,2,60,259046,60,176
64.135,6,3,156,3,0,0,0,156,0,0,0,0,0
2.121,6,67,52117,44,1256,49,1368,45016,23,982,87,2736,7101
0.063,1,2,112,2,28,63,28,112,0,0,0,0,0
1386.328,1,32,1792,32,28,44720,28,1792,0,0,0,0,0
1741.165,6,89,6426,58,31,30546,31,3915,31,31,58037,31,2511
0.443,6,17,6337,9,141,55,275,646,8,894,31,1440,5691
3.039,17,2,1430,2,687,3039,687,1430,0,0,0,0,0
0.452,6,5,1564,3,413,226,413,946,2,269,203,269,618
1767.913,1,86,9116,86,78,20798,78,9116,0,0,0,0,0
1797.287,1,261,14616,261,28,6912,28,14616,0,0,0,0,0
1792.86,17,44,14784,44,308,41694,308,14784,0,0,0,0,0
6.696,6,22,4426,12,213,608,597,1689,10,552,723,1767,2737
207.595,6,23,5438,8,187,1042,293,1075,15,341,14811,1179,4363
1740.701,17,28,29551,28,1027,64470,1028,29551,0,0,0,0,0
1.607,6,48,19312,27,898,61,1360,13696,21,433,68,1360,5616
99.288,6,22,9498,11,337,64,673,1485,11,1080,9915,1460,8013
722.194,17,466,33414,377,40,1920,41,25883,89,56,480,57,7531
1791.283,17,87,3648,86,14,21073,14,3612,1,8,0,8,36
0.55,1,2,163,2,53,550,78,163,0,0,0,0,0
87.739,6,21,8718,11,316,65,640,1421,10,1147,9734,2720,7297
4.147,6,41,7349,21,218,207,314,3463,20,440,205,1152,3886
224.644,6,39,5962,22,331,10697,1056,3485,17,226,14035,580,2477
94.64,17,2,908,2,426,94640,687,908,0,0,0,0,0
1799.664,6,356,22520,208,69,8694,69,12460,148,69,12242,69,10060
1780.803,6,190,20837,124,110,14478,965,11947,66,94,27396,917,8890
10.981,6,20,4442,11,275,1098,275,998,9,768,776,1440,3444
11.743,6,1725,1609267,1136,1365,10,1432,1581404,589,475,19,1871,27863
1739.878,6,197,15736,105,83,16729,267,9632,92,56,19088,124,6104
2.129,17,2,136,1,32,0,32,60,1,48,0,48,76
169.176,1,4,224,4,28,56392,28,224,0,0,0,0,0
0.066,17,4,352,2,37,1,37,130,2,83,0,89,222
1.216,6,25,8056,12,164,93,267,1288,13,869,86,1408,6768
196.695,6,146,104473,86,1267,2314,1368,93214,60,738,1350,2519,11259
1781.118,1,342,28728,342,56,5223,56,28728,0,0,0,0,0
23.861,6,10,617,0,0,0,0,0,10,31,2651,31,617
0.004,6,12,27972,1,0,0,0,40,11,2487,0,5472,27932
0.036,17,2,167,1,39,0,39,67,1,72,0,72,100
1779.283,17,140,11200,70,48,25786,48,5320,70,56,25786,56,5880
39.457,6,39,8577,19,367,1114,787,1930,20,416,2069,3488,6647
58.3,6,535,245063,278,816,210,1152,229262,257,424,226,1179,15801
1799.589,17,448,39896,403,35,4476,288,25676,45,288,40020,288,14220
1788.342,17,83,3480,82,14,22078,14,3444,1,8,0,8,36
37.469,17,22,1936,11,48,3746,48,836,11,72,3745,72,1100
234.072,17,4,272,2,40,234071,47,136,2,40,234070,47,136
1787.064,6,109,8759,69,65,26280,65,5035,40,59,45818,59,3724
49.597,6,13,1807,5,100,227,100,304,8,1179,7050,1179,1503
4.387,6,22,6410,11,262,431,517,1368,11,893,430,2449,5042
32.746,6,22,6912,7,156,15,267,758,15,504,2338,3426,6154
145.838,1,4,224,4,28,48612,28,224,0,0,0,0,0
955.834,6,117,15050,68,82,12560,267,5438,49,173,19913,3417,9612
0.203,6,13,4524,8,290,29,517,993,5,1087,46,1418,3531
221.396,17,8,2688,8,308,31628,308,2688,0,0,0,0,0
4.256,6,2,88,2,0,0,0,88,0,0,0,0,0
11.061,6,92,27181,47,558,240,1152,20883,45,449,245,1179,6298
0.512,6,26,6137,12,181,46,537,1526,14,643,36,1368,4611
0.115,6,2,80,2,0,0,0,80,0,0,0,0,0
1741.047,17,29,6699,29,203,62180,203,6699,0,0,0,0,0
162.854,17,8,704,4,48,54281,48,304,4,72,54281,72,400
1787.844,6,115,12295,74,81,24491,501,5910,41,128,44693,1420,6385
15.374,6,6,288,1,0,0,0,48,5,0,3841,0,240
1789.645,1,58,4872,58,56,31397,56,4872,0,0,0,0,0
172.161,6,6,1225,4,319,57387,398,799,2,173,171839,254,426
101.754,6,10,400,10,0,0,0,400,0,0,0,0,0
1.387,6,49,18298,28,882,51,1360,12637,21,437,60,2720,5661
280.264,6,29,7392,13,158,23355,267,1317,16,603,18683,1400,6075
1043.002,17,205,15580,205,48,5112,48,15580,0,0,0,0,0
1787.925,6,354,22371,206,69,8721,69,12311,148,69,12162,69,10060
1.177,6,24,8004,12,164,91,267,1288,12,1014,91,2411,6716
1748.755,6,144,8864,75,42,23631,208,4957,69,31,25711,31,3907
161.788,17,4,950,2,39,161776,39,134,2,380,161767,380,816
1788.668,6,282,34030,117,135,15418,1360,16542,165,135,10905,4662,17488
10.766,6,20,4442,11,275,1076,275,998,9,768,745,1440,3444
0.5,17,3,451,2,39,378,39,134,1,289,0,289,317
1.318,6,44,18388,27,844,50,1360,12932,17,529,69,4075,5456
1796.418,6,81,4302,41,26,44909,26,2184,40,26,46061,26,2118
0.028,17,2,467,1,33,0,33,61,1,378,0,378,406
0.182,6,46,21022,26,1067,7,1420,16001,20,467,9,1883,5021
249.186,17,8,608,8,48,35598,48,608,0,0,0,0,0
121.433,17,8,2688,8,308,17347,308,2688,0,0,0,0,0
1.464,6,19,3781,10,234,162,564,1452,9,463,159,1343,2329
0.466,6,56,23657,30,1010,16,1380,16452,26,511,16,1923,7205
300.655,6,45,8903,22,283,14316,787,2105,23,345,500,1460,6798
368.841,6,27,1767,18,177,21696,177,1181,9,110,8645,110,586
598.41,6,108,17937,54,118,11287,721,5955,54,426,11287,2007,11982
5.404,6,39,7269,21,218,270,314,3463,18,513,303,1179,3806
215.325,6,28,7352,12,158,19575,267,1277,16,603,14350,1400,6075
498.278,6,160,33270,73,356,6920,1440,20435,87,186,5791,1440,12835
1.182,17,4,580,2,40,1136,40,136,2,194,1137,194,444
1741.494,6,87,6322,58,31,30552,31,3915,29,31,62195,31,2407
3.974,17,8,736,4,64,1324,64,368,4,64,1324,64,368
1671.5,1,8,448,8,28,238785,28,448,0,0,0,0,0
0.047,6,9,1002,5,213,11,213,417,4,421,13,421,585
7.04,6,676,612986,433,1343,15,1368,593422,243,776,28,2736,19564
11.704,6,27,10204,15,554,836,1387,2450,12,1017,1063,2816,7754
291.702,17,4,352,2,60,291701,60,176,2,60,291701,60,176
0.239,6,22,4467,11,165,23,456,1394,11,498,23,888,3073
1743.757,6,126,11672,72,96,24559,205,7594,54,31,32892,33,4078
1.909,6,14,2351,8,188,272,245,700,6,703,325,1152,1651
181.859,6,187,53666,102,643,1800,1380,20819,85,372,2164,1359,32847
130.299,17,4,352,2,60,130297,60,176,2,60,130298,60,176
0.307,6,20,7229,12,334,27,663,1969,8,1209,42,1906,5260
4.666,6,22,4490,12,226,424,597,1753,10,552,496,1767,2737
1780.688,17,304,49292,304,134,5876,376,49292,0,0,0,0,0
68.761,6,76,30514,38,775,1853,1440,22493,38,589,1853,1440,8021
1798.779,17,449,39928,404,35,4463,288,25708,45,288,40020,288,14220
391.903,17,6,456,3,48,195944,48,228,3,48,195944,48,228
15.567,6,17,14956,3,156,141,156,296,14,1408,1183,1934,14660
299.576,6,6,364,4,31,99858,31,222,2,31,299537,31,142
111.166,17,4,352,2,60,111160,60,176,2,60,111164,60,176
1799.721,1,252,14112,252,28,7170,28,14112,0,0,0,0,0
275.68,6,25,6271,9,267,119,501,1165,16,343,18372,1420,5106
1.241,6,25,8056,12,164,95,267,1288,13,869,87,1448,6768
1798.631,1,16,896,16,28,119908,28,896,0,0,0,0,0
1798.81,1,58,4872,58,56,31558,56,4872,0,0,0,0,0
0.57,6,23,7336,13,319,47,602,1960,10,1209,60,2736,5376
300.615,6,38,8566,19,315,16700,882,2053,19,441,468,1360,6513
0.219,6,3,128,2,0,146,0,88,1,0,0,0,40
4.778,17,2,656,2,300,4778,300,656,0,0,0,0,0
31.572,6,2,96,1,0,0,0,48,1,0,0,0,48
1783.811,6,356,22589,207,69,8659,69,12420,149,69,12052,69,10169
1776.869,6,244,24612,98,67,18316,659,9254,146,130,12253,1638,15358
0.231,17,2,148,1,38,0,38,66,1,54,0,54,82
61.319,6,43,21877,26,973,2452,1448,14995,17,665,3816,1448,6882
300.691,6,37,8232,20,241,15825,619,1798,17,522,534,2720,6434
39.299,6,9,512,2,0,39101,0,112,7,0,6518,0,400
4.137,6,12,4009,4,92,1379,92,296,8,548,403,1448,3713
41.652,6,30,7432,13,158,3471,267,1317,17,543,2598,1400,6115
1783.81,6,370,26239,214,105,8374,469,15514,156,69,11508,69,10725
154.081,17,4,558,2,36,154076,36,128,2,187,154077,187,430
0.087,6,9,1346,5,145,21,145,349,4,833,16,833,997
0.09,17,4,360,2,30,36,30,116,2,94,46,94,244
83.367,17,32,8386,16,40,5556,41,1099,16,427,5556,505,7287
8.678,6,36,8716,18,436,510,994,2110,18,489,499,2720,6606
1.424,6,48,19233,27,893,54,1360,13617,21,476,61,2715,5616
1786.962,6,104,8308,68,64,26671,64,4896,36,58,51053,58,3412
369.663,6,25,1651,17,177,23103,177,1117,8,110,9356,110,534
0.182,6,13,1997,8,329,25,500,1082,5,647,45,647,915
0.433,6,49,20305,27,1005,16,1380,15183,22,421,18,1923,5122
63.889,6,23,7916,8,154,9127,267,792,15,651,4559,1420,7124
1741.521,6,95,6867,61,31,29025,31,4145,34,31,52772,31,2722
0.123,17,2,382,1,44,0,44,72,1,282,0,282,310
116.87,6,22,10322,12,397,74,884,1717,10,1365,12970,3928,8605
0.367,6,29,10297,14,261,28,683,1804,15,963,25,1408,8493
0.058,17,4,352,2,37,0,37,130,2,83,39,89,222
1796.355,17,446,39832,401,35,4490,288,25612,45,288,40026,288,14220
0.599,6,29,10285,14,261,46,683,1792,15,963,42,1408,8493
1.384,6,3,168,1,0,0,0,52,2,0,1384,0,116
1798.648,6,365,25032,213,94,8484,469,14536,152,69,11909,69,10496
11.515,6,1864,1587782,1120,1364,10,1380,1553708,744,421,15,1923,34074
0.426,6,7,376,4,0,142,0,216,3,0,109,0,160
0.369,6,26,8905,13,241,30,606,1651,13,938,30,1408,7254
645.662,6,22,1144,16,0,43044,0,832,6,0,38928,0,312
0.051,6,13,3514,7,75,8,75,447,6,1373,10,1448,3067
1.614,6,31,6231,17,135,100,267,1766,14,650,109,1452,4465
247.913,17,4,240,2,32,247912,32,120,2,32,247912,32,120
1680.779,17,13,534,11,14,168059,14,462,2,8,1680591,8,72
0.16,17,2,144,1,36,0,36,64,1,52,0,52,80
0.042,17,2,159,1,33,0,33,61,1,70,0,70,98
0.033,1,3,601,3,172,16,197,601,0,0,0,0,0
1798.494,17,451,40560,405,36,4451,288,26024,46,288,39207,288,14536
141.473,17,14,1232,7,48,23566,48,532,7,72,23570,72,700
295.329,17,4,352,2,60,295328,60,176,2,60,295328,60,176
1777.633,6,283,35608,115,136,15592,1360,16436,168,146,10643,2720,19172
5.001,17,4,288,2,36,4984,36,128,2,52,4984,52,160
3.585,17,2,778,2,361,3585,361,778,0,0,0,0,0
1787.967,6,103,8336,68,65,26686,65,4930,35,59,52583,59,3406
126.547,2,2,64,2,8,126547,8,64,0,0,0,0,0
280.558,6,30,7432,13,158,23379,267,1317,17,603,17531,2076,6115
1772.212,6,180,15480,120,69,14892,69,8940,60,69,30033,69,6540
0.014,17,2,425,1,58,0,58,86,1,311,0,311,339
1794.467,17,180,14040,180,50,10024,50,14040,0,0,0,0,0
54.334,6,18,2511,8,188,7762,245,700,10,1407,6002,1407,1811
0.096,17,2,1920,2,932,96,932,1920,0,0,0,0,0
1.652,6,37,8254,19,321,91,1168,2758,18,476,84,2715,5496
22.335,17,16,8114,8,540,3186,1350,4544,8,418,3186,1350,3570
1747.992,6,94,7151,62,38,28655,205,4424,32,33,56377,98,2727
0.936,6,51,13869,24,553,40,1429,4880,27,464,35,1986,8989
1773.439,6,180,15480,120,69,14902,69,8940,60,69,30051,69,6540
1794.366,17,80,3354,79,14,23004,14,3318,1,8,0,8,36
194.45,17,4,240,2,32,194449,32,120,2,32,194448,32,120
0.204,6,23,5315,13,89,17,147,1064,10,620,21,1418,4251
0.607,17,4,352,2,60,606,60,176,2,60,606,60,176
1786.564,6,102,8172,68,63,26665,64,4868,34,57,54135,58,3304
1796.882,17,140,11200,70,48,26041,48,5320,70,56,26041,56,5880
280.504,6,29,7392,13,158,23375,267,1317,16,678,18692,3456,6075
2.166,6,9,527,5,43,541,43,311,4,0,720,0,216
1.752,6,13,2311,8,188,250,245,700,5,1407,372,1407,1611
6.114,17,6,1344,3,46,3050,46,222,3,346,3050,346,1122
0.494,17,2,144,1,36,0,36,64,1,52,0,52,80
0.072,6,5,262,4,62,8,62,222,1,0,0,0,40
1788.029,17,87,3648,86,14,21035,14,3612,1,8,0,8,36
1682.741,17,14,1036,7,30,280446,30,406,7,62,280448,62,630
84.184,6,760,354693,395,827,213,1152,335302,365,435,230,1179,19391
2.722,6,15,2391,9,125,340,245,740,6,1407,491,1407,1651
37.327,17,11,836,11,48,3732,48,836,0,0,0,0,0
1.449,6,37,8214,19,321,80,1164,2718,18,476,74,2720,5496
280.43,6,30,7432,14,158,21571,267,1357,16,678,18693,3456,6075
1772.544,6,180,15480,120,69,14895,69,8940,60,69,30035,69,6540
1140.592,2,9,288,9,8,142574,8,288,0,0,0,0,0
1772.741,6,180,15480,120,69,14896,69,8940,60,69,30045,69,6540
73.339,6,69,46801,44,1175,1705,1408,38766,25,747,2570,1408,8035
0.056,17,2,904,1,300,0,300,328,1,548,0,548,576
0.972,6,30,5973,14,123,74,267,1428,16,650,57,1452,4545
0.149,17,2,152,1,48,0,48,76,1,48,0,48,76
1789.354,6,378,28856,218,120,8245,1189,16932,160,81,11253,485,11924
70.323,6,8,332,3,0,614,0,124,5,0,17576,0,208
299.905,6,141,88512,86,1197,3527,1408,78741,55,265,5551,1408,9771
1790.693,6,363,24883,211,94,8527,469,14387,152,69,11856,69,10496
1791.087,6,27,4077,18,241,105358,241,2889,9,92,223863,92,1188
63.259,6,37,5466,22,154,3012,722,2283,15,342,1118,2026,3183
5.2,17,3,208,2,36,5005,36,128,1,52,0,52,80
212.821,6,23,3253,13,328,17735,593,1353,10,457,23625,580,1900
3.173,6,2,92,1,0,0,0,40,1,0,0,0,52
1799.284,1,58,4872,0,0,0,0,0,58,56,31566,56,4872
1.879,6,16,4638,7,290,313,517,941,9,1071,233,1408,3697
1798.534,6,374,26068,217,98,8326,469,15303,157,69,11527,69,10765
21.184,6,9,577,0,0,0,0,0,9,31,2648,31,577
4.867,6,40,7309,20,218,256,314,3423,20,440,242,1152,3886
12.742,6,1906,1770388,1254,1363,10,1380,1740021,652,355,19,1380,30367
35.002,17,10,490,9,17,4375,58,406,1,56,0,56,84
1744.717,2,29,928,29,8,62311,8,928,0,0,0,0,0
4.497,6,39,7285,20,218,236,314,3423,19,516,235,1179,3862
5.048,17,4,288,2,36,5014,36,128,2,52,5016,52,160
26.411,6,8,440,5,0,6602,0,268,3,0,13199,0,172
0.004,1,2,112,2,28,4,28,112,0,0,0,0,0
120.044,1,2,292,2,118,120044,129,292,0,0,0,0,0
1.14,6,232,166758,125,1355,9,1432,158245,107,420,10,1432,8513
1772.039,1,58,4872,0,0,0,0,0,58,56,31088,56,4872
1.135,6,10,1185,6,279,227,279,587,4,191,276,272,598
1.093,6,31,9412,16,209,72,414,1926,15,1374,68,3916,7486
31.99,6,704,609256,307,133,104,323,18581,397,1450,80,2816,590675
20.103,6,21,5418,12,107,1827,159,1074,9,773,2511,1418,4344
0.339,17,8,2742,8,314,48,353,2742,0,0,0,0,0
84.56,6,68,46112,44,1155,1966,1408,38130,24,960,2679,3847,7982
1.256,17,3,286,2,46,1000,46,148,1,110,0,110,138
280.409,6,30,7432,13,158,23367,267,1317,17,543,17520,1400,6115
1.291,6,52,20073,30,874,44,1360,14372,22,400,53,1360,5701
280.366,6,30,7432,13,158,23363,267,1317,17,543,17519,1400,6115
46.263,1,16,1664,0,0,0,0,0,16,76,3084,76,1664
1744.639,2,16,512,16,8,116309,8,512,0,0,0,0,0
281.37,6,31,7476,14,158,21643,267,1357,17,603,17583,2036,6119
1.255,6,10,1687,7,100,209,100,384,3,1179,497,1179,1303
0.264,6,21,7281,12,334,23,663,1969,9,967,32,1471,5312
336.004,6,8,692,8,46,48000,62,692,0,0,0,0,0
36.404,1,4,224,4,28,12134,28,224,0,0,0,0,0
1783.95,6,367,23236,212,69,8454,69,12896,155,69,11584,69,10340
410.079,6,41,7615,25,126,17086,507,2273,16,361,27332,1452,5342
0.006,6,3,120,3,0,0,0,120,0,0,0,0,0
5.006,6,39,7269,20,218,263,314,3423,19,513,264,1179,3846
902.435,2,9,288,9,8,112804,8,288,0,0,0,0,0
1773.16,6,181,15589,120,69,14900,69,8940,61,69,29550,69,6649
1796.777,17,448,39612,404,35,4458,288,25708,44,288,40951,288,13904
0.355,6,10,1671,6,552,70,948,1348,4,159,118,159,323
0.075,1,6,624,0,0,0,0,0,6,76,15,76,624
1798.757,17,142,11360,71,48,25696,48,5396,71,56,25696,56,5964
61.83,6,67,47583,44,1167,1437,1408,39655,23,960,2799,3847,7928
1680.824,1,15,870,15,30,120058,30,870,0,0,0,0,0
16.4,6,34,9285,19,123,911,388,1778,15,689,190,2720,7507
10.965,6,789,675833,488,1312,22,1368,655517,301,776,35,2736,20316
64.927,6,40,10917,17,450,172,1189,3844,23,438,2950,1420,7073
24.316,6,3,144,0,0,0,0,0,3,0,0,0,144
1772.624,6,180,15480,120,69,14896,69,8940,60,69,30040,69,6540
1773.504,6,202,22325,130,75,13748,267,10063,72,137,24973,4837,12262
0.035,17,2,334,1,32,0,32,60,1,246,0,246,274
2.192,6,14,2351,8,188,313,245,700,6,703,389,1152,1651
1643.499,1,30,1680,30,28,56672,28,1680,0,0,0,0,0
1799.988,1,16,896,16,28,119999,28,896,0,0,0,0,0
1770.378,6,101,9278,66,64,27236,64,5544,35,58,52067,58,3734
0.129,17,2,904,2,424,129,548,904,0,0,0,0,0
20.153,6,20,5366,12,107,1832,159,1074,8,967,2877,2816,4292
280.345,6,29,7392,13,158,23362,267,1317,16,603,18681,1400,6075
20.122,6,22,6127,13,147,1676,318,1285,9,873,2514,1674,4842
6.255,6,18,6940,6,275,1251,275,794,12,629,474,2840,6146
0.1,6,11,1973,6,242,20,517,1059,5,323,12,499,914
0.051,6,2,116,1,0,0,0,64,1,0,0,0,52
0.523,6,10,924,5,283,87,283,551,5,105,87,105,373
0.08,17,2,650,1,308,0,308,336,1,286,0,286,314
1796.241,1,238,25228,238,78,7579,78,25228,0,0,0,0,0
4.228,17,5,290,5,30,1057,30,290,0,0,0,0,0
311.255,6,74,50250,46,1201,6916,1408,42060,28,960,2281,3847,8190
7.874,6,629,575100,410,1337,18,1368,559036,219,931,35,2736,16064
1787.901,6,366,25610,210,99,8537,469,14885,156,69,11534,69,10725
1764.928,17,161,40205,161,221,11030,422,40205,0,0,0,0,0
1.587,6,47,19211,27,894,61,1360,13635,20,476,72,2715,5576
2.311,17,6,1425,3,40,1150,40,204,3,379,1149,379,1221
1.009,17,3,222,3,46,504,46,222,0,0,0,0,0
1189.291,17,92,106900,92,1133,13069,1451,106900,0,0,0,0,0
0.42,17,2,384,1,36,0,36,64,1,292,0,292,320
4.062,17,4,240,4,32,1354,32,240,0,0,0,0,0
449.098,17,14,1064,14,48,34546,48,1064,0,0,0,0,0
0.198,6,43,19423,25,1035,8,1420,14482,18,467,11,1883,4941
19.53,6,24,6627,9,154,2441,267,832,15,518,1381,1460,5795
29.15,17,13,7914,7,457,4858,1350,3399,6,724,21,1350,4515
75.734,6,32,7653,12,155,29,267,1266,20,371,3985,1997,6387
1740.442,17,30,6930,30,203,60015,203,6930,0,0,0,0,0
0.451,17,2,144,1,36,0,36,64,1,52,0,52,80
296.273,17,4,240,2,32,296272,32,120,2,32,296272,32,120
1780.77,17,140,11200,70,48,25808,48,5320,70,56,25808,56,5880
125.962,2,2,64,2,8,125962,8,64,0,0,0,0,0
1782.323,17,83,3480,82,14,22003,14,3444,1,8,0,8,36
1772.577,6,180,15480,120,69,14895,69,8940,60,69,30039,69,6540
1792.21,6,76,4004,39,26,47162,26,2054,37,26,49782,26,1950
0.301,17,14,9435,8,833,42,1350,6891,6,396,54,1350,2544
0.0,17,1,719,1,691,0,691,719,0,0,0,0,0
1775.164,6,180,15480,120,69,14917,69,8940,60,69,30078,69,6540
1777.784,17,142,11360,71,48,25396,48,5396,71,56,25396,56,5964
175.136,2,2,64,2,8,175136,8,64,0,0,0,0,0
1.363,6,41,10025,23,440,61,1360,4484,18,400,69,1360,5541
1788.523,17,87,3648,86,14,21041,14,3612,1,8,0,8,36
1770.467,6,99,9240,66,65,27237,65,5577,33,59,55324,59,3663
0.376,17,2,172,1,50,0,50,78,1,66,0,66,94
30.299,6,39,9924,19,706,489,1460,4322,20,399,1585,1460,5602
14.824,6,22,5962,11,275,1482,275,998,11,902,1205,1440,4964
0.083,6,9,1340,5,145,20,145,349,4,827,16,827,991
1605.686,1,8,448,8,28,229383,28,448,0,0,0,0,0
4.158,17,10,580,5,30,1031,30,290,5,30,1033,30,290
0.0,17,1,1047,1,1019,0,1019,1047,0,0,0,0,0
10.878,6,1926,1727088,1177,1386,9,1408,1683392,749,776,14,1408,43696
0.012,6,10,1512,5,503,2,503,771,5,473,2,473,741
14.877,6,9,685,9,31,1859,31,685,0,0,0,0,0
0.013,6,2,116,1,0,0,0,64,1,0,0,0,52
4.149,6,44,24358,26,1005,165,1360,21170,18,488,234,573,3188
159.226,6,64,41392,40,1160,4082,1408,33411,24,960,2674,3847,7981
0.256,6,28,6254,13,181,21,537,1578,15,486,17,1402,4676
51.161,6,68,38609,31,624,29,1354,3516,37,1036,1420,1491,35093
1786.719,6,102,8296,68,65,26667,65,4930,34,59,54138,59,3366
5.36,17,4,932,2,30,5345,30,116,2,380,5346,468,816
1783.84,6,106,8456,68,65,26624,65,4930,38,59,48209,59,3526
75.479,6,24,6612,12,217,6861,517,1488,12,748,6857,2417,5124
62.074,17,4,352,2,60,62073,60,176,2,60,62073,60,176
131.763,6,28,7352,13,158,10980,267,1317,15,678,9408,2045,6035
0.97,17,2,312,2,128,970,128,312,0,0,0,0,0
0.695,6,28,7575,17,302,43,693,2801,11,721,66,2760,4774
66.083,6,27,7177,13,155,5506,267,1306,14,530,5082,3417,5871
1740.608,17,30,31680,30,1028,60020,1028,31680,0,0,0,0,0
1793.706,6,356,22520,208,69,8665,69,12460,148,69,12201,69,10060
1.469,6,37,8214,19,321,81,1164,2718,18,476,74,2715,5496
2.219,6,6,252,4,0,739,0,164,2,0,1149,0,88
0.024,6,2,218,1,138,0,138,178,1,0,0,0,40
15.992,17,17,9038,9,593,1990,1350,5597,8,402,2272,1350,3441
2.024,6,15,5084,7,150,337,174,584,8,835,273,1452,4500
0.004,17,2,455,1,39,0,39,67,1,360,0,360,388
1.437,17,8,704,4,37,476,37,260,4,83,476,89,444
1.02,6,11,927,6,248,197,248,492,5,231,247,231,435
300.567,6,68,53327,45,1243,6831,1368,47118,23,625,1382,1368,6209
1.386,6,46,18664,26,924,55,1460,13088,20,529,62,4075,5576
131.273,17,4,1344,4,308,43757,308,1344,0,0,0,0,0
0.083,17,2,362,1,46,0,46,74,1,260,0,260,288
2.782,17,28,13915,13,824,230,1350,11084,15,160,195,1350,2831
367.085,6,25,1654,17,180,22942,180,1120,8,110,9201,110,534
1786.916,6,102,8296,68,65,26670,65,4930,34,59,54123,59,3366
0.956,17,4,580,2,40,932,40,136,2,194,935,194,444
1795.434,1,126,7056,126,28,14363,28,7056,0,0,0,0,0
39.486,1,10,1158,10,87,4387,119,1158,0,0,0,0,0
1780.697,6,182,15629,121,69,14839,69,9049,61,69,29661,69,6580
15.35,6,49,8914,24,227,667,314,4142,25,470,628,1179,4772
756.382,2,7,224,7,8,126063,8,224,0,0,0,0,0
12.067,6,1916,1661063,1158,1378,10,1420,1626522,758,467,15,1883,34541
1775.684,17,142,11360,71,48,25366,48,5396,71,56,25366,56,5964
10.002,1,4,1776,4,416,3334,527,1776,0,0,0,0,0
0.01,17,4,284,2,32,4,32,120,2,54,7,60,164
300.57,6,18,1251,7,177,50065,177,573,11,110,30039,110,678
1.204,6,25,8056,12,164,89,267,1288,13,869,85,1448,6768
9.717,6,15,2307,8,210,1375,210,856,7,545,1604,905,1451
1793.621,1,59,4956,59,56,30924,56,4956,0,0,0,0,0
1772.349,6,180,15480,120,69,14893,69,8940,60,69,30037,69,6540
1745.642,6,90,6540,60,31,29587,31,4050,30,31,60186,31,2490
0.027,17,2,382,1,47,0,47,75,1,279,0,279,307
1795.611,6,380,26515,218,97,8274,469,15481,162,69,11150,69,11034
0.425,6,26,9017,13,257,35,669,1714,13,945,33,1438,7303
218.215,17,4,352,2,60,218214,60,176,2,60,218214,60,176
1794.667,17,142,11360,71,48,25638,48,5396,71,56,25638,56,5964
195.989,17,6,528,3,48,97836,48,228,3,72,97942,72,300
0.233,6,10,1671,6,552,46,948,1348,4,159,77,159,323
105.856,6,887,446142,503,829,210,1152,425650,384,394,275,1152,20492
1779.716,1,342,28728,342,56,5219,56,28728,0,0,0,0,0
33.506,6,30,8872,14,158,2577,267,1357,16,763,2228,2036,7515
1780.838,6,8167,3166067,3465,449,514,1408,1011193,4702,636,378,8448,2154874
67.088,6,728,347951,393,824,171,1152,328039,335,406,200,1179,19912
1799.468,17,4522,217056,2261,20,796,20,108528,2261,20,796,20,108528
61.395,17,4,304,2,48,61394,64,152,2,48,61394,64,152
7.366,6,29,7086,16,226,487,517,1818,13,526,609,1380,5268
0.011,17,2,362,1,30,0,30,58,1,276,0,276,304
1789.651,1,222,12432,222,28,8097,28,12432,0,0,0,0,0
2.89,17,33,17765,17,792,178,1350,13951,16,210,190,1350,3814
1780.506,6,356,22941,208,69,8601,69,12460,148,74,12112,421,10481
6.616,6,25,7040,14,185,508,275,1125,11,910,634,1420,5915
0.362,6,10,968,5,256,87,256,460,5,304,86,304,508
2.646,17,4,1564,4,363,882,363,1564,0,0,0,0,0
1.13,6,4,777,1,0,0,0,40,3,308,34,586,737
132.69,6,98,70683,62,1248,2175,1408,60672,36,739,2986,2439,10011
1203.187,2,12,384,12,8,109380,8,384,0,0,0,0,0
1774.873,6,180,15480,120,69,14914,69,8940,60,69,30080,69,6540
1764.068,2,15,480,15,8,126004,8,480,0,0,0,0,0
1.008,17,8,1360,4,33,334,33,244,4,251,334,323,1116
0.883,6,10,1687,7,100,147,100,384,3,1179,313,1179,1303
251.501,2,2,64,2,8,251501,8,64,0,0,0,0,0
11.434,6,1814,1579393,1100,1382,10,1420,1546612,714,467,16,1883,32781
40.388,17,18,1368,18,48,2375,48,1368,0,0,0,0,0
37.444,17,22,1936,11,48,3743,48,836,11,72,3742,72,1100
3.774,17,4,410,2,36,3763,36,128,2,113,3763,113,282
1798.233,17,450,39960,405,35,4451,288,25740,45,288,40023,288,14220
106.27,6,45,9852,19,263,3448,1189,2873,26,370,4250,1420,6979
1.396,6,46,17176,25,877,58,1460,11560,21,433,60,1460,5616
62.396,6,38,8047,17,140,3899,267,1811,21,414,3119,1460,6236
0.27,1,2,112,2,28,270,28,112,0,0,0,0,0
1789.778,6,384,27020,216,97,8324,469,15470,168,69,10714,69,11550
8.29,6,27,4747,14,165,637,456,1562,13,415,592,888,3185
14.4,6,14,2242,8,210,2056,210,844,6,545,2877,904,1398
0.906,6,10,1687,7,100,151,100,384,3,1179,322,1179,1303
12.317,6,1005,859281,617,1317,19,1368,834441,388,776,31,1473,24840
1770.598,6,101,9410,66,66,27239,66,5610,35,60,52073,60,3800
5.691,6,596,547368,393,1329,14,1368,532148,203,776,27,2736,15220
1739.991,6,87,6322,58,31,30526,31,3915,29,31,62142,31,2407
201.419,17,4,352,2,60,201418,60,176,2,60,201418,60,176
31.179,6,13,5600,5,112,7794,112,328,8,987,4388,1917,5272
37.081,17,40,5880,20,48,1950,48,1520,20,190,1950,308,4360
1.384,6,10,1687,7,100,230,100,384,3,1179,552,1179,1303
133.918,6,32,8952,14,158,10301,267,1357,18,624,7869,1400,7595
5.045,17,4,288,2,36,5007,36,128,2,52,5014,52,160
34.527,1,4,224,4,28,11509,28,224,0,0,0,0,0
0.436,6,5,1564,3,413,218,413,946,2,269,203,269,618
1797.365,1,58,4872,0,0,0,0,0,58,56,31532,56,4872
300.653,6,39,8606,20,315,15823,882,2093,19,441,472,1440,6513
0.325,6,9,1340,5,145,81,145,349,4,827,83,827,991
1777.051,1,321,26964,321,56,5553,56,26964,0,0,0,0,0
840.626,17,8,2196,4,30,280207,30,232,4,463,280207,463,1964
252.505,17,37,2812,37,48,7014,48,2812,0,0,0,0,0
0.208,6,25,7216,13,155,17,267,1301,12,678,18,2800,5915
1761.992,6,247,24224,122,90,14561,721,12191,125,167,14207,1420,12033
280.185,6,27,7312,13,158,23348,267,1317,14,775,21549,3445,5995
1768.403,6,190,11961,95,52,18812,208,7262,95,31,18810,31,4699
1195.064,6,15,910,10,31,132784,31,555,5,31,298758,31,355
16.648,6,12,500,7,0,2774,0,284,5,0,3031,0,216
1.479,6,47,18973,26,945,59,1460,13357,21,476,64,2615,5616
899.324,6,12,728,8,31,128474,31,444,4,31,299654,31,284
27.761,6,41,12308,21,833,458,1360,6706,20,399,1450,1360,5602
300.827,6,44,13757,24,892,13079,1360,8155,20,399,505,1360,5602
3.854,6,2,88,2,0,0,0,88,0,0,0,0,0
0.287,6,23,4494,11,165,28,456,1394,12,493,23,888,3100
9.326,6,1817,1696302,1164,1380,7,1408,1657682,653,931,14,2801,38620
0.53,17,2,167,1,39,0,39,67,1,72,0,72,100
69.095,6,25,7097,12,155,6281,267,1266,13,589,5757,3426,5831
1792.978,6,860,72034,425,46,4228,1448,31833,435,74,4129,1448,40201
1772.705,6,292,37439,121,143,14771,1360,17973,171,148,10426,4662,19466
1095.79,6,210,13368,119,69,8923,69,7244,91,69,12105,69,6124
2.67,6,65,38232,39,1158,70,1380,32902,26,421,105,1380,5330
240.421,6,57,6900,25,182,10017,585,3342,32,133,7755,580,3558
0.157,6,27,7296,13,155,13,267,1301,14,603,11,2800,5995
1778.68,17,140,11200,70,48,25777,48,5320,70,56,25777,56,5880
597.838,1,60,3360,60,28,10132,28,3360,0,0,0,0,0
811.129,6,48,3829,32,45,26165,205,2430,16,35,54043,98,1399
1681.573,17,14,1036,7,30,280260,30,406,7,62,280260,62,630
2.6,17,3,1167,3,361,1300,361,1167,0,0,0,0,0
0.517,17,2,904,2,424,517,548,904,0,0,0,0,0
182.94,17,4,352,2,60,182939,60,176,2,60,182939,60,176
0.095,17,2,148,1,30,0,30,58,1,62,0,62,90
65.085,17,4,1344,4,308,21695,308,1344,0,0,0,0,0
1798.58,17,328,71241,328,189,5500,422,71241,0,0,0,0,0
302.235,6,26,5453,14,298,23248,1382,2353,12,436,27474,2433,3100
22.73,6,19,2541,11,211,2272,211,1030,8,545,2291,904,1511
5.483,6,39,7285,20,218,288,314,3423,19,516,289,1179,3862
1799.283,17,769,46394,769,32,2342,37,46394,0,0,0,0,0
41.394,6,18,3799,9,454,5174,585,2295,9,334,5155,580,1504
0.508,17,3,451,2,39,254,39,134,1,289,0,289,317
81.508,6,34,24792,19,884,35,1360,6097,15,2260,5812,6800,18695
153.21,17,14,1120,7,48,25533,48,532,7,56,25533,56,588
320.58,6,14,5891,5,189,80145,267,587,9,822,167,1452,5304
3.707,6,13,1375,6,283,706,283,886,7,105,588,105,489
0.465,6,21,7217,12,318,41,599,1905,9,967,57,1471,5312
1797.228,1,345,28980,345,56,5224,56,28980,0,0,0,0,0
1779.926,6,354,22440,207,69,8640,69,12420,147,69,12191,69,10020
1786.761,6,106,8584,69,66,26275,66,5004,37,60,49629,60,3580
12.885,6,107,34429,56,596,234,1152,27907,51,407,252,1152,6522
0.867,6,19,5908,10,281,96,544,1248,9,716,97,1420,4660
1.181,6,25,8056,12,164,92,267,1288,13,869,84,1448,6768
3.162,6,2557,3007929,659,784,4,1396,37404,1898,1515,1,4188,2970525
2.008,17,3,329,2,39,2000,39,134,1,167,0,167,195
1773.539,6,182,15560,120,69,14903,69,8940,62,69,29067,69,6620
509.939,1,6,336,6,28,101987,28,336,0,0,0,0,0
20.492,17,6,1920,6,292,4098,298,1920,0,0,0,0,0
0.445,6,12,1653,6,288,84,288,548,6,426,53,434,1105
1.247,6,58,18034,28,707,46,1360,8925,30,438,42,1360,9109
3.795,17,5,295,5,31,948,31,295,0,0,0,0,0
200.408,17,4,352,2,60,200407,60,176,2,60,200406,60,176
4.581,6,39,7285,21,218,229,314,3463,18,516,254,1179,3822
2.581,6,32,8952,14,158,198,267,1357,18,624,148,1400,7595
300.581,6,45,8944,23,286,13662,766,2156,22,346,594,2128,6788
0.125,6,2,175,1,0,0,0,40,1,83,0,83,135
1624.691,1,7,392,7,28,270781,28,392,0,0,0,0,0
281.55,6,32,7853,14,158,21657,267,1357,18,524,16561,1400,6496
3.354,17,2,213,1,48,0,48,76,1,109,0,109,137
240.289,6,46,9212,24,519,10447,1402,5934,22,236,11442,617,3278
1637.772,2,14,448,14,8,125982,8,448,0,0,0,0,0
1785.861,6,382,26995,219,102,8192,469,16059,163,69,11023,69,10936
1788.99,17,87,3648,86,14,21046,14,3612,1,8,0,8,36
11.024,6,20,4442,11,275,1102,275,998,9,768,779,1440,3444
11.144,6,1693,1528124,1080,1362,10,1420,1499229,613,475,18,1883,28895
196.951,6,53,11142,19,263,4228,1189,2873,34,265,5967,1300,8269
34.466,17,19,1444,19,48,1914,48,1444,0,0,0,0,0
1781.462,17,142,11360,71,48,25448,48,5396,71,56,25448,56,5964
1793.741,17,87,3648,86,14,21102,14,3612,1,8,0,8,36
0.0,6,1,40,1,0,0,0,40,0,0,0,0,0
1787.906,6,369,23385,213,69,8433,69,12867,156,69,11534,69,10518
1793.308,1,194,10864,194,28,9291,28,10864,0,0,0,0,0
4.068,6,37,7189,19,218,226,314,3383,18,513,224,1179,3806
4.941,17,6,1392,6,204,988,204,1392,0,0,0,0,0
1.083,6,27,9027,14,294,83,818,1769,13,960,76,1440,7258
240.181,6,58,17994,30,737,8281,1408,14842,28,211,8895,580,3152
5.644,6,25,7634,14,162,434,318,1700,11,1768,545,2736,5934
1787.017,6,104,8376,68,65,26671,65,4930,36,59,51053,59,3446
1762.382,1,47,6246,47,104,38312,320,6246,0,0,0,0,0
274.881,17,4,240,2,32,274880,32,120,2,32,274880,32,120
1797.235,6,134,8955,75,57,24286,208,5665,59,31,30983,31,3290
76.193,6,9,360,9,0,0,0,360,0,0,0,0,0
376.64,6,21,1419,15,177,26902,177,989,6,110,12261,110,430
0.26,6,26,8990,13,247,21,624,1672,13,1105,21,2816,7318
0.245,6,45,56124,29,198,8,250,2320,16,3783,10,9856,53804
150.134,17,8,2688,8,308,21447,308,2688,0,0,0,0,0
0.033,17,4,284,2,32,21,32,120,2,54,22,60,164
1.281,6,14,1542,8,304,183,304,1044,6,83,248,83,498
1796.383,17,448,39100,404,34,4457,288,25444,44,282,40946,288,13656
0.005,6,5,6040,1,0,0,0,40,4,1460,1,1460,6000
481.286,2,5,160,5,8,120321,8,160,0,0,0,0,0
1786.709,6,105,8550,69,66,26275,66,5070,36,60,51045,60,3480
896.384,17,15,4920,15,300,64027,300,4920,0,0,0,0,0
373.8,6,25,1651,17,177,23362,177,1117,8,110,9247,110,534
0.093,6,12,3462,6,75,18,75,395,6,1373,18,1448,3067
1793.557,17,178,11392,178,36,10133,36,11392,0,0,0,0,0
0.041,6,10,1677,6,555,8,951,1354,4,159,8,159,323
70.869,6,27,7315,11,155,29,267,1226,16,453,4723,2006,6089
39.043,17,22,1936,11,48,3903,48,836,11,72,3903,72,1100
2.882,17,6,594,3,39,1440,39,201,3,103,1440,103,393
13.486,6,2205,2009495,1385,1371,9,1408,1962191,820,931,16,2801,47304
0.237,6,3,120,2,0,237,0,80,1,0,0,0,40
44.138,17,2,672,2,308,44138,308,672,0,0,0,0,0
839.515,6,79,5055,39,53,22087,208,2897,40,31,21521,31,2158
1787.905,6,371,23465,213,69,8433,69,13005,158,69,11387,69,10460
92.349,6,25,9908,12,549,61,1460,2709,13,952,7684,1460,7199
1791.132,1,58,4872,58,56,31423,56,4872,0,0,0,0,0
0.275,6,2,100,1,0,0,0,60,1,0,0,0,40
19.143,6,1812,1621972,1097,1421,17,1432,1588091,715,420,26,1432,33881
280.289,17,4,296,2,30,280278,30,116,2,62,280277,62,180
1773.457,6,180,15480,120,69,14903,69,8940,60,69,30056,69,6540
8.755,17,2,244,2,94,8755,94,244,0,0,0,0,0
2.294,17,4,240,2,32,2293,32,120,2,32,2293,32,120
4.006,1,3,252,3,56,2003,56,252,0,0,0,0,0
0.106,6,3,156,2,0,106,0,104,1,0,0,0,52
1756.116,6,105,6270,60,27,29764,27,3525,45,27,39910,27,2745
3.244,17,5,373,3,31,1554,31,177,2,70,2022,70,196
0.292,6,21,7281,12,334,25,663,1969,9,967,35,1471,5312
15.128,17,24,6212,10,256,1676,1350,2848,14,212,1160,1350,3364
0.168,17,2,152,1,48,0,48,76,1,48,0,48,76
31.529,6,7,308,1,0,0,0,44,6,0,6061,0,264
198.199,17,4,352,2,60,198198,60,176,2,60,198198,60,176
240.962,6,56,14034,28,613,8924,1418,10698,28,186,8923,580,3336
1753.376,17,86,28856,86,307,20627,548,28856,0,0,0,0,0
0.17,6,28,7336,13,155,14,267,1301,15,543,11,1400,6035
2.007,17,6,480,3,40,994,41,206,3,63,994,76,274
1794.184,17,144,11520,72,48,25270,48,5472,72,56,25270,56,6048
0.488,6,10,861,5,222,120,222,426,5,231,119,231,435
1796.175,17,144,11520,72,48,25298,48,5472,72,56,25298,56,6048
601.651,2,5,160,5,8,150412,8,160,0,0,0,0,0
1797.881,6,250,25015,102,66,17799,594,9407,148,127,12229,1440,15608
306.19,6,12,850,2,64,309,64,144,10,34,34012,58,706
1681.12,1,14,784,14,28,129316,28,784,0,0,0,0,0
240.278,6,55,18206,28,809,8898,1418,15220,27,196,9241,580,2986
1744.286,6,97,7307,63,38,28133,205,4476,34,33,52845,98,2831
1795.348,1,342,28728,342,56,5264,56,28728,0,0,0,0,0
1787.471,6,102,8296,68,65,26678,65,4930,34,59,54162,59,3366
8.323,6,41,7349,22,218,396,314,3503,19,513,447,1179,3846
1795.905,17,87,3648,86,14,21128,14,3612,1,8,0,8,36
0.234,17,8,2758,8,316,33,355,2758,0,0,0,0,0
11.391,6,21,6825,12,275,1035,275,1038,9,1353,778,1440,5787
1134.233,2,8,256,8,8,162033,8,256,0,0,0,0,0
48.651,6,472,213595,241,824,202,1152,199175,231,431,210,1179,14420
3.94,17,4,240,4,32,1313,32,240,0,0,0,0,0
111.07,6,10,904,4,106,37023,106,274,6,76,22181,90,630
23.738,17,6,2016,6,308,4747,308,2016,0,0,0,0,0
1744.688,2,23,736,23,8,79304,8,736,0,0,0,0,0
0.168,17,2,233,1,50,0,50,78,1,127,0,127,155
1781.806,6,359,22709,209,69,8566,69,12569,150,69,11958,69,10140
1.054,6,28,10126,17,351,65,785,1737,11,993,97,1452,8389
37.298,1,43,4472,0,0,0,0,0,43,76,888,76,4472
1774.76,6,180,15480,120,69,14913,69,8940,60,69,30078,69,6540
120.524,6,12,716,4,106,40166,106,274,8,90,17215,90,442
30.78,17,4,1344,4,308,10260,308,1344,0,0,0,0,0
1.261,6,7,376,3,0,630,0,164,4,0,355,0,212
0.121,17,2,142,1,35,0,35,63,1,51,0,51,79
595.255,2,10,320,10,8,66139,8,320,0,0,0,0,0
300.829,2,6,192,6,8,60165,8,192,0,0,0,0,0
280.489,6,29,7392,13,158,23374,267,1317,16,603,18694,2076,6075
1795.367,17,447,39864,402,35,4477,288,25644,45,288,40018,288,14220
280.314,6,28,7352,12,158,25483,267,1277,16,603,18683,1400,6075
280.187,6,30,7432,14,158,21552,267,1357,16,603,18677,2036,6075
3.424,6,11,1551,6,261,684,261,505,5,421,852,421,1046
0.16,17,2,362,1,46,0,46,74,1,260,0,260,288
0.068,6,4,222,2,31,68,31,111,2,31,1,31,111
75.719,6,33,7693,13,155,6309,267,1306,20,371,3984,1997,6387
2.152,6,14,2351,8,188,307,245,700,6,703,379,1152,1651
1795.792,17,449,39928,404,35,4456,288,25708,45,288,40019,288,14220
31.581,6,7,336,1,0,0,0,48,6,0,6315,0,288
378.044,2,3,96,3,8,189022,8,96,0,0,0,0,0
560.415,17,6,1603,3,30,280205,30,174,3,448,280204,463,1429
1784.582,17,140,11200,70,48,25863,48,5320,70,56,25863,56,5880
1.593,6,51,19032,27,870,61,1360,13296,24,476,61,2715,5736
280.42,6,30,7432,13,158,23368,267,1317,17,543,17523,1400,6115
2.99,17,3,699,3,205,1495,205,699,0,0,0,0,0
1795.652,17,449,39928,404,35,4455,288,25708,45,288,40018,288,14220
0.013,17,3,244,2,32,10,32,120,1,96,0,96,124
1.333,6,24,8004,13,164,94,267,1340,11,1014,113,2411,6664
1797.342,6,356,22520,208,69,8682,69,12460,148,69,12226,69,10060
45.101,6,10,909,6,302,9020,302,610,4,83,15031,83,299
4.141,17,5,340,5,40,1035,40,340,0,0,0,0,0
0.094,6,9,1346,5,145,23,145,349,4,833,24,833,997
582.507,1,6,489,6,53,116501,78,489,0,0,0,0,0
1786.385,6,102,8364,68,66,26662,66,4964,34,60,54130,60,3400
0.034,6,5,4051,1,0,0,0,40,4,1283,2,1420,4011
280.232,17,4,1082,2,30,280218,30,116,2,455,280221,463,966
280.449,6,31,7472,13,158,23370,267,1317,18,543,16494,1380,6155
0.607,6,14,1745,7,288,71,288,600,7,426,69,434,1145
0.266,17,2,420,1,39,0,39,67,1,325,0,325,353
37.841,6,46,13740,23,989,453,1360,7925,23,348,1712,2667,5815
0.219,17,2,1922,2,933,219,933,1922,0,0,0,0,0
39.119,6,27,7177,13,155,3259,267,1306,14,530,3008,3417,5871
1797.506,17,449,39928,404,35,4460,288,25708,45,288,40017,288,14220
283.498,17,4,288,2,36,283466,36,128,2,52,283467,52,160
145.103,6,35,5039,17,304,9068,304,3324,18,83,8487,83,1715
147.083,17,4,558,2,36,147078,36,128,2,187,147077,187,430
0.012,17,2,382,1,37,0,37,65,1,289,0,289,317
2.264,6,13,2311,8,188,323,245,700,5,1407,501,1407,1611
17.111,6,22,6546,7,154,2851,267,752,15,576,1208,1917,5794
0.81,17,2,134,2,39,810,39,134,0,0,0,0,0
1550.809,6,122,13537,66,64,23857,517,4686,56,295,28194,2449,8851
1.259,6,24,8004,12,164,97,267,1288,12,1014,97,2804,6716
366.837,6,19,1303,14,177,28218,177,925,5,110,15158,110,378
18.862,6,13,5686,6,290,3772,517,901,7,1101,430,1418,4785
240.272,6,43,9155,21,519,12013,1402,5772,22,247,11441,618,3383
92.058,6,22,8510,11,313,67,632,1413,11,949,9192,1440,7097
6.392,6,9,588,3,106,3191,106,234,6,90,1276,90,354
1443.904,2,18,576,18,8,84935,8,576,0,0,0,0,0
1740.315,6,89,6426,58,31,30531,31,3915,31,31,58008,31,2511
1799.97,6,371,25564,159,46,11194,46,10322,212,46,8530,46,15242
1787.452,17,87,3648,86,14,21028,14,3612,1,8,0,8,36
1795.983,17,449,39928,404,35,4456,288,25708,45,288,40014,288,14220
240.29,6,43,8918,21,515,12014,1402,5740,22,225,11442,639,3178
35.475,17,20,1760,10,48,3940,48,760,10,72,3940,72,1000
1792.554,17,87,3648,86,14,21088,14,3612,1,8,0,8,36
5.344,6,39,7269,20,218,281,314,3423,19,513,282,1179,3846
0.38,6,51,21640,29,957,13,1380,16518,22,421,16,1923,5122
280.494,6,29,7392,13,158,23374,267,1317,16,678,18692,3456,6075
0.064,17,2,2386,2,1165,64,1165,2386,0,0,0,0,0
262.295,17,4,352,2,60,262294,60,176,2,60,262294,60,176
1755.404,6,119,7234,66,26,27005,26,3934,53,26,33756,26,3300
2.995,6,3,180,3,0,0,0,180,0,0,0,0,0
1724.746,1,56,4704,0,0,0,0,0,56,56,31359,56,4704
0.108,6,10,1569,5,627,26,627,895,5,406,27,406,674
5.311,17,3,208,2,36,5006,36,128,1,52,0,52,80
12.305,6,1924,1698975,1177,1389,10,1420,1664874,747,467,16,1883,34101
0.383,6,10,968,5,256,93,256,460,5,304,93,304,508
76.769,6,38,6329,16,206,222,314,2704,22,548,3644,1179,3625
13.207,6,1640,1322539,886,1393,14,1448,1271307,754,776,17,1448,51232
1.597,6,48,19487,27,911,61,1360,13871,21,433,68,1360,5616
1.777,6,50,22690,28,979,65,1460,15879,22,493,75,1460,6811
1745.375,6,99,7411,63,38,28151,205,4476,36,33,49859,98,2935
739.581,1,58,3248,58,28,12975,28,3248,0,0,0,0,0
52.992,6,7067,6814927,4740,1361,11,1408,6689259,2327,776,22,1408,125668
162.148,6,22,8319,11,525,89,1237,2048,11,831,16196,1360,6271
1.455,6,47,18991,26,946,58,1460,13375,21,433,62,1460,5616
1784.649,6,119,14039,77,82,23482,515,6044,42,157,43525,1452,7995
9.355,6,1858,1569717,1031,1430,8,1448,1516633,827,776,11,1448,53084
16.115,17,2,672,2,308,16115,308,672,0,0,0,0,0
8.281,6,41,8831,21,218,414,314,3463,20,570,421,1179,5368
1.724,17,8,2750,8,315,246,354,2750,0,0,0,0,0
8.718,6,36,8470,18,414,512,928,1996,18,441,501,1360,6474
114.668,17,4,240,2,32,114667,32,120,2,32,114667,32,120
8.353,6,80,24954,41,568,208,1152,19253,39,459,212,1179,5701
0.033,17,4,314,2,31,22,31,118,2,70,16,70,196
65.914,6,37,5719,18,162,3877,722,2228,19,227,3650,1408,3491
1682.328,1,8,448,8,28,240332,28,448,0,0,0,0,0
131.778,6,28,8106,11,261,247,467,1377,17,416,8223,1368,6729
4.3,6,21,6967,11,349,418,517,1978,10,893,470,2448,4989
407.297,6,89,13235,41,137,7867,721,5493,48,323,8661,2840,7742
0.092,17,2,176,1,48,0,48,76,1,72,0,72,100
311.123,6,27,5686,9,133,38889,159,887,18,773,18301,1408,4799
15.964,6,26,2418,12,222,1450,222,1376,14,231,1227,231,1042
120.359,2,3,96,3,8,60179,8,96,0,0,0,0,0
122.436,17,4,352,2,60,122435,60,176,2,60,122435,60,176
68.234,17,4,240,2,32,68233,32,120,2,32,68233,32,120
256.716,17,4,352,2,60,256715,60,176,2,60,256715,60,176
1798.966,1,16,896,16,28,119931,28,896,0,0,0,0,0
1782.48,1,341,28644,341,56,5242,56,28644,0,0,0,0,0
159.44,17,4,240,2,32,159438,32,120,2,32,159439,32,120
23.013,17,14,1232,7,48,3833,48,532,7,72,3832,72,700
1790.682,1,58,4872,0,0,0,0,0,58,56,31415,56,4872
0.119,17,2,340,1,34,0,34,62,1,250,0,250,278
6.203,6,1674,1527580,1041,1388,5,1408,1490000,633,776,9,1408,37580
1798.238,17,448,39896,403,35,4473,288,25676,45,288,40024,288,14220
1.298,6,47,18943,26,942,51,1460,13327,21,433,56,1460,5616
32.064,6,9,396,2,0,3484,0,88,7,0,5329,0,308
213.746,17,4,240,2,32,213745,32,120,2,32,213745,32,120
165.803,6,14,3440,5,92,41450,92,348,9,374,20700,2026,3092
120.73,17,5058,4749986,1646,39,73,1350,110931,3412,1331,35,1350,4639055
0.578,17,2,167,1,39,0,39,67,1,72,0,72,100
1799.623,17,448,39896,403,35,4476,288,25676,45,288,40018,288,14220
42.681,17,24,2112,12,48,3879,48,912,12,72,3879,72,1200
300.784,6,32,8176,18,204,17693,467,1820,14,936,5655,2694,6356
282.251,6,29,7599,12,158,25490,267,1277,17,563,17638,3465,6322
104.275,2,2,64,2,8,104275,8,64,0,0,0,0,0
0.35,17,8,2774,8,318,50,357,2774,0,0,0,0,0
150.965,6,30,7432,13,158,12580,267,1317,17,543,9430,1400,6115
295.836,17,4,240,2,32,295834,32,120,2,32,295835,32,120
4.932,6,37,7189,19,218,274,314,3383,18,513,274,1179,3806
992.463,1,42,2352,42,28,24206,28,2352,0,0,0,0,0
283.732,6,33,7621,15,143,20266,267,1466,18,603,16688,2076,6155
0.156,17,2,672,2,308,156,308,672,0,0,0,0,0
55.641,6,24,1433,12,222,5056,222,706,12,231,5056,231,727
1799.414,17,449,39928,404,35,4465,288,25708,45,288,40015,288,14220
1798.879,17,142,11360,71,48,25698,48,5396,71,56,25698,56,5964
1.061,6,11,1727,7,100,176,100,384,4,589,268,1152,1343
70.38,6,10,412,4,0,3918,0,164,6,0,14072,0,248
1.396,6,37,9809,19,503,77,1460,4313,18,433,70,1460,5496
1787.893,17,87,3648,86,14,21034,14,3612,1,8,0,8,36
234.798,2,2,64,2,8,234798,8,64,0,0,0,0,0
0.738,17,2,384,1,39,0,39,67,1,289,0,289,317
1210.188,6,255,22997,119,79,10255,267,8412,136,110,8964,1452,14585
0.927,6,24,7480,14,273,71,663,2104,10,1209,90,1946,5376
0.935,6,32,10490,17,511,58,1460,3280,15,659,54,1460,7210
1796.304,6,418,25048,209,69,8636,69,12500,209,34,8636,48,12548
1772.082,6,180,15480,120,69,14891,69,8940,60,69,30030,69,6540
0.13,17,2,2752,2,1348,130,1348,2752,0,0,0,0,0
1734.627,17,108,19224,108,150,16211,373,19224,0,0,0,0,0
1789.576,1,58,4872,58,56,31396,56,4872,0,0,0,0,0
0.292,6,20,7229,12,334,26,663,1969,8,1209,40,1906,5260
0.433,6,12,1653,6,288,80,288,548,6,426,47,434,1105
252.25,2,2,64,2,8,252250,8,64,0,0,0,0,0
10.57,6,17,2434,9,210,1270,210,904,8,545,1429,904,1530
301.095,17,7,1092,7,128,50182,128,1092,0,0,0,0,0
1653.22,1,7,392,7,28,275536,28,392,0,0,0,0,0
840.848,17,8,592,4,30,280278,30,232,4,62,280279,62,360
135.23,6,23,11278,12,433,65,990,1823,11,1286,13510,3928,9455
1768.434,6,273,44739,155,304,11483,304,31668,118,83,15114,83,13071
11.307,6,94,26957,47,534,245,1152,20595,47,447,239,1179,6362
0.421,6,26,7256,13,155,35,267,1301,13,678,28,3436,5955
0.449,6,12,1653,6,288,83,288,548,6,426,50,434,1105
1.246,6,11,1727,7,100,207,100,384,4,589,329,1152,1343
280.239,6,30,7432,14,158,21556,267,1357,16,603,18679,2800,6075
1795.614,6,356,22520,208,69,8674,69,12460,148,69,12213,69,10060
302.842,6,57,23563,32,1013,9769,1360,17532,25,358,444,1360,6031
1.041,6,17,7081,10,204,115,204,732,7,1494,167,2736,6349
2.991,17,4,248,4,34,997,34,248,0,0,0,0,0
1799.492,1,16,928,16,30,119966,30,928,0,0,0,0,0
1799.055,17,449,39416,404,34,4464,288,25444,45,282,40017,288,13972
1564.159,2,19,608,19,8,86897,8,608,0,0,0,0,0
7.293,6,1168,1011919,706,1386,10,1420,989218,462,467,15,1883,22701
280.254,6,22,6974,10,181,31139,267,1128,12,766,25472,2045,5846
72.359,6,2326,1914319,1331,1375,54,1380,1864516,995,387,72,1380,49803
449.099,17,30,5000,15,48,32077,48,1140,15,229,32077,308,3860
16.663,6,1240,1170676,802,1385,20,1448,1143236,438,776,37,1448,27440
41.342,6,19,2260,6,184,105,184,456,13,424,3428,434,1804
1.148,6,24,8004,13,164,81,267,1340,11,1014,97,2411,6664
13.87,6,22,4526,12,275,1260,275,1038,10,768,998,1440,3488
3.486,17,10,1810,5,30,868,30,290,5,276,868,292,1520
1782.429,6,219,17359,82,75,22003,337,8470,137,50,13105,143,8889
478.458,2,4,128,4,8,159486,8,128,0,0,0,0,0
200.518,17,2,142,2,43,200518,43,142,0,0,0,0,0
19.339,6,14,2185,8,324,2762,585,1073,6,396,3865,580,1112
1761.363,1,41,5418,41,104,44034,320,5418,0,0,0,0,0
100.275,6,22,9696,11,380,70,832,1613,11,1090,10014,1440,8083
1784.369,6,363,24414,212,88,8456,469,14027,151,69,11895,69,10387
1796.995,17,80,3354,79,14,23038,14,3318,1,8,0,8,36
1787.641,6,104,8376,68,65,26681,65,4930,36,59,51071,59,3446
63.943,6,34,10202,11,156,28,267,1232,23,423,2906,1420,8970
0.317,6,5,260,2,0,280,0,104,3,0,146,0,156
7.281,6,652,573857,409,1331,17,1368,555393,243,776,29,2736,18464
0.173,6,44,17224,24,935,7,1420,12203,20,420,8,1420,5021
240.644,6,54,17053,29,744,8594,1408,14166,25,196,10026,580,2887
1680.999,1,15,840,15,28,120071,28,840,0,0,0,0,0
1786.448,17,87,3648,86,14,21017,14,3612,1,8,0,8,36
2.916,6,57,41242,27,774,112,1460,7309,30,1363,96,1642,33933
1780.341,17,142,11360,71,48,25433,48,5396,71,56,25433,56,5964
1783.455,17,48,16128,48,308,37945,308,16128,0,0,0,0,0
1745.462,6,95,7203,63,38,28152,205,4476,32,33,56297,98,2727
11.625,6,1840,1608566,1116,1387,10,1420,1575385,724,467,16,1883,33181
1771.388,6,114,10535,73,65,24602,65,6184,41,59,44282,59,4351
6.896,6,20,3833,11,234,689,564,1504,9,463,760,1343,2329
1.436,6,24,8004,12,164,111,267,1288,12,1014,112,2736,6716
0.05,17,4,284,2,32,0,32,120,2,54,36,60,164
0.069,17,2,166,1,39,0,39,67,1,71,0,71,99
114.178,6,83,52618,47,1222,2482,1448,44020,36,746,1761,1448,8598
1778.173,17,140,11200,70,48,25770,48,5320,70,56,25770,56,5880
1786.844,6,104,8435,69,65,26277,65,4970,35,59,52551,59,3465
0.111,6,19,4192,10,101,12,101,629,9,514,13,587,3563
840.642,6,92,9622,55,99,15567,485,4895,37,90,23350,453,4727
0.109,6,13,2076,7,329,18,500,1030,6,363,21,500,1046
1799.161,6,371,25948,216,99,8368,469,15125,155,69,11682,69,10823
9.344,6,35,14151,16,481,622,721,2571,19,772,505,2840,11580
1776.123,17,73,3060,72,14,25015,14,3024,1,8,0,8,36
1796.471,17,142,11360,71,48,25663,48,5396,71,56,25663,56,5964
0.148,17,2,144,1,36,0,36,64,1,52,0,52,80
0.099,17,2,394,1,46,0,46,74,1,292,0,292,320
10.057,6,20,7548,11,318,1005,721,1718,9,1366,870,2828,5830
1.443,6,41,11379,21,616,72,1460,5803,20,433,65,1460,5576
0.413,6,6,324,4,0,137,0,216,2,0,231,0,108
0.28,6,21,7293,12,334,24,663,1981,9,967,34,1471,5312
22.593,17,8,2656,8,304,3227,308,2656,0,0,0,0,0
0.315,17,7,2429,7,319,52,354,2429,0,0,0,0,0
11.811,6,25,8473,13,275,984,275,1078,12,986,922,1440,7395
171.274,17,2,460,2,202,171274,355,460,0,0,0,0,0
5.011,17,4,486,2,36,5003,36,128,2,151,5006,159,358
748.797,17,200,51800,200,231,3762,388,51800,0,0,0,0,0
389.505,6,18,1239,14,177,29961,177,913,4,110,20069,110,326
29.624,6,29,7257,13,155,2468,267,1306,16,441,1973,1460,5951
15.569,17,29,15932,15,866,1109,1350,13411,14,152,1195,1350,2521
0.369,6,12,870,7,185,50,185,557,5,45,91,45,313
0.019,6,16,6016,9,88,2,88,504,7,1740,3,1880,5512
2.916,17,3,468,3,128,1458,128,468,0,0,0,0,0
113.497,17,4,1344,4,308,37832,308,1344,0,0,0,0,0
0.032,17,2,396,1,58,0,58,86,1,282,0,282,310
0.082,17,2,279,1,36,0,36,64,1,187,0,187,215
116.535,6,30,15844,14,651,49,1360,3196,16,1199,7761,2720,12648
0.337,1,5,420,5,56,84,56,420,0,0,0,0,0
257.533,6,26,6881,12,229,173,498,1632,14,425,19804,2642,5249
133.831,17,4,352,2,60,133830,60,176,2,60,133830,60,176
1.247,6,8,342,4,0,415,0,164,4,7,323,7,178
9.123,6,80,23546,40,541,233,1152,17837,40,456,227,1179,5709
1786.268,17,73,3060,72,14,25158,14,3024,1,8,0,8,36
280.49,6,30,7432,13,158,23374,267,1317,17,603,17528,2760,6115
0.438,6,48,20158,26,997,17,1380,15045,22,467,19,1923,5113
16.644,17,21,7728,10,437,1845,1350,4652,11,251,1661,1350,3076
0.592,6,116,87087,51,131,11,232,2569,65,1388,9,1955,84518
11.766,6,1882,1630217,1132,1385,10,1420,1595708,750,467,15,1883,34509
0.222,17,4,420,2,33,0,33,122,2,121,0,145,298
11.793,6,1859,1628575,1131,1386,10,1420,1595234,728,467,16,1883,33341
1799.341,17,142,11360,71,48,25704,48,5396,71,56,25704,56,5964
2.605,17,3,1164,3,360,1302,360,1164,0,0,0,0,0
1797.348,17,142,11360,71,48,25676,48,5396,71,56,25675,56,5964
1745.08,6,97,7338,64,38,27699,205,4528,33,33,54525,98,2810
11.362,6,26,9953,13,275,946,275,1078,13,1042,809,1440,8875
4.78,6,33,6129,18,206,281,314,2784,15,548,323,1179,3345
1772.224,6,180,15480,120,69,14892,69,8940,60,69,30033,69,6540
535.265,1,8,448,8,28,76466,28,448,0,0,0,0,0
1771.482,6,99,9306,66,66,27253,66,5610,33,60,55355,60,3696
1742.116,6,96,7286,64,38,27652,205,4559,32,33,56191,98,2727
1794.547,17,80,3354,79,14,23007,14,3318,1,8,0,8,36
0.248,17,2,2378,2,1161,248,1161,2378,0,0,0,0,0
184.159,6,49,22446,26,597,7366,1438,4947,23,1086,8370,1675,17499
72.581,17,10,13760,10,1348,8064,1350,13760,0,0,0,0,0
114.904,6,25,11058,12,433,75,990,1823,13,967,9564,1460,9235
8.981,6,15,4769,6,333,1796,516,1576,9,565,1110,1452,3193
1790.146,1,339,28476,339,56,5296,56,28476,0,0,0,0,0
1799.368,1,228,12768,228,28,7926,28,12768,0,0,0,0,0
1797.04,6,354,22509,205,69,8809,69,12340,149,69,12141,69,10169
1744.604,6,97,7307,63,38,28138,205,4476,34,33,52859,98,2831
0.976,17,15,8310,8,705,139,1350,5871,7,320,153,1350,2439
447.469,6,34,2596,28,145,16572,145,2344,6,0,89480,0,252
1733.201,6,77,5636,48,33,36876,33,3336,29,31,61893,31,2300
8.342,17,5,434,4,46,1333,46,296,1,110,0,110,138
1740.074,6,142,8930,75,46,23514,208,5103,67,31,26357,31,3827
35.239,17,20,1760,10,48,3914,48,760,10,72,3914,72,1000
10.937,6,20,1495,10,222,1210,222,848,10,231,1211,231,647
0.784,6,152,98899,79,1301,10,1420,91676,73,427,10,1420,7223
117.117,6,46,8959,23,358,938,728,2099,23,348,5317,3488,6860
5.517,6,40,7309,21,218,275,314,3463,19,513,292,1179,3846
1797.168,1,57,4788,0,0,0,0,0,57,56,32092,56,4788
1772.658,6,180,15480,120,69,14896,69,8940,60,69,30040,69,6540
428.174,6,55,6778,30,304,14764,304,4608,25,83,17840,83,2170
1795.493,6,369,26199,214,105,8429,469,15514,155,69,11658,69,10685
1793.88,6,359,22709,209,69,8624,69,12569,150,69,12039,69,10140
8.832,6,14,2449,6,187,1766,187,503,8,302,1113,494,1946
1786.67,6,104,8444,68,66,26666,66,4964,36,60,51045,60,3480
0.975,6,30,9277,17,263,51,586,2302,13,1073,66,3132,6975
135.436,6,126,95432,81,1277,1692,1408,82170,45,727,2163,2816,13262
280.638,6,29,7392,13,158,23386,267,1317,16,603,18703,2036,6075
1786.426,6,109,8644,69,66,26270,66,5004,40,60,45803,60,3640
10.359,6,9,527,5,43,2589,43,311,4,0,3451,0,216
1729.849,6,82,14216,50,111,35303,1440,5207,32,253,55795,1440,9009
1681.516,17,16,1265,8,30,240214,37,471,8,71,240214,136,794
1685.51,17,12,498,11,14,168551,14,462,1,8,0,8,36
2.821,6,24,8004,12,164,215,267,1288,12,1014,212,2331,6716
0.054,17,4,284,2,32,38,32,120,2,54,41,60,164
0.045,6,12,3462,6,75,9,75,395,6,1373,9,1448,3067
69.561,6,28,7286,13,155,5796,267,1306,15,488,4967,3417,5980
1680.69,17,13,534,11,14,168051,14,462,2,8,1680512,8,72
0.096,17,4,284,2,32,44,32,120,2,54,76,60,164
146.45,17,4,352,2,60,146448,60,176,2,60,146448,60,176
2.679,2,2,64,2,8,2679,8,64,0,0,0,0,0
1744.687,2,15,480,15,8,124620,8,480,0,0,0,0,0
1786.542,6,352,33317,170,324,10571,842,12480,182,66,9868,1550,20837
0.042,17,2,136,1,32,0,32,60,1,48,0,48,76
1564.156,2,13,416,13,8,130346,8,416,0,0,0,0,0
21.394,6,39,5362,19,304,1188,304,3440,20,83,1106,83,1922
0.39,6,27,9093,13,252,32,646,1694,14,832,28,1438,7399
0.004,6,2,200,1,108,0,108,160,1,0,0,0,40
0.216,17,2,196,1,62,0,62,90,1,78,0,78,106
1789.953,6,362,24305,211,88,8523,469,13987,151,69,11933,69,10318
280.035,6,27,7312,12,158,25457,267,1277,15,678,19999,2045,6035
0.509,6,27,6238,14,181,39,537,1654,13,648,38,2176,4584
117.485,6,30,7432,13,158,9790,267,1317,17,543,7336,1400,6115
48.51,6,27,7177,13,155,4042,267,1306,14,530,3731,3417,5871
7.103,6,1596,1486810,990,1423,7,1448,1450634,606,776,11,1448,36176
5.033,17,4,288,2,36,5002,36,128,2,52,4998,52,160
0.38,17,8,2758,8,316,54,355,2758,0,0,0,0,0
0.841,6,10,1687,7,100,140,100,384,3,1179,292,1179,1303
63.59,6,13,5569,4,106,21193,106,274,9,985,7947,1420,5295
0.412,6,107,115804,48,183,8,230,3065,59,1958,6,5632,112739
10.041,17,2,138,2,41,10041,41,138,0,0,0,0,0
7.153,6,1578,1461469,999,1385,6,1408,1426697,579,776,12,1408,34772
121.924,6,9,515,5,43,30481,43,299,4,0,40638,0,216
1793.183,6,382,24388,220,69,8188,69,13285,162,69,11137,69,11103
373.607,6,25,1651,17,177,23350,177,1117,8,110,9257,110,534
0.249,6,12,4225,7,127,38,127,499,5,1729,56,3293,3726
1793.478,17,66,2766,65,14,28023,14,2730,1,8,0,8,36
0.251,17,4,624,2,64,150,64,184,2,192,137,192,440
300.068,6,53,10905,27,611,11534,1360,4863,26,293,11995,2720,6042
119.41,6,22,9113,11,306,85,612,1403,11,1036,11922,1360,7710
1720.501,17,12,498,11,14,172050,14,462,1,8,0,8,36
17.697,6,6,2105,0,0,0,0,0,6,373,3539,373,2105
1790.287,17,89,3729,87,13,20815,14,3649,2,12,1790088,16,80
26.432,17,4,320,2,48,26422,48,152,2,56,26421,56,168
240.192,6,65,24912,33,853,7505,1402,17949,32,529,7747,1402,6963
0.256,6,25,6032,12,164,23,453,1442,13,651,20,1402,4590
46.35,2,2,64,2,8,46350,8,64,0,0,0,0,0
6.318,6,2,111,2,31,6318,31,111,0,0,0,0,0
0.104,6,10,1677,6,555,20,951,1354,4,159,32,159,323
0.127,6,11,1971,6,451,25,500,1222,5,481,31,481,749
3.875,17,4,352,2,48,3865,48,152,2,72,3864,72,200
7.229,6,21,2659,11,188,722,245,832,10,703,773,1152,1827
86.71,17,3,228,3,48,43355,48,228,0,0,0,0,0
289.803,17,4,240,2,32,289802,32,120,2,32,289802,32,120
83.886,6,25,12398,13,881,52,1460,4957,12,992,7614,1460,7441
0.055,1,2,163,2,53,55,78,163,0,0,0,0,0
93.389,6,11,719,11,31,9338,31,719,0,0,0,0,0
1.288,6,47,18777,27,863,49,1360,13201,20,476,58,2715,5576
1740.462,17,30,7050,30,207,60015,207,7050,0,0,0,0,0
32.983,6,27,13508,15,782,2355,1219,4543,12,1059,2980,2279,8965
1798.948,1,248,13888,248,28,7283,28,13888,0,0,0,0,0
280.503,6,30,7432,13,158,23375,267,1317,17,543,17518,1400,6115
0.318,6,28,9145,13,252,26,646,1694,15,832,22,1402,7451
0.519,17,3,543,2,39,400,39,134,1,381,0,381,409
0.052,6,10,1514,5,503,12,503,771,5,475,12,475,743
6.372,6,16,5237,5,288,1549,288,520,11,710,619,853,4717
72.979,17,4,240,2,32,72978,32,120,2,32,72978,32,120
0.498,6,9,527,5,43,124,43,311,4,0,162,0,216
35.03,17,40,5880,20,48,1843,48,1520,20,190,1842,308,4360
0.123,17,2,198,1,39,0,39,67,1,103,0,103,131
176.422,6,25,6271,9,267,95,501,1165,16,343,11755,1420,5106
241.237,6,41,8132,20,513,12694,1368,5668,21,194,12059,580,2464
0.947,6,36,8339,18,281,55,780,1866,18,441,48,1360,6473
0.93,1,2,270,2,107,930,121,270,0,0,0,0,0
834.019,6,10,1390,10,110,92668,110,1390,0,0,0,0,0
8.36,6,1576,1422287,978,1375,8,1408,1386527,598,931,13,2816,35760
12.373,6,27,4768,13,205,1017,722,1709,14,387,939,1408,3059
168.736,17,4,240,2,32,168735,32,120,2,32,168735,32,120
0.028,17,2,306,1,33,0,33,61,1,217,0,217,245
0.528,6,24,6016,13,108,44,147,959,11,768,51,1581,5057
46.989,6,28,7352,13,158,3915,267,1317,15,775,3351,4836,6035
1799.169,17,448,39896,403,35,4475,288,25676,45,288,40019,288,14220
0.043,17,4,284,2,32,31,32,120,2,54,31,60,164
0.052,17,4,284,2,32,22,32,120,2,54,33,60,164
4.306,17,19,13357,11,967,430,1350,10953,8,272,554,1350,2404
1758.683,6,99,7814,65,45,27479,205,4850,34,35,53284,98,2964
0.407,17,2,152,1,48,0,48,76,1,48,0,48,76
1792.799,6,356,22520,208,69,8660,69,12460,148,69,12195,69,10060
1775.185,17,138,11040,69,48,26105,48,5244,69,56,26105,56,5796
57.051,17,10,760,10,48,6339,48,760,0,0,0,0,0
1799.628,17,448,39896,403,35,4476,288,25676,45,288,40016,288,14220
1.509,6,4,284,0,0,0,0,0,4,31,503,31,284
109.857,6,190,145597,117,1274,947,1368,132287,73,633,1522,1368,13310
0.12,6,10,1495,5,507,30,507,727,5,556,29,556,768
5.19,6,42,8289,21,227,259,314,4022,21,489,245,1179,4267
5.935,6,34,6169,17,206,370,314,2744,17,548,355,1179,3425
1719.47,17,12,498,11,14,171947,14,462,1,8,0,8,36
1742.112,6,87,6322,58,31,30563,31,3915,29,31,62218,31,2407
21.798,6,14,2676,6,821,4357,1420,1886,8,231,3113,231,790
0.134,17,2,152,1,48,0,48,76,1,48,0,48,76
12.78,6,26,4705,13,204,1051,722,1708,13,463,1051,1408,2997
1770.496,6,105,9636,68,64,26425,65,5677,37,58,49177,59,3959
1106.648,1,64,3584,64,28,17565,28,3584,0,0,0,0,0
1799.473,17,144,11520,72,48,25344,48,5472,72,56,25344,56,6048
0.501,6,14,3952,8,124,71,124,572,6,1530,100,1612,3380
0.545,17,4,288,2,36,497,36,128,2,52,496,52,160
1795.236,6,356,22520,208,69,8672,69,12460,148,69,12212,69,10060
31.985,6,418,443699,132,123,244,293,7235,286,1495,112,2804,436464
1.082,6,11,913,6,182,216,182,490,5,77,177,134,423
1112.282,1,54,3024,54,28,20986,28,3024,0,0,0,0,0
15.017,6,20,5882,10,275,1668,275,958,10,902,1388,1440,4924
0.036,17,4,859,2,37,27,37,130,2,336,26,348,729
1792.629,6,331,30569,194,109,9288,469,15431,137,130,13181,1997,15138
0.501,6,23,7406,13,335,41,668,2026,10,968,51,1946,5380
1.015,6,28,8460,15,222,61,540,1964,13,994,70,1791,6496
1783.145,17,83,3480,82,14,22014,14,3444,1,8,0,8,36
316.997,6,110,35978,57,536,5660,1360,24829,53,322,6093,3289,11149
1779.981,1,230,12880,230,28,7772,28,12880,0,0,0,0,0
1788.767,17,87,3648,86,14,21044,14,3612,1,8,0,8,36
0.024,17,2,527,1,47,0,47,75,1,424,0,424,452
1703.224,17,12,498,11,14,170322,14,462,1,8,0,8,36
0.451,6,12,1653,6,288,90,288,548,6,426,46,434,1105
0.555,6,24,10117,13,136,46,136,820,11,1089,55,1448,9297
1740.435,1,16,896,16,28,116029,28,896,0,0,0,0,0
1.01,17,2,685,1,308,0,308,336,1,321,0,321,349
6.16,6,1264,1169684,781,1418,7,1448,1138240,483,776,12,1448,31444
1788.865,17,87,3648,86,14,21045,14,3612,1,8,0,8,36
1784.281,17,83,3480,82,14,22028,14,3444,1,8,0,8,36
1785.335,6,104,8376,68,65,26646,65,4930,36,59,51006,59,3446
11.202,17,4,304,4,48,3734,48,304,0,0,0,0,0
1.204,1,5,420,5,56,301,56,420,0,0,0,0,0
740.607,17,84,7017,78,30,9618,37,4545,6,384,136172,463,2472
61.598,6,52,31347,32,1094,1987,1448,23553,20,749,3230,1448,7794
1681.268,17,14,1045,7,30,280208,30,406,7,63,280208,71,639
1786.646,6,102,8296,68,65,26666,65,4930,34,59,54138,59,3366
24.51,1,4,224,4,28,8170,28,224,0,0,0,0,0
280.505,6,29,7392,13,158,23375,267,1317,16,678,18696,3456,6075
8.787,2,2,64,2,8,8787,8,64,0,0,0,0,0
1680.928,1,15,870,15,30,120066,30,870,0,0,0,0,0
126.624,2,2,64,2,8,126624,8,64,0,0,0,0,0
0.334,6,10,1380,6,145,66,145,389,4,827,42,827,991
0.365,2,3,96,3,8,182,8,96,0,0,0,0,0
243.47,6,28,7352,13,158,20289,267,1317,15,678,17389,3436,6035
1773.047,6,180,15480,120,69,14899,69,8940,60,69,30049,69,6540
651.655,1,20,1120,20,28,34297,28,1120,0,0,0,0,0
1784.06,6,358,22600,207,69,8660,69,12420,151,69,11893,69,10180
1696.264,1,8,448,8,28,242323,28,448,0,0,0,0,0
0.752,6,25,8441,12,285,68,763,1774,13,995,58,1368,6667
1772.0,6,180,15480,120,69,14890,69,8940,60,69,30033,69,6540
1.426,6,55,23967,30,997,49,1460,18191,25,433,51,1460,5776
1.156,6,24,8004,12,164,89,267,1288,12,1014,89,2411,6716
1742.039,6,87,6322,58,31,30562,31,3915,29,31,62215,31,2407
11.446,6,27,11355,13,275,953,275,1078,14,1078,822,1414,10277
5.669,6,69,25228,32,875,182,1440,14493,37,543,152,1440,10735
280.245,6,29,7392,13,158,23353,267,1317,16,603,18676,2036,6075
267.102,6,22,8161,7,150,425,174,584,15,581,19071,1452,7577
1793.67,17,180,14040,180,50,10020,50,14040,0,0,0,0,0
1789.466,6,356,22520,208,69,8644,69,12460,148,69,12171,69,10060
1369.207,17,65,2730,65,14,21393,14,2730,0,0,0,0,0
1741.065,6,87,6322,58,31,30545,31,3915,29,31,62180,31,2407
240.179,6,54,17868,29,748,8577,1408,14980,25,197,10007,580,2888
0.045,17,2,265,1,45,0,45,73,1,164,0,164,192
36.481,17,4,352,2,60,36480,60,176,2,60,36480,60,176
0.07,6,10,1903,5,657,17,657,925,5,710,17,710,978
0.575,17,2,152,2,48,575,48,152,0,0,0,0,0
1650.798,1,8,848,8,78,235828,78,848,0,0,0,0,0
1.106,6,24,8004,12,164,85,267,1288,12,1014,85,2804,6716
201.254,6,131,99140,81,1294,2515,1440,88381,50,679,2456,1440,10759
0.09,6,10,1888,5,130,22,130,350,5,1326,22,1326,1538
1.71,6,13,2311,8,188,244,245,700,5,1407,354,1407,1611
0.782,17,2,144,1,36,0,36,64,1,52,0,52,80
6.685,6,38,7245,20,218,351,314,3423,18,516,376,1179,3822
0.955,6,27,5740,13,125,79,267,1275,14,650,67,1420,4465
5.012,17,4,558,2,36,5007,36,128,2,187,5007,187,430
0.008,17,2,459,1,40,0,40,68,1,363,0,363,391
1796.759,17,448,39896,403,35,4469,288,25676,45,288,40020,288,14220
9.656,6,1135,958462,550,350,17,351,34497,585,1535,16,5472,923965
3.523,6,21,5000,11,137,352,267,1132,10,692,361,1467,3868
0.171,6,46,21851,27,1051,6,1420,16870,19,467,9,1883,4981
1787.325,6,102,8296,68,65,26676,65,4930,34,59,54158,59,3366
0.159,6,3,151,2,31,1,31,111,1,0,0,0,40
382.351,6,18,1242,14,180,29411,180,916,4,110,20057,110,326
1727.713,1,148,8288,148,28,11753,28,8288,0,0,0,0,0
0.859,6,41,11003,25,147,35,615,3390,16,994,46,4649,7613
21.394,6,15,2306,9,210,2674,210,908,6,545,4270,904,1398
367.049,6,18,1239,14,177,28234,177,913,4,110,20057,110,326
300.171,6,52,22492,31,1038,9999,1360,16850,21,435,14999,2720,5642
72.566,6,15,1928,9,483,9070,483,1442,6,83,14509,83,486
18.434,6,18,5822,8,272,2633,516,1140,10,611,2038,1452,4682
65.892,6,22,8361,11,532,88,1257,2068,11,973,6570,1791,6293
1.074,6,45,11199,26,147,42,615,3466,19,773,48,2720,7733
34.155,17,40,5880,20,48,1796,48,1520,20,190,1797,308,4360
1796.936,1,320,26880,320,56,5633,56,26880,0,0,0,0,0
0.002,6,2,87,1,0,0,0,40,1,7,0,7,47
1681.278,17,14,1036,7,30,280209,30,406,7,62,280210,62,630
280.253,6,30,7432,13,158,23354,267,1317,17,543,17510,1400,6115
1.967,6,43,8566,22,283,93,1168,2905,21,400,87,1360,5661
216.093,6,22,6974,10,181,24010,267,1128,12,766,19644,2800,5846
4.645,17,4,240,2,32,4643,32,120,2,32,4644,32,120
1792.198,1,342,28728,342,56,5255,56,28728,0,0,0,0,0
162.415,6,22,8884,11,265,63,486,1292,11,1020,16228,1360,7592
5.295,6,14,2254,8,210,756,210,856,6,545,1058,904,1398
1799.8,17,4140,198720,2070,20,869,20,99360,2070,20,869,20,99360
84.149,17,4,352,2,60,84148,60,176,2,60,84148,60,176
0.115,6,15,1144,9,181,14,181,669,6,77,21,134,475
1.494,6,9,482,4,0,498,0,204,5,7,320,7,278
4.459,17,4,450,2,37,4442,37,130,2,132,4442,132,320
1.736,6,38,8254,19,321,96,1164,2718,19,433,84,1360,5536
0.78,6,28,5967,13,156,65,267,1462,15,650,51,1420,4505
17.977,6,7,308,7,0,0,0,308,0,0,0,0,0
75.604,6,13,540,6,0,2631,0,244,7,0,12599,0,296
4.787,17,2,656,2,300,4787,300,656,0,0,0,0,0
11.671,6,1854,1612878,1121,1383,10,1420,1579265,733,467,15,1883,33613
1764.845,6,119,12038,75,63,23849,722,6268,44,96,41038,1408,5770
1769.717,6,99,9240,66,65,27226,65,5577,33,59,55291,59,3663
0.205,6,46,20819,26,1052,8,1420,15798,20,467,10,1883,5021
1749.576,17,12,498,11,14,174957,14,462,1,8,0,8,36
0.095,17,2,322,1,33,0,33,61,1,233,0,233,261
0.013,17,2,228,1,30,0,30,58,1,142,0,142,170
19.278,17,8,1176,4,48,6421,48,304,4,190,6421,308,872
5.078,17,27,10129,12,453,461,1350,5777,15,262,254,1350,4352
1791.426,1,58,4872,58,56,31428,56,4872,0,0,0,0,0
1763.25,6,140,8592,74,26,24153,26,4504,66,26,27126,26,4088
5.424,6,41,7349,21,218,271,314,3463,20,440,271,1152,3886
2.803,17,2,144,1,36,0,36,64,1,52,0,52,80
1798.62,17,449,39928,404,35,4463,288,25708,45,288,40021,288,14220
240.66,6,49,10020,24,503,10463,1418,6327,25,237,10026,580,3693
0.549,6,22,8158,12,211,49,290,1147,10,942,46,3068,7011
120.309,2,2,64,2,8,120309,8,64,0,0,0,0,0
280.471,6,29,7392,13,158,23372,267,1317,16,678,18691,3456,6075
3.78,6,33,6129,17,206,236,314,2744,16,548,234,1179,3385
0.506,6,24,7461,14,334,38,663,2085,10,967,52,1946,5376
4.191,17,15,15475,5,836,1047,1350,4323,10,1087,273,1350,11152
0.058,17,2,389,1,34,0,34,62,1,299,0,299,327
1740.547,17,30,31650,30,1027,60018,1027,31650,0,0,0,0,0
24.155,1,27,2808,0,0,0,0,0,27,76,929,76,2808
1700.528,17,12,498,11,14,170052,14,462,1,8,0,8,36
853.864,6,124,15441,61,107,14228,721,6977,63,296,13769,1440,8464
11.372,6,19,6745,10,275,1263,275,958,9,1353,1385,1440,5787
33.77,6,4736,4572560,3171,1365,10,1408,4486492,1565,776,21,1408,86068
218.726,17,11,3688,11,307,21872,308,3688,0,0,0,0,0
0.255,6,10,1669,6,551,51,947,1346,4,159,84,159,323
1771.529,6,107,9916,70,65,25674,65,6045,37,59,49206,59,3871
110.952,6,74,15703,32,369,3579,1418,8391,42,229,2698,580,7312
4.389,6,38,7229,19,218,243,314,3383,19,513,228,1179,3846
1797.67,17,96,7680,48,48,38248,48,3648,48,56,38248,56,4032
1785.434,1,8,448,8,28,255062,28,448,0,0,0,0,0
1787.405,6,104,8376,68,65,26677,65,4930,36,59,51065,59,3446
49.793,17,4,3621,4,877,16597,1451,3621,0,0,0,0,0
67.835,6,25,7097,12,155,6166,267,1266,13,589,5652,3426,5831
14.404,6,7,380,4,0,4801,0,216,3,0,7196,0,164
1675.233,1,52,2912,52,28,32847,28,2912,0,0,0,0,0
1.159,6,25,8056,12,164,90,267,1288,13,869,82,1408,6768
1786.762,6,106,8584,69,66,26275,66,5004,37,60,49629,60,3580
1775.466,6,214,24546,136,88,13151,981,11485,78,134,23057,1460,13061
0.094,17,2,362,1,46,0,46,74,1,260,0,260,288
1772.496,6,203,22359,130,75,13740,267,10057,73,135,24611,3417,12302
1771.668,6,102,9462,66,66,27256,66,5610,36,60,50616,60,3852
1770.266,6,149,16005,77,87,23292,517,6190,72,230,24932,2408,9815
6.244,6,19,6980,6,275,1248,275,794,13,566,433,2840,6186
0.557,6,27,8990,13,247,46,627,1672,14,938,39,1368,7318
240.639,2,2,64,2,8,240639,8,64,0,0,0,0,0
1740.432,17,29,30624,29,1028,62158,1028,30624,0,0,0,0,0
12.137,6,1899,1658985,1148,1389,10,1420,1624724,751,467,16,1883,34261
300.854,6,39,8608,18,283,17688,787,1921,21,364,15035,1360,6687
2.578,6,7,2719,4,100,859,100,264,3,1165,593,1179,2455
1756.645,6,3749,3944546,2028,147,866,911,134373,1721,2256,1021,9856,3810173
64.705,6,27,7177,13,155,5392,267,1306,14,530,4976,3417,5871
158.879,6,21,8224,11,549,87,1309,2120,10,948,17633,1591,6104
1.407,6,24,8004,12,164,109,267,1288,12,1014,110,2491,6716
217.111,17,17,18720,17,1073,13569,1451,18720,0,0,0,0,0
12.182,6,1777,1659961,1172,1366,10,1432,1631470,605,427,20,1432,28491
300.214,6,34,12059,18,592,17659,1408,4549,16,833,16033,1578,7510
1.197,6,29,6120,14,150,92,267,1615,15,650,75,1452,4505
0.047,6,7,423,4,43,5,43,259,3,0,22,0,164
300.997,6,23,9643,13,416,25068,1330,2219,10,1402,33424,3639,7424
565.912,6,60,7512,32,93,18255,721,3077,28,156,17463,1448,4435
121.408,6,52,13652,27,926,536,1360,7681,25,309,5051,2667,5971
1.324,6,30,6149,15,141,94,267,1593,15,564,89,1420,4556
1792.589,17,1924,146162,1048,40,1712,41,71962,876,56,2048,57,74200
1.017,6,28,8160,15,222,62,540,1964,13,944,69,1591,6196
1742.163,6,95,7203,63,38,28099,205,4476,32,33,56191,98,2727
1779.717,17,140,11200,70,48,25792,48,5320,70,56,25792,56,5880
126.225,2,2,64,2,8,126225,8,64,0,0,0,0,0
280.402,6,29,7392,13,158,23366,267,1317,16,603,18689,2036,6075
1792.577,17,46,15486,46,308,39835,329,15486,0,0,0,0,0
11.638,6,1846,1606494,1116,1384,10,1420,1573073,730,467,15,1883,33421
97.358,6,935,436422,483,835,201,1152,411798,452,408,215,1179,24624
0.848,6,10,1687,7,100,141,100,384,3,1179,302,1179,1303
13.605,6,23,6909,13,275,1133,275,1078,10,1353,932,1440,5831
0.11,6,13,3041,7,695,18,860,1763,6,479,21,939,1278
3.197,6,10,1691,5,100,799,100,304,5,589,732,1152,1387
23.958,6,38,8410,17,175,1497,722,2086,21,608,1177,1380,6324
1788.306,6,359,22778,209,69,8597,69,12638,150,69,12001,69,10140
0.004,6,11,15431,1,0,0,0,40,10,1487,0,2736,15391
1767.377,1,50,2800,50,28,36068,28,2800,0,0,0,0,0
1775.932,17,140,11200,70,48,25738,48,5320,70,56,25738,56,5880
1061.528,6,108,14180,63,86,17121,502,5108,45,201,24120,1420,9072
1741.273,6,95,6898,62,31,28545,31,4209,33,31,54413,31,2689
19.252,6,3340,3243138,2235,1375,8,1408,3181014,1105,776,17,1408,62124
0.505,6,61,31698,35,1136,14,1380,23113,26,683,18,3303,8585
3.58,17,4,240,4,32,1193,32,240,0,0,0,0,0
1797.977,17,140,11200,70,48,26057,48,5320,70,56,26057,56,5880
1.619,6,49,19404,29,895,57,1360,13783,20,437,73,2715,5621
2.12,17,2,677,1,300,0,300,328,1,321,0,321,349
0.023,17,2,347,1,29,0,29,57,1,262,0,262,290
1709.195,1,8,448,8,28,244170,28,448,0,0,0,0,0
240.192,6,100,113870,24,211,10442,526,2525,76,1652,3202,7010,111345
782.082,2,10,320,10,8,86898,8,320,0,0,0,0,0
280.454,6,29,7392,13,158,23371,267,1317,16,603,18693,2076,6075
1799.358,17,448,39612,404,35,4464,288,25708,44,288,40950,288,13904
3.416,17,2,154,1,33,0,33,61,1,65,0,65,93
1748.478,6,100,7860,66,45,26899,205,4896,34,35,52971,98,2964
367.335,6,23,1535,16,177,24489,177,1053,7,110,10362,110,482
1796.227,6,367,25549,213,88,8472,501,14083,154,80,11739,469,11466
2.147,17,30,15341,15,751,153,1350,11687,15,215,132,1350,3654
1764.872,1,124,6944,124,28,14348,28,6944,0,0,0,0,0
7.571,6,40,7309,21,218,378,314,3463,19,513,400,1179,3846
10.745,6,20,4442,11,275,1074,275,998,9,768,747,1440,3444
90.909,6,47,8984,22,401,810,889,2200,25,412,3782,1360,6784
0.001,6,4,4300,1,0,0,0,40,3,1368,0,1368,4260
180.503,2,2,64,2,8,180503,8,64,0,0,0,0,0
1795.11,17,318,50130,318,129,5662,376,50130,0,0,0,0,0
78.445,6,14,1080,4,226,121,226,442,10,110,8695,110,638
300.587,6,39,9772,22,254,14313,671,1978,17,591,528,3488,7794
0.023,17,4,420,2,33,0,33,122,2,121,10,145,298
48.791,6,78,105933,50,260,995,517,4168,28,4012,1806,9856,101765
2.173,17,4,962,2,40,2160,40,136,2,385,13,407,826
84.477,6,9,515,5,43,21119,43,299,4,0,28157,0,216
1795.827,17,66,2766,65,14,28059,14,2730,1,8,0,8,36
1782.525,6,104,8477,68,52,26604,205,5276,36,36,50923,98,3201
1799.679,17,449,39644,405,35,4454,288,25740,44,288,40952,288,13904
1787.636,17,87,3648,86,14,21031,14,3612,1,8,0,8,36
245.749,6,87,22099,41,520,6143,1418,13594,46,339,5460,1418,8505
1.579,6,6,240,2,0,1280,0,80,4,0,465,0,160
20.064,6,2782,2610087,1751,1410,11,1448,2551751,1031,776,19,1448,58336
280.635,6,89,31445,46,593,6236,1408,11328,43,744,6681,2816,20117
117.78,17,4,240,2,32,117779,32,120,2,32,117779,32,120
240.175,6,56,20027,30,813,8281,1402,17021,26,205,9606,580,3006
0.524,6,27,8996,13,243,43,611,1656,14,941,36,1368,7340
0.146,17,2,708,1,40,0,40,68,1,612,0,612,640
13.285,6,2507,2331974,1597,1381,8,1408,2279990,910,931,14,2801,51984
240.386,6,3,210,0,0,0,0,0,3,30,120193,30,210
1681.347,17,16,1265,8,30,240189,37,471,8,71,240189,136,794
2.693,6,33,6411,16,141,179,267,1775,17,564,164,1420,4636
1.071,17,3,1170,3,362,535,362,1170,0,0,0,0,0
0.174,17,2,602,1,46,0,46,74,1,500,0,500,528
11.462,6,17,7429,9,425,1432,721,1639,8,1366,1609,2840,5790
1798.307,2,15,480,15,8,128450,8,480,0,0,0,0,0
1786.756,6,80,6424,52,65,35034,65,3770,28,59,66171,59,2654
3.924,17,4,352,2,48,3919,48,152,2,72,3917,72,200
0.241,6,21,5000,10,137,26,267,1092,11,692,22,1467,3908
0.276,6,22,5040,11,137,27,267,1132,11,577,27,1400,3908
139.601,6,1065,521293,569,846,245,1152,495262,496,412,281,1179,26031
220.47,6,25,7117,5,154,55117,267,672,20,375,11593,1460,6445
0.44,6,12,1653,6,288,82,288,548,6,426,50,434,1105
1791.047,6,356,22520,208,69,8652,69,12460,148,69,12183,69,10060
0.114,17,2,152,1,48,0,48,76,1,48,0,48,76
0.819,6,376,308191,174,194,4,230,9847,202,1439,3,2896,298344
1.291,2,4,160,4,16,430,16,160,0,0,0,0,0
300.803,6,40,8576,19,266,16704,720,1858,21,391,15033,3488,6718
37.644,17,11,836,11,48,3764,48,836,0,0,0,0,0
0.015,6,3,168,2,0,15,0,104,1,0,0,0,64
1.588,6,40,9928,21,440,79,1360,4392,19,433,76,1360,5536
1.349,6,10,1687,7,100,224,100,384,3,1179,546,1179,1303
0.185,6,8,1303,4,145,61,145,309,4,830,35,830,994
0.011,17,2,602,1,46,0,46,74,1,500,0,500,528
0.406,6,8,335,4,0,135,0,164,4,7,63,7,171
2.327,6,14,2351,8,188,332,245,700,6,703,414,1152,1651
50.009,17,6,384,6,36,10001,36,384,0,0,0,0,0
13.934,6,42,21873,25,238,580,640,2260,17,1872,869,4801,19613
157.13,6,37,22114,20,549,41,1360,3052,17,1670,9812,3934,19062
5.898,6,681,559456,399,1328,14,1368,540128,282,776,20,1473,19328
1741.005,17,30,6930,30,203,60034,203,6930,0,0,0,0,0
1690.454,6,85,6249,59,31,29145,31,4091,26,31,60178,31,2158
0.992,6,10,1687,7,100,165,100,384,3,1179,367,1179,1303
364.438,6,18,1242,14,180,28033,180,916,4,110,20055,110,326
0.123,17,2,142,1,35,0,35,63,1,51,0,51,79
1763.869,2,14,448,14,8,135682,8,448,0,0,0,0,0
1797.909,1,345,28980,345,56,5226,56,28980,0,0,0,0,0
1772.388,6,180,15480,120,69,14894,69,8940,60,69,30033,69,6540
1788.069,1,176,9856,176,28,10217,28,9856,0,0,0,0,0
1787.771,17,142,11360,71,48,25539,48,5396,71,56,25538,56,5964
1135.232,6,62,4837,35,66,25478,66,2522,27,53,43647,60,2315
15.375,6,1873,1712442,1187,1364,12,1408,1672106,686,931,22,2801,40336
261.318,6,83,12838,37,306,7258,751,4748,46,157,5798,1418,8090
1774.912,6,180,15480,120,69,14915,69,8940,60,69,30078,69,6540
1177.37,6,84,9568,53,74,22641,722,4845,31,135,34828,2329,4723
0.402,6,10,968,5,256,97,256,460,5,304,97,304,508
1781.763,6,359,22709,209,69,8566,69,12569,150,69,11958,69,10140
60.145,2,2,64,2,8,60145,8,64,0,0,0,0,0
2.999,17,23,17569,11,728,299,1350,8317,12,743,265,1350,9252
1763.567,2,14,448,14,8,135659,8,448,0,0,0,0,0
0.611,6,28,10165,14,266,47,705,1814,14,951,45,1438,8351
94.093,17,4,240,2,32,94092,32,120,2,32,94092,32,120
1776.321,1,58,4872,58,56,31163,56,4872,0,0,0,0,0
1786.184,17,87,3648,86,14,21013,14,3612,1,8,0,8,36
56.606,6,29,7392,13,158,4717,267,1317,16,603,3767,2036,6075
0.191,6,26,7256,13,155,15,267,1301,13,603,15,1400,5955
15.049,17,13,7653,7,756,2501,1350,5491,6,332,3002,1350,2162
0.352,6,10,1669,6,551,70,947,1346,4,159,117,159,323
1775.587,17,138,11040,69,48,26111,48,5244,69,56,26111,56,5796
1250.012,6,2186,1251038,894,527,1131,1368,237950,1292,1020,968,5472,1013088
316.992,6,62,18043,36,340,9056,1360,9298,26,591,12674,3289,8745
5.846,6,1575,1444585,989,1382,5,1408,1409449,586,776,9,1408,35136
299.539,6,6,364,4,31,99846,31,222,2,31,299514,31,142
0.042,6,17,6068,10,88,4,88,556,7,1740,6,1880,5512
0.552,6,10,924,5,283,92,283,551,5,105,92,105,373
1787.386,6,102,8364,68,66,26677,66,4964,34,60,54153,60,3400
7.508,6,67,20246,34,543,227,1152,15499,33,489,226,1179,4747
470.908,1,18,1008,18,28,27700,28,1008,0,0,0,0,0
52.562,6,6941,6757911,4683,1367,11,1408,6635831,2258,776,23,1408,122080
170.824,6,18,744,5,0,4438,0,204,13,0,14234,0,540
265.638,6,30,7432,13,158,22136,267,1317,17,543,16601,1400,6115
8.132,6,15,6421,5,189,2030,267,587,10,904,902,1452,5834
371.179,6,20,1343,14,177,28552,177,913,6,110,16712,110,430
1799.572,17,142,11360,71,48,25708,48,5396,71,56,25708,56,5964
1783.832,6,354,22440,207,69,8659,69,12420,147,69,12217,69,10020
1.332,6,46,18735,26,929,53,1460,13159,20,529,60,4075,5576
1774.827,6,82,4357,41,27,44369,27,2186,41,27,44369,27,2171
125.345,6,28,10227,9,216,578,314,1876,19,689,6950,1179,8351
4.776,17,2,656,2,300,4776,300,656,0,0,0,0,0
1.061,6,25,8056,12,164,82,267,1288,13,869,75,1408,6768
11.898,6,1897,1636252,1154,1363,10,1380,1602290,743,383,15,1380,33962
0.993,17,8,2750,8,315,141,354,2750,0,0,0,0,0
15.4,17,10,760,10,48,1711,48,760,0,0,0,0,0
10.765,6,20,4402,11,275,1076,275,998,9,758,712,1420,3404
98.915,6,49,20171,29,805,3532,1402,17613,20,215,4750,580,2558
0.014,17,2,136,1,32,0,32,60,1,48,0,48,76
125.365,6,16,3247,8,92,17909,92,504,8,387,17884,1408,2743
255.206,17,18,6048,18,308,15012,308,6048,0,0,0,0,0
1741.994,6,87,6322,58,31,30561,31,3915,29,31,62213,31,2407
1786.846,6,102,8228,68,64,26669,64,4896,34,58,54144,58,3332
1696.367,2,27,864,27,8,65244,8,864,0,0,0,0,0
0.422,6,21,7203,12,318,36,600,1906,9,964,50,1471,5297
0.302,17,116,103732,43,174,6,1350,8697,73,1273,4,1350,95035
1681.51,17,14,1036,7,30,280247,30,406,7,62,280246,62,630
20.733,6,23,8047,13,408,1727,581,1896,10,803,2269,1408,6151
1797.126,17,180,14040,180,50,10039,50,14040,0,0,0,0,0
1793.701,6,125,12435,78,61,23294,721,6477,47,94,38987,2118,5958
44.128,6,30,7297,14,155,3394,267,1346,16,441,2941,1420,5951
1793.928,17,180,11520,180,36,10021,36,11520,0,0,0,0,0
1793.657,1,75,6300,75,56,24238,56,6300,0,0,0,0,0
0.471,6,27,8942,13,232,39,569,1614,14,941,34,1438,7328
1796.41,1,268,15008,268,28,6728,28,15008,0,0,0,0,0
120.489,6,11,7487,3,100,686,100,224,8,1156,17178,1179,7263
377.797,2,3,96,3,8,188898,8,96,0,0,0,0,0
4.164,17,10,740,10,46,462,46,740,0,0,0,0,0
35.065,17,14,3248,14,204,2697,204,3248,0,0,0,0,0
317.026,6,71,19177,36,352,9057,1360,9612,35,370,9319,2720,9565
1787.29,6,439,37678,240,114,7478,1189,19570,199,133,9024,1917,18108
192.704,6,69,48462,45,1191,4379,1408,40480,24,960,2677,3847,7982
271.564,17,4,352,2,60,271563,60,176,2,60,271562,60,176
1755.948,6,186,11593,93,50,19086,208,6943,93,31,19083,31,4650
300.627,6,38,8439,20,283,15822,787,1965,18,441,495,1460,6474
0.948,6,29,8200,15,222,56,540,1964,14,809,59,1460,6236
1799.863,17,763,46018,763,32,2362,37,46018,0,0,0,0,0
4.578,6,18,7846,8,150,654,174,624,10,974,497,1452,7222
1787.64,17,46,15432,46,307,39725,308,15432,0,0,0,0,0
0.1,6,10,1514,5,503,24,503,771,5,475,25,475,743
1772.112,6,180,15480,120,69,14891,69,8940,60,69,30033,69,6540
6.47,17,4,1344,4,308,2156,308,1344,0,0,0,0,0
1688.468,1,7,392,7,28,281411,28,392,0,0,0,0,0
756.155,2,5,160,5,8,189038,8,160,0,0,0,0,0
3.344,17,5,290,5,30,836,30,290,0,0,0,0,0
0.0,17,3,1218,3,378,0,388,1218,0,0,0,0,0
6.048,17,4,304,3,48,2975,48,228,1,48,0,48,76
138.619,17,4,1344,4,308,46206,308,1344,0,0,0,0,0
2.104,17,4,240,2,32,2102,32,120,2,32,2103,32,120
11.319,6,1807,1555334,1100,1362,10,1380,1522767,707,426,15,3303,32567
1755.958,6,107,6374,60,27,29761,27,3525,47,27,38172,27,2849
1787.211,6,102,8296,68,65,26674,65,4930,34,59,54154,59,3366
1745.084,6,97,7338,62,38,28607,205,4424,35,33,51319,98,2914
1.296,6,46,19190,27,895,49,1360,13654,19,476,62,2715,5536
1.36,6,48,18745,26,924,54,1460,13089,22,433,56,1460,5656
377.547,2,3,96,3,8,188773,8,96,0,0,0,0,0
1794.521,17,140,11200,70,48,26007,48,5320,70,56,26007,56,5880
168.147,6,34,2832,14,98,12923,337,1544,20,54,8842,143,1288
1792.137,17,565,79672,277,183,6493,1350,58643,288,45,6236,1350,21029
1.06,6,12,3462,7,75,176,75,447,5,1373,264,1448,3015
1.339,6,47,19101,26,954,53,1460,13485,21,476,58,2615,5616
212.285,6,169,127200,104,1281,2061,1408,114306,65,731,2004,2816,12894
15.524,6,1771,1463927,986,1393,15,1448,1413011,785,776,19,1448,50916
1707.217,17,15,3426,15,200,121944,682,3426,0,0,0,0,0
1743.453,6,100,7866,66,45,26822,205,4902,34,35,52826,98,2964
276.474,17,4,352,2,60,276473,60,176,2,60,276473,60,176
124.884,6,216,179345,143,1299,879,1368,164640,73,641,1664,2736,14705
0.063,6,10,1823,6,108,12,108,428,4,1179,12,1179,1395
248.408,17,4,386,2,33,248392,37,123,2,103,248322,136,263
128.333,6,29,16808,14,634,69,1360,3141,15,1450,9157,3934,13667
7.738,1,12,1248,0,0,0,0,0,12,76,703,76,1248
8.788,6,32,12380,14,108,676,147,999,18,968,515,1608,11381
40.097,6,28,7286,13,155,3341,267,1306,15,488,2863,3417,5980
1.001,17,2,685,1,308,0,308,336,1,321,0,321,349
179.055,6,25,6273,9,267,94,502,1166,16,343,11931,1420,5107
0.361,6,10,1677,6,555,67,951,1354,4,159,114,159,323
1790.286,1,342,28728,342,56,5250,56,28728,0,0,0,0,0
0.884,6,27,5927,13,156,73,267,1462,14,650,62,1452,4465
1795.603,17,449,39928,404,35,4455,288,25708,45,288,40012,288,14220
0.291,17,2,2728,2,1336,291,1336,2728,0,0,0,0,0
20.645,6,45,12618,21,189,1032,517,3222,24,624,872,1408,9396
4.087,2,2,64,2,8,4087,8,64,0,0,0,0,0
295.579,6,8,475,6,31,59115,31,333,2,31,104540,31,142
280.421,6,31,7472,13,158,23368,267,1317,18,543,16492,1380,6155
280.499,6,30,7432,14,158,21576,267,1357,16,678,18695,3456,6075
0.335,6,22,7218,11,257,32,748,1611,11,1005,32,2380,5607
1733.899,6,99,8118,66,66,26675,66,4818,33,60,54180,60,3300
12.174,17,14,16229,14,1131,936,1449,16229,0,0,0,0,0
11.232,6,27,11355,13,275,936,275,1078,14,1078,831,1414,10277
0.367,6,7,716,4,226,122,226,442,3,110,92,110,274
1783.712,17,134,10720,67,48,27025,48,5092,67,56,27025,56,5628
0.252,17,2,178,1,29,0,29,57,1,93,0,93,121
0.169,6,9,1339,5,145,42,145,349,4,826,39,826,990
1797.915,17,364,47479,173,180,10452,1350,36044,191,31,9461,60,11435
283.939,6,30,7687,11,158,28393,267,1237,19,473,15771,1400,6450
0.518,6,12,1653,6,288,98,288,548,6,426,56,434,1105
5.274,6,40,7309,21,218,263,314,3463,19,513,279,1179,3846
1.35,6,48,19237,27,893,51,1440,13621,21,433,58,1440,5616
3.923,17,4,368,4,64,1307,64,368,0,0,0,0,0
1.314,6,47,19570,27,920,50,1360,13994,20,476,58,2720,5576
1771.006,6,99,9306,66,66,27246,66,5610,33,60,55340,60,3696
1784.302,17,71,2966,65,13,27879,14,2710,6,14,152951,16,256
0.007,17,2,471,1,42,0,42,70,1,373,0,373,401
4.401,6,13,1096,7,283,704,283,663,6,105,845,105,433
0.019,6,13,3980,7,88,3,88,388,6,1670,3,1880,3592
251.186,6,31,7813,14,158,19322,267,1357,17,577,15696,1400,6456
0.78,6,11,1727,7,100,130,100,384,4,589,171,1152,1343
1784.047,17,748,45092,748,32,2388,37,45092,0,0,0,0,0
183.65,6,268,218821,171,1310,1080,1408,201488,97,646,1910,3847,17333
44.151,6,30,7297,14,155,3396,267,1346,16,441,2942,1420,5951
1784.044,6,104,8376,68,65,26627,65,4930,36,59,50969,59,3446
5.454,6,15,3205,5,92,1363,92,348,10,579,586,1408,2857
300.69,6,37,8506,21,307,15034,882,2113,16,521,570,3488,6393
158.879,6,40,2455,19,69,8825,69,1174,21,40,7943,69,1281
0.055,6,12,1846,7,139,9,139,511,5,533,13,905,1335
586.099,6,53,8289,27,117,22539,517,2348,26,510,23440,3816,5941
1793.022,6,364,23047,211,69,8538,69,12718,153,69,11796,69,10329
1795.934,17,142,11360,71,48,25655,48,5396,71,56,25655,56,5964
20.151,6,21,5417,12,107,1831,159,1074,9,773,2517,1402,4343
1.023,6,39,10755,22,482,48,1420,3334,17,517,45,1802,7421
1785.859,6,362,22898,210,69,8544,69,12678,152,69,11826,69,10220
1778.184,17,131,10468,67,48,26942,48,5092,64,56,28225,56,5376
0.016,17,4,368,2,32,1,32,120,2,96,0,96,248
7.586,2,2,64,2,8,7586,8,64,0,0,0,0,0
0.016,17,4,859,2,37,0,37,130,2,336,5,348,729
1024.758,1,33,2772,33,56,32023,56,2772,0,0,0,0,0
1762.433,17,170,14464,157,30,11297,37,9155,13,380,141892,463,5309
13.686,6,33,7693,13,155,1140,267,1306,20,348,719,1420,6387
1.33,17,4,240,2,32,1329,32,120,2,32,1329,32,120
0.911,6,43,36875,22,219,43,517,2239,21,2096,45,9488,34636
2.007,6,3,160,2,0,1002,0,120,1,0,0,0,40
0.626,17,4,624,2,64,596,64,184,2,192,536,192,440
377.921,2,3,96,3,8,188960,8,96,0,0,0,0,0
1795.451,2,28,896,28,8,66498,8,896,0,0,0,0,0
1781.365,6,271,19396,164,69,10928,69,10838,107,69,16805,69,8558
0.661,6,26,7256,12,155,60,267,1261,14,775,47,3465,5995
0.237,17,2,198,1,39,0,39,67,1,103,0,103,131
0.122,17,2,136,1,32,0,32,60,1,48,0,48,76
15.11,17,21,8700,10,534,1675,1350,5620,11,252,1507,1350,3080
0.058,17,2,263,1,36,0,36,64,1,171,0,171,199
1776.908,17,138,11040,69,48,26130,48,5244,69,56,26130,56,5796
3.189,17,5,290,5,30,797,30,290,0,0,0,0,0
1.328,6,46,18496,26,911,53,1440,12920,20,433,60,1440,5576
11.965,6,1878,1647278,1148,1381,10,1420,1613857,730,467,16,1883,33421
1786.997,6,101,8198,66,66,27492,66,4818,35,60,52553,60,3380
1745.949,6,95,7203,63,38,28160,205,4476,32,33,56314,98,2727
5.283,6,41,7365,21,218,264,314,3463,20,442,264,1152,3902
31.739,6,7,308,1,0,0,0,44,6,0,6297,0,264
1699.441,17,12,498,11,14,169944,14,462,1,8,0,8,36
1795.195,17,87,3648,86,14,21119,14,3612,1,8,0,8,36
1.69,6,10,1687,7,100,281,100,384,3,1179,714,1179,1303
0.007,17,2,399,1,57,0,57,85,1,286,0,286,314
1625.001,1,8,448,8,28,232143,28,448,0,0,0,0,0
1798.34,17,142,11360,71,48,25690,48,5396,71,56,25690,56,5964
0.068,6,12,3704,6,171,12,171,491,6,964,13,1448,3213
1.06,6,24,8004,12,164,81,267,1288,12,1014,82,2804,6716
1623.383,6,335,21266,194,69,8411,69,11831,141,69,11594,69,9435
187.873,6,7,404,4,31,62624,31,222,3,31,93931,31,182
240.399,6,48,10297,23,213,10921,517,2700,25,483,10014,1501,7597
0.008,6,10,1514,5,503,2,503,771,5,475,1,475,743
19.655,6,7,694,0,0,0,0,0,7,69,3275,69,694
246.173,6,111,75351,47,269,5351,878,4079,64,1358,3907,2804,71272
6.67,6,684,605995,427,1350,15,1368,586575,257,931,25,2736,19420
560.504,17,6,444,3,30,280243,30,174,3,62,280245,62,270
68.491,17,4,240,2,32,68490,32,120,2,32,68490,32,120
615.861,6,170,39125,82,443,7603,1360,25196,88,189,7077,2720,13929
60.96,17,28,2339,26,30,2438,37,1515,2,384,347,463,824
0.026,17,6,912,3,60,0,60,264,3,188,0,188,648
4.432,6,2,87,1,0,0,0,40,1,7,0,7,47
372.082,6,25,1651,17,177,23255,177,1117,8,110,9233,110,534
1683.919,17,14,3843,7,30,280651,30,406,7,463,280651,463,3437
1744.4,6,97,7307,63,38,28135,205,4476,34,33,52851,98,2831
0.014,17,5,696,3,60,5,60,264,2,188,1,188,432
1799.543,6,365,23087,211,69,8569,69,12787,154,69,11761,69,10300
541.438,2,6,192,6,8,108287,8,192,0,0,0,0,0
285.977,1,4,326,4,53,95325,78,326,0,0,0,0,0
16.185,6,9,512,5,0,4046,0,272,4,0,999,0,240
0.105,6,13,2100,7,329,17,500,1030,6,375,20,500,1070
0.037,17,2,243,1,53,0,53,81,1,134,0,134,162
283.993,6,49,10838,18,131,16704,267,1910,31,384,9466,1933,8928
15.103,17,10,880,5,48,3772,48,380,5,72,3772,72,500
3.908,17,4,352,2,48,3898,48,152,2,72,3896,72,200
1797.645,1,93,5208,93,28,19539,28,5208,0,0,0,0,0
13.762,6,22,5782,12,275,1251,275,1042,10,1440,970,1440,4740
1770.813,6,101,9410,66,66,27243,66,5610,35,60,52079,60,3800
3.393,17,8,1248,4,64,1128,64,368,4,192,1127,192,880
0.262,6,25,5989,12,164,23,453,1442,13,643,20,1408,4547
6.027,17,4,748,2,47,6019,47,150,2,271,6019,271,598
27.745,6,31,7491,11,165,8,267,1109,20,348,1459,1420,6382
7.12,6,6,280,2,0,7120,0,88,4,0,2352,0,192
310.507,6,11,572,10,0,34497,0,520,1,0,0,0,52
10.283,6,12,3423,7,188,1713,245,660,5,1279,363,1407,2763
1772.801,6,180,15480,120,69,14897,69,8940,60,69,30047,69,6540
1796.499,17,448,39896,403,35,4468,288,25676,45,288,40019,288,14220
0.266,6,14,6093,7,128,44,128,500,7,1305,43,1448,5593
1799.999,6,314,40010,132,170,13511,1460,21330,182,125,9944,1460,18680
5.553,6,41,7349,21,218,277,314,3463,20,513,276,1179,3886
1741.248,6,87,6322,58,31,30548,31,3915,29,31,62187,31,2407
1740.69,17,30,31680,30,1028,60023,1028,31680,0,0,0,0,0
23.515,6,32,8778,16,340,1567,721,2685,16,681,1553,1420,6093
1.767,6,49,19038,27,876,67,1360,13382,22,433,73,1360,5656
63.79,6,11,2993,6,92,12758,92,400,5,1164,15899,1448,2593
1789.216,1,188,10528,188,28,9568,28,10528,0,0,0,0,0
1499.357,1,6,336,6,28,299871,28,336,0,0,0,0,0
97.408,6,884,447373,500,832,195,1152,427222,384,435,253,1179,20151
33.625,6,28,4937,14,180,2586,721,1807,14,399,2569,1368,3130
0.208,6,33,18071,16,171,13,313,1526,17,1565,12,4128,16545
64.864,6,41,10756,17,819,2601,1360,4808,24,292,2812,2667,5948
1.936,17,3,186,3,34,968,34,186,0,0,0,0,0
0.129,17,4,336,2,45,0,45,146,2,67,36,73,190
1.223,6,27,14284,15,894,87,1360,5997,12,1299,94,3639,8287
280.27,6,29,7392,13,158,23355,267,1317,16,678,18681,2045,6075
11.253,6,21,4482,11,275,1125,275,998,10,768,1223,1440,3484
4.982,17,4,288,2,36,4982,36,128,2,52,4981,52,160
301.074,6,46,18217,27,961,11579,1360,12655,19,435,494,2667,5562
1798.143,17,448,39896,403,35,4472,288,25676,45,288,40018,288,14220
1742.991,6,101,7515,63,38,28112,205,4476,38,33,47100,98,3039
83.834,6,34,8423,17,410,547,882,1990,17,521,5229,3488,6433
5.726,6,42,7389,21,218,286,314,3463,21,440,273,1152,3926
1770.643,6,101,9421,67,65,26827,65,5694,34,59,53653,59,3727
167.155,17,4,352,2,60,167154,60,176,2,60,167154,60,176
0.478,2,2,64,2,8,478,8,64,0,0,0,0,0
17.501,6,2544,2393461,1686,1366,10,1420,2354838,858,475,20,1883,38623
75.791,6,34,8575,12,155,47,267,1266,22,377,3608,1420,7309
1770.005,6,99,9240,66,65,27230,65,5577,33,59,55308,59,3663
1.918,17,2,672,2,308,1918,308,672,0,0,0,0,0
0.075,17,2,180,1,30,0,30,58,1,94,0,94,122
136.348,6,29,6778,11,220,5646,516,1326,18,315,8014,1452,5452
1788.424,6,219,17366,82,75,22077,337,8477,137,50,13149,143,8889
510.483,1,12,672,12,28,46407,28,672,0,0,0,0,0
1795.095,17,142,11360,71,48,25644,48,5396,71,56,25644,56,5964
6.099,6,29,7114,16,282,406,613,2803,13,725,492,1767,4311
0.978,17,2,312,2,128,978,128,312,0,0,0,0,0
1786.577,6,102,8364,68,66,26665,66,4964,34,60,54136,60,3400
280.448,6,31,7472,13,158,23370,267,1317,18,603,16494,2760,6155
93.482,6,24,9833,12,465,59,1360,2374,12,1161,8486,2720,7459
0.049,17,2,362,1,41,0,41,69,1,265,0,265,293
1786.991,6,106,8456,68,65,26671,65,4930,38,59,48292,59,3526
9.389,6,79,24381,40,550,240,1152,18680,39,459,238,1179,5701
1.549,17,12,5948,6,585,309,1350,3680,6,350,162,1350,2268
179.739,6,22,9783,12,410,59,922,1742,10,1271,19955,4416,8041
5.905,6,13,2311,8,188,843,245,700,5,1407,1410,1407,1611
4.286,17,27,10014,11,349,428,1350,4150,16,338,213,1350,5864
303.14,1,24,1344,24,28,13180,28,1344,0,0,0,0,0
91.818,6,874,419668,472,825,194,1152,397742,402,389,228,1152,21926
3.758,17,5,295,5,31,939,31,295,0,0,0,0,0
124.371,17,4,352,2,60,124369,60,176,2,60,124370,60,176
0.2,17,5,1762,5,324,50,355,1762,0,0,0,0,0
14.514,6,16,1327,8,222,2070,222,768,8,231,2070,231,559
1.263,6,50,20288,28,898,46,1360,14632,22,476,52,2715,5656
1796.654,17,29,9512,29,300,64166,300,9512,0,0,0,0,0
1390.986,6,159,29318,91,279,12651,1271,15930,68,226,20759,1420,13388
0.387,6,12,1653,6,288,76,288,548,6,426,44,434,1105
0.018,6,4,160,4,0,0,0,160,0,0,0,0,0
12.173,6,1794,1657413,1116,1406,10,1448,1617481,678,776,17,1448,39932
0.02,17,2,393,1,32,0,32,60,1,305,0,305,333
240.213,6,53,18293,28,813,8896,1418,15301,25,210,10008,580,2992
0.017,17,2,482,1,37,0,37,65,1,389,0,389,417
768.989,17,112,8512,112,48,6927,48,8512,0,0,0,0,0
108.433,17,4,1344,4,308,36144,308,1344,0,0,0,0,0
140.7,6,9,491,3,0,70350,0,152,6,7,28099,7,339
80.855,6,22,8512,11,314,68,634,1415,11,949,8072,1440,7097
1773.187,6,180,15480,120,69,14900,69,8940,60,69,30046,69,6540
0.036,6,11,913,6,182,7,182,490,5,77,8,134,423
43.357,1,7,1959,7,251,7226,293,1959,0,0,0,0,0
184.064,6,28,7352,12,158,16733,267,1277,16,603,12268,1400,6075
1.369,6,10,1687,7,100,228,100,384,3,1179,562,1179,1303
60.066,6,11,3613,11,276,6006,301,3613,0,0,0,0,0
1746.77,6,95,7203,63,38,28173,205,4476,32,33,56338,98,2727
6.504,6,21,6379,11,268,640,517,1386,10,893,711,2736,4993
0.298,17,2,212,1,46,0,46,74,1,110,0,110,138
0.368,17,2,144,1,36,0,36,64,1,52,0,52,80
0.816,6,24,5569,12,140,74,267,1184,12,650,67,1420,4385
15.081,6,21,6825,12,275,1371,275,1038,9,1353,1263,1440,5787
1779.354,17,142,11360,71,48,25419,48,5396,71,56,25419,56,5964
3.032,1,3,168,3,28,1516,28,168,0,0,0,0,0
16.045,6,24,7096,16,346,1069,511,4289,8,595,2253,1448,2807
280.575,6,30,7432,13,158,23381,267,1317,17,603,17532,2076,6115
287.42,1,6,336,6,28,57484,28,336,0,0,0,0,0
0.019,17,2,158,1,34,0,34,62,1,68,0,68,96
36.791,6,35,12137,19,105,2043,199,1614,16,880,2450,1440,10523
1.705,6,69,52199,44,1252,39,1402,44892,25,857,63,1402,7307
0.015,17,2,394,1,36,0,36,64,1,302,0,302,330
14.625,6,81,25613,39,569,384,1152,19792,42,459,350,1179,5821
296.449,1,4,224,4,28,98816,28,224,0,0,0,0,0
1026.64,6,123,8416,46,46,22814,46,3588,77,46,13506,46,4828
1799.274,17,142,11360,71,48,25703,48,5396,71,56,25703,56,5964
101.377,6,50,11911,17,403,4125,1189,3913,33,317,3167,1420,7998
1787.453,6,104,8376,68,65,26678,65,4930,36,59,51066,59,3446
1745.272,6,95,7203,63,38,28149,205,4476,32,33,56290,98,2727
1793.643,17,66,2766,65,14,28025,14,2730,1,8,0,8,36
1624.181,1,7,392,7,28,270696,28,392,0,0,0,0,0
302.918,2,3,96,3,8,151459,8,96,0,0,0,0,0
11.476,6,27,11433,13,275,956,275,1078,14,1087,838,1440,10355
1763.718,2,15,480,15,8,125979,8,480,0,0,0,0,0
1705.319,1,8,448,8,28,243617,28,448,0,0,0,0,0
738.658,17,141,10716,141,48,5276,48,10716,0,0,0,0,0
1799.99,6,359,23178,210,75,8612,469,13009,149,69,12066,69,10169
1781.023,6,354,22440,207,69,8645,69,12420,147,69,12198,69,10020
1797.869,17,448,39896,403,35,4472,288,25676,45,288,40014,288,14220
1757.649,1,64,6784,64,78,27899,78,6784,0,0,0,0,0
0.337,6,124,97860,59,194,5,230,3927,65,1437,3,4320,93933
1.247,6,30,11312,16,254,83,658,1713,14,1003,81,1460,9599
1788.969,6,152,15374,94,94,19236,502,7439,58,124,31383,1420,7935
249.083,6,307,238518,134,171,39,904,10201,173,1337,1447,2736,228317
1657.8,1,39,5165,39,104,43626,351,5165,0,0,0,0,0
1798.522,6,375,25639,217,92,8326,469,14903,158,69,11455,69,10736
1800.0,6,249,18912,96,67,18631,577,9304,153,48,11842,142,9608
1.268,6,25,8056,12,164,98,267,1288,13,869,90,1448,6768
0.079,17,2,1920,2,932,79,932,1920,0,0,0,0,0
8.592,6,14,2242,8,210,1227,210,844,6,545,1716,904,1398
59.807,6,9,527,5,43,14951,43,311,4,0,19914,0,216
0.017,17,2,138,1,33,0,33,61,1,49,0,49,77
1.012,6,28,8160,15,222,61,540,1964,13,944,68,1591,6196
1787.003,6,104,8308,68,64,26671,64,4896,36,58,51054,58,3412
0.086,17,2,144,1,36,0,36,64,1,52,0,52,80
0.435,6,26,8890,13,232,36,569,1614,13,941,33,1438,7276
1496.971,6,154,20746,84,86,18011,721,7664,70,270,21692,1414,13082
280.424,6,28,7352,12,158,25493,267,1277,16,678,18690,2085,6075
0.555,17,2,152,1,48,0,48,76,1,48,0,48,76
0.932,6,23,6509,13,333,77,1003,2189,10,979,102,1731,4320
300.741,6,38,8538,20,308,15828,885,2064,18,441,506,1460,6474
0.054,6,12,4224,7,126,8,126,498,5,1729,12,3293,3726
1787.784,17,54,17714,54,300,33731,314,17714,0,0,0,0,0
0.39,6,20,7196,12,325,34,626,1932,8,1210,54,2816,5264
0.346,6,20,7151,12,318,31,600,1906,8,964,46,1471,5245
1798.243,17,448,39896,403,35,4473,288,25676,45,288,40022,288,14220
3.927,17,5,290,5,30,981,30,290,0,0,0,0,0
0.477,6,22,5933,12,108,43,147,919,10,922,52,1581,5014
5.013,17,4,288,2,36,4981,36,128,2,52,4980,52,160
0.414,6,50,21480,28,1013,15,1380,16358,22,421,17,1923,5122
0.214,1,2,163,2,53,214,78,163,0,0,0,0,0
1789.969,6,362,22898,210,69,8564,69,12678,152,69,11853,69,10220
67.133,6,49,9216,23,410,632,882,2254,26,328,2679,1360,6962
0.137,1,2,112,2,28,137,28,112,0,0,0,0,0
126.193,2,2,64,2,8,126193,8,64,0,0,0,0,0
0.103,17,4,344,2,47,94,47,150,2,69,95,75,194
0.307,17,2,152,1,48,0,48,76,1,48,0,48,76
1771.813,6,274,27499,114,76,15678,659,11173,160,122,11142,1460,16326
1783.512,17,83,3480,82,14,22018,14,3444,1,8,0,8,36
8.386,6,11,682,4,112,2791,112,280,7,90,1395,90,402
0.231,6,24,6064,12,181,21,537,1526,12,781,20,2224,4538
83.627,17,7,2352,7,308,13937,308,2352,0,0,0,0,0
0.022,17,2,241,1,36,0,36,64,1,149,0,149,177
0.011,6,10,1542,5,505,2,505,773,5,501,2,501,769
0.014,17,2,362,1,46,0,46,74,1,260,0,260,288
37.906,17,22,1936,11,48,3789,48,836,11,72,3789,72,1100
0.976,17,4,334,2,39,928,39,134,2,72,923,72,200
0.041,17,2,206,1,44,0,44,72,1,106,0,106,134
1759.374,6,94,7151,62,38,28842,205,4424,32,33,56743,98,2727
5.929,6,41,7349,21,218,296,314,3463,20,513,297,1179,3886
1081.484,17,42,3937,21,33,54072,37,1288,21,98,54073,155,2649
0.016,6,9,1560,5,514,4,514,782,4,562,5,562,778
0.027,6,13,4256,7,85,4,85,457,6,1159,5,1863,3799
0.523,6,22,7368,13,337,43,674,2032,9,1212,61,1946,5336
8.778,6,23,4478,13,213,731,597,1741,10,552,955,1767,2737
27.316,6,17,3623,7,188,4552,245,660,10,1279,3007,1407,2963
13.82,6,17,8392,6,106,2764,106,354,11,843,1381,3426,8038
1786.609,6,152,19470,91,302,19851,302,13800,61,83,29776,83,5670
112.072,6,34,15081,18,585,43,1360,3677,16,977,7463,1360,11404
0.323,17,2,196,1,62,0,62,90,1,78,0,78,106
250.341,1,20,560,20,0,0,0,560,0,0,0,0,0
1672.16,1,7,392,7,28,278693,28,392,0,0,0,0,0
1786.594,6,154,19574,92,302,19632,302,13852,62,83,29288,83,5722
1789.748,1,342,28728,342,56,5248,56,28728,0,0,0,0,0
156.75,6,24,8601,12,316,235,640,1473,12,829,14238,1460,7128
301.071,6,23,9247,13,382,25074,1193,2082,10,1350,33432,2720,7165
1.506,6,11,1727,7,100,251,100,384,4,589,415,1152,1343
0.026,17,2,192,1,37,0,37,65,1,99,0,99,127
0.499,17,3,451,2,39,119,39,134,1,289,0,289,317
4.017,17,8,1304,4,33,1330,33,244,4,237,1336,249,1060
98.775,17,4,1344,4,308,32925,308,1344,0,0,0,0,0
2.711,6,27,6857,14,350,207,1420,2315,13,669,225,1731,4542
1049.579,1,14,784,14,28,80736,28,784,0,0,0,0,0
0.392,6,11,1008,6,256,78,256,500,5,304,93,304,508
776.76,17,34,1428,34,14,23538,14,1428,0,0,0,0,0
3.865,6,2,1175,1,0,0,0,40,1,1095,0,1095,1135
1663.45,6,21,3171,14,241,127957,241,2247,7,92,277208,92,924
1744.659,2,20,640,20,8,91824,8,640,0,0,0,0,0
0.286,17,2,198,1,39,0,39,67,1,103,0,103,131
4.387,6,19,3781,10,234,487,564,1452,9,463,439,1343,2329
12.261,6,1931,1693110,1174,1388,10,1414,1658597,757,467,16,1889,34513
1727.641,1,20,1120,20,28,90928,28,1120,0,0,0,0,0
0.528,17,2,476,1,39,0,39,67,1,381,0,381,409
0.175,6,9,1339,5,145,43,145,349,4,826,37,826,990
1739.499,6,96,6962,62,31,28516,31,4209,34,31,52711,31,2753
1.54,6,30,10405,18,367,90,833,1825,12,1012,133,1420,8580
192.24,17,4,352,2,60,192239,60,176,2,60,192239,60,176
1797.093,17,448,39896,403,35,4470,288,25676,45,288,40022,288,14220
71.169,17,3,228,3,48,35584,48,228,0,0,0,0,0
1799.0,17,449,39928,404,35,4464,288,25708,45,288,40017,288,14220
76.094,6,6,348,2,0,76094,0,104,4,9,25308,9,244
10.002,6,17,2422,11,210,980,210,1024,6,545,2000,904,1398
193.437,6,66,12470,28,294,7164,1189,4666,38,313,5223,1917,7804
0.011,17,2,184,1,32,0,32,60,1,96,0,96,124
0.019,17,4,308,2,33,0,33,122,2,65,1,65,186
0.305,6,25,6116,12,181,27,537,1526,13,651,24,1448,4590
1625.17,6,85,6466,56,39,29548,205,3988,29,33,58032,98,2478
0.437,6,21,7203,13,318,36,600,1958,8,964,59,1471,5245
11.761,6,1882,1624985,1149,1362,10,1380,1589455,733,515,15,1923,35530
0.338,6,20,6387,12,281,30,517,1768,8,1048,47,3299,4619
0.313,17,2,154,1,33,0,33,61,1,65,0,65,93
1796.254,6,478,27464,269,69,6702,69,14900,209,34,8635,64,12564
1.034,17,4,963,2,33,1029,37,123,2,392,1021,463,840
1772.966,6,180,15480,120,69,14898,69,8940,60,69,30042,69,6540
0.006,17,2,180,1,30,0,30,58,1,94,0,94,122
300.17,6,40,10364,21,655,15000,1360,4802,19,399,16666,1360,5562
1740.391,17,30,6930,30,203,60013,203,6930,0,0,0,0,0
6.332,6,1460,1376202,944,1382,6,1408,1344706,516,931,11,2801,31496
1.0,6,11,1727,7,100,166,100,384,4,589,247,1152,1343
6.042,6,29,7114,16,282,402,613,2803,13,604,489,1448,4311
1782.719,6,356,22520,208,69,8612,69,12460,148,69,12127,69,10060
1782.682,6,354,22440,207,69,8653,69,12420,147,69,12209,69,10020
15.35,17,20,14037,12,960,1392,1350,11858,8,244,2188,1350,2179
28.582,17,4,352,2,60,28581,60,176,2,60,28581,60,176
1787.014,6,102,8296,68,65,26671,65,4930,34,59,54148,59,3366
226.97,6,29,8832,14,158,17459,267,1357,15,858,16209,2800,7475
2.286,6,15,2391,9,188,285,245,740,6,703,408,1152,1651
1247.031,6,154,11646,58,68,21351,309,5485,96,48,13126,78,6161
4.253,6,40,7325,21,218,212,314,3463,19,516,222,1179,3862
299.54,6,6,364,4,31,99846,31,222,2,31,299525,31,142
1744.43,6,95,7203,63,38,28135,205,4476,32,33,56266,98,2727
1756.922,6,4333,4052983,1550,150,1134,927,92952,2783,1408,631,4254,3960031
0.146,17,2,212,1,46,0,46,74,1,110,0,110,138
1759.691,6,78,3588,39,0,46307,0,2028,39,0,46307,0,1560
205.203,17,4,352,2,60,205202,60,176,2,60,205202,60,176
1795.833,17,447,39296,404,35,4456,288,25708,43,288,41924,288,13588
1793.9,17,140,11200,70,48,25998,48,5320,70,56,25998,56,5880
0.326,6,37,8301,20,350,17,1420,2554,17,506,19,1485,5747
22.43,17,2,677,1,300,0,300,328,1,321,0,321,349
98.758,6,828,408884,447,850,221,1152,388853,381,435,259,1179,20031
315.799,6,112,21859,51,333,6315,1360,10886,61,202,5232,1360,10973
1788.494,6,356,22520,208,69,8640,69,12460,148,69,12166,69,10060
0.222,6,9,1002,5,213,55,213,417,4,421,62,421,585
280.19,6,29,7392,13,158,23349,267,1317,16,603,18677,2236,6075
1755.967,1,102,5712,102,28,17385,28,5712,0,0,0,0,0
22.854,6,8,460,3,0,11427,0,160,5,0,2041,0,300
29.842,6,6,1257,4,327,9947,414,815,2,181,29663,270,442
1750.734,17,13,534,11,14,175054,14,462,2,8,1750552,8,72
315.962,6,99,21071,56,274,5744,1360,11140,43,303,7519,4649,9931
5.924,6,38,7245,20,218,311,314,3423,18,516,332,1179,3822
214.957,1,6,336,6,28,42991,28,336,0,0,0,0,0
1.97,6,4,224,1,0,0,0,40,3,64,933,64,184
0.351,6,3,160,2,0,351,0,100,1,0,0,0,60
0.569,6,50,21523,28,1015,21,1380,16401,22,421,24,1923,5122
280.337,6,27,7312,12,158,25485,267,1277,15,678,20022,2045,6035
62.213,6,21,2997,11,324,6221,585,1253,10,304,6887,580,1744
1792.423,6,137,15607,82,84,22128,516,6650,55,146,33191,1420,8957
12.09,6,2449,2309011,1536,1423,7,1448,2256847,913,776,13,1448,52164
1731.827,17,313,50921,313,134,5550,376,50921,0,0,0,0,0
170.656,17,4,352,2,60,170655,60,176,2,60,170655,60,176
1.528,2,3,96,3,8,764,8,96,0,0,0,0,0
1793.758,1,59,4956,59,56,30926,56,4956,0,0,0,0,0
1771.777,6,108,9856,68,65,26444,65,5758,40,59,45427,59,4098
1.258,6,50,18921,27,865,48,1360,13225,23,433,49,1360,5696
240.214,6,53,17439,28,770,8896,1402,14563,25,196,10008,580,2876
11.247,6,89,26197,45,550,255,1152,19955,44,447,255,1179,6242
1.941,17,6,912,3,60,959,60,264,3,188,960,188,648
1772.512,6,180,15480,120,69,14895,69,8940,60,69,30034,69,6540
1269.271,17,56,2352,56,14,23077,14,2352,0,0,0,0,0
240.142,6,39,5267,19,235,13340,752,2647,20,196,12638,535,2620
1787.906,6,365,25432,213,100,8433,469,14936,152,69,11840,69,10496
10.631,6,785,703342,511,1305,20,1368,684430,274,776,38,1473,18912
236.576,6,38,8775,19,410,13143,882,2034,19,426,472,1460,6741
3.746,6,13,2311,8,188,535,245,700,5,1407,874,1407,1611
64.203,17,6,360,3,32,32101,32,180,3,32,32101,32,180
1.542,6,25,8056,12,164,118,267,1288,13,869,107,1448,6768
280.236,6,29,7392,14,158,21556,267,1357,15,678,20015,3436,6035
1.013,17,2,685,1,308,0,308,336,1,321,0,321,349
16.785,6,25,13049,12,249,1525,431,1369,13,1220,1346,1408,11680
17.247,6,16,1327,8,222,2462,222,768,8,231,2462,231,559
116.893,6,29,13106,13,394,184,634,2173,16,934,7784,1360,10933
1771.077,6,99,9306,66,66,27247,66,5610,33,60,55343,60,3696
1.436,6,43,10691,23,513,65,1460,5070,20,400,65,1460,5621
0.931,6,5,248,3,0,465,0,144,2,0,453,0,104
1798.397,6,367,25112,214,93,8443,469,14645,153,69,11830,69,10467
0.608,6,3,355,2,211,574,211,315,1,0,0,0,40
1744.636,2,21,672,21,8,87231,8,672,0,0,0,0,0
4.758,6,40,7309,21,218,237,314,3463,19,513,250,1179,3846
1781.762,6,362,22967,210,69,8525,69,12678,152,69,11799,69,10289
227.255,17,4,352,2,60,227254,60,176,2,60,227254,60,176
16.653,17,22,13314,11,613,1658,1350,7053,11,541,1656,1350,6261
2.46,17,3,1173,3,363,1230,363,1173,0,0,0,0,0
61.779,6,37,15941,22,801,2941,1448,9163,15,665,4391,1448,6778
0.26,6,12,3705,6,171,51,171,491,6,964,51,1448,3214
281.182,6,33,7712,14,158,21629,267,1357,19,465,15614,1400,6355
1.613,17,2,146,1,37,0,37,65,1,53,0,53,81
0.658,6,11,976,5,283,109,283,551,6,105,91,105,425
1793.344,1,246,13776,246,28,7319,28,13776,0,0,0,0,0
2.956,17,20,14958,12,1016,267,1350,12539,8,274,416,1350,2419
7.557,6,999,860809,572,1419,12,1448,831673,427,776,17,1448,29136
1786.685,6,106,8388,68,64,26666,64,4896,38,58,48286,58,3492
25.054,6,195,89579,109,768,231,1152,82030,86,456,291,1179,7549
0.498,6,22,7342,12,335,44,668,1974,10,1210,54,1906,5368
2.015,6,40,8395,19,320,111,1162,2728,21,370,92,1360,5667
4.002,17,4,932,4,205,1334,205,932,0,0,0,0,0
1.408,6,37,8212,19,320,78,1162,2716,18,476,72,2715,5496
51.69,17,4,240,2,32,51689,32,120,2,32,51687,32,120
4.393,6,38,7229,19,218,244,314,3383,19,440,229,1152,3846
240.308,6,45,9130,23,524,10922,1418,5922,22,228,11442,684,3208
0.752,6,119,150584,70,260,10,517,5734,49,3162,14,16896,144850
19.342,17,41,23017,21,557,965,1350,12288,20,508,1016,1350,10729
1.172,6,28,8546,15,229,70,583,2007,13,1201,81,3151,6539
0.256,17,2,214,1,39,0,39,67,1,119,0,119,147
0.067,17,2,136,1,32,0,32,60,1,48,0,48,76
0.391,6,26,9026,13,263,32,691,1736,13,943,30,1448,7290
280.443,6,32,7512,13,158,23370,267,1317,19,543,15577,1380,6195
1787.905,6,360,22887,209,69,8595,69,12500,151,69,11919,69,10387
8.263,17,2,144,2,44,8263,44,144,0,0,0,0,0
295.267,1,4,326,4,53,98422,78,326,0,0,0,0,0
0.338,17,2,180,1,30,0,30,58,1,94,0,94,122
1750.195,6,80,5588,40,36,44875,36,2140,40,456,44875,456,3448
60.211,2,2,64,2,8,60211,8,64,0,0,0,0,0
1.204,6,4,220,2,0,1204,0,92,2,0,9,0,128
1796.439,6,205,25108,132,138,13713,981,14591,73,104,24948,549,10517
1.171,6,25,8056,12,164,90,267,1288,13,869,82,1440,6768
37.156,6,25,7097,12,155,3377,267,1266,13,589,3095,3426,5831
33.754,6,32,5144,15,154,2411,722,1858,17,299,2096,1408,3286
105.326,6,385,298856,225,1314,470,1368,277199,160,613,660,1368,21657
10.767,6,20,7026,11,275,1076,275,998,9,1414,755,1414,6028
1788.784,6,356,22589,207,69,8683,69,12420,149,69,12086,69,10169
297.471,1,4,224,4,28,99157,28,224,0,0,0,0,0
5.989,6,39,7285,21,218,299,314,3463,18,516,335,1179,3822
1773.419,6,180,15480,120,69,14902,69,8940,60,69,30052,69,6540
3.675,17,10,900,5,30,907,30,290,5,94,911,94,610
3.046,17,4,610,3,39,762,39,201,1,381,0,381,409
10.633,17,731,618678,514,1123,20,1350,592002,217,94,49,1350,26676
1742.133,6,91,6604,59,31,30036,31,3998,32,31,56197,31,2606
1785.795,6,104,8444,68,66,26653,66,4964,36,60,51020,60,3480
240.213,6,52,17967,28,798,8896,1402,15040,24,238,10443,580,2927
7.843,6,2,80,1,0,0,0,40,1,0,0,0,40
57.056,17,23,1748,23,48,2593,48,1748,0,0,0,0,0
0.315,6,9,1342,5,145,78,145,349,4,829,34,829,993
6.868,6,1107,951861,670,1374,10,1420,930160,437,467,15,1883,21701
0.011,17,2,263,1,36,0,36,64,1,171,0,171,199
8.277,6,26,8211,13,294,689,574,1567,13,662,689,1408,6644
1.755,6,13,2311,8,188,250,245,700,5,1407,373,1407,1611
31.627,6,9,396,2,0,0,0,88,7,0,5254,0,308
1383.692,2,15,480,15,8,98835,8,480,0,0,0,0,0
158.95,17,4,352,2,60,158948,60,176,2,60,158949,60,176
20.522,17,3,228,3,48,10261,48,228,0,0,0,0,0
2.782,6,2,88,2,0,0,0,88,0,0,0,0,0
1740.167,17,29,2407,29,55,62148,55,2407,0,0,0,0,0
0.309,17,2,152,1,48,0,48,76,1,48,0,48,76
1794.44,6,359,22709,209,69,8627,69,12569,150,69,12041,69,10140
4.522,6,38,7229,20,218,238,314,3423,18,513,250,1179,3806
0.807,6,10,1687,7,100,134,100,384,3,1179,271,1179,1303
1798.959,6,367,25650,214,99,8445,469,15045,153,69,11833,69,10605
0.027,17,2,322,1,36,0,36,64,1,230,0,230,258
406.116,6,132,28680,64,267,6446,1360,11866,68,380,6057,1360,16814
159.479,1,12,672,12,28,14498,28,672,0,0,0,0,0
0.2,6,51,24292,28,1124,7,1432,19139,23,420,8,1432,5153
280.465,6,30,7432,13,158,23372,267,1317,17,678,17525,2085,6115
1771.774,6,99,9116,66,63,27258,64,5515,33,57,55365,58,3601
1763.455,2,15,480,15,8,125961,8,480,0,0,0,0,0
1787.722,6,104,8308,68,64,26682,64,4896,36,58,51075,58,3412
1781.518,6,354,22440,207,69,8648,69,12420,147,69,12202,69,10020
243.884,17,5,1029,5,177,60971,371,1029,0,0,0,0,0
1799.167,17,762,45988,762,32,2364,37,45988,0,0,0,0,0
1153.123,1,225,18900,225,56,5147,56,18900,0,0,0,0,0
33.839,6,31,5092,15,154,2417,721,1857,16,342,2241,1368,3235
1799.679,17,494,93355,494,160,3650,352,93355,0,0,0,0,0
0.471,6,27,9169,13,268,39,710,1758,14,951,33,2598,7411
0.05,17,4,284,2,32,4,32,120,2,54,35,60,164
1772.007,6,180,15480,120,69,14890,69,8940,60,69,30032,69,6540
29.162,6,225,96041,120,754,245,1152,86336,105,423,277,1179,9705
378.481,6,18,1242,14,180,29113,180,916,4,110,20064,110,326
128.555,6,23,8428,7,154,21425,267,752,16,638,8567,1420,7676
1796.2,17,449,39928,404,35,4457,288,25708,45,288,40021,288,14220
1793.932,17,144,11520,72,48,25266,48,5472,72,56,25266,56,6048
1792.148,6,356,22520,208,69,8657,69,12460,148,69,12191,69,10060
3.152,6,33,6218,17,122,197,267,1669,16,780,198,1491,4549
0.464,6,13,1693,6,288,85,288,548,7,426,44,434,1145
1788.637,1,256,14336,256,28,7014,28,14336,0,0,0,0,0
58.997,17,3,1008,3,308,29498,308,1008,0,0,0,0,0
30.1,6,45,7525,21,218,1505,314,3463,24,516,1297,1179,4062
0.22,6,24,7176,13,155,18,267,1301,11,775,21,3445,5875
1741.342,6,87,6322,58,31,30549,31,3915,29,31,62189,31,2407
129.601,17,4,240,2,32,129600,32,120,2,32,129600,32,120
1786.579,6,104,8444,68,66,26665,66,4964,36,60,51042,60,3480
5.051,17,4,288,2,36,5019,36,128,2,52,5006,52,160
2.191,17,2,214,1,39,0,39,67,1,119,0,119,147
17.511,17,18,6693,9,432,2185,1350,4146,9,255,2184,1350,2547
1790.456,6,357,22767,206,69,8733,69,12380,151,69,11935,69,10387
20.129,6,22,5470,12,107,1829,159,1074,10,773,2235,1418,4396
1750.719,17,13,534,11,14,175053,14,462,2,8,1750533,8,72
8.998,17,20,17112,9,626,1124,1350,5893,11,991,645,1350,11219
0.12,17,2,196,1,62,0,62,90,1,78,0,78,106
0.236,6,46,21319,26,1088,9,1420,16298,20,467,12,1883,5021
1.56,6,29,10365,17,367,97,833,1785,12,1012,133,1420,8580
1799.443,17,449,39928,404,35,4465,288,25708,45,288,40018,288,14220
1780.468,6,118,13935,75,81,24060,500,5949,43,160,42390,1420,7986
1790.027,17,140,11200,70,48,25942,48,5320,70,56,25942,56,5880
1796.005,17,448,39896,403,35,4467,288,25676,45,288,40019,288,14220
11.844,6,25,8453,13,275,987,275,1078,12,983,853,1420,7375
0.261,6,26,8991,13,247,21,624,1672,13,1105,21,2816,7319
1680.927,17,12,498,11,14,168092,14,462,1,8,0,8,36
1.314,6,47,18164,26,882,52,1440,12548,21,433,55,1440,5616
253.129,17,4,558,2,36,253125,36,128,2,187,253125,187,430
31.704,6,7,420,1,0,0,0,60,6,0,6305,0,360
1771.256,6,103,9448,66,65,27250,65,5577,37,59,49198,59,3871
16.906,6,12,2199,4,275,5635,275,439,8,1420,2258,1420,1760
16.341,17,4,240,2,32,16341,32,120,2,32,16340,32,120
1.516,6,10,1687,7,100,252,100,384,3,1179,627,1179,1303
1756.063,6,105,6270,60,27,29762,27,3525,45,27,39908,27,2745
0.169,17,2,586,1,46,0,46,74,1,484,0,484,512
10.428,17,4,352,2,48,10421,48,152,2,72,10420,72,200
280.232,6,29,7392,13,158,23352,267,1317,16,603,18676,2036,6075
0.135,17,4,668,2,32,125,32,120,2,246,42,246,548
0.309,17,2,152,1,48,0,48,76,1,48,0,48,76
1.385,6,30,6427,15,164,98,267,1922,15,780,86,1460,4505
70.462,6,21,860,10,0,5671,0,408,11,0,7043,0,452
7.219,6,1351,1252574,862,1377,8,1408,1222482,489,931,14,2801,30092
190.514,17,3,521,3,145,95257,345,521,0,0,0,0,0
0.021,17,2,672,2,308,21,308,672,0,0,0,0,0
135.558,6,20,5919,10,784,15062,1360,3538,10,247,15037,272,2381
62.206,6,15,5777,6,407,12441,722,1134,9,1390,7748,2329,4643
615.923,6,141,24287,66,247,9475,1360,11788,75,182,8321,2720,12499
1797.846,17,449,39928,404,35,4461,288,25708,45,288,40018,288,14220
316.983,6,71,19497,35,384,9323,1360,9892,36,339,9052,1360,9605
1798.464,6,369,25799,215,99,8404,469,15085,154,69,11752,69,10714
0.037,6,12,3513,6,126,7,126,446,6,1373,7,1448,3067
1782.662,17,83,3480,82,14,22008,14,3444,1,8,0,8,36
169.364,17,4,352,2,60,169362,60,176,2,60,169363,60,176
280.503,6,30,7432,13,158,23375,267,1317,17,603,17528,2076,6115
1777.422,1,113,11978,113,78,15869,78,11978,0,0,0,0,0
3.923,17,2,216,1,49,0,49,77,1,111,0,111,139
1786.73,6,104,8444,68,66,26667,66,4964,36,60,51046,60,3480
7.98,17,8,544,4,32,2658,32,240,4,48,2656,48,304
0.02,6,19,9089,10,96,2,96,624,9,1332,2,1817,8465
1041.958,17,271,24168,235,35,4452,288,14948,36,228,27443,308,9220
1.274,6,39,9888,21,440,63,1360,4392,18,433,64,1360,5496
1798.445,17,432,36544,396,35,4553,288,25168,36,288,50306,288,11376
3.635,6,609,502985,358,1370,10,1420,488700,251,526,14,3303,14285
1780.175,1,62,5208,62,56,29183,56,5208,0,0,0,0,0
0.378,17,2,152,1,48,0,48,76,1,48,0,48,76
1795.361,17,316,53125,316,140,5699,376,53125,0,0,0,0,0
83.57,6,28,7890,8,154,11938,267,792,20,449,4387,1420,7098
11.538,6,12,1355,7,284,1923,517,940,5,147,2883,147,415
72.337,6,20,8154,11,511,84,1194,2005,9,1155,9020,3151,6149
1.684,6,14,2351,8,188,240,245,700,6,703,285,1152,1651
0.12,1,2,163,2,53,120,78,163,0,0,0,0,0
1789.927,6,357,22629,208,69,8646,69,12460,149,69,12093,69,10169
1733.197,1,8,448,8,28,247599,28,448,0,0,0,0,0
0.133,17,2,574,1,32,0,32,60,1,486,0,486,514
0.471,17,2,152,1,48,0,48,76,1,48,0,48,76
152.81,6,515,238795,260,845,590,1152,225099,255,436,600,1179,13696
1.453,6,47,18784,26,930,58,1460,13168,21,433,61,1460,5616
1.082,17,2,152,1,48,0,48,76,1,48,0,48,76
1789.955,6,373,26028,214,98,8403,469,15183,159,69,11328,69,10845
1774.847,1,44,3696,44,56,41275,56,3696,0,0,0,0,0
0.012,17,8,2446,8,277,1,316,2446,0,0,0,0,0
241.992,6,49,9329,26,524,9679,1418,6083,23,226,10999,618,3246
619.987,17,26,4495,26,144,24799,351,4495,0,0,0,0,0
240.976,6,60,19338,31,829,8032,1418,15742,29,206,8605,580,3596
79.655,17,4,240,2,32,79654,32,120,2,32,79654,32,120
0.127,17,2,672,2,308,127,308,672,0,0,0,0,0
0.001,17,3,1561,3,492,0,520,1561,0,0,0,0,0
1799.866,6,129,8109,72,44,25347,208,4620,57,31,32137,31,3489
1797.784,17,180,14040,180,50,10043,50,14040,0,0,0,0,0
6.263,1,8,448,8,28,894,28,448,0,0,0,0,0
153.757,6,46,9041,19,120,8542,267,2098,27,292,5913,1420,6943
1771.181,6,99,9240,66,65,27248,65,5577,33,59,55345,59,3663
219.352,6,38,9823,13,123,18278,267,1513,25,365,9139,1933,8310
0.459,6,21,7290,12,335,41,668,1974,9,968,56,1475,5316
0.321,6,21,7203,12,318,28,600,1906,9,964,39,1471,5297
1786.256,17,87,3648,86,14,21014,14,3612,1,8,0,8,36
172.431,17,4,240,2,32,172430,32,120,2,32,172430,32,120
71.614,17,2,2751,2,1347,71614,1348,2751,0,0,0,0,0
3.017,6,3,2313,3,719,1508,719,2313,0,0,0,0,0
0.316,17,2,144,1,36,0,36,64,1,52,0,52,80
1741.49,6,90,6571,61,31,29024,31,4164,29,31,62184,31,2407
280.749,6,32,7853,14,158,21596,267,1357,18,524,16513,1400,6496
2.45,6,12,5628,3,106,1225,106,234,9,718,281,1460,5394
1.365,6,24,8004,12,164,104,267,1288,12,1014,105,2736,6716
275.865,6,158,121322,98,1311,2843,1448,108699,60,633,2306,1448,12623
420.552,6,49,4306,29,73,15019,138,2264,20,69,22134,69,2042
0.424,6,26,8892,13,237,35,589,1634,13,939,33,1438,7258
1798.01,17,98,7840,49,48,37458,48,3724,49,56,37458,56,4116
1772.255,6,181,15589,120,69,14892,69,8940,61,69,29536,69,6649
0.453,6,22,7345,13,334,37,663,2021,9,1209,52,1946,5324
0.076,6,2,104,0,0,0,0,0,2,0,0,0,104
1.331,6,51,20415,28,904,49,1360,14719,23,476,51,2720,5696
424.613,2,4,128,4,8,141537,8,128,0,0,0,0,0
1797.4,6,355,22480,207,69,8725,69,12420,148,69,12226,69,10060
240.176,6,55,19594,30,831,8281,1408,16531,25,219,10007,580,3063
367.408,6,27,1767,18,177,21612,177,1181,9,110,9106,110,586
28.198,6,15,4560,4,272,1362,516,980,11,391,2784,1452,3580
1663.15,1,7,392,7,28,277191,28,392,0,0,0,0,0
11.807,6,1710,1620134,1128,1362,10,1368,1585194,582,776,19,1473,34940
1790.28,17,87,3648,86,14,21062,14,3612,1,8,0,8,36
401.365,17,5,380,5,48,100341,48,380,0,0,0,0,0
0.061,17,2,167,1,39,0,39,67,1,72,0,72,100
1791.439,6,344,21764,201,69,8957,69,12042,143,69,12615,69,9722
0.34,6,11,1709,7,551,56,947,1386,4,159,113,159,323
15.116,17,16,5043,7,360,2514,1350,2716,9,230,1885,1350,2327
1786.462,6,102,8364,68,66,26663,66,4964,34,60,54132,60,3400
1786.829,6,177,27982,105,272,17181,1294,18384,72,126,25164,362,9598
0.005,17,2,477,1,33,0,33,61,1,388,0,388,416
1664.719,17,146,13072,133,30,12611,37,7763,13,380,133752,463,5309
16.889,6,2342,2194659,1477,1406,11,1448,2145015,865,776,19,1448,49644
1772.142,6,180,15480,120,69,14891,69,8940,60,69,30034,69,6540
13.183,6,1901,1688768,1187,1368,11,1380,1654286,714,383,18,1380,34482
1749.225,6,99,7411,63,38,28213,205,4476,36,33,49970,98,2935
6.983,6,29,6175,15,338,498,1314,2294,14,368,527,1460,3881
0.538,17,2,384,1,39,0,39,67,1,289,0,289,317
1.36,6,41,8429,21,320,68,1162,2808,20,400,62,1460,5621
1.37,6,37,8214,19,321,76,1164,2718,18,476,69,2615,5496
31.619,6,7,336,1,0,0,0,48,6,0,6321,0,288
1794.998,17,449,39928,404,35,4454,288,25708,45,288,40017,288,14220
2.039,6,19,3781,10,234,226,564,1452,9,463,232,1343,2329
110.473,6,34,8308,18,367,521,786,1914,16,574,7354,4848,6394
84.26,6,34,7871,13,155,7021,267,1306,21,357,4212,3417,6565
1798.859,17,449,39928,404,35,4463,288,25708,45,288,40025,288,14220
135.269,6,28,12549,15,519,63,884,2721,13,1032,11260,1503,9828
41.72,6,27,7177,13,155,3476,267,1306,14,530,3208,2840,5871
1773.393,17,140,11200,70,48,25701,48,5320,70,56,25701,56,5880
0.01,17,2,426,1,46,0,46,74,1,324,0,324,352
151.588,6,25,9160,13,654,70,1360,3193,12,782,13764,1360,5967
165.205,6,30,7432,13,158,13767,267,1317,17,543,10319,1400,6115
15.682,17,25,14937,11,597,1564,1350,6878,14,547,1203,1350,8059
1797.357,1,270,15120,270,28,6681,28,15120,0,0,0,0,0
5.369,6,354,296557,158,985,34,1460,19159,196,1464,26,4380,277398
19.816,17,11,8969,11,787,1981,1451,8969,0,0,0,0,0
2.121,6,20,3833,11,234,212,564,1504,9,463,243,1343,2329
1799.526,17,450,39960,405,35,4454,288,25740,45,288,40021,288,14220
1769.095,6,27,4077,18,241,104064,241,2889,9,92,221113,92,1188
0.511,17,16,5232,7,316,85,1350,2414,9,285,53,1350,2818
0.165,6,9,902,5,201,41,201,405,4,333,36,333,497
1773.608,6,181,15589,120,69,14904,69,8940,61,69,29552,69,6649
0.39,6,7,295,4,0,130,0,164,3,7,94,7,131
10.799,6,20,4442,11,275,1079,275,998,9,768,749,1440,3444
1770.484,6,101,9344,66,65,27238,65,5577,35,59,52070,59,3767
1791.14,1,58,4872,58,56,31423,56,4872,0,0,0,0,0
2.907,6,25,8056,12,164,223,267,1288,13,869,199,1448,6768
1.426,6,50,21376,28,969,52,1460,15720,22,476,58,2615,5656
0.02,17,2,588,1,39,0,39,67,1,493,0,493,521
0.823,6,31,8259,16,411,54,888,1907,15,521,45,3488,6352
1799.598,1,57,4788,57,56,32135,56,4788,0,0,0,0,0
11.141,6,81,24765,41,560,278,1152,19008,40,461,278,1179,5757
11.55,6,1788,1585662,1121,1363,10,1380,1554740,667,421,17,1923,30922
0.461,6,13,1693,7,288,74,288,588,6,426,55,434,1105
1782.323,17,142,11360,71,48,25461,48,5396,71,56,25461,56,5964
1799.699,1,60,5040,60,56,30503,56,5040,0,0,0,0,0
0.02,17,4,420,2,33,0,33,122,2,121,0,145,298
0.013,17,2,180,1,30,0,30,58,1,94,0,94,122
269.278,17,4,304,2,48,269255,48,152,2,48,269261,48,152
1740.519,6,104,7550,66,31,26777,31,4503,38,31,47040,31,3047
0.098,17,6,393,6,37,19,220,393,0,0,0,0,0
0.141,6,12,3462,6,75,28,75,395,6,1373,28,1448,3067
1786.845,6,102,8296,68,65,26669,65,4930,34,59,54143,59,3366
11.483,6,27,11253,13,275,956,275,1078,14,1067,842,1380,10175
1726.496,17,12,498,11,14,172649,14,462,1,8,0,8,36
1786.117,17,142,11360,71,48,25515,48,5396,71,56,25515,56,5964
301.062,6,53,23303,29,1167,10752,1460,17541,24,399,388,1460,5762
0.821,17,2,134,2,39,821,39,134,0,0,0,0,0
4.881,17,4,288,2,36,4862,36,128,2,52,4857,52,160
13.574,6,9,873,4,302,4524,302,506,5,83,3390,83,367
128.414,6,6,339,2,0,3247,0,112,4,7,42749,7,227
45.764,17,47,19337,23,420,2078,1350,10313,24,348,1989,1350,9024
3.11,6,22,5675,12,158,282,370,1275,10,999,228,1731,4400
0.015,17,2,330,1,30,0,30,58,1,244,0,244,272
300.798,2,4,128,4,8,100266,8,128,0,0,0,0,0
4.813,6,35,6209,18,206,283,314,2784,17,548,282,1179,3425
83.804,1,8,448,8,28,11972,28,448,0,0,0,0,0
100.774,6,22,9783,12,410,49,922,1742,10,1271,11184,4416,8041
11.369,17,4,352,2,60,11368,60,176,2,60,11368,60,176
17.296,6,2826,2629969,1814,1371,9,1408,2572681,1012,931,16,2816,57288
364.382,6,18,1242,14,180,28029,180,916,4,110,20055,110,326
8.898,6,3,180,3,0,0,0,180,0,0,0,0,0
38.496,17,6,1236,3,48,19237,48,228,3,308,19235,308,1008
1799.82,1,55,4620,0,0,0,0,0,55,56,33330,56,4620
0.137,17,2,159,1,33,0,33,61,1,70,0,70,98
503.787,2,4,128,4,8,167929,8,128,0,0,0,0,0
210.463,17,4,352,2,60,210462,60,176,2,60,210461,60,176
13.977,6,24,6993,13,275,1164,275,1078,11,910,895,1440,5915
0.166,6,41,14651,22,877,7,1420,9670,19,420,8,1420,4981
1780.047,17,142,11360,71,48,25429,48,5396,71,56,25429,56,5964
1317.026,6,242,15614,137,69,9683,69,8309,105,69,12663,69,7305
1736.952,1,56,4704,56,56,31580,56,4704,0,0,0,0,0
41.477,6,36,5478,15,154,2962,722,1859,21,229,2065,1408,3619
2.17,6,11,1095,5,177,542,177,445,6,110,342,110,650
11.475,6,15,4893,8,290,1639,517,1005,7,1172,1835,1368,3888
0.01,17,2,366,1,36,0,36,64,1,274,0,274,302
936.884,6,11711,10347948,6037,409,155,426,354044,5674,1711,130,12672,9993904
1797.141,17,449,39928,404,35,4459,288,25708,45,288,40019,288,14220
1681.46,1,15,870,15,30,120104,30,870,0,0,0,0,0
2.549,17,2,685,1,308,0,308,336,1,321,0,321,349
21.227,6,11,5554,3,131,3,131,295,8,967,3032,967,5259
280.246,6,29,7392,13,158,23353,267,1317,16,603,18676,2036,6075
168.002,6,34,8031,9,141,4727,267,1215,25,290,6999,1460,6816
166.181,6,20,9856,11,380,71,832,1613,9,1574,20756,3928,8243
1674.823,17,16,4197,8,30,239258,37,471,8,437,239258,463,3726
0.117,17,6,6312,6,1024,23,1024,6312,0,0,0,0,0
0.207,17,3,1167,3,361,103,361,1167,0,0,0,0,0
1754.414,6,181,11154,91,48,19493,208,6624,90,31,19709,31,4530
5.419,6,39,7269,19,218,301,314,3383,20,513,269,1179,3886
38.874,17,22,1936,11,48,3886,48,836,11,72,3886,72,1100
114.069,17,26,6694,26,229,4562,422,6694,0,0,0,0,0
0.509,6,27,9155,13,282,42,769,1814,14,943,35,1368,7341
18.398,17,26,19486,14,819,1413,1350,11865,12,607,1669,1350,7621
1.067,17,3,1170,3,362,533,362,1170,0,0,0,0,0
1739.313,1,56,4704,56,56,31623,56,4704,0,0,0,0,0
0.43,17,2,184,1,32,0,32,60,1,96,0,96,124
141.898,6,22,8779,11,323,76,661,1442,11,983,14173,1360,7337
62.529,6,49,12812,24,833,561,1360,6886,25,307,2598,1360,5926
240.205,6,56,20296,30,842,8282,1418,17580,26,169,9607,580,2716
0.537,6,25,8367,12,264,48,677,1712,13,995,44,1408,6655
85.929,6,84,58852,53,1220,1652,1448,49128,31,675,2856,1448,9724
1.284,6,31,6467,15,164,91,267,1922,16,650,75,1452,4545
0.247,1,2,112,2,28,247,28,112,0,0,0,0,0
1794.239,17,144,11520,72,48,25270,48,5472,72,56,25270,56,6048
1796.196,17,448,39896,403,35,4468,288,25676,45,288,40020,288,14220
1797.352,6,1816,2193851,615,129,2927,347,40818,1201,1853,1497,5608,2153033
1794.135,17,80,3354,79,14,23001,14,3318,1,8,0,8,36
1787.689,6,106,8456,68,65,26681,65,4930,38,59,48313,59,3526
4.276,6,37,7189,19,218,237,314,3383,18,513,236,1179,3806
85.598,6,100,15600,53,304,1646,304,10728,47,83,1844,83,4872
1680.384,1,15,870,15,30,120027,30,870,0,0,0,0,0
1788.472,17,87,3648,86,14,21040,14,3612,1,8,0,8,36
4.657,6,39,7269,19,218,258,314,3383,20,440,231,1152,3886
63.049,6,10,648,10,31,7005,31,648,0,0,0,0,0
629.089,2,4,128,4,8,209696,8,128,0,0,0,0,0
9.363,6,1901,1773507,1220,1377,7,1408,1733431,681,931,13,2801,40076
1263.056,6,251,15974,145,69,8771,69,8767,106,69,12028,69,7207
1745.83,6,97,7307,63,38,28158,205,4476,34,33,52895,98,2831
1772.988,6,180,15480,120,69,14899,69,8940,60,69,30046,69,6540
17.302,6,2562,2428695,1630,1411,10,1448,2375567,932,776,18,1448,53128
1772.641,6,182,15698,120,69,14896,69,8940,62,69,29059,69,6758
1783.829,6,376,26286,215,98,8335,469,15292,161,69,11148,69,10994
0.949,6,10,1687,7,100,158,100,384,3,1179,341,1179,1303
15.266,6,6,288,1,0,0,0,48,5,0,3813,0,240
280.251,6,31,7472,14,158,21557,267,1357,17,543,17512,1400,6115
0.294,6,22,4442,11,165,29,456,1394,11,493,27,888,3048
280.294,6,29,7392,13,158,23357,267,1317,16,603,18680,1400,6075
10.79,6,18,5610,10,275,1198,275,958,8,1440,827,1440,4652
0.694,17,2,144,1,36,0,36,64,1,52,0,52,80
955.57,6,62,9747,39,109,18548,498,3526,23,252,43431,1420,6221
10.966,6,18,4226,10,275,1218,275,958,8,978,885,1420,3268
93.57,6,23,940,10,0,5465,0,404,13,0,7793,0,536
61.788,6,68,49015,45,1173,1404,1408,41086,23,960,2798,3847,7929
1.276,6,38,9127,20,399,67,1360,3631,18,476,64,2720,5496
1106.169,6,87,9672,52,79,21686,721,4698,35,125,32528,1448,4974
304.079,6,264,235430,171,525,1788,1408,12023,93,2455,713,25344,223407
240.349,6,44,8447,23,449,10924,1402,5700,21,205,12017,580,2747
0.186,17,2,152,1,48,0,48,76,1,48,0,48,76
442.508,6,11,872,9,92,55313,92,752,2,0,3354,0,120
1744.714,2,28,896,28,8,64619,8,896,0,0,0,0,0
371.003,6,25,1651,17,177,23187,177,1117,8,110,9204,110,534
1789.98,6,289,37018,121,140,14915,1360,17430,168,149,10717,3302,19588
1787.99,6,356,22520,208,69,8637,69,12460,148,69,12163,69,10060
35.081,6,30,7297,14,155,2698,267,1346,16,441,2338,1420,5951
0.309,17,7,1416,4,151,83,288,716,3,205,123,288,700
812.161,6,38,1748,19,0,45119,0,988,19,0,45119,0,760
3.298,17,5,340,5,40,824,40,340,0,0,0,0,0
1681.529,1,8,448,8,28,240218,28,448,0,0,0,0,0
1797.708,17,142,11360,71,48,25681,48,5396,71,56,25681,56,5964
0.195,6,11,1864,6,262,39,517,844,5,752,48,752,1020
28.368,6,47,13987,23,289,1289,721,3531,24,730,1187,2840,10456
0.088,17,4,288,2,36,57,36,128,2,52,57,52,160
1739.955,6,91,6530,58,31,30525,31,3915,33,31,54373,31,2615
0.066,17,4,336,2,45,0,45,146,2,67,0,73,190
1787.126,6,104,8376,68,65,26673,65,4930,36,59,51057,59,3446
629.5,2,6,192,6,8,125900,8,192,0,0,0,0,0
1.743,6,48,18849,27,865,67,1360,13233,21,433,71,1360,5616
1798.421,17,142,11360,71,48,25691,48,5396,71,56,25691,56,5964
0.013,17,4,248,2,34,10,34,124,2,34,11,34,124
282.264,6,73,10393,44,165,2441,519,3091,29,306,10078,1420,7302
27.932,6,21,5501,8,517,3990,517,945,13,1274,2311,1418,4556
629.73,2,6,192,6,8,125946,8,192,0,0,0,0,0
300.569,6,44,8947,22,315,14312,882,2221,22,364,418,1440,6726
1789.623,17,138,11040,69,48,26317,48,5244,69,56,26317,56,5796
1748.495,6,179,17406,94,66,18801,721,7564,85,157,20812,1414,9842
1564.214,2,13,416,13,8,130351,8,416,0,0,0,0,0
1680.773,17,13,534,11,14,168058,14,462,2,8,1680581,8,72
630.148,2,5,160,5,8,157537,8,160,0,0,0,0,0
299.56,6,6,364,4,31,99853,31,222,2,31,299528,31,142
1681.654,17,14,1036,7,30,280272,30,406,7,62,280272,62,630
100.54,17,3,4125,3,1347,50270,1347,4125,0,0,0,0,0
1120.004,17,164,12464,164,48,6871,48,12464,0,0,0,0,0
152.205,6,87,50643,50,1188,3106,1448,41885,37,567,1829,1448,8758
4.298,6,1171,1119678,436,338,9,341,28019,735,1439,5,2896,1091659
46.858,6,49,14267,25,911,596,1360,8381,24,327,2030,2667,5886
1786.855,6,105,8416,68,65,26669,65,4930,37,59,49632,59,3486
0.008,6,2,302,1,222,0,222,262,1,0,0,0,40
118.488,6,32,16856,17,426,43,956,2079,15,1287,8454,3957,14777
7.557,6,127,158856,85,145,89,230,4996,42,3888,184,14080,153860
121.228,1,4,224,4,28,40409,28,224,0,0,0,0,0
0.315,6,20,4960,10,137,35,267,1092,10,692,31,1467,3868
1790.499,6,375,28522,218,126,8251,469,17481,157,69,11475,69,11041
0.169,1,10,840,10,56,18,56,840,0,0,0,0,0
5.115,6,57,12572,31,383,170,706,3633,26,375,196,2720,8939
300.602,6,37,8526,19,315,16700,882,2053,18,441,498,1440,6473
183.016,17,4,240,2,32,183015,32,120,2,32,183015,32,120
2.186,6,30,10405,18,367,128,833,1825,12,1012,190,1420,8580
1747.083,6,97,7338,64,38,27731,205,4528,33,33,54590,98,2810
280.484,6,28,7352,13,158,23373,267,1317,15,678,20030,3456,6035
60.207,2,2,64,2,8,60207,8,64,0,0,0,0,0
132.544,17,2,148,2,46,132544,46,148,0,0,0,0,0
0.039,17,4,284,2,32,22,32,120,2,54,19,60,164
19.978,17,4,824,2,48,19974,48,152,2,308,19973,308,672
1120.945,17,10,2745,5,30,280235,30,290,5,463,280235,463,2455
1781.49,17,142,11360,71,48,25449,48,5396,71,56,25449,56,5964
57.135,17,4,352,2,60,57134,60,176,2,60,57133,60,176
51.518,1,12,852,9,28,6439,28,504,3,88,605,88,348
1774.931,6,180,15480,120,69,14915,69,8940,60,69,30078,69,6540
2.227,6,26,8636,13,164,171,267,1352,13,942,171,3819,7284
0.483,6,52,22910,29,1034,17,1380,17748,23,421,19,1923,5162
374.106,6,26,1703,17,177,23381,177,1117,9,110,8666,110,586
38.339,6,30,7487,18,124,2255,159,1716,12,734,3484,1675,5771
2.594,6,21,6349,10,262,283,517,1316,11,744,254,1418,5033
10.021,6,81,24765,41,560,250,1152,19008,40,461,250,1179,5757
20.487,17,4,3621,4,877,6829,1451,3621,0,0,0,0,0
1797.461,6,356,22520,208,69,8683,69,12460,148,69,12227,69,10060
0.063,17,4,284,2,32,52,32,120,2,54,12,60,164
300.693,6,36,8391,19,291,16705,786,1957,17,478,533,2720,6434
108.954,6,44,8833,20,180,5734,721,2253,24,467,4625,1440,6580
1739.194,6,92,6668,60,31,29477,31,4062,32,31,56102,31,2606
11.676,17,67,55792,27,432,449,1350,12431,40,1056,278,1350,43361
280.284,6,30,7432,13,158,23357,267,1317,17,543,17515,1300,6115
37.948,6,14,2185,8,324,5421,585,1073,6,396,7576,580,1112
1784.388,17,83,3480,82,14,22029,14,3444,1,8,0,8,36
241.357,6,44,5547,19,238,13408,616,2461,25,177,10056,580,3086
1773.4,6,180,15480,120,69,14902,69,8940,60,69,30050,69,6540
4.945,17,24,7200,9,276,618,1350,2738,15,269,235,1350,4462
377.568,2,4,128,4,8,125856,8,128,0,0,0,0,0
1760.288,6,82,4392,41,26,44005,26,2196,41,26,44005,26,2196
300.879,6,52,10630,26,433,12035,910,3322,26,329,604,2720,7308
224.341,6,46,6306,18,132,4436,722,2133,28,159,8301,1408,4173
11.484,6,27,11433,13,275,957,275,1078,14,1087,838,1440,10355
1777.82,17,74,3096,72,14,25039,14,3024,2,8,25027,8,72
0.136,17,2,672,2,308,136,308,672,0,0,0,0,0
240.115,6,39,4683,20,181,12637,517,2139,19,193,13339,851,2544
107.012,6,39421,40863796,13695,624,7,627,779925,25726,1506,4,7240,40083871
3.373,6,53,14047,27,551,129,1429,5020,26,419,120,1986,9027
1782.9,6,367,23236,212,69,8449,69,12896,155,69,11577,69,10340
7.437,1,3,279,3,65,3718,88,279,0,0,0,0,0
0.508,6,318,311635,210,201,2,230,12877,108,2791,3,19712,298758
1791.149,1,335,28140,335,56,5362,56,28140,0,0,0,0,0
0.296,6,22,7333,12,334,26,663,1969,10,806,32,1408,5364
47.681,6,28,7217,13,155,3973,267,1306,15,482,3405,1997,5911
1.784,6,67,46336,41,1165,44,1408,38282,26,836,64,1408,8054
71.732,6,21,9845,11,380,83,832,1613,10,1303,7956,2720,8232
32.432,6,25,6284,14,117,2494,159,1337,11,727,3242,1418,4947
629.832,2,5,160,5,8,157458,8,160,0,0,0,0,0
1740.065,6,93,6720,60,31,29492,31,4081,33,31,54376,31,2639
166.014,6,24,10054,12,532,60,1360,2642,12,1153,15080,2574,7412
34.103,6,40,7728,19,154,1894,722,2115,21,376,1695,1408,5613
103.996,6,30,8872,14,158,7999,267,1357,16,763,6930,2036,7515
1.638,6,24,8004,12,164,125,267,1288,12,1014,126,2331,6716
1786.44,17,87,3648,86,14,21016,14,3612,1,8,0,8,36
88.548,6,21,8523,11,549,89,1308,2119,10,1198,9818,3151,6404
0.046,17,2,452,2,198,46,348,452,0,0,0,0,0
1792.975,1,58,4872,58,56,31455,56,4872,0,0,0,0,0
80.357,6,44,10244,21,541,599,910,3087,23,389,3646,4848,7157
283.859,6,30,7501,12,158,25805,267,1277,18,500,16696,1400,6224
0.018,6,12,3631,6,99,2,99,419,6,964,3,1448,3212
15.936,6,28,4949,14,154,1225,722,1819,14,479,1209,1402,3130
7.108,17,44,12022,13,306,591,1350,4346,31,219,235,1350,7676
1799.14,1,57,4788,57,56,32127,56,4788,0,0,0,0,0
0.228,17,2,572,1,39,0,39,67,1,477,0,477,505
127.478,17,4,240,2,32,127477,32,120,2,32,127477,32,120
1.145,6,25,8068,13,164,81,267,1352,12,1014,89,2411,6716
8.395,6,14,2626,7,152,1399,267,742,7,400,1358,1179,1884
129.754,6,67,46215,44,1160,3017,1408,38285,23,960,2797,3847,7930
0.405,6,9,1340,5,145,101,145,349,4,827,62,827,991
154.322,6,13,532,4,0,4133,0,164,9,0,19288,0,368
282.412,6,29,7392,13,158,23534,267,1317,16,678,18825,4140,6075
3.01,6,15,1313,8,283,403,283,731,7,105,470,105,582
1782.565,6,140,8872,77,49,23454,208,5422,63,31,28745,31,3450
0.907,17,4,950,2,40,898,40,136,2,379,894,379,814
11.632,6,101,32334,53,580,223,1152,25916,48,449,241,1179,6418
1795.854,17,448,39612,404,35,4456,288,25708,44,288,40949,288,13904
0.728,17,5,352,3,36,339,36,192,2,52,696,52,160
61.326,6,37,15880,22,795,2920,1448,9102,15,665,4361,1448,6778
1799.491,1,14,784,14,28,138422,28,784,0,0,0,0,0
300.638,6,43,8847,22,315,14316,882,2209,21,413,463,1440,6638
127.313,6,17,3360,6,92,25462,92,400,11,264,12705,1448,2960
1781.237,6,106,8456,68,65,26585,65,4930,38,59,48138,59,3526
280.268,6,29,7392,13,158,23355,267,1317,16,603,18679,1400,6075
20.74,6,26,8120,10,134,2304,267,947,16,593,1370,1420,7173
1770.364,6,103,9514,66,66,27236,66,5610,37,60,49174,60,3904
240.315,6,46,9269,24,524,10448,1418,5974,22,238,11443,618,3295
38.175,17,4,352,2,60,38174,60,176,2,60,38174,60,176
4.942,6,38,7229,20,218,260,314,3423,18,513,273,1179,3806
0.055,17,5,1757,5,323,13,354,1757,0,0,0,0,0
280.486,6,31,7472,13,158,23373,267,1317,18,543,16492,1380,6155
508.0,6,62,4433,23,59,21727,295,1982,39,46,13368,78,2451
1.693,6,25,8761,15,284,120,586,1458,10,985,168,1420,7303
1686.842,1,8,448,8,28,240977,28,448,0,0,0,0,0
0.872,1,10,840,10,56,96,56,840,0,0,0,0,0
125.531,6,10,3135,4,92,41843,92,296,6,630,25066,2118,2839
29.135,6,20,3130,12,183,2648,517,1561,8,381,4160,499,1569
88.18,6,759,383790,424,848,208,1152,365599,335,435,263,1179,18191
0.82,6,21,5983,12,279,74,539,1323,9,716,92,1420,4660
1410.646,6,308,54942,197,304,7197,304,40644,111,83,12812,83,14298
1.41,6,2,80,1,0,0,0,40,1,0,0,0,40
966.984,6,105,8961,68,71,14432,138,5135,37,69,26860,69,3826
247.214,6,74,18706,35,337,33,1460,9534,39,361,6501,3089,9172
0.028,17,2,399,1,39,0,39,67,1,304,0,304,332
95.674,6,68,47377,44,1196,2224,1408,39395,24,960,2687,3847,7982
0.045,6,14,4020,7,88,7,88,388,7,1113,7,1460,3632
462.803,17,114,10265,50,101,9353,1350,6499,64,30,7346,60,3766
5.917,17,35,17799,17,773,369,1350,13629,18,203,189,1350,4170
280.215,6,30,7432,14,158,21555,267,1357,16,603,18678,2800,6075
0.009,17,2,547,1,40,0,40,68,1,451,0,451,479
1082.867,2,11,352,11,8,108286,8,352,0,0,0,0,0
0.07,6,10,767,5,186,15,186,454,5,45,16,45,313
24.159,17,4,352,2,60,24158,60,176,2,60,24158,60,176
302.166,6,50,17750,23,960,13734,1372,9873,27,430,4450,1408,7877
17.207,17,35,13943,18,572,1010,1350,10816,17,155,1073,1350,3127
283.477,6,32,7788,12,158,25468,267,1277,20,439,14919,1400,6511
7.283,17,6,528,3,48,3576,48,228,3,72,3582,72,300
1700.496,17,12,498,11,14,170049,14,462,1,8,0,8,36
1740.374,6,88,6417,58,31,30532,31,3927,30,31,60011,31,2490
280.03,6,29,7392,14,158,21540,267,1357,15,678,19999,3436,6035
134.439,17,6,2152,6,330,26887,382,2152,0,0,0,0,0
10.869,6,84,23194,43,506,258,1152,17429,41,457,265,1179,5765
20.178,6,24,5845,13,107,1681,159,1138,11,687,2014,1408,4707
1780.818,17,122,9760,61,48,29680,48,4636,61,56,29680,56,5124
0.062,17,2,176,1,60,0,60,88,1,60,0,60,88
404.215,1,18,1008,18,28,23777,28,1008,0,0,0,0,0
240.181,6,54,17609,28,780,8895,1402,14741,26,167,9607,580,2868
1773.411,1,59,4956,0,0,0,0,0,59,56,30576,56,4956
2.572,6,53,19726,27,914,98,1440,13910,26,433,94,1440,5816
0.398,6,12,1653,6,288,79,288,548,6,426,47,434,1105
179.527,6,45,11629,17,123,6657,267,1673,28,367,6648,1420,9956
240.894,6,369,382379,140,455,1733,1402,10929,229,1656,1056,8412,371450
1694.511,17,134,10720,67,48,25674,48,5092,67,56,25674,56,5628
1789.954,6,388,27373,220,101,8173,469,16237,168,69,10718,69,11136
70.737,6,16,1183,8,177,10105,177,649,8,110,9411,110,534
3.586,17,2,656,2,300,3586,300,656,0,0,0,0,0
131.36,6,22,8126,12,201,52,290,1115,10,1099,14580,4428,7011
11.827,6,1906,1628651,1150,1363,10,1380,1594124,756,426,15,3303,34527
550.832,1,6,755,6,97,110166,117,755,0,0,0,0,0
1779.593,1,72,6048,0,0,0,0,0,72,56,25064,56,6048
0.279,6,26,6150,13,181,23,537,1578,13,555,22,1542,4572
1746.818,6,95,7203,63,38,28174,205,4476,32,33,56340,98,2727
4.256,6,38,7229,19,218,236,314,3383,19,513,222,1179,3846
280.216,6,30,7432,15,158,20015,267,1397,15,678,20012,3436,6035
1676.518,1,7,392,7,28,279419,28,392,0,0,0,0,0
1.285,6,25,8044,13,164,107,267,1328,12,869,82,1408,6716
321.53,17,8,480,4,32,107176,32,240,4,32,107176,32,240
2.868,6,2,88,2,0,0,0,88,0,0,0,0,0
9.143,6,7,581,7,31,1523,31,581,0,0,0,0,0
0.196,6,26,7256,13,155,16,267,1301,13,678,15,2045,5955
1750.854,17,13,534,11,14,175066,14,462,2,8,1750669,8,72
186.151,6,38,8425,12,141,3140,267,1335,26,287,7445,3386,7090
1784.577,6,105,8475,68,65,26635,65,4930,37,59,49569,59,3545
40.809,17,3,228,3,48,20404,48,228,0,0,0,0,0
0.035,6,13,3980,7,88,5,88,388,6,1670,7,1880,3592
300.606,6,48,8909,24,286,13069,766,2196,24,441,654,1460,6713
429.674,6,53,6816,28,304,15913,304,4496,25,83,17899,83,2320
119.785,6,75,17251,36,419,735,944,4190,39,459,3148,1360,13061
29.307,1,4,224,4,28,9769,28,224,0,0,0,0,0
0.072,17,3,208,2,36,32,36,128,1,52,0,52,80
1793.69,17,140,11200,70,48,25995,48,5320,70,56,25995,56,5880
373.05,6,112,13021,51,102,7461,267,4304,61,250,6209,1460,8717
232.889,6,2341,1196389,1307,845,178,1152,1142672,1034,374,225,1179,53717
169.001,17,2,672,2,308,169001,308,672,0,0,0,0,0
114.468,6,121,91395,77,1258,1506,1408,79580,44,865,1796,4224,11815
0.019,17,4,780,2,32,0,32,120,2,302,0,308,660
0.295,6,25,8961,13,257,24,669,1714,12,1102,26,2804,7247
366.803,6,16,2020,10,103,28457,138,1435,6,69,2474,69,585
1773.349,6,180,15480,120,69,14902,69,8940,60,69,30053,69,6540
0.013,17,4,368,2,32,11,32,120,2,96,12,96,248
124.43,6,35,7975,13,155,10369,267,1306,22,340,5924,3417,6669
0.108,17,4,284,2,32,1,32,120,2,54,0,60,164
0.035,17,2,144,1,36,0,36,64,1,52,0,52,80
280.058,6,30,7432,14,158,21542,267,1357,16,678,18666,3456,6075
1776.336,17,73,3060,72,14,25018,14,3024,1,8,0,8,36
3.76,17,5,290,5,30,940,30,290,0,0,0,0,0
5.077,6,28,14128,15,831,355,1307,4801,13,977,407,1360,9327
241.71,6,6,316,3,0,120855,0,152,3,0,120847,0,164
1.42,6,49,17401,28,813,52,1360,11740,21,437,61,2720,5661
18.016,17,4,352,2,60,18015,60,176,2,60,18015,60,176
1772.512,6,203,22359,130,75,13740,267,10057,73,135,24612,2006,12302
21.932,2,2,64,2,8,21932,8,64,0,0,0,0,0
1707.4,1,8,448,8,28,243914,28,448,0,0,0,0,0
4.034,6,2,88,2,0,0,0,88,0,0,0,0,0
1741.399,17,30,7050,30,207,60048,207,7050,0,0,0,0,0
1773.201,6,181,15589,120,69,14900,69,8940,61,69,29547,69,6649
300.927,6,48,17146,26,943,12037,1360,11464,22,399,416,1360,5682
1765.056,2,14,448,14,8,135773,8,448,0,0,0,0,0
35.857,17,44,6468,22,48,1704,48,1672,22,190,1703,308,4796
20.111,17,21,12472,9,612,2512,1350,5766,12,530,1824,1350,6706
0.547,6,20,7151,12,318,49,600,1906,8,1205,77,1891,5245
81.107,1,20,1120,20,28,4268,28,1120,0,0,0,0,0
1096.967,17,216,16416,216,48,5102,48,16416,0,0,0,0,0
1.955,6,19,3781,10,234,217,564,1452,9,463,221,1343,2329
0.676,6,37,8313,20,353,35,1432,2570,17,505,38,1473,5743
1.826,17,20,6005,8,280,260,1350,2469,12,266,120,1350,3536
47.154,6,42,10204,20,706,646,1360,4398,22,327,2237,2667,5806
1739.113,1,56,4704,0,0,0,0,0,56,56,31620,56,4704
60.185,6,7,526,4,214,19981,214,394,3,0,30022,0,132
158.937,6,23,8118,11,525,91,1236,2047,12,797,14433,1440,6071
0.116,17,2,2384,2,1164,116,1164,2384,0,0,0,0,0
11.675,6,1716,1597853,1127,1366,10,1432,1570002,589,427,19,1432,27851
0.435,1,5,2880,5,548,108,548,2880,0,0,0,0,0
72.132,6,42,8884,20,401,1327,889,2096,22,368,3428,3488,6788
1776.294,17,138,11040,69,48,26121,48,5244,69,56,26121,56,5796
1.006,6,11,1727,7,100,167,100,384,4,589,243,1152,1343
9.123,6,1441,1250507,869,1386,10,1420,1223394,572,467,15,1883,27113
2.486,17,4,1556,4,361,828,361,1556,0,0,0,0,0
286.087,6,37,7781,15,158,20434,267,1397,22,500,13621,1400,6384
0.738,6,23,9488,12,498,67,1183,2030,11,875,56,1905,7458
0.44,6,5,272,2,0,440,0,104,3,0,119,0,168
179.516,6,30,9133,14,175,13808,267,1618,16,858,11962,2085,7515
1775.072,1,59,4956,59,56,30604,56,4956,0,0,0,0,0
2.438,17,2,204,1,34,0,34,62,1,114,0,114,142
1786.733,6,255,36114,104,179,17345,1360,20022,151,137,11910,3298,16092
1798.119,17,140,11200,70,48,26059,48,5320,70,56,26059,56,5880
22.901,6,35,8177,16,188,1526,721,1964,19,544,1262,1414,6213
60.989,17,2,672,2,308,60989,308,672,0,0,0,0,0
240.564,6,48,6391,22,209,11455,585,3050,26,180,9622,580,3341
0.025,6,12,4936,6,99,3,99,419,6,1049,4,1448,4517
263.146,17,5,1912,5,354,65786,548,1912,0,0,0,0,0
180.037,6,12,903,11,31,18003,31,820,1,31,0,31,83
0.268,17,2,384,1,39,0,39,67,1,289,0,289,317
1785.86,6,454,26647,241,69,7441,69,13987,213,34,8423,64,12660
1787.294,6,104,8376,68,65,26676,65,4930,36,59,51061,59,3446
299.522,6,7,404,4,31,99840,31,222,3,31,149757,31,182
14.788,6,13,2145,8,326,2112,589,1077,5,396,227,580,1068
1775.252,17,142,11360,71,48,25360,48,5396,71,56,25360,56,5964
1633.263,1,7,392,7,28,272210,28,392,0,0,0,0,0
282.695,6,34,7677,16,158,18846,267,1437,18,501,16628,1400,6240
30.179,6,11,600,6,0,6035,0,340,5,0,3745,0,260
1783.81,6,428,25778,214,69,8374,69,12838,214,35,8374,69,12940
0.007,6,2,463,1,0,0,0,40,1,371,0,371,423
107.11,6,33,5306,16,144,7140,722,1986,17,304,6683,1448,3320
0.403,6,21,7290,12,335,35,668,1974,9,968,49,1475,5316
4.92,6,40,7309,19,218,273,314,3383,21,440,232,1152,3926
1.396,6,44,16593,25,835,58,1360,11057,19,433,67,1360,5536
0.29,6,21,5000,10,137,32,267,1092,11,692,28,1467,3908
1792.748,17,66,2766,65,14,28011,14,2730,1,8,0,8,36
1.334,6,46,18124,26,882,53,1360,12548,20,529,59,4075,5576
0.229,17,2,2380,2,1162,229,1162,2380,0,0,0,0,0
840.68,17,8,2196,4,30,280222,30,232,4,463,280223,463,1964
0.033,17,2,208,1,35,0,35,63,1,117,0,117,145
0.012,17,2,433,1,34,0,34,62,1,343,0,343,371
1750.36,6,112,8359,70,38,25367,205,4902,42,32,42680,98,3457
3.977,6,36,6383,18,161,233,267,1699,18,564,205,1420,4684
629.998,2,4,128,4,8,209999,8,128,0,0,0,0,0
300.803,6,39,9967,22,593,14323,1360,4485,17,435,538,2667,5482
1771.234,6,99,9174,66,64,27249,64,5544,33,58,55347,58,3630
0.053,6,12,3704,6,171,10,171,491,6,964,8,1448,3213
1143.008,2,8,256,8,8,163286,8,256,0,0,0,0,0
1782.611,17,140,11200,70,48,25834,48,5320,70,56,25834,56,5880
689.232,1,16,896,16,28,45948,28,896,0,0,0,0,0
93.473,6,34,7777,15,141,6676,267,1455,19,370,5185,1460,6322
0.411,6,27,8965,13,242,34,610,1655,14,939,30,1408,7310
0.33,6,9,526,5,42,82,42,310,4,0,109,0,216
240.276,6,55,19777,30,846,8284,1418,16804,25,208,10010,580,2973
171.937,1,4,224,4,28,57312,28,224,0,0,0,0,0
25.945,6,3049,2639041,1765,1404,14,1448,2558785,1284,776,20,1448,80256
0.274,6,26,9034,13,257,22,667,1715,13,1105,22,2816,7319
0.111,17,2,329,1,45,0,45,73,1,228,0,228,256
1773.848,6,172,14815,114,69,15697,69,8493,58,69,31119,69,6322
2.397,6,2,1500,1,0,0,0,40,1,1420,0,1420,1460
0.419,6,6,328,4,0,139,0,216,2,0,400,0,112
280.584,6,28,7352,12,158,25507,267,1277,16,603,18700,1400,6075
0.197,6,41,16800,23,992,8,1420,11859,18,420,10,1420,4941
14.335,6,16,3262,9,210,1791,210,908,7,664,2388,904,2354
2.324,6,14,2351,8,188,332,245,700,6,703,412,1152,1651
7.3,6,6,280,2,0,7300,0,88,4,0,2383,0,192
21.096,6,31,5253,12,170,1917,722,1644,19,218,1161,1440,3609
15.48,6,10,2929,4,92,5160,92,296,6,579,2992,1408,2633
0.66,6,27,8920,13,227,55,547,1592,14,941,50,1408,7328
3.873,6,13,3085,7,92,645,92,452,6,579,50,1408,2633
4.171,6,24,6512,11,262,412,517,1368,13,744,343,1418,5144
1794.986,6,356,22520,208,69,8671,69,12460,148,69,12210,69,10060
364.54,6,19,1306,14,180,28041,180,928,5,110,15160,110,378
22.463,6,24,3739,12,149,2042,293,1527,12,432,2019,1179,2212
0.833,17,29,18280,14,578,64,1350,8496,15,624,45,1350,9784
125.213,6,32,6614,12,181,450,293,1393,20,367,6577,1152,5221
503.987,2,5,160,5,8,125996,8,160,0,0,0,0,0
15.858,17,27,13846,13,412,1318,1350,5727,14,551,1219,1350,8119
0.19,6,26,7256,13,155,15,267,1301,13,603,15,2036,5955
1.903,6,25,5795,14,158,145,370,1355,11,999,189,1737,4440
3.245,17,2,154,1,33,0,33,61,1,65,0,65,93
474.721,17,15,5057,15,309,33908,322,5057,0,0,0,0,0
1798.423,2,24,768,24,8,78192,8,768,0,0,0,0,0
96.311,6,35,16496,13,249,94,431,1433,22,732,4578,1408,15063
1.357,6,45,15520,24,810,59,1360,9904,21,433,58,1360,5616
0.5,6,23,7409,13,334,41,663,2033,10,967,51,1471,5376
1776.817,17,142,11360,71,48,25382,48,5396,71,56,25382,56,5964
240.194,6,52,17670,28,784,8895,1418,14796,24,202,10442,580,2874
1.426,6,23,7952,12,164,111,267,1288,11,1216,122,3859,6664
0.945,6,3,156,2,0,945,0,92,1,0,0,0,64
110.973,17,4,304,2,48,110956,48,152,2,48,110957,48,152
0.598,17,4,368,2,64,597,64,184,2,64,597,64,184
31.794,6,7,396,1,0,0,0,60,6,0,6322,0,336
0.405,17,8,2758,8,316,57,355,2758,0,0,0,0,0
2.394,17,33,7369,14,217,181,1350,3432,19,179,131,1350,3937
1771.125,1,58,4872,58,56,31072,56,4872,0,0,0,0,0
1772.794,6,183,15807,120,69,14897,69,8940,63,69,28591,69,6867
24.387,6,27,7602,13,275,2032,275,1078,14,992,1860,1440,6524
280.48,6,30,7432,13,158,23373,267,1317,17,603,17523,2076,6115
1783.824,6,228,18938,184,84,9747,498,10586,44,156,41481,1420,8352
54.969,6,37,8400,18,378,510,786,1886,19,441,3046,1360,6514
31.7,1,4,224,4,28,10566,28,224,0,0,0,0,0
1787.093,6,108,8664,69,66,26280,66,5004,39,60,47025,60,3660
35.564,6,9,540,0,0,0,0,0,9,0,0,0,540
0.079,6,9,1002,5,213,19,213,417,4,421,23,421,585
1791.319,6,359,22709,209,69,8612,69,12569,150,69,12021,69,10140
1783.202,17,83,3480,82,14,22014,14,3444,1,8,0,8,36
374.982,6,25,1651,17,177,23436,177,1117,8,110,9248,110,534
1773.149,6,180,15480,120,69,14900,69,8940,60,69,30046,69,6540
25.686,6,13,4504,4,92,8562,92,296,9,746,3181,1408,4208
299.739,6,68,8195,31,192,9991,585,3987,37,133,8325,580,4208
1.457,6,52,23539,29,1040,52,1460,17843,23,433,57,1460,5696
5.374,6,46,8449,23,227,244,314,4102,23,489,232,1179,4347
1746.306,1,78,6552,78,56,22679,56,6552,0,0,0,0,0
1794.494,6,359,22709,209,69,8627,69,12569,150,69,12042,69,10140
0.596,6,21,6103,12,317,54,594,1900,9,931,70,1946,4203
0.005,17,2,410,1,30,0,30,58,1,324,0,324,352
97.915,6,715,329369,368,829,266,1152,309984,347,423,282,1179,19385
1.611,6,40,8427,21,321,80,1164,2846,19,437,77,2715,5581
11.168,6,2097,1978960,1361,1377,8,1408,1936024,736,931,14,2816,42936
0.566,6,120,88506,53,131,10,232,2649,67,1341,8,1420,85857
1.431,6,24,8004,12,164,111,267,1288,12,1014,110,2736,6716
0.331,6,20,4960,10,137,36,267,1092,10,692,35,1467,3868
1786.08,6,3204,3056618,1126,127,1587,336,68895,2078,1437,859,4206,2987723
0.052,17,4,336,2,34,0,34,124,2,78,2,84,212
8.512,6,1909,1753473,1201,1381,6,1408,1711993,708,931,11,2801,41480
280.284,6,30,7432,13,158,23357,267,1317,17,543,17512,1400,6115
69.918,6,41,10404,19,239,198,532,2445,22,400,3325,1408,7959
1795.887,17,142,11360,71,48,25655,48,5396,71,56,25655,56,5964
173.586,6,37,24926,19,884,36,1360,6109,18,1644,10202,4080,18817
109.748,6,23,11278,12,433,77,990,1823,11,1286,10960,3928,9455
223.923,6,27,7312,12,158,20356,267,1277,15,678,15992,2045,6035
125.637,17,4,352,2,60,125636,60,176,2,60,125636,60,176
300.367,6,106,85596,66,145,4620,230,4208,40,2143,7701,9856,81388
0.39,17,2,2386,2,1165,390,1165,2386,0,0,0,0,0
0.894,6,15,4226,8,171,127,171,937,7,1446,140,2675,3289
3.571,6,2,88,2,0,0,0,88,0,0,0,0,0
1.346,6,37,8214,19,321,74,1164,2718,18,433,69,1360,5496
0.175,6,3,213,2,46,0,62,173,1,0,0,0,40
356.121,6,24,2406,17,416,22257,416,1332,7,351,10094,697,1074
56.095,17,3,126,3,14,28047,14,126,0,0,0,0,0
1.507,17,6,552,3,32,613,32,180,3,96,569,96,372
280.79,6,31,7472,14,158,21599,267,1357,17,543,17544,1400,6115
1663.881,1,7,392,7,28,277313,28,392,0,0,0,0,0
2.247,6,13,1096,7,283,344,283,663,6,105,412,105,433
0.294,17,2,167,1,39,0,39,67,1,72,0,72,100
15.598,6,19,8472,7,106,2599,106,394,12,759,1417,3417,8078
1772.555,1,67,5628,67,56,26856,56,5628,0,0,0,0,0
16.495,6,18,3378,10,210,1832,210,972,8,664,2356,904,2406
1.085,6,23,7952,12,164,83,267,1288,11,1216,92,2816,6664
137.462,17,4,352,2,60,137461,60,176,2,60,137461,60,176
5.01,17,4,288,2,36,5009,36,128,2,52,5008,52,160
11.455,6,14,2242,8,210,1633,210,844,6,545,2285,904,1398
130.659,1,3,348,3,88,65329,88,348,0,0,0,0,0
0.018,17,2,425,1,48,0,48,76,1,321,0,321,349
192.296,17,4,240,2,32,192295,32,120,2,32,192295,32,120
1779.503,17,140,11200,70,48,25789,48,5320,70,56,25789,56,5880
0.481,17,4,284,2,32,243,32,120,2,54,239,60,164
0.14,1,2,112,2,28,140,28,112,0,0,0,0,0
1.722,6,50,20572,26,943,68,1460,13376,24,518,66,1460,7196
8.994,6,4,240,4,0,0,0,240,0,0,0,0,0
175.138,17,4,352,2,60,175136,60,176,2,60,175137,60,176
0.055,17,2,198,1,37,0,37,65,1,105,0,105,133
1777.768,1,58,4872,58,56,31188,56,4872,0,0,0,0,0
122.875,6,52,11626,20,290,6467,469,4000,32,234,3958,1460,7626
0.023,6,2,1494,1,0,0,0,40,1,1414,0,1414,1454
176.731,17,4,240,2,32,176730,32,120,2,32,176730,32,120
1.313,6,52,19240,29,877,46,1360,13499,23,437,51,2715,5741
1797.143,17,449,39928,404,35,4459,288,25708,45,288,40014,288,14220
9.708,6,16,3911,9,275,1213,275,643,7,992,789,1440,3268
0.529,6,24,7489,14,274,40,668,2109,10,1210,54,1946,5380
54.589,6,41,10699,20,819,823,1360,4964,21,348,2721,2667,5735
1798.479,17,87,3648,86,14,21158,14,3612,1,8,0,8,36
0.138,17,2,237,1,72,0,72,100,1,109,0,109,137
282.82,6,35,8577,16,158,18854,267,1437,19,579,15705,1300,7140
1783.814,6,356,22520,208,69,8617,69,12460,148,69,12134,69,10060
2.774,17,8,1036,4,31,920,31,236,4,172,921,196,800
158.386,6,145,115949,94,1317,1703,1448,103724,51,683,2165,2359,12225
7.371,6,1342,1301656,899,1375,8,1408,1273956,443,776,16,1408,27700
1785.995,6,364,25392,212,100,8464,469,14896,152,69,11827,69,10496
0.254,17,2,241,1,36,0,36,64,1,149,0,149,177
20.204,6,17,2316,10,189,2244,517,1298,7,323,3358,499,1018
0.006,17,2,403,1,65,0,65,93,1,282,0,282,310
284.515,1,9,504,9,28,35564,28,504,0,0,0,0,0
1.378,6,48,19731,27,928,53,1360,14115,21,433,58,1360,5616
13.734,17,36,8585,17,271,856,1350,5084,19,156,761,1350,3501
1797.752,6,373,26028,216,98,8361,469,15263,157,69,11523,69,10765
1793.861,17,136,10864,70,48,25997,48,5320,66,56,27597,56,5544
3.513,17,5,290,5,30,878,30,290,0,0,0,0,0
1792.293,6,125,12455,77,62,23582,721,6433,48,94,38129,1448,6022
1786.322,6,356,22520,208,69,8629,69,12460,148,69,12149,69,10060
5.965,17,3,1008,3,308,2982,308,1008,0,0,0,0,0
23.828,17,27,5916,12,251,2163,1350,3348,15,143,1699,1350,2568
376.661,17,5,659,5,103,94165,335,659,0,0,0,0,0
1793.46,17,180,11520,180,36,10019,36,11520,0,0,0,0,0
0.109,6,13,1997,7,329,18,500,1030,6,323,21,500,967
0.555,6,11,819,6,186,93,186,506,5,45,91,45,313
0.046,6,2,133,1,0,0,0,40,1,53,0,53,93
0.039,17,2,180,1,30,0,30,58,1,94,0,94,122
1788.687,17,87,3648,86,14,21043,14,3612,1,8,0,8,36
300.588,6,18,1227,5,177,75100,177,445,13,110,25034,110,782
0.038,6,2,100,1,0,0,0,60,1,0,0,0,40
7.952,6,18,6871,9,275,994,275,643,9,1171,645,1440,6228
0.609,6,23,7406,13,335,50,668,2038,10,968,64,1475,5368
5.084,6,42,8289,21,227,254,314,4022,21,489,240,1179,4267
4.124,17,5,340,5,40,1031,40,340,0,0,0,0,0
280.202,6,29,7392,13,158,23350,267,1317,16,603,18677,2800,6075
0.075,6,10,1495,5,507,18,507,727,5,556,18,556,768
0.002,17,2,158,1,43,0,43,71,1,59,0,59,87
360.967,2,4,128,4,8,120322,8,128,0,0,0,0,0
1.262,6,29,9704,15,222,77,540,2008,14,1017,83,1591,7696
3.254,17,5,340,5,40,813,40,340,0,0,0,0,0
1.369,6,47,19478,27,913,52,1360,13902,20,476,62,2720,5576
21.951,6,23,2821,16,211,1463,211,1370,7,545,3657,904,1451
0.066,17,2,247,1,49,0,49,77,1,142,0,142,170
0.126,6,10,1495,5,507,31,507,727,5,556,31,556,768
0.592,6,27,9032,13,253,49,653,1710,14,939,42,1368,7322
1744.294,6,127,12619,77,62,22951,722,6351,50,87,35591,1408,6268
0.025,17,8,2446,8,277,3,316,2446,0,0,0,0,0
1682.814,17,14,1036,7,30,280460,30,406,7,62,280462,62,630
0.572,17,4,768,2,39,568,39,134,2,289,300,289,634
41.642,17,6,528,3,48,20816,48,228,3,72,20816,72,300
51.408,6,47,9017,22,371,802,766,2109,25,346,2135,2720,6908
70.818,6,50,20372,27,1041,370,1360,14650,23,399,3209,1360,5722
0.012,17,2,362,1,46,0,46,74,1,260,0,260,288
45.13,17,64,16776,25,420,1880,1350,11216,39,114,1187,1350,5560
1740.585,17,30,7050,30,207,60020,207,7050,0,0,0,0,0
0.055,6,9,1002,5,213,13,213,417,4,421,12,421,585
969.605,17,19,6556,19,317,53866,382,6556,0,0,0,0,0
1796.262,1,58,4872,58,56,31513,56,4872,0,0,0,0,0
0.715,6,10,4878,4,517,238,517,733,6,1275,110,1418,4145
1744.266,6,196,17582,98,125,17982,208,12608,98,31,17979,31,4974
1794.704,1,58,4872,58,56,31486,56,4872,0,0,0,0,0
1798.39,17,449,39928,404,35,4462,288,25708,45,288,40015,288,14220
69.1,6,29,7257,13,155,5758,267,1306,16,441,4606,1420,5951
1773.212,6,180,15480,120,69,14900,69,8940,60,69,30049,69,6540
16.118,6,2051,1936879,1347,1362,11,1408,1895607,704,776,22,1408,41272
95.669,6,25,9939,12,410,49,922,1778,13,847,7962,1360,8161
199.818,17,4,240,2,32,199817,32,120,2,32,199816,32,120
1785.905,6,274,32699,112,131,16088,1460,15912,162,128,11091,1642,16787
1754.216,6,31,5201,21,241,87710,241,3973,10,92,194892,92,1228
1691.152,17,14,1036,7,30,281855,30,406,7,62,281855,62,630
1768.853,1,58,4872,58,56,31032,56,4872,0,0,0,0,0
14.347,6,30,7573,12,155,1304,267,1266,18,398,843,3417,6307
1797.855,17,448,39612,404,35,4461,288,25708,44,288,40949,288,13904
0.043,17,4,336,2,34,0,34,124,2,78,34,84,212
1288.095,6,257,16283,149,69,8703,69,8996,108,69,12038,69,7287
0.061,6,9,1340,5,145,15,145,349,4,827,15,827,991
122.376,6,31,16564,15,634,67,1360,3181,16,1273,8147,2720,13383
1783.549,17,83,3480,82,14,22019,14,3444,1,8,0,8,36
1798.187,6,398,32118,224,92,8063,469,15500,174,134,10394,4837,16618
0.159,6,40,16900,23,1005,7,1420,11999,17,467,9,1883,4901
1752.364,6,95,7203,63,38,28263,205,4476,32,33,56515,98,2727
1772.194,6,180,15480,120,69,14892,69,8940,60,69,30035,69,6540
280.387,6,29,7392,13,158,23365,267,1317,16,603,18686,2036,6075
0.054,17,2,180,1,30,0,30,58,1,94,0,94,122
1789.962,6,351,22458,201,69,8949,69,12180,150,69,12013,69,10278
0.309,6,27,9042,14,247,23,624,1724,13,947,25,1448,7318
0.425,6,22,7255,12,318,38,600,1906,10,1205,46,1891,5349
365.124,6,39,8651,17,153,14233,516,1760,22,316,17382,1452,6891
7.109,6,29,9348,16,608,473,1460,3716,13,850,579,1544,5632
245.279,6,68,41561,40,1157,6289,1448,33350,28,843,2295,2359,8211
0.016,6,3,120,1,0,0,0,40,2,0,14,0,80
20.266,6,66,20595,33,588,633,1152,15459,33,476,625,1179,5136
2.022,6,16,2431,9,125,252,245,740,7,703,292,1152,1691
1775.5,6,181,15589,120,69,14920,69,8940,61,69,29590,69,6649
105.966,17,4,240,2,32,105965,32,120,2,32,105965,32,120
72.183,6,9291,8767195,6090,1360,11,1408,8596079,3201,931,22,2801,171116
240.268,6,59,18267,28,796,8898,1408,14996,31,206,8008,580,3271
1681.562,17,14,1036,7,30,280256,30,406,7,62,280257,62,630
281.001,6,33,8234,15,158,20071,267,1397,18,555,16528,2036,6837
755.962,2,5,160,5,8,188990,8,160,0,0,0,0,0
27.011,6,19,3703,7,125,328,245,660,12,853,2433,1152,3043
4.006,17,4,244,4,33,1335,33,244,0,0,0,0,0
66.168,17,26,1585,26,32,2646,37,1585,0,0,0,0,0
1740.608,6,96,7255,62,38,28534,205,4424,34,33,52739,98,2831
1771.025,6,99,9240,66,65,27246,65,5577,33,59,55341,59,3663
33.939,6,35,7530,17,180,2107,721,2010,18,508,1984,2026,5520
55.711,6,35,5335,20,154,2932,721,2153,15,399,1163,2026,3182
1323.553,2,10,320,10,8,147061,8,320,0,0,0,0,0
11.922,6,1888,1649275,1145,1386,10,1414,1615334,743,467,16,1889,33941
278.868,17,6,360,3,32,139433,32,180,3,32,139433,32,180
316.979,6,87,20287,45,327,7204,1360,10396,42,315,7727,1360,9891
300.809,2,3,96,3,8,150404,8,96,0,0,0,0,0
1210.217,6,32,3350,20,99,63695,138,2387,12,69,8068,69,963
0.088,17,4,284,2,32,81,32,120,2,54,77,60,164
288.511,6,29,8874,11,181,28851,267,1168,18,537,16879,2036,7706
1681.957,17,14,1036,7,30,280320,30,406,7,62,280320,62,630
1.3,6,46,19050,27,885,50,1360,13514,19,476,63,2715,5536
1.121,17,11,4539,5,432,280,1350,2301,6,345,124,1350,2238
0.454,6,3,120,1,0,0,0,40,2,0,454,0,80
7.646,17,12,1764,6,48,1523,48,456,6,190,1525,308,1308
0.087,17,2,241,1,36,0,36,64,1,149,0,149,177
271.147,1,6,336,6,28,54229,28,336,0,0,0,0,0
0.161,6,9,1340,5,145,40,145,349,4,827,50,827,991
2.126,17,22,5709,22,231,101,389,5709,0,0,0,0,0
16.284,17,6,528,3,48,8137,48,228,3,72,8136,72,300
1756.312,6,240,46440,150,483,11787,483,36780,90,83,19733,83,9660
1770.543,6,101,9410,66,66,27239,66,5610,35,60,52072,60,3800
1771.631,6,101,9344,66,65,27255,65,5577,35,59,52104,59,3767
1.564,6,24,6041,13,108,130,147,959,11,773,127,1608,5082
0.006,1,4,416,0,0,0,0,0,4,76,2,76,416
255.88,17,4,240,2,32,255879,32,120,2,32,255879,32,120
0.94,6,82,68310,51,210,18,255,3867,31,2166,29,7040,64443
0.589,6,28,9101,14,205,45,633,1761,14,941,42,1368,7340
1789.566,6,131,8388,73,51,24855,208,5169,58,31,31389,31,3219
1790.405,1,190,20140,190,78,9473,78,20140,0,0,0,0,0
15.803,6,1551,1324998,897,1391,17,1448,1285318,654,776,23,1448,39680
18.62,6,21,4405,10,241,2068,722,1480,11,465,1790,1448,2925
7.648,17,12,1764,6,48,1524,48,456,6,190,1527,308,1308
210.132,17,4,558,2,36,210127,36,128,2,187,210126,187,430
499.39,6,50,8288,30,115,17220,501,2590,20,287,26278,1420,5698
1792.034,6,356,22520,208,69,8657,69,12460,148,69,12190,69,10060
576.005,6,4,712,4,138,192001,138,712,0,0,0,0,0
1682.076,17,12,498,11,14,168207,14,462,1,8,0,8,36
127.391,17,4,240,2,32,127390,32,120,2,32,127390,32,120
0.344,17,4,624,2,64,206,64,184,2,192,216,192,440
0.76,17,4,947,2,33,749,37,123,2,384,747,463,824
1146.763,17,769,53796,706,40,1626,41,48471,63,56,551,57,5325
1769.932,6,105,9759,68,65,26416,65,5758,37,59,49162,59,4001
21.704,17,4,824,2,48,21690,48,152,2,308,21691,308,672
1794.605,17,144,11520,72,48,25276,48,5472,72,56,25276,56,6048
4.672,6,40,7309,21,218,233,314,3463,19,513,245,1179,3846
0.035,17,2,553,1,36,0,36,64,1,461,0,461,489
300.275,6,29,8148,14,286,23097,832,1930,15,777,21447,2529,6218
1.161,17,6,552,3,32,498,32,180,3,96,460,96,372
78.107,17,32,6919,21,40,3904,41,1440,11,470,7695,505,5479
15.3,6,5,476,0,0,0,0,0,5,69,3825,69,476
1744.413,1,60,5040,60,56,29566,56,5040,0,0,0,0,0
0.571,6,55,23125,29,978,20,1380,17831,26,383,21,1380,5294
0.103,6,2,104,1,0,0,0,40,1,0,0,0,64
1787.602,1,87,4872,87,28,20786,28,4872,0,0,0,0,0
10.998,6,18,4226,10,275,1222,275,958,8,978,889,1420,3268
1785.358,6,116,13443,74,164,24456,1289,9037,42,73,43542,240,4406
0.283,17,2,417,1,34,0,34,62,1,327,0,327,355
1778.564,1,59,4956,59,56,30664,56,4956,0,0,0,0,0
1795.784,6,374,26137,216,98,8352,469,15332,158,69,11436,69,10805
0.939,6,29,8544,15,222,57,540,2008,14,852,58,1360,6536
1.602,6,50,19392,29,892,57,1360,13731,21,437,70,2715,5661
1787.514,6,102,8364,68,66,26679,66,4964,34,60,54163,60,3400
0.872,6,21,5982,12,281,79,544,1328,9,715,97,1414,4654
11.003,17,8,704,4,48,3664,48,304,4,72,3664,72,400
1796.109,17,479,51454,214,138,8431,1350,35708,265,31,6798,60,15746
122.781,6,20,4744,7,220,10682,516,1166,13,338,10223,1452,3578
177.38,6,23,9108,12,329,63,679,1499,11,1022,17723,1696,7609
0.953,6,28,8160,15,222,55,540,1964,13,944,64,1591,6196
0.023,17,2,368,1,32,0,32,60,1,280,0,280,308
126.133,6,24,6248,9,272,1014,516,1180,15,372,9002,1452,5068
315.538,6,27,5686,9,133,39441,159,887,18,773,18560,1408,4799
17.615,6,54,19055,26,630,704,1460,6822,28,652,605,1460,12233
280.056,6,28,7352,13,158,23338,267,1317,15,678,19999,3436,6035
11.506,6,9,1049,1,407,0,407,459,8,31,1643,31,590
0.348,17,4,288,2,36,346,36,128,2,52,346,52,160
1779.229,17,140,11200,70,48,25785,48,5320,70,56,25785,56,5880
5.027,17,4,288,2,36,4995,36,128,2,52,4995,52,160
13.191,6,21,6825,12,275,1199,275,1038,9,1353,1023,1440,5787
1771.992,6,180,15480,120,69,14890,69,8940,60,69,30033,69,6540
0.053,17,4,284,2,32,0,32,120,2,54,33,60,164
17.213,6,20,1495,10,222,1911,222,848,10,231,1911,231,647
1770.852,6,103,9664,68,66,26430,66,5792,35,60,52081,60,3872
0.011,17,2,412,1,33,0,33,61,1,323,0,323,351
682.369,17,22,1408,22,36,32493,36,1408,0,0,0,0,0
2.263,6,4,184,2,0,2263,0,88,2,0,1007,0,96
29.276,17,18,1584,9,48,3654,48,684,9,72,3651,72,900
79.575,17,2288,2671599,350,72,228,1350,35231,1938,1332,41,1350,2636368
293.529,1,4,224,4,28,97843,28,224,0,0,0,0,0
0.865,17,15,8469,8,705,123,1350,5871,7,343,135,1350,2598
1791.074,17,87,3648,86,14,21071,14,3612,1,8,0,8,36
0.019,17,4,284,2,32,1,32,120,2,54,6,60,164
5.208,6,12,6134,4,275,1736,275,439,8,1073,427,2007,5695
681.691,17,13,5132,13,366,56807,548,5132,0,0,0,0,0
0.851,6,10,1687,7,100,141,100,384,3,1179,303,1179,1303
5.643,2,2,64,2,8,5643,8,64,0,0,0,0,0
1.344,17,3,1170,3,362,672,362,1170,0,0,0,0,0
71.479,6,45,8985,23,401,454,889,2228,22,391,3397,3488,6757
1718.144,6,24,3624,16,241,114542,241,2568,8,92,245420,92,1056
10.004,17,3,486,2,43,10004,43,142,1,316,0,316,344
107.43,6,125,90807,79,1238,1377,1408,79641,46,674,2382,3847,11166
41.816,17,24,2112,12,48,3800,48,912,12,72,3800,72,1200
3.521,17,8,1664,4,32,1171,32,240,4,328,1169,470,1424
46.371,6,48,9231,22,410,414,882,2214,26,350,1849,1460,7017
1787.096,17,87,3648,86,14,21024,14,3612,1,8,0,8,36
0.028,17,2,198,1,39,0,39,67,1,103,0,103,131
272.008,17,4,1312,4,300,90669,308,1312,0,0,0,0,0
1733.184,6,77,5636,48,33,36876,33,3336,29,31,61893,31,2300
1.294,6,25,8056,12,164,99,267,1288,13,869,91,1448,6768
5.513,6,701,639362,453,1344,11,1368,621802,248,776,21,2736,17560
1786.47,6,102,8364,68,66,26663,66,4964,34,60,54132,60,3400
316.922,6,125,37286,58,530,5560,1360,25163,67,241,4799,2720,12123
21.633,6,12,836,4,92,7057,92,308,8,92,3015,92,528
1740.634,17,30,20190,30,645,60021,645,20190,0,0,0,0,0
6.096,6,33,10343,19,577,338,1360,3681,14,761,313,3494,6662
242.444,6,64,37534,21,717,12121,1408,7558,43,1107,5772,1408,29976
1.335,6,47,18696,26,923,53,1460,13080,21,433,57,1460,5616
1772.987,6,180,15480,120,69,14899,69,8940,60,69,30044,69,6540
1748.289,1,52,4368,52,56,34280,56,4368,0,0,0,0,0
1786.064,6,175,36868,102,466,17683,1289,27854,73,119,24805,241,9014
1786.587,6,104,8308,68,64,26665,64,4896,36,58,51042,58,3412
2.881,17,4,624,4,128,960,128,624,0,0,0,0,0
0.221,6,3,168,1,0,0,0,52,2,0,1,0,116
12.531,6,24,4602,12,204,1122,722,1656,12,579,1122,1448,2946
0.336,6,3,160,2,0,336,0,100,1,0,0,0,60
0.708,6,23,5715,13,158,58,370,1315,10,999,78,1791,4400
1786.734,6,104,8424,68,64,26667,64,4896,36,58,51046,58,3528
6.713,6,46,8449,24,227,291,314,4142,22,489,306,1179,4307
240.175,6,45,8267,23,168,10916,346,2384,22,471,11436,1408,5883
20.133,6,18,2368,10,189,2237,517,1298,8,323,2874,499,1070
1794.018,17,180,14040,180,50,10022,50,14040,0,0,0,0,0
1772.028,1,58,4872,0,0,0,0,0,58,56,31088,56,4872
5.036,17,4,288,2,36,5001,36,128,2,52,5004,52,160
26.81,6,49,13105,23,182,1218,721,2569,26,632,1064,1420,10536
1740.127,6,87,6322,58,31,30528,31,3915,29,31,62147,31,2407
33.702,6,29,4989,15,154,2407,721,1857,14,480,2579,2026,3132
5.892,6,40,7309,21,218,294,314,3463,19,513,312,1179,3846
184.138,6,32,8952,14,158,14164,267,1357,18,624,10827,1400,7595
0.003,6,2,92,1,0,0,0,52,1,0,0,0,40
1.134,6,24,8004,11,164,96,267,1236,13,869,80,1440,6768
1789.801,1,342,28728,342,56,5248,56,28728,0,0,0,0,0
196.708,6,32,6940,13,189,9075,516,1472,19,294,10922,1452,5468
1790.489,6,356,22520,208,69,8649,69,12460,148,69,12179,69,10060
1323.531,2,12,384,12,8,120321,8,384,0,0,0,0,0
0.619,6,14,1745,7,288,73,288,600,7,426,74,434,1145
32.066,17,4,352,2,60,32065,60,176,2,60,32065,60,176
279.42,17,4,352,2,60,279419,60,176,2,60,279419,60,176
1.181,17,2,122,2,33,1181,33,122,0,0,0,0,0
114.196,1,8,448,8,28,16313,28,448,0,0,0,0,0
1.089,6,26,8466,14,275,70,583,1967,12,1201,81,3151,6499
366.819,6,21,1419,15,177,26201,177,989,6,110,12232,110,430
5.747,6,848,768765,549,1360,10,1432,752514,299,475,19,1871,16251
5.031,17,4,558,2,36,5027,36,128,2,187,5026,187,430
280.45,6,31,7472,13,158,23370,267,1317,18,543,16494,1380,6155
1630.028,1,8,448,8,28,232861,28,448,0,0,0,0,0
2.876,6,35,20429,20,778,151,1360,6290,15,1932,195,5294,14139
0.183,6,41,17739,24,988,7,1420,12838,17,526,11,3303,4901
562.347,17,6,444,3,30,281166,30,174,3,62,281121,62,270
10.634,6,16,3911,9,275,1329,275,643,7,992,957,1440,3268
280.228,6,31,7733,14,175,21556,267,1618,17,603,17511,2036,6115
94.55,1,4,224,4,28,31516,28,224,0,0,0,0,0
561.284,17,6,444,3,30,280604,30,174,3,62,280618,62,270
1797.245,6,240,35580,150,302,12062,302,25920,90,83,20193,83,9660
14.959,6,2188,2034318,1370,1405,10,1448,1987094,818,776,18,1448,47224
10.39,6,1936,1802219,1239,1376,8,1408,1761311,697,931,14,2816,40908
44.109,6,5257,4826797,3244,1403,13,1448,4710317,2013,776,21,1448,116480
0.405,6,13,1693,7,288,64,288,588,6,426,47,434,1105
0.01,17,3,520,3,145,5,356,520,0,0,0,0,0
0.036,17,3,392,2,60,9,60,176,1,188,0,188,216
1744.691,1,51,4284,51,56,34893,56,4284,0,0,0,0,0
1.315,6,38,8278,19,321,73,1164,2742,19,433,63,1360,5536
1.629,6,19,3781,10,234,181,564,1452,9,463,178,1343,2329
0.756,6,25,6081,13,108,63,147,959,12,773,64,1608,5122
10.111,6,83,24877,43,561,240,1152,19136,40,413,252,1152,5741
691.634,6,156,40823,78,448,8982,1460,27832,78,205,8977,2920,12991
2.341,6,4,220,2,0,2341,0,100,2,0,307,0,120
5.876,6,41,7349,21,218,293,314,3463,20,513,293,1179,3886
1769.643,6,192,11749,95,47,18825,208,6908,97,31,18431,31,4841
120.342,2,2,64,2,8,120342,8,64,0,0,0,0,0
0.035,6,3,120,2,0,35,0,80,1,0,0,0,40
1.769,17,4,580,2,40,1732,40,136,2,194,1727,194,444
1.581,17,22,11841,11,549,150,1350,6353,11,470,151,1350,5488
0.291,6,22,7333,12,334,25,663,1969,10,806,31,1408,5364
172.545,2,2,64,2,8,172545,8,64,0,0,0,0,0
0.454,6,10,968,5,256,104,256,460,5,304,105,304,508
20.138,6,21,5442,12,107,1830,159,1098,9,773,2516,1408,4344
1744.638,2,28,896,28,8,64616,8,896,0,0,0,0,0
350.182,17,3,126,3,14,175091,14,126,0,0,0,0,0
1783.999,17,83,3480,82,14,22024,14,3444,1,8,0,8,36
1746.248,6,95,7203,63,38,28165,205,4476,32,33,56315,98,2727
1795.958,1,230,12880,230,28,7842,28,12880,0,0,0,0,0
1772.132,6,180,15480,120,69,14891,69,8940,60,69,30032,69,6540
0.016,17,2,664,1,308,0,308,336,1,300,0,300,328
0.207,17,2,778,2,361,207,361,778,0,0,0,0,0
177.749,6,27,7312,13,158,14812,267,1317,14,775,13672,3445,5995
11.566,6,25,8453,13,275,963,275,1078,12,983,736,1420,7375
2.876,6,48,26012,24,746,125,1360,6249,24,1173,118,1696,19763
404.124,6,32,2625,16,65,26941,205,1288,16,36,26928,98,1337
1741.563,17,28,6580,28,207,64502,207,6580,0,0,0,0,0
0.302,6,28,9001,13,227,25,547,1592,15,827,20,1408,7409
1645.703,17,41,16593,41,376,41142,548,16593,0,0,0,0,0
1791.189,6,357,22629,208,69,8653,69,12460,149,69,12102,69,10169
2.633,17,4,1556,4,361,877,361,1556,0,0,0,0,0
1798.096,6,356,22520,208,69,8686,69,12460,148,69,12231,69,10060
10.747,6,20,4442,11,275,1074,275,998,9,768,747,1440,3444
1782.794,6,246,25150,98,67,18377,659,9266,148,132,12126,1360,15884
0.022,17,4,352,2,37,14,37,130,2,83,12,89,222
1.399,6,37,8214,19,321,77,1164,2718,18,476,71,2720,5496
1771.978,1,62,5208,62,56,29048,56,5208,0,0,0,0,0
1.838,17,3,468,3,128,919,128,468,0,0,0,0,0
0.32,1,2,112,2,28,320,28,112,0,0,0,0,0
1739.133,6,87,6322,58,31,30511,31,3915,29,31,62111,31,2407
94.388,6,22,9028,11,365,70,792,1567,11,1001,9425,1440,7461
0.975,6,29,13101,17,517,60,1360,3311,12,1162,72,3921,9790
83.324,6,25,9963,13,410,63,922,1794,12,959,7562,3056,8169
1786.593,6,104,8444,68,66,26665,66,4964,36,60,51042,60,3480
1796.862,6,429,26692,233,81,7745,469,14398,196,41,9213,69,12294
1744.698,2,18,576,18,8,102629,8,576,0,0,0,0,0
1.644,6,32,12163,17,525,102,1360,3350,15,820,103,1380,8813
1153.503,6,135,17155,89,84,13107,267,7865,46,186,20713,3432,9290
1764.858,2,15,480,15,8,126061,8,480,0,0,0,0,0
2.976,17,2,784,2,364,2976,364,784,0,0,0,0,0
11.595,1,16,1664,0,0,0,0,0,16,76,773,76,1664
3.523,6,157,102146,79,955,45,1360,14726,78,1296,43,1360,87420
1661.612,17,39,13104,39,308,43726,308,13104,0,0,0,0,0
1.184,6,10,1687,7,100,197,100,384,3,1179,464,1179,1303
0.072,17,4,288,2,33,0,33,122,2,55,67,61,166
1786.411,6,114,9835,72,77,25160,292,5655,42,69,43568,247,4180
0.132,17,3,451,2,39,127,39,134,1,289,0,289,317
1788.734,17,142,11360,71,48,25553,48,5396,71,56,25553,56,5964
20.237,6,23,5807,13,107,1686,159,1138,10,690,2245,1402,4669
1778.088,17,142,11360,71,48,25400,48,5396,71,56,25400,56,5964
3.523,17,10,1415,5,31,879,31,295,5,196,879,196,1120
1.818,6,10,1042,5,213,454,213,417,5,421,414,421,625
208.213,17,4,352,2,60,208212,60,176,2,60,208212,60,176
0.257,6,22,7333,12,334,22,663,1969,10,806,27,1408,5364
280.501,6,29,7392,13,158,23375,267,1317,16,603,18693,2036,6075
1782.434,17,83,3480,82,14,22005,14,3444,1,8,0,8,36
1795.694,17,448,39384,403,35,4466,288,25412,45,282,40021,288,13972
3.97,17,3,183,3,33,1985,33,183,0,0,0,0,0
363.779,6,37,7294,17,153,13564,516,1760,20,278,19141,1452,5534
1777.856,17,73,3060,72,14,25040,14,3024,1,8,0,8,36
1786.501,6,102,8296,68,65,26664,65,4930,34,59,54133,59,3366
5.47,6,38,7229,20,218,287,314,3423,18,513,305,1179,3806
361.015,2,4,128,4,8,120338,8,128,0,0,0,0,0
20.172,6,20,5525,12,115,1833,159,1221,8,967,2877,1675,4304
66.307,6,22,9860,11,433,74,990,1771,11,1091,6617,1460,8089
231.171,17,6,528,3,60,115585,60,264,3,60,115584,60,264
1.62,6,48,19070,27,881,62,1360,13454,21,433,70,1360,5616
242.484,17,4,240,2,32,242483,32,120,2,32,242483,32,120
5.703,6,628,562977,400,1340,13,1368,546445,228,931,24,2736,16532
1.766,17,2,144,1,36,0,36,64,1,52,0,52,80
0.871,17,28,18072,17,745,52,1350,13154,11,419,83,1350,4918
1772.529,1,58,4872,58,56,31097,56,4872,0,0,0,0,0
11.023,6,2165,1996853,1327,1422,8,1448,1948491,838,792,12,1448,48362
6.949,6,1671,1519928,1042,1380,6,1408,1482556,629,776,10,1408,37372
348.462,6,213,175641,140,1302,2506,1408,160943,73,680,2274,3847,14698
13.993,6,1600,1298184,866,1400,15,1448,1247992,734,776,18,1448,50192
1062.984,6,75,12227,42,96,21148,500,3508,33,238,33215,1420,8719
280.766,6,32,8912,14,158,21597,267,1357,18,621,16513,1400,7555
1787.084,6,102,8364,68,66,26672,66,4964,34,60,54151,60,3400
0.135,17,4,588,2,48,126,48,152,2,190,126,308,436
1798.533,6,367,25650,214,99,8443,469,15045,153,69,11829,69,10605
10.763,6,20,4442,11,275,1076,275,998,9,768,754,1440,3444
0.629,6,10,924,5,283,108,283,551,5,105,108,105,373
31.541,6,4291,4115529,2856,1364,10,1408,4036245,1435,776,21,1408,79284
1789.431,6,412,24760,205,69,8771,69,12340,207,34,8686,69,12420
5.485,6,40,7309,21,218,274,314,3463,19,440,289,1152,3846
72.766,6,21,860,10,0,6063,0,404,11,0,7275,0,456
240.214,6,56,18199,28,761,8896,1402,15170,28,195,8896,580,3029
127.09,17,4,352,2,60,127089,60,176,2,60,127089,60,176
1789.838,17,142,11360,71,48,25569,48,5396,71,56,25568,56,5964
1794.752,6,356,22520,208,69,8670,69,12460,148,69,12209,69,10060
0.012,17,2,290,1,40,0,40,68,1,194,0,194,222
0.08,6,9,1346,5,145,20,145,349,4,833,22,833,997
1789.708,6,356,22520,208,69,8645,69,12460,148,69,12174,69,10060
1.09,6,129,87264,62,131,17,232,3009,67,1337,16,1430,84255
300.693,6,36,8496,20,317,15825,923,2102,16,522,568,3488,6394
4.978,6,40,7309,20,218,262,314,3423,20,513,246,1179,3886
42.122,17,24,2112,12,48,3828,48,912,12,72,3828,72,1200
1786.742,17,87,3648,86,14,21020,14,3612,1,8,0,8,36
1781.145,17,142,11360,71,48,25444,48,5396,71,56,25444,56,5964
1789.644,17,142,11360,71,48,25566,48,5396,71,56,25566,56,5964
232.015,17,4,352,2,60,232014,60,176,2,60,232014,60,176
3.163,17,2,186,1,41,0,41,69,1,89,0,89,117
1679.585,17,12,498,11,14,167958,14,462,1,8,0,8,36
1770.341,1,8,448,8,28,252905,28,448,0,0,0,0,0
13.781,6,26,4815,13,154,1126,721,1767,13,473,1132,1368,3048
0.042,17,2,172,1,50,0,50,78,1,66,0,66,94
0.165,6,10,1388,6,145,33,145,389,4,835,52,835,999
1.337,6,50,19187,27,884,51,1360,13491,23,433,52,1360,5696
32.005,6,7,396,1,0,0,0,60,6,0,6319,0,336
1782.224,17,83,3480,82,14,22002,14,3444,1,8,0,8,36
0.229,17,3,1102,3,339,114,354,1102,0,0,0,0,0
5.002,17,4,288,2,36,5000,36,128,2,52,4988,52,160
1.035,17,2,389,1,34,0,34,62,1,299,0,299,327
38.483,17,11,836,11,48,3848,48,836,0,0,0,0,0
1.262,6,53,21493,31,906,42,1360,15792,22,437,51,2715,5701
1680.666,17,12,498,11,14,168066,14,462,1,8,0,8,36
61.3,6,35,15970,22,814,2919,1408,9296,13,855,5088,3847,6674
1782.212,17,73,3060,72,14,25101,14,3024,1,8,0,8,36
23.471,17,31,8317,15,298,1674,1350,4903,16,185,1562,1350,3414
1793.392,6,356,22520,208,69,8663,69,12460,148,69,12199,69,10060
137.52,17,4,352,2,60,137519,60,176,2,60,137519,60,176
0.885,17,4,566,2,31,874,31,118,2,196,836,196,448
369.718,6,25,1651,17,177,23107,177,1117,8,110,9233,110,534
20.022,6,25,4723,11,205,2002,722,1593,14,299,1514,1408,3130
0.276,17,2,178,1,29,0,29,57,1,93,0,93,121
53.505,6,19,2551,7,188,239,245,660,12,703,4841,1152,1891
0.731,6,24,6637,13,347,60,1076,2263,11,786,72,1420,4374
2.143,6,17,6337,9,141,267,275,646,8,894,131,1414,5691
300.592,6,36,8567,20,335,15820,994,2173,16,522,563,3488,6394
2.877,6,41,16030,24,685,125,1402,8798,17,576,169,2694,7232
10.065,17,2,138,2,41,10065,41,138,0,0,0,0,0
106.888,6,14,572,6,0,21377,0,244,8,0,14659,0,328
1766.39,1,65,5460,65,56,27599,56,5460,0,0,0,0,0
1795.944,6,371,26086,214,99,8431,469,15045,157,69,11512,69,11041
1787.253,6,102,8228,68,64,26675,64,4896,34,58,54156,58,3332
0.289,6,21,5000,10,137,32,267,1092,11,692,27,1467,3908
122.194,6,34,9520,11,162,1075,267,1423,23,421,5553,1942,8097
1781.976,17,142,11360,71,48,25456,48,5396,71,56,25456,56,5964
1784.878,6,273,34436,113,148,15934,1360,17237,160,133,11224,2720,17199
1383.634,2,15,480,15,8,98831,8,480,0,0,0,0,0
0.88,6,25,8962,13,208,73,475,1386,12,1012,64,1360,7576
1700.607,17,13,534,11,14,170043,14,462,2,8,1700438,8,72
0.239,17,2,152,1,48,0,48,76,1,48,0,48,76
5.048,6,43,16078,22,738,240,1460,6857,21,643,243,1460,9221
1744.022,6,95,7203,63,38,28129,205,4476,32,33,56252,98,2727
1771.447,6,99,9306,66,66,27253,66,5610,33,60,55354,60,3696
2.409,6,13,2311,8,188,344,245,700,5,1407,536,1407,1611
74.708,6,77,51206,47,1190,1624,1448,42921,30,746,2125,1448,8285
3.237,6,2,88,2,0,0,0,88,0,0,0,0,0
8.084,17,4,352,2,48,8076,48,152,2,72,8076,72,200
240.282,6,43,8978,21,524,12013,1418,5818,22,223,11441,618,3160
1719.433,17,12,498,11,14,171943,14,462,1,8,0,8,36
75.817,17,4,352,2,60,75816,60,176,2,60,75816,60,176
40.729,6,25,7097,12,155,3702,267,1266,13,589,3393,3426,5831
1788.269,17,32,10496,32,300,57686,300,10496,0,0,0,0,0
1776.05,17,73,3060,72,14,25014,14,3024,1,8,0,8,36
3.6,6,10,1102,6,483,720,483,803,4,83,1196,83,299
0.416,6,53,22872,30,967,14,1380,17710,23,421,16,1923,5162
0.057,17,2,196,1,46,0,46,74,1,94,0,94,122
57.609,6,25,7101,6,156,1000,267,718,19,374,3199,1452,6383
1768.409,1,58,4872,58,56,31024,56,4872,0,0,0,0,0
1.145,6,27,8196,14,164,74,267,1428,13,869,81,1408,6768
2.096,6,29,10386,17,367,131,833,1785,12,1014,182,1414,8601
23.455,6,231,94837,118,748,200,1152,84812,113,423,207,1179,10025
703.664,6,141,14980,69,86,10347,267,4926,72,183,9910,1420,10054
21.379,17,2,642,1,300,0,300,328,1,286,0,286,314
377.941,2,3,96,3,8,188970,8,96,0,0,0,0,0
1789.452,1,110,6160,110,28,16416,28,6160,0,0,0,0,0
281.306,6,32,7650,13,158,23442,267,1317,19,464,15613,1400,6333
0.138,17,2,136,1,32,0,32,60,1,48,0,48,76
0.014,17,7,2445,7,321,2,355,2445,0,0,0,0,0
16.882,17,18,8915,10,651,1872,1350,6798,8,236,2407,1350,2117
0.094,6,10,2103,6,591,18,1026,1426,4,513,31,513,677
1773.803,6,182,15629,121,69,14781,69,9049,61,69,29562,69,6580
183.054,6,4,312,3,92,91527,92,256,1,0,0,0,56
1681.574,17,16,1265,8,30,240220,37,471,8,71,240220,136,794
1797.745,17,345,26220,345,48,5226,48,26220,0,0,0,0,0
36.155,17,40,5880,20,48,1902,48,1520,20,190,1902,308,4360
0.019,17,2,148,1,38,0,38,66,1,54,0,54,82
1771.249,6,99,9306,66,66,27249,66,5610,33,60,55348,60,3696
14.086,17,4,352,2,48,14077,48,152,2,72,14076,72,200
0.916,6,29,8512,15,222,59,540,1976,14,852,57,1360,6536
1791.725,17,87,3648,86,14,21079,14,3612,1,8,0,8,36
1703.612,1,8,848,8,78,243373,78,848,0,0,0,0,0
554.629,6,34,9410,10,181,28,267,1128,24,385,24113,1400,8282
1800.0,6,214,16878,79,72,23076,374,8101,135,49,13431,143,8777
1786.446,6,154,25004,92,483,19631,483,19282,62,83,29285,83,5722
1796.505,6,361,22858,210,69,8595,69,12678,151,69,11976,69,10180
4.964,6,40,7309,20,218,261,314,3423,20,440,247,1152,3886
0.185,6,10,584,5,44,46,44,312,5,0,39,0,272
479.074,6,65,8757,29,296,17109,1056,4505,36,158,13687,580,4252
1.307,6,25,8056,12,164,100,267,1288,13,869,92,1408,6768
3.149,17,8,1856,8,204,449,204,1856,0,0,0,0,0
1.356,6,48,16194,27,783,52,1360,10533,21,437,58,2715,5661
1787.905,6,360,22749,209,69,8595,69,12569,151,69,11919,69,10180
876.519,6,126,14899,65,91,13695,721,6465,61,239,14605,1440,8434
86.892,6,2642,2385564,1646,1364,52,1368,2320958,996,749,87,1368,64606
130.155,6,25,10088,13,673,66,1360,3246,12,1058,11816,2235,6842
1782.374,17,83,3480,82,14,22004,14,3444,1,8,0,8,36
1794.174,17,80,3354,79,14,23002,14,3318,1,8,0,8,36
280.429,6,30,7432,13,158,23369,267,1317,17,603,17522,2076,6115
22.575,17,24,13207,13,791,1878,1350,10651,11,204,2254,1350,2556
0.833,6,23,6376,13,299,69,838,2019,10,988,91,1791,4357
1788.392,6,356,22520,208,69,8639,69,12460,148,69,12165,69,10060
1.448,6,41,10565,21,514,72,1440,4989,20,433,66,1440,5576
1784.854,17,140,11200,70,48,25867,48,5320,70,56,25867,56,5880
76.618,17,4,240,2,32,76617,32,120,2,32,76617,32,120
0.048,6,14,2867,8,139,6,139,575,6,657,7,905,2292
125.521,6,518,230691,263,809,479,1152,215359,255,427,493,1179,15332
1790.99,17,65,2730,65,14,27984,14,2730,0,0,0,0,0
3.27,17,4,1568,4,364,1090,364,1568,0,0,0,0,0
0.016,17,2,465,1,32,0,32,60,1,377,0,377,405
0.027,6,18,6108,10,88,3,88,556,8,1305,3,1880,5552
5.771,6,11,4031,6,100,1154,100,344,5,1161,1318,1179,3687
1786.782,6,102,8296,68,65,26668,65,4930,34,59,54141,59,3366
31.425,6,4,176,3,0,15712,0,128,1,0,0,0,48
102.279,6,34,18732,18,702,46,1360,4967,16,1192,6810,3056,13765
147.56,17,4,352,2,60,147559,60,176,2,60,147559,60,176
0.92,6,27,8942,13,232,76,569,1614,14,941,67,1438,7328
3.444,6,20,4003,10,288,378,288,1020,10,639,360,853,2983
1.369,2,2,64,2,8,1369,8,64,0,0,0,0,0
6.743,6,66,20126,34,540,204,1152,15419,32,489,209,1179,4707
68.279,6,674,317034,354,828,193,1152,298388,320,417,213,1179,18646
2.976,17,21,7181,8,280,425,1350,2470,13,334,134,1350,4711
1798.467,17,144,11520,72,48,25330,48,5472,72,56,25330,56,6048
1770.546,6,99,9240,66,65,27239,65,5577,33,59,55321,59,3663
11.912,6,14,952,7,92,1985,92,460,7,92,1760,92,492
106.628,6,22,900,9,0,6178,0,368,13,0,8885,0,532
3.461,17,5,295,5,31,865,31,295,0,0,0,0,0
1682.03,17,14,3815,7,30,280336,30,406,7,459,280335,463,3409
54.064,6,26,7137,12,155,4914,267,1266,14,530,4158,2006,5871
562.062,17,5,5854,5,1142,140515,1444,5854,0,0,0,0,0
1789.153,17,142,11360,71,48,25559,48,5396,71,56,25559,56,5964
689.543,1,14,784,14,28,53041,28,784,0,0,0,0,0
0.954,6,24,8745,13,270,79,722,1633,11,951,77,1440,7112
4.055,17,4,240,4,32,1351,32,240,0,0,0,0,0
0.041,17,4,420,2,33,0,33,122,2,121,0,145,298
185.338,6,39,10961,20,390,9745,1246,3782,19,476,10287,1368,7179
1797.01,17,448,39896,403,35,4470,288,25676,45,288,40022,288,14220
1792.312,1,248,13888,248,28,7256,28,13888,0,0,0,0,0
1796.197,17,448,39896,403,35,4468,288,25676,45,288,40017,288,14220
0.164,17,2,152,1,48,0,48,76,1,48,0,48,76
0.283,6,18,6061,9,186,25,267,749,9,987,26,1917,5312
0.195,17,4,308,2,33,83,33,122,2,65,82,65,186
0.128,6,9,1002,5,213,32,213,417,4,421,39,421,585
0.088,17,2,144,1,36,0,36,64,1,52,0,52,80
160.928,17,12,2472,6,48,32183,48,456,6,308,32183,308,2016
1797.375,17,1739,131993,954,40,1885,41,65506,785,56,2292,57,66487
1770.127,6,210,16158,78,68,22986,295,7650,132,48,13512,78,8508
1773.421,6,180,15480,120,69,14902,69,8940,60,69,30051,69,6540
1.084,6,33,12958,17,529,67,1460,3370,16,812,58,1460,9588
0.171,6,44,20557,26,1039,6,1420,15616,18,467,9,1883,4941
0.305,6,28,7336,13,155,25,267,1301,15,543,17,1400,6035
264.648,6,27,8752,13,158,22054,267,1317,14,981,20351,3445,7435
1632.052,6,1030,116282,361,109,4533,114,51858,669,110,2442,220,64424
0.621,17,4,352,2,37,0,37,130,2,83,0,89,222
9.33,1,8,672,0,0,0,0,0,8,56,1332,56,672
240.135,6,47,9993,23,197,10915,752,2598,24,511,10440,1402,7395
0.025,6,3,221,1,0,0,0,40,2,38,0,46,181
9.472,2,3,96,3,8,4736,8,96,0,0,0,0,0
76.925,17,3,1008,3,308,38462,308,1008,0,0,0,0,0
140.537,6,22,9126,12,304,68,597,1425,10,1214,15596,3081,7701
1779.716,6,103,8395,68,65,26562,65,4930,35,59,52341,59,3465
1720.448,17,12,498,11,14,172044,14,462,1,8,0,8,36
1798.003,6,979,176428,642,304,2804,304,132252,337,83,5350,83,44176
2.067,17,26,10289,11,485,206,1350,5649,15,281,121,1350,4640
0.02,17,2,448,2,196,20,346,448,0,0,0,0,0
601.64,2,5,160,5,8,150410,8,160,0,0,0,0,0
1756.616,6,107,6374,60,27,29772,27,3525,47,27,38186,27,2849
6.548,6,29,6175,15,338,467,1314,2294,14,368,500,1460,3881
1770.825,6,104,9648,68,65,26430,65,5758,36,59,50592,59,3890
0.708,6,2,80,1,0,0,0,40,1,0,0,0,40
1772.815,6,180,15480,120,69,14897,69,8940,60,69,30046,69,6540
3.283,17,32,16835,18,748,191,1350,13981,14,175,250,1350,2854
378.391,2,4,128,4,8,126130,8,128,0,0,0,0,0
1772.478,6,180,15480,120,69,14894,69,8940,60,69,30033,69,6540
0.508,6,5,260,2,0,490,0,104,3,0,253,0,156
1785.172,6,298,30495,125,87,14394,659,13513,173,121,10377,1360,16982
0.398,6,12,1653,6,288,72,288,548,6,426,47,434,1105
1797.473,17,449,39928,404,35,4460,288,25708,45,288,40021,288,14220
1785.252,17,82,3438,81,14,22315,14,3402,1,8,0,8,36
1764.369,2,16,512,16,8,117624,8,512,0,0,0,0,0
1795.834,6,356,22520,208,69,8675,69,12460,148,69,12216,69,10060
1796.19,17,448,39896,403,35,4468,288,25676,45,288,40017,288,14220
366.858,6,21,1419,15,177,26204,177,989,6,110,12229,110,430
240.651,1,2,212,2,78,240651,78,212,0,0,0,0,0
17.104,17,32,17638,16,700,1138,1350,11658,16,345,1138,1350,5980
1774.019,6,183,15669,121,69,14783,69,8980,62,69,29073,69,6689
1800.0,6,355,24192,155,46,11493,46,10028,200,46,9045,46,14164
1794.069,17,80,3354,79,14,23000,14,3318,1,8,0,8,36
240.698,6,41,8562,20,574,12667,1418,5645,21,227,12034,580,2917
1794.373,17,142,11360,71,48,25633,48,5396,71,56,25633,56,5964
0.013,17,2,255,1,31,0,31,59,1,168,0,168,196
692.677,6,145,16560,79,86,8880,267,5602,66,244,10656,2840,10958
1.34,6,48,17807,26,852,53,1460,12151,22,433,54,1460,5656
1798.744,17,448,39896,403,35,4474,288,25676,45,288,40023,288,14220
1125.885,6,16,2227,14,103,81231,138,2009,2,69,11776,69,218
280.323,6,29,7392,13,158,23360,267,1317,16,603,18685,1400,6075
1.409,17,2,136,1,32,0,32,60,1,48,0,48,76
33.975,17,10,880,5,48,8491,48,380,5,72,8491,72,500
1121.154,17,12,969,6,31,224227,37,355,6,74,224228,136,614
1783.998,6,104,8504,69,66,26235,66,5004,35,60,52463,60,3500
649.149,6,84,6234,32,65,20935,293,2909,52,47,12728,78,3325
4.467,6,38,7229,19,218,248,314,3383,19,513,233,1179,3846
353.511,6,26,6337,10,273,179,519,1223,16,406,23562,1420,5114
4.037,17,5,295,5,31,1009,31,295,0,0,0,0,0
1785.858,6,382,26526,218,97,8229,469,15550,164,69,10956,69,10976
128.037,6,38,8212,13,149,33,267,1423,25,304,5334,1460,6789
0.403,6,7,295,4,0,134,0,164,3,7,104,7,131
756.68,2,4,128,4,8,252226,8,128,0,0,0,0,0
1682.593,17,14,1036,7,30,280425,30,406,7,62,280423,62,630
0.175,6,24,7377,12,177,15,337,1342,12,1080,15,1588,6035
75.45,17,4,240,2,32,75449,32,120,2,32,75448,32,120
0.687,17,3,404,2,64,664,64,184,1,192,0,192,220
39.637,1,45,4680,0,0,0,0,0,45,76,900,76,4680
1744.18,6,97,7307,63,38,28131,205,4476,34,33,52845,98,2831
96.697,6,24,6248,9,272,104,516,1180,15,372,6900,1452,5068
1788.813,6,406,24781,212,69,8477,69,12689,194,41,9268,69,12092
97.261,6,18,1532,6,180,128,180,680,12,110,8824,110,852
94.618,17,6,528,3,60,47308,60,264,3,60,47308,60,264
1794.496,1,236,13216,236,28,7636,28,13216,0,0,0,0,0
0.361,6,160,187678,72,183,5,230,4313,88,2078,2,4206,183365
0.271,6,2,123,1,0,0,0,40,1,31,0,31,83
1799.995,6,216,17129,80,74,22784,375,8312,136,49,13333,143,8817
130.758,6,10,555,3,0,65379,0,152,7,7,21764,7,403
85.641,1,6,336,6,28,17128,28,336,0,0,0,0,0
2.619,6,6,340,3,0,1309,0,160,3,0,1006,0,180
3.844,6,33,6129,17,206,240,314,2744,16,548,237,1179,3385
8.244,6,18,6871,9,275,1030,275,643,9,1171,957,1440,6228
0.968,6,12,1352,6,256,191,256,500,6,304,191,304,852
7.742,6,9,392,4,0,2580,0,172,5,0,1127,0,220
1787.355,1,210,11760,210,28,8551,28,11760,0,0,0,0,0
38.269,6,41,8669,21,367,672,787,2022,20,416,2006,3488,6647
0.266,17,2,198,1,39,0,39,67,1,103,0,103,131
3.904,17,2,176,2,60,3904,60,176,0,0,0,0,0
1794.268,17,144,11520,72,48,25271,48,5472,72,56,25271,56,6048
0.392,6,28,9994,14,227,30,547,1656,14,950,29,1438,8338
1683.862,17,14,1036,7,30,280636,30,406,7,62,280636,62,630
1776.07,17,140,11200,70,48,25740,48,5320,70,56,25740,56,5880
371.528,6,23,1535,16,177,24768,177,1053,7,110,10380,110,482
1740.249,6,87,6322,58,31,30530,31,3915,29,31,62151,31,2407
0.161,17,3,1167,3,361,80,361,1167,0,0,0,0,0
4.181,6,20,3833,11,234,418,564,1504,9,463,352,1343,2329
1772.249,6,182,15629,121,69,14768,69,9049,61,69,29534,69,6580
0.211,6,22,5876,12,164,19,453,1442,10,558,22,1402,4434
291.416,6,49,9841,23,211,13244,517,2916,26,504,11654,1418,6925
10.233,6,1419,1311317,928,1364,11,1432,1287333,491,393,20,1432,23984
240.174,6,55,19629,30,795,8281,1408,16682,25,204,10007,580,2947
15.247,17,18,10822,8,705,2174,1350,5866,10,467,1690,1350,4956
1.483,6,39,8292,19,320,82,1162,2716,20,433,67,1360,5576
1788.583,17,87,3648,86,14,21042,14,3612,1,8,0,8,36
7.268,6,1394,1281129,881,1377,8,1408,1249789,513,931,13,2816,31340
378.181,2,4,128,4,8,126060,8,128,0,0,0,0,0
127.788,6,19,3739,4,92,350,92,308,15,203,9102,1448,3431
596.079,6,12,697,7,31,99346,31,373,5,31,148931,31,324
20.682,6,26,7066,11,275,2068,275,719,15,441,1411,1380,6347
1789.437,1,244,13664,244,28,7363,28,13664,0,0,0,0,0
34.664,17,10,760,10,48,3851,48,760,0,0,0,0,0
4.768,6,38,7245,19,218,264,314,3383,19,516,250,1179,3862
1780.133,1,107,5992,107,28,16793,28,5992,0,0,0,0,0
53.573,6,13,1079,12,43,4870,43,1019,1,0,0,0,60
27.069,6,31,7472,14,158,2082,267,1357,17,678,1686,3456,6115
1753.597,17,363,60010,363,137,4844,391,60010,0,0,0,0,0
0.427,6,11,975,6,304,85,304,624,5,83,99,83,351
0.03,17,4,368,2,32,13,32,120,2,96,11,96,248
0.617,17,2,157,1,31,0,31,59,1,70,0,70,98
0.229,6,9,1002,5,213,57,213,417,4,421,67,421,585
1082.9,2,11,352,11,8,108290,8,352,0,0,0,0,0
62.038,6,73,53413,48,1190,1319,1368,45376,25,961,2575,3887,8037
13.823,6,27,4867,13,154,1134,722,1767,14,394,1049,1448,3100
0.265,6,7,466,5,43,58,43,354,2,0,262,0,112
1799.907,6,356,22520,208,69,8695,69,12460,148,69,12243,69,10060
1786.647,17,87,3648,86,14,21019,14,3612,1,8,0,8,36
7.522,17,4,304,4,48,2507,48,304,0,0,0,0,0
1668.035,1,52,4368,0,0,0,0,0,52,56,32706,56,4368
127.062,6,5,545,5,69,31765,69,545,0,0,0,0,0
1786.598,6,102,8296,68,65,26665,65,4930,34,59,54136,59,3366
1.429,6,45,18860,26,942,57,1460,13324,19,476,68,2920,5536
0.965,17,2,120,2,32,965,32,120,0,0,0,0,0
1799.869,17,443,39736,398,36,4533,288,25516,45,288,40014,288,14220
1.263,6,12,1304,6,256,251,256,756,6,304,250,304,548
33.711,6,30,5066,15,154,2407,722,1883,15,399,2394,2026,3183
4.488,17,18,9933,9,734,561,1350,6859,9,313,491,1350,3074
350.394,17,6,456,6,48,70078,48,456,0,0,0,0,0
316.168,6,1219,1076099,783,1403,404,1460,1044654,436,150,84,1460,31445
1775.806,6,242,24877,98,67,18305,616,9201,144,137,12417,4080,15676
1775.644,6,27,4077,18,241,104449,241,2889,9,92,221927,92,1188
1.303,6,10,1687,7,100,217,100,384,3,1179,521,1179,1303
86.039,6,25,9968,12,549,73,1440,2709,13,961,7156,1440,7259
0.632,6,30,10252,15,252,45,646,1810,15,956,43,1438,8442
300.201,6,30,11783,17,592,18762,1408,4461,13,1106,20021,2816,7322
2.036,17,6,460,3,40,1003,41,206,3,56,1009,57,254
0.378,6,48,20107,27,927,14,1380,15024,21,421,17,1924,5083
464.731,17,6,525,3,32,232357,37,181,3,86,232359,136,344
1772.512,6,204,22399,130,75,13740,267,10057,74,133,24274,1997,12342
1788.226,6,1088,323923,480,931,3733,1418,275254,608,49,2945,157,48669
10.796,6,18,5610,10,275,1199,275,958,8,1440,822,1440,4652
1.379,6,50,19366,27,897,53,1360,13670,23,433,54,1360,5696
96.227,6,87,32748,41,699,2405,1152,26117,46,435,2131,1179,6631
973.112,17,192,14592,192,48,5094,48,14592,0,0,0,0,0
0.305,6,27,9072,13,247,25,624,1672,14,952,23,2816,7400
7.266,6,64,20979,34,575,220,1152,16336,30,491,241,1179,4643
39.094,6,19,4400,10,267,4343,502,1206,9,565,4875,1420,3194
1785.959,17,140,11200,70,48,25883,48,5320,70,56,25883,56,5880
11.882,6,2347,2227290,1529,1380,7,1408,2180090,818,931,14,2801,47200
0.127,6,12,3704,6,171,24,171,491,6,964,24,1448,3213
0.047,17,2,912,1,308,0,308,336,1,548,0,548,576
189.427,17,6,360,3,32,94713,32,180,3,32,94713,32,180
1.493,6,29,10368,17,367,93,833,1785,12,1012,128,1420,8583
5.884,6,44,8369,22,227,280,314,4062,22,427,267,1152,4307
6.426,6,3,134,1,0,0,0,40,2,7,6144,7,94
0.122,17,2,154,1,33,0,33,61,1,65,0,65,93
1.811,17,6,1022,3,30,900,30,174,3,254,900,276,848
3.521,6,23,6479,11,268,347,517,1385,12,744,315,1418,5094
2.998,17,3,1021,2,308,2000,308,672,1,321,0,321,349
6.302,6,29,6175,15,338,450,1314,2294,14,368,483,1460,3881
1797.218,1,226,12656,226,28,7987,28,12656,0,0,0,0,0
0.317,17,7,2429,7,319,52,354,2429,0,0,0,0,0
0.699,6,28,9111,14,252,53,647,1744,14,945,52,1438,7367
0.034,17,2,279,1,36,0,36,64,1,187,0,187,215
7.227,6,1210,1001060,710,1358,10,1380,976818,500,421,14,1923,24242
1771.63,6,102,9643,68,68,26442,232,5880,34,58,53683,81,3763
20.137,6,20,5366,12,107,1830,159,1074,8,967,2874,1659,4292
125.532,6,16,3248,8,92,17933,92,504,8,387,17903,1408,2744
0.038,17,2,176,1,48,0,48,76,1,72,0,72,100
1773.957,17,140,11200,70,48,25709,48,5320,70,56,25709,56,5880
0.616,6,12,1067,6,185,123,185,690,6,45,119,45,377
280.158,6,27,7312,13,158,23346,267,1317,14,775,21550,3445,5995
371.237,6,27,1767,18,177,21837,177,1181,9,110,8943,110,586
0.424,6,51,20792,28,965,15,1380,15630,23,383,17,1380,5162
0.187,6,10,1671,6,552,37,948,1348,4,159,62,159,323
0.554,6,24,7503,14,275,42,674,2115,10,969,56,1483,5388
317.054,6,57,12713,28,141,11742,615,3568,29,398,11318,3289,9145
300.42,6,35,12134,19,593,16690,1408,4593,16,744,16078,1578,7541
1746.29,6,97,7307,63,38,28165,205,4476,34,33,52908,98,2831
0.525,6,21,7281,13,334,43,663,2021,8,967,68,1471,5260
280.469,6,30,7432,13,158,23372,267,1317,17,603,17525,2076,6115
0.113,6,9,1346,5,145,28,145,349,4,833,32,833,997
0.096,6,10,767,6,186,19,186,506,4,45,22,45,261
1.186,6,132,89693,63,131,19,232,3049,69,1310,16,1430,86644
1795.75,17,142,11360,71,48,25653,48,5396,71,56,25653,56,5964
0.117,6,3,144,2,0,117,0,92,1,0,0,0,52
0.155,17,5,4254,3,909,77,1350,2812,2,693,45,1350,1442
1774.259,17,140,11200,70,48,25713,48,5320,70,56,25713,56,5880
4.533,17,2,656,2,300,4533,300,656,0,0,0,0,0
243.09,6,50,22418,22,440,11566,1360,4900,28,910,8996,1595,17518
4.007,17,6,462,3,33,2002,33,183,3,65,1996,65,279
0.039,6,10,1816,6,624,7,1092,1493,4,159,12,159,323
9.205,6,50,22314,28,1089,340,1360,16403,22,418,427,4027,5911
66.919,6,21,3225,12,237,6083,585,1357,9,457,8360,580,1868
15.036,6,29,5016,14,154,1113,722,1820,15,344,1060,1448,3196
187.181,6,21,3360,12,483,17016,483,2552,9,83,23396,83,808
0.569,6,27,9047,13,248,47,633,1678,14,945,40,2736,7369
119.013,6,11,3276,4,174,39671,174,338,7,1321,19791,1420,2938
131.505,6,27,5429,10,92,14611,92,644,17,278,8201,1408,4785
1740.031,1,56,4704,0,0,0,0,0,56,56,31636,56,4704
0.091,6,10,1800,6,616,18,1076,1477,4,159,30,159,323
0.91,6,11,1727,7,100,151,100,384,4,589,218,1152,1343
5.207,17,10,1830,5,36,1300,36,320,5,274,1300,318,1510
1773.311,6,180,15480,120,69,14901,69,8940,60,69,30047,69,6540
1.214,6,11,1426,6,145,242,145,389,5,829,300,829,1037
4.295,6,11,891,5,177,1073,177,445,6,110,705,110,446
300.659,6,37,8540,19,318,16703,928,2067,18,441,501,1440,6473
0.313,6,26,8925,13,239,26,597,1642,13,1099,25,2804,7283
1747.815,6,96,7286,63,38,28190,205,4476,33,33,54612,98,2810
0.525,6,12,1653,6,288,101,288,548,6,426,64,434,1105
1.537,6,53,19907,29,923,54,1460,14126,24,400,59,1460,5781
300.581,6,39,8606,20,315,15820,882,2093,19,441,468,1360,6513
0.055,6,20,10009,12,125,4,125,781,8,2201,7,4344,9228
0.001,6,3,144,1,0,0,0,40,2,0,1,0,104
0.073,17,2,348,1,39,0,39,67,1,253,0,253,281
0.271,6,25,8939,13,247,22,624,1672,12,1105,23,2816,7267
1731.196,6,72,5276,45,33,39345,33,3123,27,31,66577,31,2153
14.113,6,14,1025,7,222,2350,222,506,7,231,2350,231,519
0.222,17,2,362,1,46,0,46,74,1,260,0,260,288
291.367,6,56,9590,27,106,11204,517,2433,29,401,10404,1418,7157
107.12,6,19,4505,12,220,9738,516,1366,7,571,9246,1452,3139
42.693,17,8,704,4,48,14228,48,304,4,72,14227,72,400
1787.934,6,364,25392,212,100,8473,469,14896,152,69,11840,69,10496
0.06,17,2,154,1,33,0,33,61,1,65,0,65,93
1771.022,6,101,9410,66,66,27246,66,5610,35,60,52081,60,3800
807.524,6,220,16767,93,141,8777,469,8535,127,39,6408,69,8232
83.21,6,30,13033,17,578,5196,1368,4940,13,927,6931,1613,8093
24.995,17,4,320,2,48,24986,48,152,2,56,24986,56,168
2.496,6,18,3257,10,99,257,182,924,8,477,330,1343,2333
1781.754,6,465,27018,254,69,7042,69,14438,211,34,8484,64,12580
1791.955,1,77,6468,0,0,0,0,0,77,56,23578,56,6468
1785.172,6,360,24156,210,88,8541,469,13878,150,69,11978,69,10278
0.03,17,8,2750,8,315,4,354,2750,0,0,0,0,0
1767.717,1,67,5628,67,56,26783,56,5628,0,0,0,0,0
53.678,17,4,824,2,48,53671,48,152,2,308,53672,308,672
0.164,6,9,1148,5,145,41,145,349,4,635,39,635,799
1785.951,1,60,5040,0,0,0,0,0,60,56,30270,56,5040
0.11,17,8,2446,8,277,15,316,2446,0,0,0,0,0
36.879,6,22,7642,11,773,66,1440,3675,11,566,3679,1440,3967
0.005,17,2,266,1,36,0,36,64,1,174,0,174,202
1719.464,17,12,498,11,14,171946,14,462,1,8,0,8,36
30.084,6,2765,2606658,1708,1442,17,1448,2542996,1057,899,28,1448,63662
0.502,17,3,451,2,39,326,39,134,1,289,0,289,317
235.239,6,137,139431,89,430,2673,647,6010,48,3044,1546,11264,133421
4.762,6,39,7269,19,218,264,314,3383,20,513,235,1179,3886
1269.236,6,141,15896,75,87,17149,721,6961,66,179,19523,1420,8935
0.03,17,4,344,2,47,25,47,150,2,69,25,75,194
1797.189,1,228,12768,228,28,7917,28,12768,0,0,0,0,0
9.569,6,33,8335,18,410,562,916,1983,15,574,666,4848,6352
1787.248,6,161,20835,95,302,19013,302,14640,66,83,27495,83,6195
158.882,6,119,92696,78,1264,2063,1408,82441,41,811,2302,3847,10255
1740.015,17,29,1653,29,29,62143,29,1653,0,0,0,0,0
1791.785,6,242,46639,151,483,11945,483,36844,91,83,19908,83,9795
45.497,6,18,5883,6,241,9098,517,1287,12,562,4135,1408,4596
165.316,6,23,940,9,0,6155,0,364,14,0,12715,0,576
0.153,17,2,180,1,30,0,30,58,1,94,0,94,122
71.79,6,9,468,9,0,0,0,468,0,0,0,0,0
286.407,6,29,6569,15,290,20453,517,1381,14,1116,22028,2460,5188
5.298,6,35,6209,19,206,294,314,2824,16,548,335,1179,3385
1798.018,17,475,59695,230,163,7851,1350,44055,245,35,7361,1350,15640
0.915,6,20,9028,10,124,101,124,652,10,1121,101,1448,8376
0.403,6,14,5792,7,135,67,135,507,7,1228,67,1448,5285
300.878,6,42,9836,23,544,13676,1440,4229,19,371,482,1440,5607
253.203,17,4,352,2,60,253202,60,176,2,60,253201,60,176
0.014,17,2,572,1,39,0,39,67,1,477,0,477,505
1783.34,17,83,3480,82,14,22016,14,3444,1,8,0,8,36
1561.341,17,18,4460,9,32,195166,37,543,9,407,195166,463,3917
0.324,1,5,2880,0,0,0,0,0,5,548,81,548,2880
315.716,6,27,6369,11,139,31571,159,1174,16,727,21047,1408,5195
25.628,17,34,24043,19,710,1421,1350,14033,15,639,1827,1350,10010
1747.154,6,95,7203,63,38,28179,205,4476,32,33,56345,98,2727
0.088,6,10,1495,5,507,22,507,727,5,556,22,556,768
1773.404,6,85,5052,42,31,43252,36,2308,43,242,42222,458,2744
0.061,17,2,154,1,33,0,33,61,1,65,0,65,93
1008.908,2,7,224,7,8,168151,8,224,0,0,0,0,0
1782.301,17,83,3480,82,14,22003,14,3444,1,8,0,8,36
4.98,6,38,7229,20,218,262,314,3423,18,513,277,1179,3806
1772.96,6,180,15480,120,69,14898,69,8940,60,69,30041,69,6540
881.785,2,5,160,5,8,220446,8,160,0,0,0,0,0
1799.352,1,345,28980,345,56,5230,56,28980,0,0,0,0,0
1795.757,6,264,32428,107,135,16939,1360,15441,157,135,11510,4080,16987
0.807,17,23,9597,11,359,77,1350,4260,12,416,70,1350,5337
1.836,6,27,8799,16,277,122,565,1477,11,859,163,1380,7322
4.201,17,24,13246,14,720,323,1350,10482,10,248,279,1350,2764
5.534,6,17,2425,9,211,691,211,922,8,545,790,904,1503
5.024,17,4,288,2,36,5000,36,128,2,52,5001,52,160
1772.86,6,180,15480,120,69,14897,69,8940,60,69,30043,69,6540
2.925,6,42,16805,22,241,139,722,2203,20,985,141,1440,14602
300.987,6,54,26164,32,1127,9709,1360,20482,22,399,419,1360,5682
1795.652,17,449,39928,404,35,4455,288,25708,45,288,40021,288,14220
198.076,6,30,7432,13,158,16506,267,1317,17,543,12377,1400,6115
280.377,6,29,7392,13,158,23364,267,1317,16,603,18683,2800,6075
1772.484,6,180,15480,120,69,14894,69,8940,60,69,30039,69,6540
18.06,17,40,24531,17,476,1126,1350,8575,23,665,819,1350,15956
3.74,6,18,3397,10,49,415,92,615,8,393,91,1408,2782
1715.146,1,8,448,8,28,245020,28,448,0,0,0,0,0
0.056,6,10,585,5,45,14,45,313,5,0,12,0,272
1779.905,17,142,11360,71,48,25427,48,5396,71,56,25427,56,5964
1798.46,1,345,28980,345,56,5228,56,28980,0,0,0,0,0
1772.489,6,205,22508,131,75,13634,267,10235,74,136,24276,2840,12273
1.01,17,26,13020,13,618,80,1350,8398,13,327,80,1350,4622
1792.047,1,77,6468,77,56,23579,56,6468,0,0,0,0,0
9.556,6,1914,1697805,1118,1432,8,1448,1649313,796,776,11,1448,48492
9.012,6,16,1402,8,275,1287,275,878,8,96,1145,96,524
0.119,6,10,1841,5,658,29,658,926,5,647,29,647,915
1772.505,6,204,22330,130,75,13740,267,10057,74,132,24276,1420,12273
0.046,6,15,4072,8,88,6,88,440,7,1670,7,1880,3632
1749.641,17,12,498,11,14,174964,14,462,1,8,0,8,36
7.026,6,4,240,4,0,0,0,240,0,0,0,0,0
1786.688,17,87,3648,86,14,21019,14,3612,1,8,0,8,36
13.76,6,22,5782,12,275,1250,275,1042,10,1440,968,1440,4740
0.649,6,10,1840,5,901,162,901,1169,5,403,162,403,671
300.335,6,26,8556,14,405,23102,1066,2370,12,793,4566,2816,6186
0.163,17,2,198,1,39,0,39,67,1,103,0,103,131
2.521,6,56,29679,29,143,90,253,2102,27,1308,95,2054,27577
1781.806,6,81,4340,40,26,45686,26,2144,41,26,44543,26,2196
1796.975,17,140,11200,70,48,26043,48,5320,70,56,26043,56,5880
300.11,6,41,13194,23,840,13633,1360,7672,18,435,17643,2667,5522
3.078,6,90,61334,46,959,68,1460,13371,44,1358,64,1607,47963
1770.922,6,163,27643,96,300,18641,823,19407,67,99,26831,192,8236
80.688,6,133,104677,85,1280,960,1368,94055,48,676,1711,1368,10622
1780.789,17,140,11192,71,48,25439,48,5396,69,56,26187,56,5796
0.267,6,3,136,2,0,267,0,88,1,0,0,0,48
73.16,6,694,324271,365,825,200,1152,305963,329,428,222,1179,18308
1667.07,1,7,742,7,78,277845,78,742,0,0,0,0,0
9.616,6,95,29903,48,600,204,1152,23541,47,447,203,1179,6362
5.021,17,3,208,2,36,4999,36,128,1,52,0,52,80
0.08,1,2,112,2,28,80,28,112,0,0,0,0,0
0.269,6,20,7229,12,334,23,663,1969,8,1209,37,1906,5260
0.022,17,2,152,1,48,0,48,76,1,48,0,48,76
3.187,6,12,507,7,0,531,0,288,5,7,745,7,219
42.678,17,24,2112,12,48,3879,48,912,12,72,3878,72,1200
254.204,17,5,3615,5,695,63551,1115,3615,0,0,0,0,0
5.061,6,38,7245,20,218,266,314,3423,18,516,282,1179,3822
1.432,6,52,19612,29,902,51,1460,13871,23,437,55,2615,5741
1777.745,17,79,3312,78,14,23087,14,3276,1,8,0,8,36
0.333,6,10,1188,6,145,66,145,389,4,635,86,635,799
1796.908,1,345,28980,345,56,5223,56,28980,0,0,0,0,0
240.198,6,55,17663,30,744,8282,1408,14970,25,173,10008,580,2693
1774.176,6,188,16076,123,69,14542,69,9198,65,69,27716,69,6878
0.664,6,135,99012,81,1314,8,1420,92619,54,526,12,3303,6393
1797.09,6,407,36404,223,120,8095,1189,17716,184,128,9819,1420,18688
300.902,6,38,8534,20,307,15836,882,2061,18,441,508,1360,6473
1466.839,17,116,9280,58,48,25733,48,4408,58,56,25733,56,4872
11.025,6,20,4402,11,275,1102,275,998,9,758,1352,1420,3404
0.012,6,13,3980,7,88,2,88,388,6,1670,2,2920,3592
0.701,6,20,7238,13,335,58,668,2026,7,1210,109,1946,5212
158.82,6,8,332,4,0,52940,0,164,4,0,52912,0,168
158.247,6,35,8114,12,152,14381,267,1404,23,340,7190,3457,6710
1793.721,17,305,62376,305,176,5900,422,62376,0,0,0,0,0
1765.359,1,8,448,8,28,252194,28,448,0,0,0,0,0
34.301,17,89,34700,48,599,729,1350,30131,41,83,837,1350,4569
284.72,6,31,6286,17,286,17795,1314,2405,14,368,190,1452,3881
0.011,6,2,170,1,0,0,0,40,1,90,0,90,130
1.43,6,19,3781,10,234,158,564,1452,9,463,157,1343,2329
0.538,17,4,368,2,32,220,32,120,2,96,226,96,248
23.113,6,32,8057,15,188,1650,721,1924,17,681,1431,1414,6133
21.168,6,16,1327,8,222,3022,222,768,8,231,3021,231,559
0.007,17,2,382,1,33,0,33,61,1,293,0,293,321
87.039,6,32,26822,18,666,80,1360,4084,14,2462,6681,8160,22738
1.365,6,53,21718,29,922,48,1360,15982,24,433,50,1360,5736
0.017,6,2,149,1,0,0,0,40,1,69,0,69,109
26.412,17,17,5576,17,300,1650,300,5576,0,0,0,0,0
1795.871,17,449,39928,404,35,4456,288,25708,45,288,40016,288,14220
6.133,6,42,7389,21,201,306,314,3463,21,513,291,1179,3926
149.703,17,52,7644,26,48,5985,48,1976,26,190,5986,308,5668
1681.174,1,15,840,15,28,120083,28,840,0,0,0,0,0
1793.646,6,366,23196,212,69,8500,69,12896,154,69,11723,69,10300
1788.947,6,356,22520,208,69,8642,69,12460,148,69,12169,69,10060
110.823,6,41,9653,20,631,537,1360,4011,21,399,5532,1360,5642
1798.596,1,264,14784,264,28,6838,28,14784,0,0,0,0,0
1771.703,6,99,9240,66,65,27256,65,5577,33,59,55362,59,3663
62.429,17,7,2824,7,375,10404,548,2824,0,0,0,0,0
364.238,6,28,6558,12,221,5567,519,1368,16,349,24276,1420,5190
1683.709,17,16,1265,8,30,240523,37,471,8,71,240525,136,794
240.518,6,41,8751,20,594,12658,1418,5803,21,231,12025,580,2948
1776.215,6,180,15480,120,69,14926,69,8940,60,69,30103,69,6540
1672.266,1,7,392,7,28,278711,28,392,0,0,0,0,0
1770.761,6,103,9448,66,65,27242,65,5577,37,59,49185,59,3871
0.101,17,4,368,2,32,99,32,120,2,96,88,96,248
0.337,6,28,9123,13,247,28,624,1672,15,832,23,1408,7451
20.668,1,8,832,0,0,0,0,0,8,76,2952,76,832
11.8,6,7,292,4,0,3929,0,164,3,0,5893,0,128
280.274,17,4,296,2,30,280262,30,116,2,62,280258,62,180
252.54,6,4,176,3,0,126270,0,128,1,0,0,0,48
5.959,6,10,420,5,0,1489,0,208,5,0,1124,0,212
1773.762,6,182,15629,121,69,14781,69,8980,61,69,29560,69,6649
1758.47,6,190,11607,95,47,18707,208,6877,95,31,18704,31,4730
29.984,6,4102,3897355,2621,1407,11,1448,3815679,1481,776,20,1448,81676
145.575,6,70,50024,46,1201,3235,1408,42039,24,961,2703,3847,7985
0.184,6,25,7216,12,155,16,267,1261,13,603,14,1400,5955
0.092,6,10,1495,5,507,23,507,727,5,556,23,556,768
240.315,6,43,9082,21,521,12015,1418,5792,22,237,11442,619,3290
0.017,17,4,336,2,34,0,34,124,2,78,0,84,212
93.048,17,10,880,5,48,23260,48,380,5,72,23260,72,500
40.973,6,31,7771,18,248,2410,314,3701,13,591,3394,1179,4070
1780.177,1,73,6132,73,56,24724,56,6132,0,0,0,0,0
625.924,17,124,9424,124,48,5088,48,9424,0,0,0,0,0
130.307,6,20,9856,11,380,74,832,1613,9,1574,16271,3928,8243
703.773,1,4,224,4,28,234591,28,224,0,0,0,0,0
0.393,6,13,1693,7,288,63,288,588,6,426,44,434,1105
95.735,17,60,15540,60,231,1622,388,15540,0,0,0,0,0
67.872,6,25,7097,12,155,6170,267,1266,13,589,5655,3426,5831
2.97,6,40,20400,20,689,156,1440,5673,20,1159,149,1638,14727
292.035,6,72,12937,34,660,8849,1418,6552,38,156,7892,1013,6385
1770.387,6,108,10721,68,87,26423,822,6503,40,62,45392,191,4218
0.113,17,2,2382,2,1163,113,1163,2382,0,0,0,0,0
1744.568,2,15,480,15,8,124612,8,480,0,0,0,0,0
1797.948,17,179,13962,179,50,10100,50,13962,0,0,0,0,0
1789.594,17,142,11360,71,48,25564,48,5396,71,56,25565,56,5964
1789.322,17,142,11360,71,48,25561,48,5396,71,56,25561,56,5964
282.113,17,2,672,2,308,282113,308,672,0,0,0,0,0
12.531,6,11,4535,5,188,3132,245,580,6,1237,1401,1407,3955
1.35,6,52,19940,29,928,48,1460,14199,23,400,53,1460,5741
53.587,17,4,240,2,32,53586,32,120,2,32,53586,32,120
0.289,6,24,5980,12,164,26,453,1442,12,781,25,2224,4538
144.586,6,16,1266,6,64,11660,64,560,10,34,15898,58,706
1681.219,17,14,3843,7,30,280202,30,406,7,463,280202,463,3437
0.088,17,4,284,2,32,0,32,120,2,54,0,60,164
1768.689,1,58,4872,58,56,31029,56,4872,0,0,0,0,0
1779.621,1,61,5124,0,0,0,0,0,61,56,29660,56,5124
1798.644,6,368,25759,214,99,8444,469,15045,154,69,11753,69,10714
1799.765,17,290,70398,290,214,6227,422,70398,0,0,0,0,0
0.848,6,19,5907,11,281,84,543,1287,8,859,108,2642,4620
5.206,17,2,152,2,48,5206,48,152,0,0,0,0,0
9.15,6,28,9113,9,166,1143,267,1035,19,487,499,1452,8078
0.245,17,3,451,2,39,130,39,134,1,289,0,289,317
25.605,6,26,15244,11,296,2560,826,1927,15,1271,1827,1691,13317
4.747,6,13,3463,7,188,791,245,660,6,1279,896,1407,2803
148.409,6,17835,17193211,11977,1358,12,1408,16883931,5858,931,25,2801,309280
1.909,6,11,912,6,181,381,181,489,5,77,311,134,423
299.536,6,6,364,4,31,99845,31,222,2,31,299523,31,142
1740.659,17,29,30624,29,1028,62166,1028,30624,0,0,0,0,0
0.04,17,6,936,3,64,0,64,276,3,192,0,192,660
2.976,17,2,178,1,29,0,29,57,1,93,0,93,121
1745.556,6,95,7203,63,38,28154,205,4476,32,33,56298,98,2727
1789.279,6,358,22669,209,69,8602,69,12500,149,69,12089,69,10169
60.467,6,11,2994,6,92,12093,92,400,5,1165,15065,1408,2594
4.365,6,38,7245,19,218,242,314,3383,19,516,228,1179,3862
1.303,6,57,17994,28,707,48,1360,8925,29,464,46,2186,9069
0.266,17,2,672,2,308,266,308,672,0,0,0,0,0
0.143,6,10,1378,5,145,35,145,349,5,825,31,825,1029
0.014,6,2,302,1,222,0,222,262,1,0,0,0,40
289.443,1,4,224,4,28,96481,28,224,0,0,0,0,0
112.091,2,4,128,4,8,37363,8,128,0,0,0,0,0
1.571,6,30,10994,17,350,98,1041,2136,13,1040,109,2370,8858
1796.672,17,448,39896,403,35,4469,288,25676,45,288,40021,288,14220
1740.406,17,24,5640,24,207,75669,207,5640,0,0,0,0,0
379.82,6,18,1242,14,180,29216,180,916,4,110,20061,110,326
1771.377,1,59,4956,59,56,30540,56,4956,0,0,0,0,0
0.215,17,2,672,2,308,215,308,672,0,0,0,0,0
285.499,6,28,2964,14,324,21960,584,1384,14,282,21960,580,1580
108.218,17,4,240,2,32,108217,32,120,2,32,108217,32,120
1790.22,17,140,11200,70,48,25945,48,5320,70,56,25945,56,5880
1794.623,6,432,25917,216,69,8347,69,12780,216,35,8347,48,13137
1.988,17,2,120,2,32,1988,32,120,0,0,0,0,0
1.431,6,24,8004,12,164,111,267,1288,12,1014,111,2736,6716
6.008,17,4,390,2,44,6004,44,144,2,95,6003,95,246
1787.39,6,102,8296,68,65,26677,65,4930,34,59,54159,59,3366
1.303,6,10,1687,7,100,217,100,384,3,1179,532,1179,1303
0.168,6,2,111,1,0,0,0,40,1,31,0,31,71
1797.386,17,448,39896,403,35,4471,288,25676,45,288,40020,288,14220
1791.968,6,356,22520,208,69,8656,69,12460,148,69,12186,69,10060
1022.706,2,8,256,8,8,146100,8,256,0,0,0,0,0
2.081,1,4,1360,4,312,693,344,1360,0,0,0,0,0
1773.328,6,180,15480,120,69,14901,69,8940,60,69,30048,69,6540
1.409,6,47,19015,26,948,56,1460,13399,21,433,61,1460,5616
1687.205,17,12,498,11,14,168720,14,462,1,8,0,8,36
32.341,17,4,240,2,32,32340,32,120,2,32,32340,32,120
1772.959,6,180,15480,120,69,14898,69,8940,60,69,30047,69,6540
34.337,6,31,7613,11,150,3433,267,1502,20,441,1791,1420,6111
1.392,6,50,19989,27,941,53,1460,14293,23,433,54,1460,5696
4.854,6,39,7269,19,218,269,314,3383,20,440,241,1152,3886
0.31,6,26,9003,13,247,25,624,1684,13,947,25,1408,7319
0.053,6,10,1866,6,649,10,1142,1543,4,159,14,159,323
2.422,6,14,2351,8,188,346,245,700,6,703,430,1152,1651
280.288,6,28,7352,12,158,25480,267,1277,16,603,18682,1400,6075
0.438,17,3,543,2,39,432,39,134,1,381,0,381,409
0.002,6,2,458,1,0,0,0,40,1,378,0,378,418
0.72,6,10,861,5,222,175,222,426,5,231,175,231,435
0.092,6,2,149,1,0,0,0,40,1,69,0,69,109
1.345,6,38,8258,19,321,74,1168,2722,19,433,65,1360,5536
0.283,6,26,8903,13,234,23,575,1620,13,1099,23,2816,7283
280.205,6,25,7094,11,181,28020,267,1168,14,595,21553,1400,5926
280.071,6,27,7312,13,158,23339,267,1317,14,775,21539,4836,5995
290.198,6,28,3561,14,324,22322,585,1393,14,357,22322,580,2168
300.713,6,37,8562,17,308,18786,889,1947,20,414,15820,2128,6615
1770.719,6,105,9694,68,65,26428,65,5811,37,59,49179,59,3883
0.256,17,4,420,2,33,0,33,122,2,121,33,145,298
1797.499,1,262,14672,262,28,6886,28,14672,0,0,0,0,0
782.105,2,10,320,10,8,86900,8,320,0,0,0,0,0
5.898,6,38,7229,20,218,310,314,3423,18,513,332,1179,3806
1.456,17,12,6855,6,772,276,1350,4800,6,314,171,1350,2055
283.086,6,31,7476,14,158,21775,267,1361,17,543,17513,1400,6115
0.993,6,32,12986,17,529,62,1440,3370,15,818,58,1440,9616
8.47,6,22,6726,5,154,2117,267,672,17,447,500,1420,6054
1793.192,17,83,3480,82,14,22138,14,3444,1,8,0,8,36
6.146,17,6,486,3,45,3069,45,219,3,61,3069,61,267
807.678,6,173,19908,79,144,10354,469,7926,94,144,8684,2006,11982
1734.688,17,144,24390,144,141,12130,373,24390,0,0,0,0,0
1797.225,6,382,26595,219,97,8244,469,15590,163,69,11092,69,11005
48.84,6,22,2085,9,304,6105,304,1100,13,83,4067,83,985
0.397,6,26,8862,13,231,33,563,1608,13,938,31,1448,7254
237.574,17,6,528,3,48,118781,48,228,3,72,118781,72,300
0.22,17,7,2375,7,311,36,355,2375,0,0,0,0,0
1796.126,17,449,39928,404,35,4456,288,25708,45,288,40028,288,14220
1782.608,6,375,26384,215,98,8329,469,15292,160,69,11209,69,11092
9.921,17,4,5484,4,1343,3307,1348,5484,0,0,0,0,0
97.894,6,32,16103,16,520,63,1246,2320,16,1193,6515,4151,13783
6.627,6,20,6301,9,262,817,517,1264,11,893,656,2452,5037
1777.303,1,8,448,8,28,253900,28,448,0,0,0,0,0
1.44,6,50,19304,28,888,53,1460,13603,22,400,59,1460,5701
1795.987,17,447,39864,402,35,4478,288,25644,45,288,40018,288,14220
1745.775,6,94,7151,62,38,28619,205,4424,32,33,56307,98,2727
0.586,6,15,1785,8,288,70,288,640,7,426,67,434,1145
1795.525,17,448,39896,403,35,4466,288,25676,45,288,40018,288,14220
1799.807,17,180,14040,180,50,10054,50,14040,0,0,0,0,0
4.187,1,9,504,9,28,523,28,504,0,0,0,0,0
8.736,6,34,8377,18,410,513,916,1983,16,522,569,2720,6394
1680.711,17,12,498,11,14,168071,14,462,1,8,0,8,36
0.758,6,26,5680,13,121,63,267,1255,13,650,57,1420,4425
30.794,6,37,8467,18,400,521,885,1953,19,441,1702,1440,6514
0.299,6,26,9039,13,266,24,705,1750,13,1100,23,2804,7289
190.669,6,33,9061,14,158,14666,267,1357,19,578,10577,1400,7704
1787.368,6,102,8228,68,64,26677,64,4896,34,58,54159,58,3332
0.479,6,12,1653,6,288,88,288,548,6,426,55,434,1105
5.635,6,19,9170,9,275,704,275,639,10,1015,401,2760,8531
0.63,6,35,23918,22,840,30,1360,5979,13,1934,41,5440,17939
1787.368,17,83,3480,82,14,22066,14,3444,1,8,0,8,36
0.1,6,10,767,5,186,20,186,454,5,45,24,45,313
262.125,17,176,12622,142,40,1858,41,9747,34,56,464,57,2875
54.005,6,29,2111,17,411,3375,411,1323,12,92,2793,92,788
0.083,17,2,180,1,30,0,30,58,1,94,0,94,122
1779.42,17,142,11360,71,48,25420,48,5396,71,56,25420,56,5964
1759.685,6,282,50124,184,302,9615,302,37360,98,83,18140,83,12764
77.998,6,28,7352,12,158,7090,267,1277,16,603,5197,1400,6075
0.147,6,50,23512,28,1078,5,1420,18399,22,467,6,1883,5113
7.498,6,8,348,4,0,2499,0,172,4,0,1170,0,176
280.613,6,32,7853,14,158,21585,267,1357,18,524,16505,1400,6496
1795.572,17,447,39864,402,35,4477,288,25644,45,288,40017,288,14220
1.704,6,27,10180,16,285,113,587,1499,11,1029,153,1420,8681
0.003,6,4,160,2,0,2,0,80,2,0,0,0,80
132.107,6,30,10272,9,328,16505,1189,2341,21,442,6602,3457,7931
1797.998,17,769,46373,769,32,2341,37,46373,0,0,0,0,0
0.107,17,4,352,2,37,57,37,130,2,83,51,89,222
252.676,2,3,96,3,8,126338,8,96,0,0,0,0,0
0.033,6,9,1612,5,636,8,636,904,4,492,10,492,708
280.447,6,29,7392,13,158,23370,267,1317,16,603,18689,1400,6075
6.258,17,28,20392,12,542,568,1350,6850,16,818,414,1350,13542
1.297,6,51,19786,29,920,46,1460,14085,22,400,53,1460,5701
1.425,6,50,21271,29,903,50,1360,15655,21,476,61,2715,5616
86.835,17,4,1344,4,308,28945,308,1344,0,0,0,0,0
1786.499,6,102,8296,68,65,26664,65,4930,34,59,54133,59,3366
1799.228,17,758,45742,758,32,2376,37,45742,0,0,0,0,0
1697.953,17,16,1265,8,30,242558,37,471,8,71,242556,136,794
62.398,6,42,8849,21,389,648,852,2100,21,393,3113,4848,6749
11.967,6,87,26421,45,559,271,1152,20259,42,447,284,1179,6162
1786.554,6,102,8228,68,64,26664,64,4896,34,58,54135,58,3332
1788.306,1,61,5124,61,56,29805,56,5124,0,0,0,0,0
2.849,17,4,624,4,128,949,128,624,0,0,0,0,0
162.912,6,29,13805,16,832,53,1360,6498,13,967,13560,2720,7307
262.31,6,71,49318,46,1178,5829,1408,41285,25,960,2565,3847,8033
0.087,17,2,376,1,39,0,39,67,1,281,0,281,309
1794.215,6,397,41851,227,194,7939,789,22481,170,153,10614,645,19370
1681.806,17,16,1265,8,30,240236,37,471,8,71,240255,136,794
0.431,6,4,220,2,0,431,0,100,2,0,306,0,120
240.634,2,2,64,2,8,240634,8,64,0,0,0,0,0
236.678,17,4,352,2,60,236677,60,176,2,60,236677,60,176
1785.946,6,102,8296,68,65,26655,65,4930,34,59,54116,59,3366
373.579,6,18,1239,14,177,28736,177,913,4,110,20062,110,326
0.337,6,26,8995,13,252,28,647,1692,13,945,27,1438,7303
629.92,2,4,128,4,8,209973,8,128,0,0,0,0,0
1740.843,6,87,6322,58,31,30541,31,3915,29,31,62171,31,2407
1794.69,1,339,28476,339,56,5309,56,28476,0,0,0,0,0
80.594,6,45,8817,22,345,656,720,2019,23,391,3656,2720,6798
3.948,17,4,240,4,32,1316,32,240,0,0,0,0,0
1799.813,1,250,14000,250,28,7228,28,14000,0,0,0,0,0
1773.688,6,181,15589,120,69,14904,69,8940,61,69,29554,69,6649
1779.826,1,206,11536,206,28,8682,28,11536,0,0,0,0,0
3.374,6,14,1518,8,304,482,304,1032,6,83,671,83,486
1795.936,17,449,39928,404,35,4456,288,25708,45,288,40019,288,14220
553.078,1,88,4928,88,28,6357,28,4928,0,0,0,0,0
1795.713,17,448,39896,403,35,4466,288,25676,45,288,40020,288,14220
15.705,6,11,772,4,112,5235,112,280,7,90,2601,90,492
61.437,6,31,17666,18,708,41,1360,4342,13,1599,5108,4416,13324
0.096,17,4,268,4,39,32,39,268,0,0,0,0,0
1771.584,6,101,9344,66,65,27255,65,5577,35,59,52102,59,3767
1.131,6,22,7900,11,164,95,267,1236,11,1216,95,3819,6664
322.683,17,6,2016,6,308,64536,308,2016,0,0,0,0,0
0.17,6,9,1339,5,145,42,145,349,4,826,36,826,990
1741.287,17,29,30624,29,1028,62188,1028,30624,0,0,0,0,0
0.261,6,24,6064,12,181,23,537,1526,12,651,22,1402,4538
1792.794,17,136,10880,68,48,26758,48,5168,68,56,26758,56,5712
353.579,6,17,1236,13,226,29464,226,910,4,110,20089,110,326
1619.34,1,7,742,7,78,269890,78,742,0,0,0,0,0
0.117,17,2,198,1,39,0,39,67,1,103,0,103,131
1741.19,17,29,30624,29,1028,62185,1028,30624,0,0,0,0,0
0.013,17,4,284,2,32,2,32,120,2,54,0,60,164
74.546,6,24,5122,10,201,8282,516,1412,14,314,5518,1452,3710
1756.317,6,3946,4163008,1339,146,1312,868,83394,2607,1556,673,5608,4079614
3.35,17,5,295,5,31,837,31,295,0,0,0,0,0
301.428,6,40,8853,14,278,23176,734,1729,26,303,12051,1440,7124
240.196,6,54,19474,29,837,8578,1418,16592,25,196,10007,580,2882
234.137,17,66,2668,44,12,5445,16,1772,22,12,4532,16,896
0.849,6,25,6460,13,299,70,842,2023,12,790,76,1420,4437
5.047,17,4,288,2,36,4982,36,128,2,52,4884,52,160
1.794,1,10,840,10,56,199,56,840,0,0,0,0,0
1785.192,6,284,28151,170,104,10563,469,14002,114,131,15798,1933,14149
0.917,6,12,1653,6,288,179,288,548,6,426,101,434,1105
0.481,6,5,248,3,0,240,0,144,2,0,478,0,104
268.103,6,224,176523,138,1302,1956,1368,162223,86,679,1589,2519,14300
0.013,6,11,1564,6,503,2,503,823,5,473,3,473,741
1081.114,17,211,16036,211,48,5148,48,16036,0,0,0,0,0
0.396,6,10,1992,5,288,92,288,508,5,424,55,434,1484
3.57,6,25,6090,14,108,274,147,1003,11,927,46,1608,5087
1742.847,6,109,8576,70,44,25258,150,5191,39,38,45864,163,3385
1792.76,6,800,54620,398,31,4515,31,27150,402,31,4470,71,27470
282.017,6,34,8024,15,158,20144,267,1397,19,488,15665,1400,6627
1788.232,17,83,3480,82,14,22076,14,3444,1,8,0,8,36
11.72,6,1856,1620825,1100,1418,10,1432,1586340,756,420,15,1432,34485
182.587,17,29,6441,19,40,10143,41,1303,10,485,20154,505,5138
1777.942,17,140,11200,70,48,25767,48,5320,70,56,25767,56,5880
482.645,17,6,360,3,32,241322,32,180,3,32,241322,32,180
1.04,17,4,678,3,32,513,32,180,1,470,0,470,498
18.577,17,29,19337,14,605,1426,1350,8871,15,669,1324,1350,10466
1.383,6,41,11378,22,547,65,1360,5842,19,433,66,1360,5536
1796.582,17,448,39896,403,35,4469,288,25676,45,288,40016,288,14220
40.868,17,22,1936,11,48,4085,48,836,11,72,4085,72,1100
739.973,6,54,3630,34,49,22423,208,2396,20,31,38935,31,1234
1786.561,17,140,11200,70,48,25892,48,5320,70,56,25892,56,5880
20.261,6,17,2316,10,189,2251,517,1298,7,323,3374,499,1018
1781.755,6,359,22709,209,69,8566,69,12569,150,69,11958,69,10140
28.898,6,20,2125,11,65,2889,65,721,9,888,3549,888,1404
11.966,6,1907,1626984,1149,1363,10,1380,1590463,758,514,15,1923,36521
0.011,17,8,2750,8,315,1,354,2750,0,0,0,0,0
1347.161,6,272,17366,155,70,8747,138,9443,117,69,11613,69,7923
1797.836,17,448,39896,403,35,4472,288,25676,45,288,40021,288,14220
0.095,6,12,3462,6,75,18,75,395,6,1373,19,1448,3067
93.059,6,23,5638,9,139,11631,159,1046,14,967,7157,1669,4592
1720.282,17,12,498,11,14,172028,14,462,1,8,0,8,36
1.715,6,13,2311,8,188,245,245,700,5,1407,368,1407,1611
1.951,17,4,424,2,46,1950,46,148,2,110,1940,110,276
1741.462,6,87,6322,58,31,30551,31,3915,29,31,62194,31,2407
15.721,17,28,10755,12,368,1426,1350,4752,16,347,1045,1350,6003
0.079,6,9,1346,5,145,19,145,349,4,833,22,833,997
0.287,6,10,1383,6,145,57,145,389,4,830,43,830,994
1385.969,2,11,352,11,8,138596,8,352,0,0,0,0,0
20.328,6,17,2316,10,189,2258,517,1298,7,323,3378,499,1018
1784.771,6,102,8296,68,65,26638,65,4930,34,59,54081,59,3366
0.134,6,10,1514,5,503,33,503,771,5,475,33,475,743
100.366,17,4,240,2,32,100365,32,120,2,32,100365,32,120
0.059,17,2,174,1,45,0,45,73,1,73,0,73,101
1791.097,17,144,11520,72,48,25226,48,5472,72,56,25226,56,6048
5.809,6,32,6295,17,338,363,1314,2374,15,331,414,1420,3921
1785.471,17,142,11360,71,48,25506,48,5396,71,56,25505,56,5964
1744.103,6,95,7203,63,38,28130,205,4476,32,33,56250,98,2727
1177.671,6,463,63073,178,185,6653,871,31069,285,111,4146,580,32004
0.225,6,6,718,3,304,102,304,460,3,102,91,102,258
1792.405,17,87,3648,86,14,21087,14,3612,1,8,0,8,36
206.594,6,13,2571,3,245,2990,245,369,10,299,22904,299,2202
29.222,17,9,7164,4,697,9740,1350,2902,5,824,36,1350,4262
0.302,6,10,1514,5,503,75,503,771,5,475,75,475,743
1.404,6,45,19015,26,954,56,1460,13479,19,529,67,4075,5536
0.026,6,10,1800,6,616,4,1073,1477,4,159,8,159,323
12.355,6,13,3740,8,171,1765,171,631,5,947,3039,1368,3109
9.514,6,81,24461,42,550,232,1152,18760,39,459,242,1179,5701
1749.197,6,151,9405,80,48,22141,208,5666,71,31,24981,31,3739
0.093,6,12,4309,7,126,14,126,498,5,1771,21,3378,3811
0.087,6,2,80,0,0,0,0,0,2,0,0,0,80
299.531,6,6,364,4,31,99843,31,222,2,31,299517,31,142
1791.529,1,58,4872,0,0,0,0,0,58,56,31430,56,4872
571.509,17,9,3020,9,307,71438,308,3020,0,0,0,0,0
91.95,6,33,12805,18,884,301,1360,6073,15,680,6554,2720,6732
0.972,6,9,1340,5,145,243,145,349,4,827,224,827,991
111.525,17,2,2446,2,1195,111525,1360,2446,0,0,0,0,0
1781.026,6,121,12203,77,62,23434,721,6401,44,97,41409,2329,5802
340.865,1,8,448,8,28,48695,28,448,0,0,0,0,0
0.213,6,46,21887,27,1053,8,1420,16906,19,467,11,1883,4981
1799.419,6,409,51605,205,170,8818,1440,37084,204,167,8862,1440,14521
327.631,2,6,320,6,29,65526,32,320,0,0,0,0,0
1.533,6,51,19422,29,894,54,1460,13721,22,400,63,1460,5701
11.112,6,1774,1538753,1067,1387,10,1420,1506152,707,467,15,1883,32601
1.362,6,49,20240,28,897,50,1360,14624,21,476,59,2715,5616
0.299,17,2,152,1,48,0,48,76,1,48,0,48,76
781.245,1,46,2576,46,28,17361,28,2576,0,0,0,0,0
1.335,6,15,1148,9,181,166,181,665,6,77,143,134,483
3.131,17,2,350,1,39,0,39,67,1,255,0,255,283
300.643,6,36,8370,19,286,16702,797,1936,17,478,532,2128,6434
0.001,6,2,92,1,0,0,0,52,1,0,0,0,40
175.207,17,2,72,1,8,0,8,36,1,8,0,8,36
0.855,6,28,7336,13,155,71,267,1301,15,543,58,1400,6035
1.353,6,50,19014,27,871,52,1360,13318,23,433,53,1360,5696
76.947,17,4,352,2,60,76946,60,176,2,60,76946,60,176
902.424,2,7,224,7,8,150404,8,224,0,0,0,0,0
0.212,6,10,767,5,186,51,186,454,5,45,38,45,313
0.03,17,2,500,1,60,0,60,88,1,384,0,384,412
1720.467,17,12,498,11,14,172046,14,462,1,8,0,8,36
2.883,17,4,296,4,46,961,46,296,0,0,0,0,0
72.223,6,22,8319,11,525,91,1237,2048,11,831,7204,1360,6271
0.976,17,7,1576,6,228,195,944,1536,1,12,0,12,40
1746.113,6,94,7151,62,38,28624,205,4424,32,33,56306,98,2727
2.843,17,3,201,3,39,1421,39,201,0,0,0,0,0
1542.582,1,7,392,7,28,257097,28,392,0,0,0,0,0
299.75,6,6,364,4,31,99916,31,222,2,31,299726,31,142
0.189,6,9,527,5,43,47,43,311,4,0,30,0,216
129.773,17,4,352,2,60,129771,60,176,2,60,129771,60,176
1798.228,17,449,39928,404,35,4462,288,25708,45,288,40019,288,14220
13.277,6,5,414,2,65,8538,65,145,3,149,2702,149,269
0.01,17,2,309,1,40,0,40,68,1,213,0,213,241
1.581,6,30,10317,18,368,93,837,1829,12,1000,135,1452,8488
278.656,17,8,2672,8,306,39808,308,2672,0,0,0,0,0
15.357,6,23,2282,11,222,1534,222,1332,12,231,1394,231,950
3.051,6,6,340,3,0,1525,0,160,3,0,533,0,180
1744.623,2,30,960,30,8,60159,8,960,0,0,0,0,0
1799.689,17,449,39928,404,35,4465,288,25708,45,288,40018,288,14220
1785.261,6,416,24920,208,69,8624,69,12460,208,34,8624,48,12460
1773.523,6,180,15480,120,69,14903,69,8940,60,69,30054,69,6540
1772.918,6,180,15480,120,69,14898,69,8940,60,69,30045,69,6540
73.259,6,23,10858,11,367,63,783,1574,12,1256,6648,2169,9284
0.46,17,2,152,1,48,0,48,76,1,48,0,48,76
1799.303,17,449,39928,404,35,4464,288,25708,45,288,40018,288,14220
1769.961,6,158,21378,92,153,19450,818,11867,66,116,27228,240,9511
0.67,6,37,11900,21,676,33,1188,7853,16,356,38,758,4047
1131.027,2,21,672,21,8,56551,8,672,0,0,0,0,0
280.262,6,29,7392,13,158,23355,267,1317,16,603,18680,1400,6075
271.861,6,404,323656,241,1367,1132,1448,299806,163,527,1676,1448,23850
1.678,17,3,1173,3,363,839,363,1173,0,0,0,0,0
1.585,6,38,9848,21,440,79,1360,4392,17,476,85,2715,5456
0.451,6,20,7151,12,318,41,600,1906,8,964,58,1471,5245
191.632,6,14,5625,4,106,63875,106,274,10,706,21291,1420,5351
0.465,6,22,7345,13,334,38,663,2021,9,1209,54,1946,5324
1740.68,17,30,31680,30,1028,60023,1028,31680,0,0,0,0,0
1773.528,6,180,15480,120,69,14903,69,8940,60,69,30057,69,6540
2.239,6,13,2311,8,188,319,245,700,5,1407,492,1407,1611
1781.603,6,107,8421,70,45,25820,205,5179,37,35,49479,98,3242
1681.314,1,15,840,15,28,120093,28,840,0,0,0,0,0
216.261,17,4,240,2,32,216260,32,120,2,32,216260,32,120
1792.0,6,362,22898,210,69,8574,69,12678,152,69,11867,69,10220
0.143,17,4,284,2,32,6,32,120,2,54,132,60,164
1786.309,17,88,3684,86,14,21013,14,3612,2,8,1786152,8,72
36.151,17,20,1760,10,48,4015,48,760,10,72,4015,72,1000
221.493,17,4,1344,4,308,73831,308,1344,0,0,0,0,0
21.956,6,20,3130,12,183,1996,517,1561,8,381,3135,499,1569
1.663,6,25,8765,15,285,118,588,1460,10,985,165,1420,7305
12.426,17,8,700,4,34,4139,34,248,4,85,4139,91,452
129.959,6,25,11106,13,612,52,1360,3616,12,999,11802,1360,7490
8.196,6,18,8085,9,275,1024,275,643,9,1414,947,1414,7442
0.893,6,30,12096,16,525,59,1360,3322,14,820,55,1380,8774
2.551,6,113,87350,51,131,50,232,2569,62,1469,41,2840,84781
13.115,6,6,328,4,0,4371,0,216,2,0,13092,0,112
366.212,6,18,1239,14,177,28170,177,913,4,110,20056,110,326
1.475,6,51,21504,30,973,50,1460,15843,21,400,62,1460,5661
5.821,6,50,20355,22,1008,277,1440,14030,28,324,208,1440,6325
1770.686,6,99,9306,66,66,27241,66,5610,33,60,55331,60,3696
1.384,6,38,9848,20,502,72,1440,4352,18,433,71,1440,5496
2.002,6,14,2181,8,322,286,581,1069,6,396,397,580,1112
2.041,17,47,39253,20,505,107,1350,10678,27,1030,73,1350,28575
0.126,17,2,152,1,48,0,48,76,1,48,0,48,76
1772.657,6,180,15480,120,69,14896,69,8940,60,69,30037,69,6540
1.871,17,2,116,2,30,1871,30,116,0,0,0,0,0
0.45,6,12,1653,6,288,87,288,548,6,426,48,434,1105
0.037,6,5,307,3,43,18,43,207,2,0,36,0,100
1795.525,17,317,64727,317,176,5682,422,64727,0,0,0,0,0
1699.421,17,12,498,11,14,169942,14,462,1,8,0,8,36
53.855,17,10,1352,5,48,13461,48,380,5,166,13460,308,972
278.815,17,4,240,2,32,278813,32,120,2,32,278814,32,120
0.102,17,8,2446,8,277,14,316,2446,0,0,0,0,0
41.004,17,6,456,6,48,8200,48,456,0,0,0,0,0
18.728,17,6,456,6,48,3745,48,456,0,0,0,0,0
1763.445,6,136,14952,73,84,24491,517,5617,63,250,28441,2451,9335
0.021,17,4,352,2,60,19,60,176,2,60,19,60,176
61.879,6,69,50160,45,1206,1406,1408,42178,24,960,2680,3847,7982
15.039,17,26,12459,9,298,1879,1350,2936,17,532,770,1350,9523
300.765,6,50,13249,26,884,12030,1460,7332,24,290,666,1460,5917
60.054,6,32,5728,19,174,3336,517,2402,13,440,5003,499,3326
0.2,17,2,136,1,32,0,32,60,1,48,0,48,76
0.031,6,14,4020,8,88,4,88,428,6,1670,6,1880,3592
39.506,17,1993,397320,1977,172,19,172,395400,16,92,2353,172,1920
3.123,6,23,6482,10,268,341,517,1333,13,744,256,1418,5149
0.202,6,46,20126,26,1003,8,1420,15105,20,467,10,1883,5021
22.161,6,9,516,3,0,11080,0,164,6,0,4427,0,352
1.922,17,2,168,1,48,0,48,76,1,64,0,64,92
240.594,2,2,64,2,8,240594,8,64,0,0,0,0,0
112.391,17,4,352,2,60,112389,60,176,2,60,112390,60,176
1683.138,1,15,840,15,28,120224,28,840,0,0,0,0,0
1742.756,6,87,6322,58,31,30574,31,3915,29,31,62240,31,2407
200.69,6,43,6140,26,98,8027,722,2771,17,275,917,2026,3369
4.697,6,55,12503,29,551,167,1460,6215,26,326,169,1460,6288
0.024,17,2,255,1,43,0,43,71,1,156,0,156,184
280.399,6,28,7352,12,158,25490,267,1277,16,603,18685,1400,6075
419.367,6,49,6662,24,112,18233,721,2600,25,183,15545,1448,4062
106.013,6,51,12624,22,346,2239,1189,5387,29,357,3785,1420,7237
101.709,17,2,136,2,40,101709,47,136,0,0,0,0,0
1.812,6,27,8797,16,277,120,564,1476,11,859,160,1380,7321
3.101,17,3,228,2,48,3049,48,152,1,48,0,48,76
263.471,6,116,89588,76,1257,3512,1408,79387,40,811,2006,3847,10201
1773.007,6,205,23859,132,75,13534,267,10137,73,156,24619,4837,13722
1773.304,6,180,15480,120,69,14901,69,8940,60,69,30049,69,6540
1783.826,6,356,22520,208,69,8617,69,12460,148,69,12133,69,10060
23.096,17,4,352,2,60,23094,60,176,2,60,23095,60,176
1796.512,6,356,22520,208,69,8678,69,12460,148,69,12221,69,10060
0.622,17,2,188,1,58,0,58,86,1,74,0,74,102
91.506,6,24,10061,12,531,65,1360,2649,12,1153,8305,2574,7412
0.533,17,3,543,2,39,529,39,134,1,381,0,381,409
2.891,17,2,178,1,29,0,29,57,1,93,0,93,121
1134.235,17,164,12464,164,48,6958,48,12464,0,0,0,0,0
1.08,6,25,6696,14,354,82,1109,2336,11,783,107,1420,4360
6.22,6,649,505319,343,1389,17,1448,484743,306,776,19,1448,20576
1793.57,17,180,14040,180,50,10019,50,14040,0,0,0,0,0
1792.711,6,318,21207,188,69,9586,69,11729,130,69,13896,69,9478
772.101,6,36,1860,19,0,42892,0,988,17,0,48253,0,872
33.196,6,30,7297,14,155,2553,267,1346,16,441,2212,1420,5951
316.462,6,10,562,3,106,158225,106,234,7,0,52741,0,328
61.916,6,75,51731,46,1208,1375,1448,43495,29,746,2203,1448,8236
1777.653,17,140,11200,70,48,25762,48,5320,70,56,25762,56,5880
0.017,17,2,154,1,33,0,33,61,1,65,0,65,93
0.423,6,27,6202,13,181,35,537,1578,14,555,31,1542,4624
0.38,6,10,968,5,256,92,256,460,5,304,92,304,508
0.014,6,11,3410,6,75,2,75,395,5,2747,3,2747,3015
5.019,17,4,288,2,36,5000,36,128,2,52,5000,52,160
1786.328,6,104,8510,69,66,26269,66,5070,35,60,52535,60,3440
1754.329,1,176,18656,176,78,10024,78,18656,0,0,0,0,0
1799.685,6,399,38517,227,159,7963,485,20081,172,137,10524,453,18436
1795.758,6,145,9134,78,49,23321,208,5524,67,31,27203,31,3610
1784.904,1,342,28728,342,56,5234,56,28728,0,0,0,0,0
24.982,17,4,320,2,48,24977,48,152,2,56,24975,56,168
1787.274,6,104,8376,68,65,26675,65,4930,36,59,51060,59,3446
0.0,6,2,92,1,0,0,0,40,1,0,0,0,52
0.002,17,5,1757,5,323,0,354,1757,0,0,0,0,0
0.384,6,10,968,5,256,94,256,460,5,304,94,304,508
5.683,6,21,5608,11,190,558,370,1204,10,1332,621,3151,4404
0.128,17,2,912,1,308,0,308,336,1,548,0,548,576
1780.783,17,136,10880,68,48,26578,48,5168,68,56,26578,56,5712
134.305,17,4,352,2,60,134304,60,176,2,60,134304,60,176
0.245,17,2,259,1,53,0,53,81,1,150,0,150,178
1795.708,6,356,22520,208,69,8674,69,12460,148,69,12212,69,10060
5.021,17,4,736,2,37,5011,37,130,2,275,5011,275,606
1796.792,17,448,39896,403,35,4469,288,25676,45,288,40016,288,14220
0.186,6,10,1042,5,213,46,213,417,5,421,36,421,625
0.072,17,3,436,2,46,3,46,148,1,260,0,260,288
1781.246,1,98,5488,98,28,18363,28,5488,0,0,0,0,0
88.555,6,847,401300,443,838,200,1152,379278,404,418,219,1179,22022
9.407,6,1197,970371,647,1407,14,1448,934679,550,776,16,1448,35692
97.311,6,14,1031,4,177,112,177,393,10,110,10794,110,638
1795.176,17,80,3354,79,14,23015,14,3318,1,8,0,8,36
13.538,1,4,224,4,28,4512,28,224,0,0,0,0,0
6.889,6,1549,1434968,957,1420,7,1448,1399520,592,776,11,1448,35448
0.354,6,28,10262,14,262,27,690,1811,14,964,26,1408,8451
658.296,17,126,9576,126,48,5266,48,9576,0,0,0,0,0
7.237,6,1543,1397444,961,1375,7,1408,1362516,582,931,12,2801,34928
0.406,6,7,295,4,0,135,0,164,3,7,102,7,131
0.003,6,2,80,1,0,0,0,40,1,0,0,0,40
280.004,6,29,7392,13,158,23333,267,1317,16,603,18664,2036,6075
0.032,6,10,1514,5,503,8,503,771,5,475,7,475,743
1796.251,6,357,22629,208,69,8677,69,12460,149,69,12136,69,10169
1746.002,6,95,7203,63,38,28161,205,4476,32,33,56312,98,2727
0.942,6,2,1235,1,0,0,0,40,1,1155,0,1155,1195
1797.896,17,142,11360,71,48,25684,48,5396,71,56,25684,56,5964
0.059,6,10,1512,5,503,14,503,771,5,473,14,473,741
14.419,6,30,7642,11,155,11,267,1226,19,376,800,3417,6416
1398.785,6,338,25469,183,120,7403,469,15750,155,69,9083,69,9719
1666.369,1,7,392,7,28,277728,28,392,0,0,0,0,0
4.886,17,6,1392,6,204,977,204,1392,0,0,0,0,0
4.598,6,43,22290,23,973,209,1360,11691,20,1223,233,2222,10599
0.125,17,2,574,1,32,0,32,60,1,486,0,486,514
1770.652,6,103,9519,67,65,26828,65,5641,36,59,50586,59,3878
4.744,17,58,48933,23,328,215,1350,8190,35,1136,137,1350,40743
280.036,6,30,7432,14,158,21541,267,1357,16,603,18665,2036,6075
1797.298,17,448,39896,403,35,4470,288,25676,45,288,40021,288,14220
300.782,6,50,10526,25,433,12532,910,3258,25,312,523,1460,7268
1741.269,6,87,6322,58,31,30548,31,3915,29,31,62186,31,2407
76.572,6,194,145204,92,354,841,647,6508,102,1360,741,1408,138696
1796.321,6,233,20306,90,80,20181,337,9426,143,70,12649,1062,10880
300.801,6,44,14575,26,879,12032,1360,9008,18,402,505,2667,5567
1.359,6,48,18785,27,860,52,1360,13169,21,433,59,1360,5616
0.425,6,13,1693,6,288,80,288,548,7,426,38,434,1145
1772.492,6,180,15480,120,69,14894,69,8940,60,69,30035,69,6540
0.001,17,2,904,1,300,0,300,328,1,548,0,548,576
231.689,6,65,12906,27,231,8911,469,4562,38,200,6256,1452,8344
0.802,17,4,352,2,60,801,60,176,2,60,801,60,176
1796.682,17,449,39928,404,35,4458,288,25708,45,288,40021,288,14220
1782.709,6,476,27320,268,69,6676,69,14860,208,34,8612,64,12460
4.093,17,5,1160,5,204,1023,204,1160,0,0,0,0,0
7.182,6,7,466,0,0,0,0,0,7,31,1197,31,466
8.119,6,70,20627,35,562,238,1152,15459,35,470,230,1179,5168
0.549,1,20,560,20,0,0,0,560,0,0,0,0,0
1773.406,6,181,15589,120,69,14902,69,8940,61,69,29550,69,6649
47.24,17,4,352,2,60,47238,60,176,2,60,47239,60,176
800.04,6,110,10098,42,81,18780,339,4195,68,90,11940,1062,5903
1744.638,2,25,800,25,8,72693,8,800,0,0,0,0,0
0.093,1,2,112,2,28,93,28,112,0,0,0,0,0
0.346,17,8,2750,8,315,49,354,2750,0,0,0,0,0
1772.052,6,180,15480,120,69,14891,69,8940,60,69,30034,69,6540
1745.442,6,95,7203,63,38,28152,205,4476,32,33,56294,98,2727
281.192,6,28,7352,12,158,25562,267,1277,16,603,18739,1400,6075
170.718,6,20,6558,3,106,250,106,234,17,375,10669,1460,6324
6.959,6,29,7464,12,155,632,267,1266,17,423,432,3417,6198
118.966,6,16,2149,6,210,23793,210,530,10,545,11627,905,1619
0.874,6,21,9222,11,514,87,1237,2015,10,970,71,1360,7207
5.744,6,40,7309,21,218,287,314,3463,19,513,304,1179,3846
1786.443,6,102,8364,68,66,26663,66,4964,34,60,54131,60,3400
0.278,1,2,112,2,28,278,28,112,0,0,0,0,0
1681.819,17,14,1036,7,30,280297,30,406,7,62,280297,62,630
1772.284,6,180,15480,120,69,14893,69,8940,60,69,30033,69,6540
0.004,6,3,120,2,0,4,0,80,1,0,0,0,40
1.325,6,62,44940,38,1235,35,1408,37787,24,1179,50,3819,7153
1746.961,6,95,7203,63,38,28176,205,4476,32,33,56345,98,2727
33.798,6,4403,4184637,2816,1405,11,1448,4097009,1587,931,21,2761,87628
6.578,17,26,14137,13,811,548,1350,10911,13,220,440,1350,3226
16.141,6,489,414823,292,1350,55,1368,398797,197,899,81,2736,16026
1681.279,17,16,4241,8,30,240181,37,471,8,443,240181,463,3770
9.183,1,3,312,3,76,4591,121,312,0,0,0,0,0
1772.253,6,99,9240,66,65,27265,65,5577,33,59,55379,59,3663
5.774,6,38,7229,20,218,303,314,3423,18,513,324,1179,3806
1.101,6,28,8582,15,229,68,583,2043,13,1001,76,2720,6539
1772.894,6,180,15480,120,69,14898,69,8940,60,69,30040,69,6540
1680.502,17,24,25296,24,1026,73065,1026,25296,0,0,0,0,0
1.756,17,20,5190,20,231,92,389,5190,0,0,0,0,0
1786.042,6,114,9383,70,72,25884,292,5336,44,65,41533,247,4047
1786.676,6,106,8320,68,63,26666,63,4862,38,57,48286,57,3458
1783.142,17,82,3438,81,14,22289,14,3402,1,8,0,8,36
0.417,6,16,6734,8,120,59,120,544,8,1153,59,1448,6190
1787.353,6,104,8308,68,64,26676,64,4896,36,58,51063,58,3412
1777.572,17,142,11360,71,48,25393,48,5396,71,56,25393,56,5964
1.363,6,2,176,1,0,0,0,40,1,96,0,96,136
0.022,17,2,200,1,64,0,64,92,1,80,0,80,108
280.308,6,30,7432,13,158,23359,267,1317,17,543,17516,1400,6115
280.499,6,30,7432,13,158,23374,267,1317,17,603,17529,2076,6115
289.786,17,4,352,2,60,289785,60,176,2,60,289785,60,176
1786.467,17,87,3648,86,14,21017,14,3612,1,8,0,8,36
105.107,17,4,288,2,36,105094,36,128,2,52,105093,52,160
0.483,17,4,420,2,33,0,33,122,2,121,0,145,298
0.175,17,8,2758,8,316,25,355,2758,0,0,0,0,0
0.777,17,2,677,1,300,0,300,328,1,321,0,321,349
280.447,6,28,7352,12,158,25495,267,1277,16,775,18693,3465,6075
5.385,6,40,7325,21,218,269,314,3463,19,516,284,1179,3862
1770.53,6,99,9240,66,65,27238,65,5577,33,59,55325,59,3663
183.879,6,118,94063,79,1266,2357,1408,83914,39,811,2624,3847,10149
17.427,17,31,14198,15,674,1242,1350,10544,16,200,1159,1350,3654
15.068,17,3,2145,3,687,7534,687,2145,0,0,0,0,0
1744.677,2,19,608,19,8,96926,8,608,0,0,0,0,0
1750.548,17,12,498,11,14,175054,14,462,1,8,0,8,36
4.017,17,5,1160,5,204,1004,204,1160,0,0,0,0,0
1753.446,17,1027,70520,1027,40,1709,41,70520,0,0,0,0,0
1775.323,17,73,3060,72,14,25004,14,3024,1,8,0,8,36
1.32,6,45,18559,25,919,55,1460,12983,20,476,60,2615,5576
1.163,6,4,224,2,0,999,0,120,2,0,999,0,104
1738.735,6,92,6668,60,31,29470,31,4062,32,31,56087,31,2606
1742.383,6,95,7203,63,38,28102,205,4476,32,33,56190,98,2727
1789.989,6,356,23072,200,69,8994,69,12140,156,69,11548,69,10932
1799.401,17,450,39960,405,35,4453,288,25740,45,288,40018,288,14220
0.308,6,20,4960,10,137,34,267,1092,10,692,33,1467,3868
166.205,17,4,352,2,60,166204,60,176,2,60,166203,60,176
149.295,17,6,456,3,48,74638,48,228,3,48,74639,48,228
0.42,6,10,2101,5,1195,105,1195,1451,5,370,56,370,650
1729.162,6,60,4400,40,33,44337,33,2740,20,31,91000,31,1660
0.073,17,2,466,1,33,0,33,61,1,377,0,377,405
1.303,17,8,568,4,32,432,32,240,4,54,431,60,328
1770.946,6,101,9410,66,66,27245,66,5610,35,60,52084,60,3800
0.605,6,61,24193,34,935,18,1380,15514,27,582,21,3303,8679
1770.305,6,99,9306,66,66,27235,66,5610,33,60,55319,60,3696
13.534,6,36,6467,18,200,796,314,2933,18,468,778,1179,3534
1744.568,6,96,7286,64,38,27691,205,4559,32,33,56183,98,2727
15.975,6,2482,2389096,1654,1369,9,1408,2341376,828,931,19,2801,47720
1796.392,17,140,11200,70,48,26034,48,5320,70,56,26034,56,5880
138.92,6,12,858,12,26,12629,26,858,0,0,0,0,0
0.354,6,21,5000,10,137,39,267,1092,11,692,33,1467,3908
39.933,17,44,6468,22,48,1901,48,1672,22,190,1901,308,4796
0.212,17,4,284,2,32,133,32,120,2,54,80,60,164
240.255,6,39,7230,19,461,13347,1402,4687,20,213,12644,580,2543
0.447,6,83,70081,54,209,8,253,3973,29,2392,14,9856,66108
6.374,6,41,7349,21,218,318,314,3463,20,513,318,1179,3886
265.013,6,63,6840,26,222,8110,469,3937,37,61,7361,69,2903
0.023,17,2,1922,2,933,23,933,1922,0,0,0,0,0
1680.69,1,15,840,15,28,120049,28,840,0,0,0,0,0
1.315,6,25,8056,12,164,91,267,1288,13,869,94,1448,6768
0.016,17,2,219,1,50,0,50,78,1,113,0,113,141
0.501,17,3,451,2,39,206,39,134,1,289,0,289,317
1797.498,1,345,28980,345,56,5225,56,28980,0,0,0,0,0
375.217,6,166,134862,109,1296,3474,1408,122390,57,730,2125,3847,12472
6.154,6,1457,1313930,900,1381,6,1408,1280302,557,931,10,2816,33628
1785.863,6,372,25919,216,99,8306,469,15194,156,69,11521,69,10725
240.209,6,57,18114,30,800,8282,1402,15184,27,168,9238,580,2930
1742.702,6,94,7151,62,38,28568,205,4424,32,33,56207,98,2727
1795.82,17,142,11360,71,48,25654,48,5396,71,56,25654,56,5964
0.113,17,2,2384,2,1164,113,1164,2384,0,0,0,0,0
1502.811,6,153,13158,102,69,14879,69,7599,51,69,30046,69,5559
280.241,6,29,7392,13,158,23353,267,1317,16,603,18678,1400,6075
0.01,17,2,223,1,36,0,36,64,1,131,0,131,159
136.891,6,15,938,5,0,34222,0,256,10,7,15186,7,682
12.212,6,42,9752,19,289,678,722,3375,23,605,545,1380,6377
98.445,6,619,284526,321,822,307,1152,267101,298,423,330,1179,17425
1.266,6,47,16328,25,803,52,1460,10672,22,433,52,1460,5656
1.747,6,11,1727,7,100,291,100,384,4,1179,496,1179,1343
11.035,6,22,4474,12,275,1003,275,1038,10,755,694,1414,3436
1731.916,1,20,1120,20,28,91153,28,1120,0,0,0,0,0
1792.264,6,360,24156,210,88,8575,469,13878,150,69,12027,69,10278
1798.992,6,216,17268,80,76,22772,376,8419,136,50,13324,143,8849
3.494,17,5,290,5,30,873,30,290,0,0,0,0,0
1117.358,6,73,10547,45,102,19700,498,3955,28,227,41380,1420,6592
280.269,6,30,7432,13,158,23355,267,1317,17,543,17516,1400,6115
0.184,6,9,1338,5,145,46,145,349,4,825,47,825,989
0.797,6,44,23982,24,262,34,517,1612,20,1197,28,1336,22370
1791.467,6,358,22669,209,69,8612,69,12500,149,69,12104,69,10169
0.392,6,12,1653,6,288,74,288,548,6,426,45,434,1105
8.55,6,6,272,3,0,4275,0,128,3,0,1519,0,144
131.358,17,4,352,2,60,131357,60,176,2,60,131357,60,176
0.916,6,10,1687,7,100,152,100,384,3,1179,330,1179,1303
127.282,6,13,5585,4,106,42421,106,274,9,823,15908,1460,5311
15.699,6,9,588,3,106,7842,106,234,6,90,3136,90,354
1782.02,6,368,25759,213,100,8405,469,14936,155,69,11570,69,10823
1.806,6,7,295,4,0,602,0,164,3,7,390,7,131
1680.842,1,13,754,13,30,140070,30,754,0,0,0,0,0
3.911,17,4,244,4,33,1303,33,244,0,0,0,0,0
126.402,2,2,64,2,8,126402,8,64,0,0,0,0,0
0.143,17,2,2728,2,1336,143,1336,2728,0,0,0,0,0
0.105,17,2,672,2,308,105,308,672,0,0,0,0,0
36.019,17,4,240,2,32,36019,32,120,2,32,36018,32,120
3.59,6,2,176,0,0,0,0,0,2,96,3590,96,176
93.122,17,20,2940,10,48,10346,48,760,10,190,10345,308,2180
0.186,6,9,1002,5,213,46,213,417,4,421,58,421,585
1690.523,17,17,3332,17,168,105657,168,3332,0,0,0,0,0
1741.425,17,30,31680,30,1028,60049,1028,31680,0,0,0,0,0
0.01,17,2,154,1,33,0,33,61,1,65,0,65,93
240.284,6,57,18343,29,801,8580,1418,15138,28,217,8898,580,3205
1789.23,6,416,24920,208,69,8643,69,12460,208,34,8643,48,12460
0.5,6,10,766,5,185,113,185,453,5,45,124,45,313
1709.367,1,28,1568,28,28,63309,28,1568,0,0,0,0,0
2.864,6,9,1002,5,213,716,213,417,4,421,951,421,585
2.555,6,13,2311,8,188,365,245,700,5,1407,574,1407,1611
300.906,6,43,14343,24,865,13082,1440,8781,19,399,480,1440,5562
0.52,17,3,451,2,39,274,39,134,1,289,0,289,317
0.148,17,2,327,1,35,0,35,63,1,236,0,236,264
280.496,6,29,7392,13,158,23374,267,1317,16,678,18695,3456,6075
2.148,17,28,14769,12,394,191,1350,5075,16,577,140,1350,9694
1783.514,17,83,3480,82,14,22018,14,3444,1,8,0,8,36
368.631,6,18,1239,14,177,28356,177,913,4,110,24282,110,326
0.242,17,3,451,2,39,232,39,134,1,289,0,289,317
85.794,1,4,224,4,28,28598,28,224,0,0,0,0,0
0.012,17,3,544,2,60,10,60,176,1,340,0,340,368
1787.615,17,87,3648,86,14,21030,14,3612,1,8,0,8,36
1700.621,17,12,498,11,14,170062,14,462,1,8,0,8,36
0.22,17,4,420,2,33,48,33,122,2,121,173,145,298
133.544,6,164,25817,89,304,1517,304,17852,75,83,1791,83,7965
1796.247,17,448,39896,403,35,4468,288,25676,45,288,40016,288,14220
0.053,17,2,136,1,32,0,32,60,1,48,0,48,76
1794.929,17,140,11200,70,48,26013,48,5320,70,56,26013,56,5880
1744.655,6,101,7918,65,45,27260,205,4850,36,35,49837,98,3068
0.072,17,2,642,1,300,0,300,328,1,286,0,286,314
84.382,6,31,8912,14,158,6490,267,1357,17,763,5269,2760,7555
278.501,6,44,8782,19,562,15472,1418,5516,25,139,10302,580,3266
0.328,6,21,5000,10,137,36,267,1092,11,692,30,1467,3908
499.491,1,3,168,3,28,249745,28,168,0,0,0,0,0
216.792,6,20175,16649908,8695,340,24,343,537356,11480,1360,18,4104,16112552
1794.336,17,300,59242,300,169,6001,358,59242,0,0,0,0,0
0.182,17,2,225,1,37,0,37,65,1,132,0,132,160
1783.525,6,356,22520,208,69,8616,69,12460,148,69,12130,69,10060
1.043,6,28,8503,15,225,62,561,1985,13,997,70,2720,6518
39.827,17,22,1936,11,48,3982,48,836,11,72,3982,72,1100
1787.139,17,142,11360,71,48,25530,48,5396,71,56,25530,56,5964
1772.3,6,180,15480,120,69,14893,69,8940,60,69,30036,69,6540
3.462,6,34,6169,17,206,216,314,2744,17,456,201,1152,3425
0.01,6,6,716,3,302,3,302,458,3,102,3,102,258
1785.637,6,356,22520,208,69,8626,69,12460,148,69,12147,69,10060
1737.961,6,137,17188,83,84,21194,876,7807,54,152,32791,2087,9381
0.919,6,23,6390,13,309,76,884,2070,10,979,101,1731,4320
3.454,6,22,7341,10,357,383,722,1476,12,672,275,1380,5865
472.644,1,18,1008,18,28,27802,28,1008,0,0,0,0,0
1776.475,1,290,30740,290,78,6146,78,30740,0,0,0,0,0
1780.622,1,63,5292,63,56,28719,56,5292,0,0,0,0,0
12.149,6,1955,1662674,1174,1363,10,1380,1625056,781,515,15,1923,37618
0.469,6,27,9130,13,263,39,688,1748,14,947,32,1368,7382
3.061,17,3,228,2,48,3049,48,152,1,48,0,48,76
289.327,1,4,224,4,28,96442,28,224,0,0,0,0,0
1785.519,17,87,3648,86,14,21006,14,3612,1,8,0,8,36
2.007,1,3,252,3,56,1003,56,252,0,0,0,0,0
3.162,6,4,1368,2,1208,3043,1208,1288,2,0,3152,0,80
0.031,6,6,716,3,302,9,302,458,3,102,8,102,258
1786.149,6,102,8296,68,65,26658,65,4930,34,59,54123,59,3366
0.02,17,2,182,1,39,0,39,67,1,87,0,87,115
1.468,6,47,18542,26,911,58,1460,12926,21,476,62,2615,5616
240.236,6,53,17574,28,777,8897,1408,14687,25,197,10009,580,2887
1786.394,6,104,8444,68,66,26662,66,4964,36,60,51037,60,3480
9.323,17,6,528,3,48,4656,48,228,3,72,4656,72,300
0.284,17,4,556,2,36,279,36,128,2,186,280,186,428
1771.169,6,105,9552,66,65,27248,65,5577,39,59,46607,59,3975
1770.878,6,99,9240,66,65,27244,65,5577,33,59,55336,59,3663
34.639,6,33,6040,16,154,2309,722,1934,17,402,2153,2026,4106
0.263,6,7,466,5,43,55,43,354,2,0,260,0,112
61.283,6,36,15980,22,810,2918,1408,9254,14,748,4694,2439,6726
3.93,6,32,6089,17,206,245,314,2744,15,548,260,1179,3345
1788.741,6,345,21873,201,69,8943,69,12042,144,69,12508,69,9831
70.096,6,37,20314,18,702,46,1460,4979,19,1040,3887,1460,15335
1682.749,17,14,1036,7,30,280451,30,406,7,62,280450,62,630
12.137,6,1915,1672775,1158,1389,10,1420,1638274,757,467,16,1883,34501
71.1,6,28,7355,12,155,6463,267,1266,16,494,4739,3426,6089
3.205,17,5,295,5,31,801,31,295,0,0,0,0,0
702.193,17,115,20991,115,154,6159,462,20991,0,0,0,0,0
0.66,6,10,924,5,283,110,283,551,5,105,115,105,373
2.867,17,4,624,4,128,955,128,624,0,0,0,0,0
73.93,6,32,7806,13,155,6160,267,1306,19,440,4104,1420,6500
2.498,17,4,1564,4,363,832,363,1564,0,0,0,0,0
962.525,2,9,288,9,8,120315,8,288,0,0,0,0,0
144.123,17,6,462,3,41,72061,41,207,3,57,71983,57,255
1777.031,17,79,3312,78,14,23078,14,3276,1,8,0,8,36
0.415,6,7,295,4,0,138,0,164,3,7,105,7,131
424.833,6,79,14765,41,93,10620,267,3323,38,309,11481,1420,11442
0.068,6,2,80,1,0,0,0,40,1,0,0,0,40
0.008,6,3,175,2,31,0,31,135,1,0,0,0,40
4.064,17,4,240,4,32,1354,32,240,0,0,0,0,0
0.335,17,2,182,1,39,0,39,67,1,87,0,87,115
1688.959,17,14,1036,7,30,281482,30,406,7,62,281486,62,630
57.511,6,514,442855,246,260,234,398,19050,268,1540,214,5792,423805
1788.176,17,87,3648,86,14,21037,14,3612,1,8,0,8,36
7.163,6,67,20662,36,559,204,1152,15995,31,427,230,1152,4667
516.868,6,47,8010,29,113,18459,499,2530,18,317,30399,1420,5480
334.692,6,78,22331,39,502,8807,1360,12213,39,355,8422,1360,10118
0.912,6,25,8805,14,290,70,802,1753,11,942,73,1460,7052
1726.564,17,24,1002,23,14,78480,14,966,1,8,0,8,36
0.025,17,4,284,2,32,16,32,120,2,54,10,60,164
1.72,6,14,2351,8,188,245,245,700,6,703,289,1152,1651
0.005,17,2,390,1,30,0,30,58,1,304,0,304,332
63.929,6,10,754,10,26,7103,26,754,0,0,0,0,0
4.47,6,29,10253,16,284,298,584,1496,13,1029,358,1420,8757
36.004,6,6,585,3,115,17998,138,465,3,0,17999,0,120
191.231,6,160,127861,103,1309,1874,1448,115398,57,632,1978,1448,12463
1.887,6,2,87,1,0,0,0,40,1,7,0,7,47
1.377,6,14,2598,7,288,192,288,600,7,568,154,853,1998
1.319,6,11,1727,7,100,219,100,384,4,589,350,1152,1343
0.081,17,2,348,1,39,0,39,67,1,253,0,253,281
1772.926,6,181,15589,121,69,14774,69,9049,60,69,30048,69,6540
66.878,17,24,2112,12,48,6079,48,912,12,72,6079,72,1200
25.869,6,26,10638,14,408,1989,916,1829,12,1039,2335,1565,8809
1723.269,17,26,8736,26,308,68930,308,8736,0,0,0,0,0
1781.786,6,361,24196,211,88,8484,469,13918,150,69,11958,69,10278
63.806,6,32,8952,14,158,4908,267,1357,18,624,3750,1400,7595
1.535,6,16,3555,7,288,226,288,624,9,639,169,853,2931
0.009,6,10,1852,6,108,1,108,428,4,1208,3,1208,1424
1.37,6,10,1687,7,100,228,100,384,3,1179,552,1179,1303
45.111,6,11,788,3,92,22467,92,256,8,92,6419,92,532
0.0,1,2,373,2,158,0,219,373,0,0,0,0,0
300.541,6,18,1227,6,177,60074,177,497,12,110,27306,110,730
300.822,6,47,14537,26,865,12032,1440,8895,21,399,537,1440,5642
1783.754,17,140,11200,70,48,25851,48,5320,70,56,25851,56,5880
3.362,6,12,1767,7,100,560,100,384,5,1179,776,1179,1383
1746.708,6,95,7203,63,38,28172,205,4476,32,33,56338,98,2727
72.224,6,31,7544,13,155,6018,267,1306,18,423,4247,3417,6238
1757.488,6,112,8322,62,26,28810,26,3638,50,115,35865,427,4684
14.006,6,23,4620,11,204,1400,721,1592,12,400,1255,2026,3028
594.002,1,5,280,5,28,148500,28,280,0,0,0,0,0
1744.635,2,29,928,29,8,62308,8,928,0,0,0,0,0
1.075,17,23,8095,11,452,106,1350,5280,12,206,93,1350,2815
1746.874,6,95,7203,63,38,28175,205,4476,32,33,56344,98,2727
2.243,6,14,2351,8,188,320,245,700,6,703,397,1152,1651
1799.274,17,448,39896,403,35,4475,288,25676,45,288,40019,288,14220
5.745,6,27,8110,16,637,383,1360,6412,11,411,557,541,1698
1624.284,2,12,384,12,8,147662,8,384,0,0,0,0,0
4.672,6,8,464,4,0,1498,0,216,4,0,1497,0,248
1797.747,17,449,39928,404,35,4460,288,25708,45,288,40015,288,14220
23.701,6,139,96621,67,621,359,804,6531,72,1263,114,5728,90090
1781.645,6,104,8424,68,64,26591,64,4896,36,58,50901,58,3528
1.675,6,49,19462,29,900,59,1360,13841,20,437,76,2715,5621
1795.793,17,449,39928,404,35,4456,288,25708,45,288,40017,288,14220
45.24,6,49,24872,29,951,1615,1402,22431,20,199,2380,580,2441
1.841,6,9,527,5,43,460,43,311,4,0,611,0,216
52.671,6,27,11618,15,693,3762,1152,3563,12,1060,4773,2728,8055
1680.257,1,7,392,7,28,280042,28,392,0,0,0,0,0
6.111,6,21,6506,6,154,1222,267,712,15,518,432,1460,5794
1783.82,6,356,22520,208,69,8617,69,12460,148,69,12134,69,10060
0.543,6,12,1653,6,288,102,288,548,6,426,59,434,1105
1786.238,17,87,3648,86,14,21014,14,3612,1,8,0,8,36
1774.291,6,180,15480,120,69,14910,69,8940,60,69,30070,69,6540
5.005,17,4,288,2,36,5004,36,128,2,52,4956,52,160
1743.091,6,95,7203,63,38,28114,205,4476,32,33,56220,98,2727
163.377,6,699,627186,270,149,607,362,15236,429,1410,370,1418,611950
0.271,17,2,384,1,39,0,39,67,1,289,0,289,317
0.109,17,2,152,1,48,0,48,76,1,48,0,48,76
1082.884,2,9,288,9,8,135360,8,288,0,0,0,0,0
659.111,2,5,160,5,8,164777,8,160,0,0,0,0,0
1793.126,17,180,11520,180,36,10017,36,11520,0,0,0,0,0
12.526,6,13,5621,4,480,4173,517,1177,9,1321,1564,1408,4444
1771.591,6,99,9240,66,65,27255,65,5577,33,59,55359,59,3663
1136.404,1,16,896,16,28,75760,28,896,0,0,0,0,0
0.502,17,3,451,2,39,418,39,134,1,289,0,289,317
1208.766,17,181,13756,181,48,6715,48,13756,0,0,0,0,0
0.016,17,2,160,1,48,0,48,76,1,56,0,56,84
3.064,6,4,192,1,0,0,0,48,3,0,1509,0,144
0.105,6,9,1340,5,145,26,145,349,4,827,31,827,991
1765.941,17,364,59744,364,136,4864,392,59744,0,0,0,0,0
12.043,17,2,152,2,48,12043,48,152,0,0,0,0,0
0.034,17,2,144,1,36,0,36,64,1,52,0,52,80
2.827,17,6,360,3,32,1412,32,180,3,32,1413,32,180
353.226,6,48,3457,19,62,19616,293,1636,29,47,12610,78,1821
188.151,6,28,9261,10,247,372,515,1393,18,549,11062,1452,7868
0.305,6,27,6118,13,164,25,453,1494,14,555,22,1542,4624
1744.343,6,95,7203,63,38,28134,205,4476,32,33,56262,98,2727
2.17,6,31,6870,15,121,155,267,1335,16,611,140,1420,5535
0.01,17,2,350,1,36,0,36,64,1,258,0,258,286
1746.649,6,95,7203,63,38,28171,205,4476,32,33,56333,98,2727
386.238,6,18,1242,14,180,29710,180,916,4,110,20087,110,326
1763.597,2,15,480,15,8,125971,8,480,0,0,0,0,0
3.149,17,3,228,2,48,3057,48,152,1,48,0,48,76
1784.682,17,86,3606,85,14,21246,14,3570,1,8,0,8,36
1.733,6,24,5594,13,151,142,380,1281,11,967,170,1771,4313
1741.215,17,30,20190,30,645,60041,645,20190,0,0,0,0,0
1618.175,2,12,384,12,8,147106,8,384,0,0,0,0,0
0.175,6,5,4891,4,1172,0,1460,4851,1,0,0,0,40
0.055,17,2,164,1,46,0,46,74,1,62,0,62,90
0.392,6,7,295,4,0,130,0,164,3,7,94,7,131
0.008,17,2,335,1,39,0,39,67,1,240,0,240,268
179.437,6,28,15226,14,648,41,1360,3196,14,1432,13793,3056,12030
180.699,6,95,64745,56,1226,3285,1368,55666,39,840,1647,2736,9079
1790.552,6,385,26784,220,97,8176,469,15699,165,69,10917,69,11085
4.258,6,32,6089,17,206,266,314,2744,15,548,284,1179,3345
10.71,6,1789,1629472,1126,1368,9,1408,1590332,663,931,15,2816,39140
1797.951,6,356,22520,208,69,8685,69,12460,148,69,12230,69,10060
1784.22,1,59,4956,59,56,30762,56,4956,0,0,0,0,0
249.104,2,6,192,6,8,49820,8,192,0,0,0,0,0
1.39,6,10,1102,6,483,278,483,803,4,83,460,83,299
280.254,6,30,7432,14,158,21558,267,1357,16,603,18679,2800,6075
1785.155,17,87,3648,86,14,21001,14,3612,1,8,0,8,36
1739.578,6,87,6322,58,31,30518,31,3915,29,31,62127,31,2407
0.084,17,4,304,2,37,44,37,130,2,59,41,65,174
1681.227,17,16,4241,8,30,240174,37,471,8,443,240174,463,3770
55.69,6,39,5531,21,154,2784,722,2183,18,267,925,1408,3348
1771.837,6,101,9278,66,64,27259,64,5544,35,58,52110,58,3734
3.718,17,8,480,4,32,1239,32,240,4,32,1239,32,240
0.466,6,2,80,1,0,0,0,40,1,0,0,0,40
7.15,6,1338,1212950,833,1378,8,1408,1182026,505,931,13,2816,30924
199.313,6,32,8952,14,158,15331,267,1357,18,624,11720,1400,7595
1389.266,6,88,11747,55,94,21079,498,4670,33,205,43411,2642,7077
1.478,6,48,18691,26,920,59,1460,13035,22,433,60,1460,5656
1780.364,17,140,11200,70,48,25802,48,5320,70,56,25802,56,5880
0.181,6,9,1339,5,145,45,145,349,4,826,43,826,990
1787.256,6,104,8376,68,65,26675,65,4930,36,59,51060,59,3446
0.182,17,2,157,1,31,0,31,59,1,70,0,70,98
48.577,6,31,7434,10,133,646,267,941,21,376,2428,1917,6493
15.49,6,8,436,3,0,7740,0,164,5,0,3870,0,272
0.915,6,30,9175,17,451,57,1460,3421,13,746,56,1547,5754
0.017,17,2,147,1,32,0,32,60,1,59,0,59,87
1782.943,6,356,22520,208,69,8613,69,12460,148,69,12128,69,10060
1739.149,6,87,6322,58,31,30511,31,3915,29,31,62111,31,2407
251.847,6,156,25230,86,304,2962,304,17940,70,83,3634,83,7290
0.011,17,2,422,1,72,0,72,100,1,294,0,294,322
1188.074,17,211,16036,211,48,5657,48,16036,0,0,0,0,0
1719.58,1,8,448,8,28,245654,28,448,0,0,0,0,0
123.249,17,14,1064,14,48,9480,48,1064,0,0,0,0,0
1.529,6,30,10543,16,614,94,1360,3756,14,690,103,1360,6787
1749.885,17,18,4627,9,31,218734,37,536,9,426,218734,463,4091
9.346,6,72,20410,36,541,267,1152,15519,36,429,256,1152,4891
0.03,17,2,235,1,36,0,36,64,1,143,0,143,171
11.236,6,26,9913,13,275,936,275,1078,13,1037,692,1420,8835
29.839,6,28,9061,14,344,2295,721,2976,14,1103,1737,2535,6085
1770.833,6,99,9306,66,66,27243,66,5610,33,60,55336,60,3696
0.112,17,2,396,1,39,0,39,67,1,301,0,301,329
41.797,6,5268,4948358,3344,1398,12,1448,4843622,1924,776,21,1448,104736
0.04,6,13,17920,1,0,0,0,40,12,1438,2,1438,17880
0.013,17,4,919,2,46,0,46,148,2,357,1,369,771
31.436,6,7,336,1,0,0,0,48,6,0,6285,0,288
11.908,6,672,546763,381,1351,31,1368,524033,291,899,40,2736,22730
0.085,6,5,200,2,0,85,0,80,3,0,2,0,120
82.268,17,4,3621,4,877,27422,1451,3621,0,0,0,0,0
0.007,6,14,3928,8,124,1,124,548,6,1530,1,2896,3380
183.982,17,4,240,2,32,183981,32,120,2,32,183981,32,120
40.54,17,6,528,3,48,20265,48,228,3,72,20264,72,300
0.007,6,3,160,2,0,7,0,100,1,0,0,0,60
0.816,6,2,80,1,0,0,0,40,1,0,0,0,40
3.496,6,13,2311,8,188,499,245,700,5,1407,811,1407,1611
0.395,6,13,1693,7,288,61,288,588,6,426,42,434,1105
1.063,6,29,5933,14,123,81,267,1428,15,650,67,1380,4505
237.873,17,4,240,2,32,237872,32,120,2,32,237872,32,120
20.311,6,3092,2903572,2010,1367,10,1408,2842644,1082,931,18,2816,60928
1.219,6,9,872,4,283,344,283,499,5,105,259,105,373
1772.663,6,180,15480,120,69,14896,69,8940,60,69,30041,69,6540
1771.747,1,58,4872,58,56,31083,56,4872,0,0,0,0,0
1786.671,6,118,15148,76,195,23822,1303,10460,42,79,43575,242,4688
1.157,6,25,8056,12,164,89,267,1288,13,869,81,1448,6768
1772.577,6,180,15480,120,69,14895,69,8940,60,69,30038,69,6540
0.257,17,2,152,1,48,0,48,76,1,48,0,48,76
1790.101,17,87,3648,86,14,21060,14,3612,1,8,0,8,36
36.218,17,20,1520,20,48,1906,48,1520,0,0,0,0,0
1789.823,6,366,25541,213,100,8442,469,14936,153,69,11774,69,10605
280.29,6,29,7392,13,158,23357,267,1317,16,603,18680,2036,6075
125.811,6,25,6318,9,272,94,516,1180,16,345,8381,1452,5138
20.887,6,8,506,0,0,0,0,0,8,31,2983,31,506
0.08,17,4,1220,2,64,56,64,184,2,490,56,504,1036
0.212,17,2,152,1,48,0,48,76,1,48,0,48,76
1775.723,6,180,15549,119,69,15048,69,8900,61,69,29591,69,6649
87.101,17,4,304,4,48,29033,48,304,0,0,0,0,0
20.564,17,4,824,2,48,20549,48,152,2,308,20550,308,672
1.318,6,46,18124,26,882,52,1360,12548,20,476,59,2715,5576
111.532,6,31,5368,16,267,4940,597,1985,15,425,7954,1448,3383
1798.358,1,286,16016,286,28,6310,28,16016,0,0,0,0,0
1787.906,6,376,26148,216,98,8315,469,15332,160,69,11244,69,10816
0.032,17,2,334,1,32,0,32,60,1,246,0,246,274
0.068,17,2,128,1,28,0,28,56,1,44,0,44,72
157.63,6,35,7960,12,142,14329,267,1341,23,316,7164,1460,6619
0.532,6,27,9008,13,243,44,611,1668,14,941,36,1368,7340
0.269,6,25,6073,12,181,24,537,1526,13,643,21,1542,4547
1.421,6,46,18768,27,865,54,1360,13232,19,476,68,2720,5536
0.128,6,9,1050,5,261,32,261,465,4,421,35,421,585
2.509,17,2,476,1,39,0,39,67,1,381,0,381,409
1680.236,1,15,840,15,28,120016,28,840,0,0,0,0,0
1781.921,6,363,23876,211,81,8485,469,13587,152,69,11800,69,10289
140.438,6,21,4636,12,186,12767,501,1415,9,570,16345,1420,3221
0.035,17,4,944,2,60,25,60,176,2,356,23,356,768
1790.705,6,361,22858,210,69,8567,69,12678,151,69,11937,69,10180
1775.051,6,180,15480,120,69,14916,69,8940,60,69,30076,69,6540
300.81,6,48,18412,27,971,11569,1360,12770,21,399,432,1360,5642
23.798,17,4,304,4,48,7932,48,304,0,0,0,0,0
3.5,17,5,295,5,31,875,31,295,0,0,0,0,0
0.01,6,3,144,1,0,0,0,40,2,0,1,0,104
0.758,6,10,1687,7,100,126,100,384,3,1179,255,1179,1303
93.718,6,40,8593,20,345,599,720,1915,20,419,4925,4848,6678
126.541,6,9,514,3,106,63265,106,234,6,0,25306,0,280
1786.231,17,87,3648,86,14,21014,14,3612,1,8,0,8,36
1789.053,6,386,29865,220,76,8169,267,13843,166,133,10842,2840,16022
8.205,6,71,20806,36,538,234,1152,15979,35,489,233,1179,4827
0.054,17,2,290,1,40,0,40,68,1,194,0,194,222
32.513,6,476,381353,224,126,145,301,15411,252,1422,129,2836,365942
56.454,6,24,13236,9,122,5136,122,594,15,1201,4023,1360,12642
11.818,6,1950,1650565,1164,1363,10,1380,1614499,786,421,15,1923,36066
1.815,6,4,270,1,31,0,31,83,3,31,907,31,187
1.612,6,13,2311,8,188,230,245,700,5,1407,342,1407,1611
20.081,6,36,12651,17,213,1254,517,1960,19,881,1115,1408,10691
367.249,6,27,1767,18,177,21602,177,1181,9,110,8534,110,586
3.666,6,14,3145,8,49,523,92,511,6,579,46,1408,2634
1.138,6,24,8028,12,164,88,267,1312,12,1014,88,2411,6716
1.938,6,20,3833,11,234,193,564,1504,9,463,219,1343,2329
1.828,6,31,11896,15,229,130,745,2202,16,1261,113,3779,9694
244.167,1,2,298,2,121,244167,121,298,0,0,0,0,0
0.032,17,2,363,1,29,0,29,57,1,278,0,278,306
589.519,17,14,2884,7,48,98250,48,532,7,308,98250,308,2352
0.125,17,4,336,2,34,0,34,124,2,78,85,84,212
7.128,6,168,198678,108,133,66,201,4887,60,3417,117,33936,193791
1741.342,17,30,31620,30,1026,60046,1026,31620,0,0,0,0,0
1797.485,17,448,39896,403,35,4471,288,25676,45,288,40023,288,14220
1680.214,1,13,754,13,30,140017,30,754,0,0,0,0,0
14.27,17,2,152,2,48,14270,48,152,0,0,0,0,0
0.169,17,2,154,1,33,0,33,61,1,65,0,65,93
252.214,2,2,64,2,8,252214,8,64,0,0,0,0,0
1793.255,17,180,14040,180,50,10018,50,14040,0,0,0,0,0
134.407,6,30,14114,14,493,54,1360,2579,16,1088,8952,1977,11535
13.114,6,122,43504,65,619,204,1152,36044,57,431,229,1179,7460
1794.927,1,204,21624,204,78,8842,78,21624,0,0,0,0,0
3.648,17,4,1564,4,363,1216,363,1564,0,0,0,0,0
0.014,17,2,245,1,32,0,32,60,1,157,0,157,185
0.04,6,2,84,1,0,0,0,44,1,0,0,0,40
1.623,6,48,19304,27,898,62,1360,13688,21,433,70,1360,5616
1756.425,6,2583,2407787,896,137,1962,358,54227,1687,1406,1041,2836,2353560
185.253,6,34,7866,11,155,1668,267,1226,23,317,8420,1460,6640
0.078,17,2,251,1,31,0,31,59,1,164,0,164,192
1789.947,6,373,26097,216,98,8325,469,15263,157,69,11474,69,10834
1681.578,17,14,1036,7,30,280255,30,406,7,62,280257,62,630
1798.259,6,121,12204,77,62,23661,722,6401,44,97,41813,2330,5803
1.986,6,13,1713,7,288,327,288,608,6,426,103,434,1105
1788.517,17,142,11360,71,48,25550,48,5396,71,56,25550,56,5964
236.932,6,6,1255,4,327,78977,413,814,2,180,236749,269,441
11.017,6,20,4442,11,275,1101,275,998,9,768,775,1440,3444
1787.211,6,102,8228,68,64,26674,64,4896,34,58,54155,58,3332
0.446,6,47,17487,26,869,17,1380,12405,21,421,20,1923,5082
9.866,6,2,1520,1,0,0,0,40,1,1440,0,1440,1480
0.287,17,4,284,2,32,0,32,120,2,54,0,60,164
0.521,6,27,9166,13,220,43,711,1799,14,945,36,1368,7367
0.01,17,3,451,2,39,8,39,134,1,289,0,289,317
1.361,17,8,1048,4,39,447,39,268,4,167,449,167,780
1790.561,6,366,25003,213,94,8446,469,14536,153,69,11778,69,10467
1784.293,6,106,8456,68,65,26631,65,4930,38,59,48221,59,3526
251.224,6,31,8981,13,158,20935,267,1317,18,578,14768,1400,7664
60.337,2,2,64,2,8,60337,8,64,0,0,0,0,0
1.644,6,15,1594,8,304,234,304,1044,7,83,271,83,550
1074.02,17,12,969,6,31,214798,37,355,6,74,214796,136,614
1.04,6,23,7940,13,164,86,267,1328,10,1216,95,3819,6612
0.802,2,3,128,3,18,401,24,128,0,0,0,0,0
3.127,17,20,6251,9,354,387,1350,3438,11,227,309,1350,2813
0.335,17,2,198,1,63,0,63,91,1,79,0,79,107
33.277,6,21,3182,12,183,3025,517,1561,9,381,4158,499,1621
0.16,6,3,175,2,31,34,31,135,1,0,0,0,40
0.026,6,2,80,1,0,0,0,40,1,0,0,0,40
0.025,17,4,284,2,32,14,32,120,2,54,12,60,164
1504.458,6,111,11456,64,70,23877,722,5509,47,97,32701,2330,5947
261.0,6,17,6188,4,106,87000,106,274,13,489,21734,1420,5914
541.441,2,7,224,7,8,90240,8,224,0,0,0,0,0
943.741,17,21,7204,21,315,47187,548,7204,0,0,0,0,0
8.327,6,39,8412,20,266,438,720,1898,19,441,454,1360,6514
1799.213,1,210,11760,210,28,8608,28,11760,0,0,0,0,0
1776.597,17,140,11200,70,48,25747,48,5320,70,56,25747,56,5880
1740.497,17,30,31680,30,1028,60017,1028,31680,0,0,0,0,0
1.173,2,2,64,2,8,1173,8,64,0,0,0,0,0
0.33,6,21,7281,12,334,28,663,1969,9,967,39,1471,5312
15.698,17,16,6344,8,484,2233,1350,4097,8,252,2229,1350,2247
1792.729,17,179,13962,179,50,10071,50,13962,0,0,0,0,0
1.397,6,24,8004,12,164,109,267,1288,12,1014,109,2491,6716
1776.7,17,140,11200,70,48,25749,48,5320,70,56,25749,56,5880
1743.074,1,16,896,16,28,116204,28,896,0,0,0,0,0
211.317,6,31,8912,13,158,17609,267,1317,18,763,12423,2085,7595
1793.813,1,333,27972,333,56,5403,56,27972,0,0,0,0,0
0.817,6,11,1727,7,100,136,100,384,4,589,181,1152,1343
1795.529,1,132,7392,132,28,13706,28,7392,0,0,0,0,0
0.176,6,10,1671,6,552,35,948,1348,4,159,58,159,323
240.208,6,54,17997,29,757,8578,1418,15146,25,192,10008,580,2851
0.012,17,2,472,1,45,0,45,73,1,371,0,371,399
20.142,6,22,5469,12,107,1831,159,1074,10,773,2235,1408,4395
0.373,6,26,9017,13,261,31,683,1728,13,943,30,1438,7289
1795.575,6,427,43507,243,167,7419,1380,22473,184,142,9810,453,21034
0.581,17,2,152,1,48,0,48,76,1,48,0,48,76
71.827,6,11,3124,11,232,7182,280,3124,0,0,0,0,0
0.22,17,5,1506,5,273,55,316,1506,0,0,0,0,0
1744.389,6,95,7203,63,38,28135,205,4476,32,33,56259,98,2727
108.724,6,38,8439,18,194,6395,721,2087,20,462,5640,2840,6352
1763.599,6,27,4077,18,241,103741,241,2889,9,92,220427,92,1188
0.997,6,26,5921,13,156,83,267,1462,13,655,77,1420,4459
0.174,6,46,22248,27,1077,6,1420,17267,19,467,9,1883,4981
3.228,17,3,228,2,48,3049,48,152,1,48,0,48,76
0.068,6,8,568,4,136,22,136,352,4,0,22,0,216
257.047,6,28,6961,13,229,155,498,1672,15,390,18355,1420,5289
1.137,6,6,328,4,0,379,0,216,2,0,1119,0,112
0.195,6,46,20830,26,1053,7,1420,15809,20,467,9,1883,5021
280.255,6,29,7392,13,158,23354,267,1317,16,603,18678,2036,6075
33.829,6,33,5399,16,154,2255,721,1911,17,371,2101,2026,3488
3.374,17,5,290,5,30,843,30,290,0,0,0,0,0
0.446,6,24,7458,13,335,36,668,2038,11,968,43,1906,5420
0.917,6,23,13518,13,520,76,1246,2112,10,1832,81,4429,11406
119.793,6,20,1961,9,69,14974,69,429,11,273,10128,341,1532
1740.622,17,30,31680,30,1028,60021,1028,31680,0,0,0,0,0
1.39,6,30,6427,15,164,99,267,1922,15,780,87,1460,4505
0.432,17,2,136,1,32,0,32,60,1,48,0,48,76
1763.463,2,14,448,14,8,135651,8,448,0,0,0,0,0
0.208,6,42,19523,25,1046,8,1420,14622,17,526,12,3303,4901
421.094,2,6,192,6,8,84218,8,192,0,0,0,0,0
1739.925,1,15,840,15,28,124280,28,840,0,0,0,0,0
1.388,6,47,19596,27,921,53,1360,14020,20,476,63,2720,5576
1680.978,1,15,840,15,28,120069,28,840,0,0,0,0,0
0.356,6,14,1733,7,288,57,288,588,7,284,31,434,1145
145.405,6,25,11705,12,433,86,990,1847,13,1036,12105,1360,9858
0.096,6,9,1339,5,145,24,145,349,4,826,17,826,990
536.347,6,88,6004,51,69,9618,69,3351,37,69,14897,69,2653
0.032,17,2,136,1,32,0,32,60,1,48,0,48,76
26.12,6,4085,3955288,2738,1368,9,1408,3880556,1347,931,19,2801,74732
1.43,6,49,21209,29,902,51,1360,15633,20,529,65,4075,5576
300.57,6,36,17822,20,1015,15819,1448,12233,16,678,4106,1448,5589
0.736,17,4,368,2,32,722,32,120,2,96,724,96,248
31.967,6,179,187131,51,126,639,300,3030,128,1431,251,2804,184101
381.034,6,18,1242,14,180,29310,180,916,4,110,20056,110,326
1779.43,17,140,11200,70,48,25788,48,5320,70,56,25788,56,5880
1772.077,6,180,15480,120,69,14891,69,8940,60,69,30030,69,6540
1796.88,17,449,39928,404,35,4458,288,25708,45,288,40017,288,14220
31.046,17,6,666,6,83,6209,84,666,0,0,0,0,0
1774.361,17,140,11200,70,48,25715,48,5320,70,56,25715,56,5880
301.009,6,25,9424,13,393,25070,1236,2137,12,970,27349,1360,7287
158.744,6,78,63381,51,1276,1027,1360,55705,27,1097,6098,3132,7676
0.775,17,5,556,2,80,439,84,216,3,85,260,104,340
12.689,6,2016,1751914,1221,1379,10,1420,1715893,795,467,15,1883,36021
124.299,6,21,8770,11,333,57,692,1473,10,1147,13798,2720,7297
1792.135,17,87,3648,86,14,21083,14,3612,1,8,0,8,36
1782.595,6,104,8376,68,65,26605,65,4930,36,59,50928,59,3446
1.18,17,32,21369,17,559,73,1350,9991,15,730,79,1350,11378
1788.09,1,264,14784,264,28,6798,28,14784,0,0,0,0,0
4.149,6,50,18479,26,452,165,1360,3908,24,799,172,2720,14571
0.98,6,28,8460,15,222,58,540,1964,13,994,66,1791,6496
12.421,17,3,375,2,41,10020,41,138,1,209,0,209,237
1742.343,6,127,11300,68,98,26005,205,7088,59,31,30034,33,4212
95.759,6,5,260,5,0,0,0,260,0,0,0,0,0
12.658,1,4,384,4,68,4219,112,384,0,0,0,0,0
1786.809,6,106,8446,69,64,26276,64,4936,37,58,49629,58,3510
15.305,17,23,16464,14,793,1174,1350,11495,9,524,1908,1350,4969
31.02,17,5,3575,5,687,7755,687,3575,0,0,0,0,0
5.511,6,41,7365,21,218,275,314,3463,20,516,276,1179,3902
1.503,6,53,21623,28,979,55,1440,15847,25,433,54,1440,5776
0.01,17,3,416,2,30,0,30,116,1,272,0,272,300
389.94,6,16,1138,12,180,35449,180,812,4,110,20318,110,326
1792.423,17,140,11200,70,48,25977,48,5320,70,56,25977,56,5880
0.51,6,20,7238,12,335,45,668,1974,8,1210,72,1906,5264
1786.185,6,154,19574,92,302,19628,302,13852,62,83,29281,83,5722
1.457,6,27,8029,15,303,104,952,2150,12,897,112,1738,5879
299.538,6,6,364,4,31,99846,31,222,2,31,299523,31,142
280.36,17,4,296,2,30,280347,30,116,2,62,280346,62,180
3.053,17,4,624,4,128,1017,128,624,0,0,0,0,0
99.144,6,15,1928,9,483,12393,483,1442,6,83,19824,83,486
8.27,6,20,6962,7,154,1378,267,752,13,631,655,1420,6210
1795.55,1,16,896,16,28,119703,28,896,0,0,0,0,0
1789.08,6,356,22520,208,69,8642,69,12460,148,69,12167,69,10060
1798.67,1,84,8904,84,78,21670,78,8904,0,0,0,0,0
6.846,6,22,4426,12,213,622,597,1689,10,552,741,1767,2737
1772.218,6,182,15560,120,69,14892,69,8940,62,69,29051,69,6620
1740.69,17,29,6815,29,207,62167,207,6815,0,0,0,0,0
1773.483,6,128,7856,70,27,25702,27,4210,58,27,31112,27,3646
61.657,6,55,36006,35,1147,1813,1408,28231,20,961,3233,3847,7775
1772.373,6,180,15480,120,69,14893,69,8940,60,69,30031,69,6540
1785.999,6,153,19582,91,304,19844,304,13860,62,83,29278,83,5722
0.889,6,167,120455,94,1318,9,1420,113244,73,427,12,1420,7211
3.337,17,5,295,5,31,834,31,295,0,0,0,0,0
185.343,17,4,240,2,32,185341,32,120,2,32,185341,32,120
494.374,6,65,10767,28,97,18309,267,2596,37,215,13732,1997,8171
1787.694,17,97,32654,97,308,18621,382,32654,0,0,0,0,0
0.055,17,4,284,2,32,0,32,120,2,54,2,60,164
17.396,17,26,6018,13,238,1446,1350,3466,13,168,1446,1350,2552
8.085,6,26,7748,13,256,673,721,1806,13,774,520,1414,5942
1675.709,1,7,392,7,28,279284,28,392,0,0,0,0,0
0.407,6,13,1693,7,288,61,288,588,6,426,48,434,1105
0.642,6,14,1745,7,288,78,288,600,7,426,77,434,1145
196.011,17,4,240,2,32,196010,32,120,2,32,196010,32,120
1.887,17,3,174,3,30,943,30,174,0,0,0,0,0
0.014,17,3,234,2,39,3,39,134,1,72,0,72,100
1.166,6,51,13829,24,551,50,1429,4840,27,464,44,1986,8989
0.018,17,4,1116,2,32,13,32,120,2,470,12,470,996
116.899,17,4,1344,4,308,38966,308,1344,0,0,0,0,0
6.176,6,15,1208,8,283,857,283,715,7,105,1000,105,493
0.868,6,118,87022,52,131,17,232,2609,66,1362,12,2760,84413
11.216,17,8,704,4,48,3735,48,304,4,72,3733,72,400
281.525,6,33,7759,14,143,21655,267,1426,19,506,15633,2760,6333
8.831,6,41,10211,20,419,464,944,2195,21,447,431,1360,8016
61.309,6,36,15904,22,802,2919,1402,9178,14,748,4697,2804,6726
0.859,6,20,5952,11,282,85,548,1292,9,716,96,1420,4660
15.82,17,10,880,5,48,3951,48,380,5,72,3951,72,500
2.982,6,3,180,3,0,0,0,180,0,0,0,0,0
1.348,6,50,19232,27,887,51,1440,13536,23,433,53,1440,5696
97.69,6,24,10054,12,532,57,1360,2642,12,1153,8868,2720,7412
0.914,6,25,9560,14,351,70,1045,1996,11,1016,74,1460,7564
1786.955,6,102,8296,68,65,26670,65,4930,34,59,54143,59,3366
0.896,6,10,1687,7,100,149,100,384,3,1179,327,1179,1303
52.663,17,16,18203,16,1109,3510,1451,18203,0,0,0,0,0
1771.149,6,99,9240,66,65,27248,65,5577,33,59,55344,59,3663
1509.384,6,89,6717,55,39,27951,205,3936,34,33,43019,98,2781
1792.245,17,87,3648,86,14,21085,14,3612,1,8,0,8,36
1772.92,6,181,15589,120,69,14898,69,8940,61,69,29546,69,6649
61.0,1,11,1144,0,0,0,0,0,11,76,6100,76,1144
661.691,2,7,224,7,8,110281,8,224,0,0,0,0,0
396.607,6,18,1242,14,180,30508,180,916,4,110,20093,110,326
1.327,6,51,19994,28,876,49,1360,14298,23,433,52,1360,5696
1789.192,17,142,11360,71,48,25559,48,5396,71,56,25559,56,5964
9.95,17,4,5476,4,1341,3316,1346,5476,0,0,0,0,0
300.631,6,38,8566,19,315,16701,882,2053,19,441,471,1460,6513
0.078,17,4,588,2,48,67,48,152,2,190,67,308,436
10.012,6,85,26554,42,554,244,1152,19979,43,404,232,1152,6575
1.209,17,4,368,2,32,379,32,120,2,96,1,96,248
0.258,17,16,8466,8,705,36,1350,5870,8,296,32,1350,2596
49.954,6,27,7177,13,155,4162,267,1306,14,530,3841,3417,5871
1792.565,17,139,11108,71,48,25607,48,5396,68,56,26754,56,5712
1789.557,17,142,11360,71,48,25564,48,5396,71,56,25564,56,5964
390.002,6,56,6196,20,95,18947,339,2329,36,127,11142,1062,3867
16.806,17,4,352,2,60,16805,60,176,2,60,16805,60,176
0.937,17,4,314,2,31,905,31,118,2,70,905,70,196
486.075,1,4,715,4,150,162025,351,715,0,0,0,0,0
1773.922,6,182,15698,120,69,14906,69,8940,62,69,29076,69,6758
0.127,17,2,389,1,34,0,34,62,1,299,0,299,327
1.318,6,30,7977,15,269,94,780,1978,15,1077,80,3098,5999
0.913,6,10,1687,7,100,152,100,384,3,1179,334,1179,1303
1776.807,17,73,3060,72,14,25025,14,3024,1,8,0,8,36
315.982,6,68,19230,37,348,8777,1360,9871,31,405,10528,3289,9359
0.135,6,2,100,1,0,0,0,60,1,0,0,0,40
603.072,2,7,224,7,8,100512,8,224,0,0,0,0,0
180.492,2,2,64,2,8,180492,8,64,0,0,0,0,0
231.871,17,6,528,3,48,115932,48,228,3,72,115932,72,300
240.2,6,53,17946,28,808,8896,1408,15212,25,178,10008,580,2734
1785.995,17,298,22648,298,48,6013,48,22648,0,0,0,0,0
1680.716,17,13,534,11,14,168053,14,462,2,8,1680531,8,72
5.532,6,39,7269,20,218,291,314,3423,19,513,292,1179,3846
4.086,6,11,467,6,0,817,0,248,5,7,751,7,219
9.537,6,20,1717,10,222,1058,222,1070,10,231,1058,231,647
61.371,6,37,15984,22,805,2922,1408,9206,15,665,4365,1408,6778
3.153,6,3,187,1,0,0,0,40,2,31,586,31,147
1486.243,6,263,23586,149,76,10042,267,10196,114,140,13151,1460,13390
251.99,2,2,64,2,8,251990,8,64,0,0,0,0,0
0.03,17,4,284,2,32,25,32,120,2,54,26,60,164
0.04,17,2,410,1,46,0,46,74,1,308,0,308,336
0.217,17,11,5089,5,468,54,1350,2482,6,406,31,1350,2607
3.935,17,5,290,5,30,983,30,290,0,0,0,0,0
1311.84,1,26,1456,26,28,52473,28,1456,0,0,0,0,0
0.062,17,4,420,2,33,0,33,122,2,121,1,145,298
15.686,17,12,5655,6,575,3131,1350,3622,6,310,3130,1350,2033
15.288,1,20,2080,0,0,0,0,0,20,76,804,76,2080
1787.833,17,87,3648,86,14,21033,14,3612,1,8,0,8,36
0.065,17,2,180,1,30,0,30,58,1,94,0,94,122
0.311,6,26,9060,13,271,25,726,1771,13,943,25,1408,7289
5.689,6,40,7325,20,218,299,314,3423,20,516,286,1179,3902
12.197,6,8,574,4,65,4065,65,355,4,59,782,59,219
6.477,6,19,6510,8,275,925,275,599,11,682,470,1414,5911
0.031,17,2,488,1,60,0,60,88,1,372,0,372,400
6.833,6,1412,1309860,897,1384,7,1408,1278416,515,931,12,2801,31444
12.278,6,32,13471,19,480,682,928,4155,13,976,1012,4416,9316
280.459,6,30,7773,13,158,23371,267,1317,17,524,17527,1400,6456
25.676,6,27,7177,13,155,2139,267,1306,14,530,1974,3417,5871
774.933,6,191,11336,99,69,7907,69,5754,92,37,8515,64,5582
1323.45,6,151,10422,55,46,24508,46,4374,96,46,13929,46,6048
1793.553,6,366,25541,213,99,8460,469,15005,153,69,11799,69,10536
300.368,6,48,23785,28,1047,11124,1440,16194,20,594,3425,1440,7591
1.104,6,28,8460,15,222,67,540,1964,13,994,77,1791,6496
0.095,6,7,423,4,43,20,43,259,3,0,20,0,164
1770.126,6,402,49704,198,169,8984,721,34935,204,146,8718,2840,14769
0.038,6,2,80,1,0,0,0,40,1,0,0,0,40
1296.001,17,303,35364,135,159,9671,1350,25273,168,32,7749,60,10091
366.362,6,22,1471,15,177,26168,177,989,7,110,13126,110,482
0.3,6,12,3462,6,75,59,75,395,6,1373,59,1448,3067
1786.25,17,140,11200,70,48,25887,48,5320,70,56,25887,56,5880
70.579,1,2,232,2,88,70579,100,232,0,0,0,0,0
17.235,17,20,2940,10,48,1913,48,760,10,190,1913,308,2180
274.363,1,20,2120,20,78,14440,78,2120,0,0,0,0,0
0.19,17,2,304,1,60,0,60,88,1,188,0,188,216
0.431,6,12,1653,6,288,80,288,548,6,426,49,434,1105
300.584,6,44,8947,23,315,13662,882,2261,21,388,436,2720,6686
10.475,6,1079,935453,633,1394,16,1448,905961,446,776,23,1448,29492
615.933,6,148,39141,72,458,8675,1360,25922,76,207,8210,2720,13219
13.82,17,16,2352,8,48,1972,48,608,8,190,1972,308,1744
1.212,6,23,7952,12,164,93,267,1288,11,1216,102,3819,6664
1772.802,6,180,15480,120,69,14897,69,8940,60,69,30042,69,6540
4.535,6,39,7285,19,218,251,314,3383,20,516,224,1179,3902
1.304,6,28,4260,13,240,108,630,2127,15,192,91,580,2133
3.352,17,34,13162,18,540,195,1350,10240,16,154,221,1350,2922
328.272,6,30,6500,11,139,32826,159,1150,19,727,18237,1408,5350
294.108,2,2,64,2,8,294108,8,64,0,0,0,0,0
0.294,1,6,336,0,0,0,0,0,6,28,58,28,336
0.302,17,2,136,1,32,0,32,60,1,48,0,48,76
240.856,6,120,80865,47,560,5235,1418,6986,73,1148,3345,1418,73879
1757.082,1,8,848,8,78,251011,78,848,0,0,0,0,0
1.428,6,50,20355,28,903,52,1360,14699,22,433,58,1360,5656
0.072,17,3,639,2,39,0,39,134,1,477,0,477,505
481.257,2,4,128,4,8,160419,8,128,0,0,0,0,0
1742.359,6,97,7307,63,38,28102,205,4476,34,33,52790,98,2831
1786.533,6,106,8524,68,66,26664,66,4964,38,60,48282,60,3560
15.508,17,16,6311,8,484,2204,1350,4096,8,248,2206,1350,2215
1716.329,1,8,848,8,78,245189,78,848,0,0,0,0,0
1782.593,6,354,22440,207,69,8653,69,12420,147,69,12209,69,10020
8.13,17,43,15831,20,525,426,1350,11065,23,179,368,1350,4766
1741.353,17,30,31620,30,1026,60046,1026,31620,0,0,0,0,0
10.658,6,20,4442,11,275,1065,275,998,9,768,735,1440,3444
113.527,6,43,10541,21,769,447,1360,4766,22,348,5397,2720,5775
6.839,6,1660,1593713,1087,1392,6,1408,1559253,573,931,11,2816,34460
1.022,17,4,668,2,39,1010,39,134,2,239,2,239,534
1787.129,6,104,8376,68,65,26673,65,4930,36,59,51056,59,3446
1793.67,17,87,3648,86,14,21102,14,3612,1,8,0,8,36
211.448,6,47,14068,20,181,11128,267,2256,27,630,8127,1400,11812
1750.616,17,12,498,11,14,175061,14,462,1,8,0,8,36
1796.267,17,446,39264,403,35,4468,288,25676,43,288,41929,288,13588
0.09,17,2,396,1,39,0,39,67,1,301,0,301,329
1699.606,1,9,504,9,28,212450,28,504,0,0,0,0,0
0.177,6,46,20820,26,1052,7,1420,15799,20,467,9,1883,5021
3.016,17,8,672,4,45,1003,45,292,4,67,1003,73,380
378.303,2,5,160,5,8,94575,8,160,0,0,0,0,0
1.483,6,47,18995,26,946,59,1460,13379,21,433,65,1460,5616
0.007,17,2,459,1,65,0,65,93,1,338,0,338,366
3.596,6,2,88,2,0,0,0,88,0,0,0,0,0
546.83,6,39,3101,23,54,24848,205,1745,16,35,36444,98,1356
1794.867,6,363,23007,211,69,8546,69,12787,152,69,11884,69,10220
1786.333,17,87,3648,86,14,21015,14,3612,1,8,0,8,36
1.383,6,46,18124,26,882,55,1460,12548,20,433,63,1460,5576
1.05,6,51,13865,24,551,45,1429,4876,27,464,39,1986,8989
1511.361,2,12,384,12,8,137396,8,384,0,0,0,0,0
16.181,1,9,504,9,28,2022,28,504,0,0,0,0,0
0.123,17,2,180,1,30,0,30,58,1,94,0,94,122
1785.228,1,228,12768,228,28,7864,28,12768,0,0,0,0,0
378.145,17,6,360,3,32,189071,32,180,3,32,189072,32,180
301.03,6,29,8120,17,397,18814,1018,2531,12,708,3030,2816,5589
575.979,6,8,692,8,46,82282,62,692,0,0,0,0,0
6.124,6,21,3433,11,324,612,585,1265,10,273,679,580,2168
1788.977,17,86,3606,85,14,21297,14,3570,1,8,0,8,36
1.109,6,28,8263,15,225,67,561,1985,13,957,77,1631,6278
30.003,6,5,384,2,46,30000,46,172,3,46,15000,46,212
1744.747,6,97,7307,63,38,28141,205,4476,34,33,52860,98,2831
1.556,6,69,46034,39,1259,40,1408,38569,30,1179,47,2816,7465
240.212,6,53,18138,28,803,8896,1402,15125,25,213,10008,580,3013
0.006,17,2,399,1,39,0,39,67,1,304,0,304,332
11.641,6,1859,1608887,1124,1376,10,1420,1575266,735,467,15,1883,33621
0.154,6,3,442,1,0,0,0,40,2,322,67,322,402
316.948,6,107,21947,42,314,7730,1360,10509,65,205,4949,1360,11438
0.277,6,28,7336,13,155,23,267,1301,15,543,18,1400,6035
1772.054,6,180,15480,120,69,14891,69,8940,60,69,30032,69,6540
86.756,6,23,8012,11,511,89,1194,2005,12,787,7871,1440,6007
1.98,17,2,148,2,46,1980,46,148,0,0,0,0,0
316.158,6,52,12360,26,174,12646,684,3519,26,458,12641,1929,8841
1772.292,6,180,15480,120,69,14893,69,8940,60,69,30038,69,6540
0.013,17,2,382,1,37,0,37,65,1,289,0,289,317
66.324,6,12,496,5,0,4732,0,204,7,0,11052,0,292
1743.189,6,95,7203,63,38,28115,205,4476,32,33,56218,98,2727
1789.95,6,366,25541,213,100,8443,469,14936,153,69,11775,69,10605
1775.612,17,152,12920,73,54,24661,136,6044,79,59,22764,104,6876
0.048,17,4,336,2,34,0,34,124,2,78,3,84,212
0.639,6,14,1745,7,288,76,288,600,7,426,76,434,1145
151.885,17,6,525,3,32,75920,37,181,3,86,75919,136,344
1795.242,17,448,39896,403,35,4465,288,25676,45,288,40018,288,14220
0.248,17,2,157,1,31,0,31,59,1,70,0,70,98
1.082,17,2,116,2,30,1082,30,116,0,0,0,0,0
1.032,6,13,989,7,222,169,222,510,6,231,202,231,479
1786.878,6,111,11674,72,131,25167,1287,7628,39,69,47019,240,4046
1795.482,17,448,39896,403,35,4466,288,25676,45,288,40017,288,14220
0.524,17,4,624,2,64,522,64,184,2,192,398,192,440
7.097,17,21,9910,9,630,882,1350,5924,12,304,641,1350,3986
967.169,6,65,5282,35,55,28446,205,2757,30,33,33342,98,2525
4.573,6,37,7189,19,218,254,314,3383,18,513,253,1179,3806
1797.704,17,449,39928,404,35,4460,288,25708,45,288,40016,288,14220
1799.635,17,142,11360,71,48,25708,48,5396,71,56,25708,56,5964
0.151,6,10,1671,6,552,30,948,1348,4,159,50,159,323
1772.934,6,181,15589,120,69,14898,69,8940,61,69,29544,69,6649
34.442,17,2,152,2,48,34442,48,152,0,0,0,0,0
20.478,6,6,665,2,241,2102,241,321,4,92,6825,92,344
8.786,6,633,559835,321,981,27,1360,33105,312,1731,27,5440,526730
42.797,6,28,7352,13,158,3566,267,1317,15,678,3054,2800,6035
0.034,6,5,276,3,0,17,0,164,2,0,20,0,112
0.6,6,7,295,4,0,200,0,164,3,7,183,7,131
0.014,17,4,352,2,37,6,37,130,2,83,5,89,222
15.923,6,81,26536,42,903,388,1101,15270,39,285,307,2128,11266
0.527,17,2,204,1,34,0,34,62,1,114,0,114,142
1764.687,2,12,384,12,8,160426,8,384,0,0,0,0,0
0.81,6,28,5967,13,156,67,267,1462,15,650,52,1420,4505
0.445,6,5,1564,3,413,222,413,946,2,269,216,269,618
1777.126,6,223,17442,83,72,21670,375,8278,140,50,12785,143,9164
3.003,17,8,792,4,39,1000,39,268,4,103,1000,103,524
196.069,6,23,6160,8,267,197,501,1125,15,369,13998,1420,5035
1.221,6,41,9968,21,440,61,1360,4392,20,433,55,1360,5576
1786.584,6,102,8296,68,65,26665,65,4930,34,59,54136,59,3366
6.141,6,6,324,4,0,2047,0,196,2,0,0,0,128
280.362,6,30,7432,13,158,23363,267,1317,17,543,17517,1400,6115
1744.696,2,19,608,19,8,96927,8,608,0,0,0,0,0
0.089,2,3,96,3,8,44,8,96,0,0,0,0,0
6.796,6,606,484731,347,1323,19,1368,466599,259,776,25,2736,18132
1796.07,6,207,19908,104,76,17435,721,9298,103,158,17606,1414,10610
15.737,6,26,6754,11,154,1573,267,912,15,475,1123,1420,5842
0.009,6,2,218,1,138,0,138,178,1,0,0,0,40
1684.534,2,28,896,28,8,62390,8,896,0,0,0,0,0
0.02,6,2,92,2,0,0,0,92,0,0,0,0,0
133.139,6,28,7352,13,158,11094,267,1317,15,678,9506,2045,6035
117.746,6,50,13982,22,840,1477,1360,7645,28,273,4354,2667,6337
0.085,17,2,422,1,46,0,46,74,1,320,0,320,348
66.105,17,4,352,2,60,66104,60,176,2,60,66103,60,176
0.371,6,12,1653,6,288,71,288,548,6,426,41,434,1105
10.027,17,2,128,2,36,10027,36,128,0,0,0,0,0
5.204,17,5,320,5,36,1301,36,320,0,0,0,0,0
1777.748,1,58,4872,58,56,31188,56,4872,0,0,0,0,0
1773.586,6,181,15589,120,69,14904,69,8940,61,69,29556,69,6649
0.051,17,2,548,2,246,51,246,548,0,0,0,0,0
1.431,1,2,701,2,322,1431,355,701,0,0,0,0,0
3.441,17,30,17777,14,629,263,1350,9204,16,507,227,1350,8573
0.159,17,2,218,1,65,0,65,93,1,97,0,97,125
1784.502,6,201,19157,103,68,17493,721,8633,98,169,18394,2828,10524
721.912,2,7,224,7,8,120318,8,224,0,0,0,0,0
120.542,6,14,2036,4,100,646,100,264,10,171,13366,1179,1772
4.839,17,2,656,2,300,4839,300,656,0,0,0,0,0
0.867,6,10,1687,7,100,144,100,384,3,1179,311,1179,1303
1780.321,6,346,57520,193,304,9272,304,40636,153,83,11712,83,16884
280.22,6,31,7472,14,158,21555,267,1357,17,543,17510,1400,6115
431.803,1,6,731,6,93,86360,125,731,0,0,0,0,0
0.912,6,9,1647,5,100,228,100,304,4,589,215,1152,1343
9.577,17,4,5480,4,1342,3192,1347,5480,0,0,0,0,0
2.31,6,13,2311,8,188,330,245,700,5,1407,511,1407,1611
0.988,6,29,8200,15,222,59,540,1964,14,944,62,1591,6236
1794.799,1,141,7896,141,28,12819,28,7896,0,0,0,0,0
903.165,6,176,11525,95,69,9081,69,5801,81,69,11289,69,5724
1792.816,1,61,5124,61,56,29880,56,5124,0,0,0,0,0
300.222,6,29,8854,16,404,20014,1242,2493,13,630,5495,1448,6361
34.289,17,40,5880,20,48,1804,48,1520,20,190,1804,308,4360
296.864,1,4,224,4,28,98954,28,224,0,0,0,0,0
3.941,17,4,352,4,60,1313,60,352,0,0,0,0,0
1790.841,6,356,22520,208,69,8651,69,12460,148,69,12182,69,10060
100.763,6,38,8499,16,227,278,721,2006,22,400,4790,2840,6493
19.982,6,21,8944,6,122,3996,122,394,15,1134,1315,1360,8550
1.142,17,6,1722,3,32,563,32,180,3,486,563,486,1542
0.009,17,2,199,1,45,0,45,73,1,98,0,98,126
0.036,6,2,92,1,0,0,0,52,1,0,0,0,40
1.76,17,20,5190,20,231,92,389,5190,0,0,0,0,0
0.017,17,2,656,1,300,0,300,328,1,300,0,300,328
1772.279,6,180,15480,120,69,14893,69,8940,60,69,30033,69,6540
0.012,17,2,376,1,39,0,39,67,1,281,0,281,309
1785.728,6,102,8296,68,65,26652,65,4930,34,59,54110,59,3366
0.82,17,2,116,2,30,820,30,116,0,0,0,0,0
20.138,6,24,6232,14,117,1549,159,1337,10,727,2236,1402,4895
0.125,6,3,120,1,0,0,0,40,2,0,3,0,80
9.565,17,3,228,3,48,4782,48,228,0,0,0,0,0
34.664,6,29,15874,17,645,2166,973,3940,12,1430,3138,3928,11934
1772.496,6,207,22588,132,75,13530,267,10206,75,133,23949,2828,12382
1799.063,17,426,35216,388,31,4648,288,23208,38,288,44356,288,12008
1.556,6,13,2311,8,188,222,245,700,5,1407,324,1407,1611
0.176,17,2,2382,2,1163,176,1163,2382,0,0,0,0,0
378.229,2,3,96,3,8,189114,8,96,0,0,0,0,0
494.628,6,9112,9095635,3157,392,156,426,175690,5955,1447,78,5752,8919945
0.621,17,28,22278,15,933,37,1350,14429,13,575,45,1350,7849
318.459,17,18,3708,9,48,39805,48,684,9,308,39805,308,3024
23.015,17,4,514,2,36,23011,36,128,2,165,23011,187,386
96.193,17,4,352,2,60,96192,60,176,2,60,96192,60,176
1776.089,17,142,11360,71,48,25372,48,5396,71,56,25372,56,5964
29.698,1,6,2297,6,354,5939,376,2297,0,0,0,0,0
0.282,6,26,6066,13,164,23,453,1494,13,555,22,1542,4572
1.538,6,19,3781,10,234,170,564,1452,9,463,167,1343,2329
1791.051,6,395,31925,225,91,7995,1189,15322,170,137,10597,2077,16603
61.849,6,76,51764,46,1208,1374,1448,43474,30,746,2124,1448,8290
5.031,17,4,288,2,36,5000,36,128,2,52,5000,52,160
15.815,17,5,380,5,48,3953,48,380,0,0,0,0,0
1771.87,6,101,9410,66,66,27259,66,5610,35,60,52111,60,3800
1772.358,6,180,15480,120,69,14893,69,8940,60,69,30035,69,6540
37.306,6,4875,4518434,3125,1366,11,1408,4422746,1750,931,21,2816,95688
145.137,17,4,240,2,32,145136,32,120,2,32,145136,32,120
288.659,17,4,352,2,60,288658,60,176,2,60,288658,60,176
0.016,17,2,350,1,39,0,39,67,1,255,0,255,283
1772.108,6,181,15589,120,69,14891,69,8940,61,69,29529,69,6649
1.135,6,24,8004,12,164,88,267,1288,12,1014,88,2804,6716
250.516,17,10,585,10,30,27835,31,585,0,0,0,0,0
0.072,6,20,9141,10,96,8,96,624,10,1141,8,1448,8517
126.711,2,2,64,2,8,126711,8,64,0,0,0,0,0
20.163,6,17,2316,10,189,2240,517,1298,7,323,3357,499,1018
1786.809,6,102,8364,68,66,26668,66,4964,34,60,54143,60,3400
12.663,17,4,352,2,60,12662,60,176,2,60,12662,60,176
11.71,6,1866,1618048,1130,1377,10,1420,1584387,736,467,15,1883,33661
273.794,1,10,280,10,0,0,0,280,0,0,0,0,0
427.746,17,8,1910,4,33,142578,37,246,4,388,142556,463,1664
240.217,6,50,17408,26,822,9608,1418,14512,24,205,10443,580,2896
1.354,6,48,18736,26,923,54,1460,13080,22,433,55,1460,5656
560.536,17,6,1647,3,30,280221,30,174,3,463,280263,463,1473
22.256,17,23,13189,11,958,2219,1350,10855,12,166,2014,1350,2334
31.454,6,7,336,1,0,0,0,48,6,0,6288,0,288
414.131,6,37,9463,18,256,24357,1189,3040,19,514,23005,2077,6423
1795.724,17,448,39896,403,35,4466,288,25676,45,288,40016,288,14220
1.472,6,48,19611,27,920,56,1360,13995,21,476,63,2715,5616
1782.531,17,83,3480,82,14,22006,14,3444,1,8,0,8,36
1700.537,17,12,498,11,14,170053,14,462,1,8,0,8,36
280.473,6,27,7312,12,158,25497,267,1277,15,775,20030,3465,6035
1797.887,17,448,39896,403,35,4472,288,25676,45,288,40016,288,14220
1681.583,17,18,1413,9,30,210193,37,529,9,70,210194,136,884
1681.812,17,14,1036,7,30,280298,30,406,7,62,280299,62,630
2.205,17,4,360,2,30,2145,30,116,2,94,2173,94,244
295.469,6,69,10551,29,170,10552,585,3609,40,242,7575,869,6942
0.134,17,4,386,2,43,2,43,142,2,94,126,100,244
1784.22,17,140,11200,70,48,25858,48,5320,70,56,25858,56,5880
1778.424,17,140,11200,70,48,25774,48,5320,70,56,25774,56,5880
9.88,6,806,713508,511,1325,18,1368,693492,295,776,32,2736,20016
1741.442,6,92,6668,60,31,29515,31,4062,32,31,56174,31,2606
10.148,6,40,8401,18,317,596,635,1703,22,387,472,1440,6698
12.97,17,30,12574,13,620,1080,1350,8425,17,216,807,1350,4149
1773.274,6,180,15480,120,69,14901,69,8940,60,69,30048,69,6540
4.01,17,8,1288,4,33,1333,33,244,4,233,1332,233,1044
6.058,6,1707,1581703,1078,1389,5,1408,1544331,629,931,9,2801,37372
1774.081,6,182,15698,120,69,14908,69,8940,62,69,29077,69,6758
148.044,6,84,55900,50,1210,3021,1368,47395,34,841,1869,2519,8505
176.757,6,22,1580,16,43,11783,43,1220,6,0,35338,0,360
11.817,6,1815,1632317,1111,1416,10,1432,1599912,704,420,16,1432,32405
318.688,6,11,843,4,65,18080,65,290,7,39,53100,59,553
1769.728,6,101,9410,66,66,27226,66,5610,35,60,52048,60,3800
15.02,6,24,6993,13,275,1251,275,1078,11,910,1000,1440,5915
4.949,6,27,3713,15,167,353,293,1614,12,402,245,1152,2099
1.244,17,30,16744,16,713,82,1350,11868,14,320,75,1350,4876
1796.085,17,448,39896,403,35,4467,288,25676,45,288,40019,288,14220
224.041,17,4,352,2,60,224040,60,176,2,60,224040,60,176
1.12,6,12,3671,6,125,222,125,445,6,968,222,1448,3226
3.101,6,10,1102,6,483,620,483,803,4,83,1016,83,299
1793.738,6,356,22520,208,69,8665,69,12460,148,69,12202,69,10060
4.387,17,40,16197,19,320,241,1350,6622,21,427,217,1350,9575
7.04,6,10,1778,7,95,1173,100,475,3,1179,2968,1179,1303
61.341,6,36,15811,22,793,2921,1402,9084,14,748,4698,2804,6727
1.229,6,41,11390,22,547,58,1360,5854,19,433,58,1360,5536
98.404,6,24,11438,12,397,67,884,1717,12,1153,8934,2720,9721
39.176,17,11,836,11,48,3917,48,836,0,0,0,0,0
293.139,17,3,181,3,32,146569,33,181,0,0,0,0,0
46.828,6,13,702,4,0,15609,0,204,9,7,5820,7,498
0.786,6,12,3702,6,170,154,170,490,6,964,111,1448,3212
157.358,17,4,352,2,60,157357,60,176,2,60,157357,60,176
1.288,6,44,10145,23,440,58,1360,4484,21,400,56,1360,5661
0.574,6,17,6992,10,146,63,175,956,7,1132,65,2601,6036
391.754,6,85,13570,43,136,9326,876,5260,42,244,9554,1408,8310
61.843,17,12,2472,6,48,12366,48,456,6,308,12366,308,2016
1.289,6,48,20072,28,889,47,1360,14496,20,476,58,2715,5576
281.073,6,30,7432,13,158,23422,267,1317,17,543,17564,1400,6115
87.01,6,28,7483,7,165,14501,267,949,21,334,4343,1420,6534
24.413,6,41,5774,23,304,1109,304,3976,18,83,1434,83,1798
300.307,6,55,30098,25,190,12512,444,2117,30,1100,8345,1461,27981
280.553,6,30,7432,14,158,21581,267,1357,16,678,18701,3456,6075
1744.191,6,95,7203,63,38,28132,205,4476,32,33,56253,98,2727
1682.386,1,15,840,15,28,120170,28,840,0,0,0,0,0
1777.067,17,73,3060,72,14,25029,14,3024,1,8,0,8,36
246.098,6,51,11041,22,247,11717,517,3873,29,432,8776,1368,7168
1786.807,6,102,8364,68,66,26668,66,4964,34,60,54142,60,3400
34.589,6,5,293,4,31,11529,31,222,1,31,0,31,71
1788.237,6,362,22898,210,69,8556,69,12678,152,69,11841,69,10220
24.001,6,31,5092,18,144,1411,517,2253,13,428,1994,499,2839
1778.852,1,254,26924,254,78,7031,78,26924,0,0,0,0,0
45.119,6,30,7297,14,155,3470,267,1346,16,441,3007,1420,5951
0.317,6,9,527,5,43,79,43,311,4,0,84,0,216
0.026,6,10,1723,6,578,4,997,1400,4,159,7,159,323
178.822,17,14,1120,7,48,29801,48,532,7,56,29801,56,588
280.26,6,28,7352,13,158,23355,267,1317,15,678,20016,3536,6035
1681.214,17,14,1036,7,30,280199,30,406,7,62,280198,62,630
5.016,6,39,7285,21,218,250,314,3463,18,516,278,1179,3822
818.144,6,106,7988,41,68,20450,292,3835,65,48,12781,78,4153
1.734,6,2,80,1,0,0,0,40,1,0,0,0,40
1744.871,6,97,7307,63,38,28143,205,4476,34,33,52863,98,2831
3.18,6,5,232,2,0,3180,0,88,3,0,1512,0,144
1.331,6,37,8214,18,321,78,1164,2678,19,433,62,1360,5536
14.098,6,16,2108,10,251,1566,564,1286,6,170,2023,258,822
0.48,6,10,968,5,256,116,256,460,5,304,117,304,508
163.761,6,24,10727,13,726,2434,1329,3457,11,1136,16356,2720,7270
1782.365,6,102,8296,68,65,26602,65,4930,34,59,54008,59,3366
0.085,6,2,87,1,0,0,0,40,1,7,0,7,47
150.177,17,6,528,3,60,75088,60,264,3,60,75088,60,264
0.349,17,2,440,1,39,0,39,67,1,345,0,345,373
299.53,6,7,404,4,31,99843,31,222,3,31,149760,31,182
75.68,6,32,7653,13,155,6306,267,1306,19,398,4203,3417,6347
0.054,17,2,152,1,48,0,48,76,1,48,0,48,76
0.278,17,2,136,1,32,0,32,60,1,48,0,48,76
445.763,1,9,954,9,78,55720,78,954,0,0,0,0,0
3.03,17,2,134,2,39,3030,39,134,0,0,0,0,0
0.228,17,2,152,1,48,0,48,76,1,48,0,48,76
1771.714,6,99,9240,66,65,27257,65,5577,33,59,55363,59,3663
1207.921,17,174,13224,174,48,6982,48,13224,0,0,0,0,0
3.53,17,5,588,4,64,1169,64,368,1,192,0,192,220
0.288,17,12,4413,12,339,26,362,4413,0,0,0,0,0
1786.47,6,104,8444,68,66,26663,66,4964,36,60,51039,60,3480
0.403,6,10,1992,5,288,92,288,508,5,424,56,434,1484
13.074,6,16,1327,8,222,1866,222,768,8,231,1866,231,559
0.014,17,2,374,1,56,0,56,84,1,262,0,262,290
22.012,17,4,288,2,36,22011,36,128,2,52,22011,52,160
1793.7,17,391,63501,391,134,4599,363,63501,0,0,0,0,0
240.182,6,51,17529,27,782,9237,1402,14714,24,194,10442,580,2815
1.521,6,77,52011,42,1272,37,1448,44184,35,857,39,1448,7827
110.916,6,21,8712,11,314,73,634,1415,10,1147,12309,2720,7297
101.589,6,824,436306,478,850,212,1152,420510,346,488,293,1179,15796
280.507,6,30,7432,13,158,23375,267,1317,17,543,17527,1380,6115
0.204,17,2,157,1,31,0,31,59,1,70,0,70,98
1798.11,6,2194,2210263,691,126,2605,332,41634,1503,1462,1197,8508,2168629
293.492,6,50,8423,22,141,13967,517,2321,28,384,10863,1418,6102
1599.588,6,97,7864,67,63,24236,63,5011,30,57,54819,57,2853
21.153,6,1758,1596932,1047,1439,19,1448,1551340,711,776,29,1448,45592
0.399,6,23,5975,13,108,33,147,959,10,922,43,2602,5016
1790.727,17,144,11520,72,48,25221,48,5472,72,56,25221,56,6048
1786.737,17,87,3648,86,14,21020,14,3612,1,8,0,8,36
61.312,6,37,15983,22,805,2919,1440,9205,15,665,4361,1440,6778
106.068,6,881,414082,463,823,229,1152,390627,418,395,251,1179,23455
0.219,6,25,7216,13,155,18,267,1301,12,678,18,3436,5915
1447.506,6,131,14531,69,81,19089,502,5614,62,139,23728,1420,8917
240.353,6,43,8990,21,519,12017,1402,5777,22,229,11445,618,3213
0.012,17,4,284,2,32,1,32,120,2,54,2,60,164
1794.487,6,359,22709,209,69,8627,69,12569,150,69,12041,69,10140
1686.159,6,123,12222,72,64,23746,722,6018,51,86,33719,2026,6204
2.069,6,28,10325,17,367,129,833,1785,11,1156,198,2840,8540
21.351,6,28,6464,17,117,1334,159,1501,11,1091,2026,3077,4963
66.667,6,27,7177,13,155,5555,267,1306,14,530,5127,3417,5871
2.992,6,44,18832,23,525,136,1440,3638,21,896,108,1440,15194
61.558,6,19,772,10,0,6838,0,404,9,0,7692,0,368
1660.013,6,106,14613,63,94,26774,721,7135,43,442,10682,2535,7478
1386.671,6,140,12017,92,69,15238,69,6923,48,69,29503,69,5094
1792.069,17,142,11352,72,48,25239,48,5472,70,56,25970,56,5880
1583.665,1,8,448,8,28,226237,28,448,0,0,0,0,0
1.267,6,26,9564,13,164,91,267,1388,13,1070,91,2411,8176
1741.566,6,87,6322,58,31,30553,31,3915,29,31,62198,31,2407
1744.914,6,97,7307,63,38,28143,205,4476,34,33,52865,98,2831
1775.657,17,140,11200,70,48,25734,48,5320,70,56,25734,56,5880
65.541,17,30,2725,27,30,2520,37,1580,3,353,2399,435,1145
0.921,6,9,1647,6,100,184,100,344,3,1179,327,1179,1303
8.682,6,1437,1206601,838,1387,10,1420,1178396,599,420,14,1420,28205
0.056,17,3,208,2,36,3,36,128,1,52,0,52,80
0.151,17,8,2758,8,316,21,355,2758,0,0,0,0,0
7.105,6,1508,1386698,951,1380,7,1408,1353070,557,931,12,2801,33628
1737.019,1,8,448,8,28,248145,28,448,0,0,0,0,0
31.57,1,4,224,4,28,10523,28,224,0,0,0,0,0
1788.73,6,106,8388,68,64,26697,64,4896,38,58,48341,58,3492
1790.227,17,32,10496,32,300,57749,300,10496,0,0,0,0,0
4.72,6,38,7245,19,218,262,314,3383,19,516,247,1179,3862
13.369,17,4,352,2,60,13368,60,176,2,60,13368,60,176
1775.584,6,210,16246,78,69,23057,313,7738,132,48,13553,78,8508
0.009,6,3,151,1,0,0,0,40,2,31,1,31,111
541.44,2,4,128,4,8,180480,8,128,0,0,0,0,0
300.851,6,68,53226,46,1241,6685,1368,47106,22,828,1964,1571,6120
1738.539,6,87,6322,58,31,30500,31,3915,29,31,62090,31,2407
1.271,6,23,7952,12,164,98,267,1288,11,1216,107,3819,6664
8.881,6,83,24877,41,561,222,1152,19056,42,413,210,1152,5821
1772.052,6,180,15480,120,69,14891,69,8940,60,69,30031,69,6540
0.21,6,35,8509,17,277,13,517,1811,18,497,11,1432,6698
0.459,6,13,1693,6,288,88,288,548,7,426,42,434,1145
9.801,6,9,527,5,43,2450,43,311,4,0,3265,0,216
0.004,17,2,341,1,38,0,38,66,1,247,0,247,275
287.084,17,4,352,2,60,287083,60,176,2,60,287082,60,176
32.993,17,40,5880,20,48,1735,48,1520,20,190,1732,308,4360
0.006,17,2,358,1,30,0,30,58,1,272,0,272,300
0.911,6,12,1048,6,256,181,256,500,6,304,181,304,548
721.86,2,8,256,8,8,103122,8,256,0,0,0,0,0
0.021,17,3,392,2,60,1,60,176,1,188,0,188,216
81.963,6,20,8986,11,364,78,773,1564,9,1410,10228,3966,7422
0.067,17,6,444,6,46,13,46,444,0,0,0,0,0
1.526,6,51,19052,28,934,56,1460,13311,23,400,58,1460,5741
0.009,17,2,157,1,31,0,31,59,1,70,0,70,98
2.944,6,69,18677,35,551,86,1429,5364,34,497,79,1986,13313
1700.771,17,13,534,11,14,170043,14,462,2,8,1700598,8,72
1737.341,1,57,4788,57,56,31023,56,4788,0,0,0,0,0
1787.398,17,87,3648,86,14,21028,14,3612,1,8,0,8,36
11.437,6,26,9953,13,275,953,275,1078,13,1042,895,1440,8875
577.602,1,11,1350,11,94,57760,125,1350,0,0,0,0,0
20.184,6,18,2368,10,189,2242,517,1298,8,323,2881,499,1070
144.544,6,25,6369,8,272,276,516,1140,17,324,9028,1452,5229
1681.164,17,14,3843,7,30,280193,30,406,7,463,280193,463,3437
2.706,17,23,7897,9,274,338,1350,2724,14,341,121,1350,5173
33.794,6,368,355528,128,134,266,324,7198,240,1423,141,2836,348330
3.673,6,3,144,2,0,3673,0,92,1,0,0,0,52
0.049,17,2,167,1,39,0,39,67,1,72,0,72,100
0.126,17,2,384,1,32,0,32,60,1,296,0,296,324
1.57,6,30,10405,18,367,92,833,1825,12,1012,134,1420,8580
16.526,17,4,352,2,48,16516,48,152,2,72,16514,72,200
6.047,17,5,1716,5,315,1511,376,1716,0,0,0,0,0
1711.969,1,8,448,8,28,244567,28,448,0,0,0,0,0
6.235,17,4,588,2,48,6227,48,152,2,190,6226,308,436
1786.375,17,87,3648,86,14,21016,14,3612,1,8,0,8,36
240.2,6,53,17466,28,767,8896,1408,14509,25,206,10008,580,2957
1754.411,1,8,448,8,28,250630,28,448,0,0,0,0,0
36.64,6,41,8437,20,311,565,618,1814,21,480,1824,4080,6623
148.829,6,25,11358,12,433,71,990,1823,13,1000,12391,1360,9535
1704.049,1,116,6496,116,28,14817,28,6496,0,0,0,0,0
0.421,6,7,371,4,0,140,0,204,3,7,108,7,167
1799.406,17,140,11200,70,48,26078,48,5320,70,56,26078,56,5880
172.051,6,42,18877,21,708,32,1360,4426,21,971,8596,1360,14451
159.138,6,31,2274,13,75,13248,296,1123,18,47,9361,78,1151
1778.01,17,142,11360,71,48,25399,48,5396,71,56,25399,56,5964
5.864,6,40,7309,21,218,293,314,3463,19,513,312,1179,3846
1799.783,17,449,39928,404,35,4465,288,25708,45,288,40015,288,14220
12.123,6,32,6910,15,214,865,314,2744,17,580,740,1179,4166
0.003,6,3,156,1,0,0,0,52,2,0,3,0,104
0.468,17,3,451,2,39,462,39,134,1,289,0,289,317
1789.259,17,142,11360,71,48,25560,48,5396,71,56,25560,56,5964
0.192,17,2,152,1,48,0,48,76,1,48,0,48,76
1791.729,1,342,28728,342,56,5254,56,28728,0,0,0,0,0
67.294,6,73,47269,44,1185,1564,1448,39034,29,746,2201,1448,8235
11.211,6,7,388,4,0,3737,0,216,3,0,5595,0,172
8.25,6,14,1047,8,275,1178,275,603,6,96,1214,96,444
1796.573,17,448,39896,403,35,4469,288,25676,45,288,40022,288,14220
0.256,17,3,951,3,289,128,292,951,0,0,0,0,0
0.322,17,4,360,2,30,290,30,116,2,94,291,94,244
0.167,17,2,152,1,48,0,48,76,1,48,0,48,76
1787.452,6,104,8504,69,66,26286,66,5004,35,60,52565,60,3500
5.018,17,4,558,2,36,5008,36,128,2,187,5008,187,430
1.29,17,14,6961,7,598,215,1350,4384,7,340,206,1350,2577
1.197,6,24,8004,11,164,101,267,1236,13,869,84,1448,6768
0.526,6,26,7495,16,302,35,693,2761,10,721,54,1460,4734
0.17,1,2,112,2,28,170,28,112,0,0,0,0,0
60.365,6,7,418,4,106,20121,106,274,3,0,1510,0,144
1732.194,6,60,4400,40,33,44415,33,2740,20,31,91158,31,1660
5.218,17,26,8656,10,248,579,1350,2761,16,340,213,1350,5895
1786.614,6,106,8574,70,65,25892,65,5010,36,59,51043,59,3564
24.996,6,19,3349,13,211,1876,211,1950,6,545,4998,904,1399
134.994,17,4,240,2,32,134993,32,120,2,32,134993,32,120
118.342,6,24,3307,8,221,88,517,1322,16,381,7889,499,1985
1.016,6,27,8120,14,266,64,540,1924,13,944,69,1591,6196
1.281,6,26,9592,14,350,98,1041,1992,12,1015,94,1460,7600
1.062,6,25,8080,12,164,82,267,1312,13,869,75,1408,6768
0.774,6,31,7813,18,405,45,1360,2791,13,498,49,1384,5022
1.542,17,27,9956,13,334,125,1350,4712,14,346,115,1350,5244
2.293,6,13,2311,8,188,327,245,700,5,1407,510,1407,1611
2.552,6,42,13520,22,225,113,561,2349,20,863,125,1631,11171
1788.584,6,398,24344,215,69,8357,69,12740,183,45,9827,69,11604
0.012,17,2,325,1,36,0,36,64,1,233,0,233,261
0.04,6,15,6364,8,126,5,126,550,7,1360,6,2381,5814
240.336,6,43,9078,21,519,12016,1402,5778,22,238,11444,617,3300
1771.085,6,104,9500,66,65,27247,65,5577,38,59,47864,59,3923
1795.358,17,448,39384,403,35,4466,288,25412,45,282,40018,288,13972
61.329,6,42,21715,26,966,2453,1408,14885,16,748,4072,2439,6830
301.015,6,65,57983,41,195,7525,431,2932,24,2561,2884,7040,55051
0.054,6,7,423,4,43,6,43,259,3,0,26,0,164
1783.261,17,118,9440,59,48,30745,48,4484,59,56,30745,56,4956
0.044,17,2,136,1,32,0,32,60,1,48,0,48,76
378.256,2,3,96,3,8,189128,8,96,0,0,0,0,0
1785.895,6,376,26148,216,98,8306,469,15332,160,69,11231,69,10816
1790.658,6,356,22520,208,69,8650,69,12460,148,69,12181,69,10060
1742.941,6,95,7203,63,38,28111,205,4476,32,33,56211,98,2727
125.466,6,18,3555,10,92,13940,92,656,8,413,17896,2026,2899
301.055,6,53,19443,30,936,10381,1360,13430,23,338,401,2667,6013
1775.259,6,182,15698,120,69,14918,69,8940,62,69,29099,69,6758
1792.058,17,179,13962,179,50,10067,50,13962,0,0,0,0,0
280.435,6,28,7352,14,158,21571,267,1357,14,678,21567,3456,5995
1769.75,1,58,4872,58,56,31048,56,4872,0,0,0,0,0
1007.187,2,6,192,6,8,201437,8,192,0,0,0,0,0
1679.535,17,12,498,11,14,167953,14,462,1,8,0,8,36
1744.716,2,29,928,29,8,62311,8,928,0,0,0,0,0
440.458,17,8,608,4,48,146813,48,304,4,48,146813,48,304
1788.257,6,134,15781,82,90,22077,502,6803,52,156,35062,1420,8978
156.893,17,4,240,2,32,156892,32,120,2,32,156892,32,120
126.243,2,2,64,2,8,126243,8,64,0,0,0,0,0
10.763,6,18,4266,10,275,1195,275,958,8,992,851,1440,3308
1740.59,17,29,30624,29,1028,62163,1028,30624,0,0,0,0,0
587.2,1,6,489,6,53,117440,78,489,0,0,0,0,0
1772.037,6,180,15480,120,69,14891,69,8940,60,69,30032,69,6540
1771.626,6,99,9306,66,66,27255,66,5610,33,60,55360,60,3696
931.523,6,151,10149,79,71,11941,138,5092,72,65,13120,69,5057
1771.892,6,99,9306,66,66,27259,66,5610,33,60,55368,60,3696
61.763,6,70,47467,43,1196,1470,1408,39326,27,961,2366,3847,8141
1745.993,6,94,7151,62,38,28622,205,4424,32,33,56312,98,2727
0.008,17,2,554,1,30,0,30,58,1,468,0,468,496
240.195,6,55,17810,29,783,8578,1418,14837,26,201,9607,580,2973
214.175,1,6,336,6,28,42835,28,336,0,0,0,0,0
0.347,6,29,9180,14,252,26,646,1746,15,947,23,1402,7434
33.551,6,32,5193,15,180,2396,722,1859,17,271,2083,1402,3334
1.19,6,31,10326,16,623,75,1460,3799,15,657,71,1460,6527
1.418,6,49,18871,27,864,54,1360,13215,22,433,58,1360,5656
268.242,17,10,585,10,30,29804,31,585,0,0,0,0,0
1584.393,6,136,10480,87,66,18423,66,6120,49,60,32803,60,4360
34.947,17,40,5880,20,48,1838,48,1520,20,190,1838,308,4360
0.163,17,2,2382,2,1163,163,1163,2382,0,0,0,0,0
1.289,6,40,9940,21,440,64,1360,4404,19,476,62,2715,5536
7.451,6,23,4478,12,213,677,597,1689,11,441,727,1448,2789
1798.915,1,16,896,16,28,119927,28,896,0,0,0,0,0
1786.933,6,102,8296,68,65,26670,65,4930,34,59,54146,59,3366
8.262,6,80,24725,41,542,206,1152,19008,39,461,210,1179,5717
1578.242,17,121,9660,63,48,25455,48,4788,58,56,25890,56,4872
1797.416,1,345,28980,345,56,5225,56,28980,0,0,0,0,0
1793.411,17,180,14040,180,50,10019,50,14040,0,0,0,0,0
0.409,6,9,527,5,43,102,43,311,4,0,100,0,216
0.847,6,20,5948,11,281,84,544,1288,9,716,94,1420,4660
0.212,6,46,21478,26,1099,8,1420,16457,20,467,10,1883,5021
9.317,6,17,6735,9,275,1164,275,643,8,1440,1163,1440,6092
7.875,6,34,6276,17,206,492,314,2744,17,474,475,1179,3532
16.301,6,37,7653,21,259,815,501,2398,16,461,1080,1420,5255
1781.766,6,364,23047,211,69,8484,69,12787,153,69,11722,69,10260
0.392,6,107,87729,59,131,6,232,2889,48,1928,8,5680,84840
1796.644,17,448,39896,403,35,4469,288,25676,45,288,40012,288,14220
1.131,6,28,9274,16,203,75,458,1498,12,910,80,2566,7776
0.039,17,4,336,2,34,1,34,124,2,78,34,84,212
0.347,6,69,55127,29,241,12,517,2483,40,1404,8,1440,52644
0.213,6,46,20716,26,1045,8,1420,15695,20,467,10,1883,5021
0.115,6,45,39884,14,273,8,517,1557,31,1359,3,1438,38327
6.217,6,38,7245,20,218,327,314,3423,18,516,350,1179,3822
1770.399,6,99,9240,66,65,27236,65,5577,33,59,55322,59,3663
1790.072,17,179,13962,179,50,10056,50,13962,0,0,0,0,0
0.041,6,13,3514,7,75,6,75,447,6,1373,8,1448,3067
1745.504,6,96,7255,62,38,28614,205,4424,34,33,52881,98,2831
2.185,6,6,340,3,0,1092,0,160,3,0,497,0,180
61.819,6,68,48610,44,1197,1437,1408,40628,24,960,2677,3847,7982
1746.224,1,60,5040,60,56,29597,56,5040,0,0,0,0,0
368.993,6,25,1651,17,177,23062,177,1117,8,110,9202,110,534
1776.541,17,73,3060,72,14,25021,14,3024,1,8,0,8,36
1782.411,6,360,22887,207,69,8652,69,12558,153,69,11725,69,10329
0.556,17,2,152,1,48,0,48,76,1,48,0,48,76
5.129,6,11,1731,7,100,854,100,384,4,1179,1615,1179,1347
1786.307,1,112,6272,112,28,16092,28,6272,0,0,0,0,0
66.273,6,12,976,4,226,146,226,442,8,110,9439,110,534
1777.733,17,73,3060,72,14,25038,14,3024,1,8,0,8,36
0.25,1,6,624,0,0,0,0,0,6,76,50,76,624
34.353,17,20,1760,10,48,3816,48,760,10,72,3816,72,1000
1795.648,17,449,39928,404,35,4455,288,25708,45,288,40015,288,14220
29.041,17,2,908,2,426,29041,687,908,0,0,0,0,0
29.053,6,37,9748,20,630,1529,1360,3355,17,518,597,3565,6393
0.116,6,14,4334,7,111,19,111,483,7,869,19,1448,3851
7.356,6,67,20166,35,540,216,1152,15459,32,489,227,1179,4707
1787.175,6,102,8296,68,65,26674,65,4930,34,59,54154,59,3366
1.938,6,3,180,3,0,0,0,180,0,0,0,0,0
33.839,17,2,122,2,33,33839,33,122,0,0,0,0,0
0.838,17,2,148,2,46,838,46,148,0,0,0,0,0
256.339,17,10,585,10,30,28482,31,585,0,0,0,0,0
237.998,17,4,352,2,60,237996,60,176,2,60,237997,60,176
1781.76,6,365,25501,212,100,8444,469,14896,153,69,11722,69,10605
1781.571,17,73,3060,72,14,25092,14,3024,1,8,0,8,36
1748.904,6,138,10734,84,65,21071,65,6155,54,59,32996,59,4579
1.363,6,51,20498,27,975,52,1460,14762,24,433,51,1460,5736
696.691,6,122,18977,60,117,11808,721,6644,62,393,11417,2391,12333
15.468,6,6,288,1,0,0,0,48,5,0,3864,0,240
0.398,6,26,8990,13,247,33,624,1672,13,947,31,1448,7318
1783.942,6,118,13894,75,81,24107,501,5950,43,159,42472,1420,7944
0.042,6,2,195,1,0,0,0,40,1,103,0,103,155
0.089,17,2,572,1,39,0,39,67,1,477,0,477,505
1620.649,1,7,392,7,28,270108,28,392,0,0,0,0,0
5.092,6,39,7269,20,218,268,314,3423,19,513,268,1179,3846
1.372,6,53,19528,29,895,49,1360,13747,24,400,51,1360,5781
1772.318,6,180,15480,120,69,14893,69,8940,60,69,30037,69,6540
11.594,6,25,8473,13,275,966,275,1078,12,986,760,1440,7395
1.372,6,47,18756,27,862,52,1360,13180,20,476,62,2715,5576
1.364,6,53,20317,29,952,48,1460,14536,24,400,51,1460,5781
6.01,6,40,7309,20,218,316,314,3423,20,513,300,1179,3886
6.82,6,27,7384,11,155,682,267,1226,16,459,454,3426,6158
1680.402,1,15,840,15,28,120028,28,840,0,0,0,0,0
736.949,6,149,9548,86,69,8669,69,5165,63,69,11881,69,4383
0.151,6,42,17897,24,997,6,1420,12944,18,467,8,1883,4953
2.35,6,47,17397,25,779,90,1460,9618,22,573,103,1934,7779
3.651,6,22,6413,10,262,400,517,1316,12,744,327,1418,5097
8.077,17,4,240,2,32,8076,32,120,2,32,8076,32,120
317.026,6,58,12695,29,150,11322,615,3596,29,417,11317,4649,9099
1.018,6,23,9487,13,351,84,1048,1959,10,1186,91,2370,7528
1795.019,17,87,3648,86,14,21117,14,3612,1,8,0,8,36
1797.203,6,370,25839,215,99,8398,469,15154,155,69,11670,69,10685
176.43,17,2,368,2,156,176430,156,368,0,0,0,0,0
1.666,6,30,10405,18,367,98,833,1825,12,1012,143,1420,8580
42.674,6,183,75285,90,762,479,1152,66892,93,424,454,1179,8393
1795.448,17,300,48945,300,135,6004,376,48945,0,0,0,0,0
1772.316,6,182,15629,121,69,14769,69,8980,61,69,29535,69,6649
8.607,6,4,1183,0,0,0,0,0,4,341,2869,341,1183
0.329,17,8,2750,8,315,47,354,2750,0,0,0,0,0
1786.9,17,87,3648,86,14,21022,14,3612,1,8,0,8,36
8.133,1,9,756,0,0,0,0,0,9,56,1016,56,756
4.219,6,38,7229,19,218,234,314,3383,19,513,220,1179,3846
1747.165,6,97,7307,63,38,28180,205,4476,34,33,52934,98,2831
1789.154,1,342,28728,342,56,5246,56,28728,0,0,0,0,0
1796.765,17,316,54529,316,144,5704,385,54529,0,0,0,0,0
316.958,6,110,36024,56,536,5762,1360,24789,54,312,5977,1929,11235
1787.327,6,103,8395,68,65,26676,65,4930,35,59,52564,59,3465
282.343,6,31,7679,12,158,25491,267,1277,19,512,15683,3456,6402
374.891,6,84,5501,38,69,10132,69,2279,46,47,8330,69,3222
95.209,6,35,5314,21,154,4760,722,2183,14,399,1197,1408,3131
1792.778,17,180,11520,180,36,10015,36,11520,0,0,0,0,0
1799.317,17,449,39928,404,35,4464,288,25708,45,288,40019,288,14220
0.195,17,2,172,1,50,0,50,78,1,66,0,66,94
1775.852,6,98,7421,64,38,28188,205,4559,34,33,53808,98,2862
1751.805,6,187,11810,94,52,18836,208,7191,93,31,19038,31,4619
3.305,17,2,702,2,323,3305,323,702,0,0,0,0,0
3.143,17,4,934,2,40,3130,40,136,2,371,13,379,798
34.841,6,27,7046,16,124,2322,159,1600,11,695,3483,1418,5446
40.256,6,5,293,4,31,13418,31,222,1,31,0,31,71
63.36,6,16,1618,8,302,9051,302,1016,8,83,9048,83,602
1797.084,17,448,39896,403,35,4470,288,25676,45,288,40020,288,14220
0.016,17,2,579,1,41,0,41,69,1,482,0,482,510
0.094,6,12,3462,6,75,18,75,395,6,1373,18,1448,3067
1.09,6,24,8028,12,164,84,267,1312,12,1014,84,2411,6716
241.294,6,57,14853,26,694,9651,1408,11121,31,192,8042,580,3732
0.424,6,26,9026,13,263,35,691,1736,13,943,33,1438,7290
1782.992,6,286,19996,171,69,10488,69,11049,115,69,15640,69,8947
1785.799,6,104,8376,68,65,26653,65,4930,36,59,51020,59,3446
2.649,6,82,55709,47,1257,57,1368,47726,35,769,72,1368,7983
43.453,6,43,13683,22,1015,517,1360,8041,21,435,2163,2667,5642
0.361,17,2,152,1,48,0,48,76,1,48,0,48,76
1797.133,6,367,25650,214,99,8437,469,15045,153,69,11822,69,10605
1.649,17,2,144,1,36,0,36,64,1,52,0,52,80
1799.668,1,264,14784,264,28,6842,28,14784,0,0,0,0,0
25.049,6,18,1407,9,222,3130,222,808,9,231,3130,231,599
1793.885,6,376,26217,218,98,8266,469,15412,158,69,11424,69,10805
1.039,6,22,4722,13,207,86,520,1711,9,633,118,2301,3011
1.741,6,27,10205,16,289,116,600,1512,11,1031,157,1420,8693
9.579,6,2011,1750476,1147,1432,8,1448,1693068,864,776,10,1448,57408
62.794,6,33,7960,14,154,4830,267,1958,19,475,3485,1452,6002
0.018,17,2,904,1,300,0,300,328,1,548,0,548,576
1797.892,1,54,4536,54,56,33922,56,4536,0,0,0,0,0
1776.046,17,73,3060,72,14,25014,14,3024,1,8,0,8,36
3.726,17,6,966,3,33,1858,33,183,3,233,1857,249,783
5.993,6,41,7349,21,218,299,314,3463,20,513,300,1179,3886
1745.553,6,97,7338,64,38,27707,205,4528,33,33,54534,98,2810
1770.197,6,101,9344,66,65,27233,65,5577,35,59,52059,59,3767
240.301,6,46,9417,23,197,10920,751,2609,23,560,10920,2378,6808
37.429,17,22,1672,22,48,1782,48,1672,0,0,0,0,0
1797.886,6,368,25759,214,99,8440,469,15045,154,69,11749,69,10714
85.356,6,23,8390,12,514,172,1237,2068,11,838,8515,2720,6322
1682.277,17,16,4348,8,30,240324,30,464,8,457,240324,463,3884
1778.902,17,352,58748,352,138,5068,385,58748,0,0,0,0,0
1776.459,6,191,18610,126,99,14211,469,11525,65,69,27751,69,7085
1752.091,6,95,7203,63,38,28259,205,4476,32,33,56505,98,2727
1772.282,6,180,15480,120,69,14893,69,8940,60,69,30031,69,6540
240.74,6,56,18488,28,815,8915,1418,15330,28,210,8915,580,3158
1784.261,17,83,3480,82,14,22027,14,3444,1,8,0,8,36
1798.197,6,356,22520,208,69,8686,69,12460,148,69,12232,69,10060
1.964,17,4,720,3,64,972,64,276,1,416,0,416,444
49.342,1,8,448,8,28,7048,28,448,0,0,0,0,0
1786.292,6,384,42025,184,264,9761,841,15329,200,88,8972,1536,26696
7.824,6,10,1718,6,100,1564,100,344,4,603,2518,1179,1374
11.318,6,6,328,4,0,3772,0,216,2,0,11075,0,112
11.838,17,3,984,3,300,5919,300,984,0,0,0,0,0
11.889,6,1877,1609572,1138,1362,10,1380,1575725,739,387,16,1923,33847
1787.394,6,102,8228,68,64,26677,64,4896,34,58,54160,58,3332
1744.725,2,30,960,30,8,60162,8,960,0,0,0,0,0
11.025,6,19,4362,11,275,1102,275,998,8,1010,893,2840,3364
294.19,17,4,240,2,32,294189,32,120,2,32,294189,32,120
1787.29,6,104,8376,68,65,26675,65,4930,36,59,51059,59,3446
0.094,17,2,1918,2,931,94,931,1918,0,0,0,0,0
1787.223,6,104,8376,68,65,26674,65,4930,36,59,51060,59,3446
1681.006,17,12,498,11,14,168100,14,462,1,8,0,8,36
1790.187,1,266,14896,266,28,6755,28,14896,0,0,0,0,0
0.351,17,17,9859,8,541,50,1350,4555,9,561,34,1350,5304
66.958,6,10,648,10,31,7439,31,648,0,0,0,0,0
1773.163,6,180,15480,120,69,14900,69,8940,60,69,30045,69,6540
200.289,6,312,385726,144,543,1400,1402,14013,168,2326,1123,7010,371713
1.277,6,48,18803,27,862,49,1360,13187,21,433,55,1360,5616
1776.468,17,140,11200,70,48,25745,48,5320,70,56,25745,56,5880
16.414,6,22,6056,11,386,1641,548,1618,11,664,1557,1420,4438
8.276,6,1747,1495358,982,1429,8,1448,1443314,765,776,10,1448,52044
1741.033,17,29,6815,29,207,62179,207,6815,0,0,0,0,0
36.403,6,73,16329,36,355,1040,916,3080,37,419,951,1460,13249
90.347,6,41,9010,14,175,6949,267,1619,27,314,3467,1460,7391
0.117,17,2,182,1,39,0,39,67,1,87,0,87,115
0.021,17,2,128,1,36,0,36,64,1,36,0,36,64
377.161,6,27,1767,18,177,22185,177,1181,9,110,8752,110,586
1.251,6,39,9900,21,440,62,1360,4404,18,433,63,1360,5496
32.67,6,38,10508,19,830,494,1440,4946,19,399,1805,1440,5562
29.348,17,15,7805,8,655,4192,1350,5471,7,305,48,1350,2334
9.385,6,2,149,0,0,0,0,0,2,69,9385,69,149
1.669,6,47,18683,27,856,64,1360,13107,20,433,76,1360,5576
377.866,2,4,128,4,8,125955,8,128,0,0,0,0,0
0.938,17,388,390044,82,96,11,1350,10245,306,1213,2,1350,379799
136.837,17,4,240,2,32,136836,32,120,2,32,136836,32,120
1740.55,17,29,30624,29,1028,62162,1028,30624,0,0,0,0,0
0.056,17,2,912,1,308,0,308,336,1,548,0,548,576
304.488,6,7,614,6,106,60897,106,566,1,0,0,0,48
0.102,17,2,180,1,30,0,30,58,1,94,0,94,122
65.248,17,3,228,3,48,32624,48,228,0,0,0,0,0
9.935,17,53,61132,9,800,1241,1350,7459,44,1191,230,1350,53673
756.101,2,6,192,6,8,151220,8,192,0,0,0,0,0
56.934,6,135,50127,72,692,801,1360,36901,63,381,915,1938,13226
16.495,17,39,15475,17,621,1029,1350,11036,22,173,784,1350,4439
67.929,6,631,293782,326,832,209,1152,276077,305,392,222,1152,17705
1799.644,17,142,11360,71,48,25709,48,5396,71,56,25709,56,5964
31.465,6,7,308,1,0,0,0,44,6,0,6275,0,264
300.825,6,14,1404,8,226,42950,226,876,6,110,60129,110,528
263.574,6,9,515,5,43,65893,43,299,4,0,87819,0,216
128.446,6,1210,602848,664,841,193,1152,575876,546,394,235,1152,26972
0.005,17,3,618,2,32,3,32,120,1,470,0,470,498
48.989,6,27,7177,13,155,4082,267,1306,14,530,3767,3417,5871
0.008,17,2,399,1,39,0,39,67,1,304,0,304,332
240.2,6,53,17846,28,788,8895,1418,14875,25,207,10007,580,2971
0.02,17,4,352,2,37,11,37,130,2,83,12,89,222
273.945,1,6,336,6,28,54789,28,336,0,0,0,0,0
1.353,6,50,21780,29,935,48,1360,16164,21,433,58,1360,5616
137.134,17,16,2068,10,48,15236,48,760,6,190,8000,308,1308
1786.725,17,242,55790,242,202,7413,342,55790,0,0,0,0,0
0.208,6,16,6056,9,70,24,133,504,7,1756,33,2440,5552
1.2,6,4,184,2,0,1200,0,88,2,0,1012,0,96
7.932,6,29,10729,17,609,495,865,3748,12,721,680,1420,6981
1797.779,17,259,85464,259,301,6968,308,85464,0,0,0,0,0
36.748,17,14,1064,14,48,2826,48,1064,0,0,0,0,0
1772.848,6,180,15480,120,69,14897,69,8940,60,69,30039,69,6540
1786.068,6,102,8364,68,66,26657,66,4964,34,60,54120,60,3400
1795.989,17,318,75638,318,209,5665,373,75638,0,0,0,0,0
116.494,17,4,240,2,32,116493,32,120,2,32,116493,32,120
3.415,17,2,136,1,32,0,32,60,1,48,0,48,76
1.69,6,224,191622,123,213,13,258,9092,101,1808,16,5632,182530
0.007,6,2,277,1,185,0,185,237,1,0,0,0,40
1781.653,17,142,11568,71,50,25452,136,5572,71,56,25452,72,5996
6.866,6,31,7544,12,155,624,267,1266,19,367,380,1420,6278
4.856,6,40,7309,20,218,255,314,3423,20,513,240,1179,3886
6.194,6,39,7269,21,218,309,314,3463,18,513,348,1179,3806
4.999,6,41,7349,22,218,238,314,3503,19,513,263,1179,3846
63.482,6,42,9435,17,327,131,1189,2663,25,477,2644,1460,6772
17.634,17,4,240,2,32,17633,32,120,2,32,17632,32,120
1770.965,6,105,9828,68,66,26432,66,5792,37,60,49190,60,4036
0.287,1,2,112,2,28,287,28,112,0,0,0,0,0
0.046,17,2,198,1,39,0,39,67,1,103,0,103,131
1793.835,1,218,12208,218,28,8266,28,12208,0,0,0,0,0
1.323,6,53,22450,29,970,47,1360,16714,24,433,49,1360,5736
0.186,6,10,1669,6,551,37,947,1346,4,159,62,159,323
0.042,17,2,201,1,40,0,40,68,1,105,0,105,133
0.559,6,11,997,6,191,77,259,623,5,58,95,110,374
184.155,17,4,288,2,36,184154,36,128,2,52,184153,52,160
1741.433,17,29,30624,29,1028,62194,1028,30624,0,0,0,0,0
4.202,17,5,295,5,31,1050,31,295,0,0,0,0,0
127.218,6,31,18451,17,708,47,1360,4314,14,1507,9775,4870,14137
41.993,6,40,8672,20,410,459,882,2074,20,413,2203,1460,6598
1772.387,6,180,15480,120,69,14894,69,8940,60,69,30034,69,6540
10.866,17,18,18224,18,984,639,1450,18224,0,0,0,0,0
90.405,6,908,438451,482,840,187,1152,415224,426,412,212,1179,23227
1785.456,6,366,23472,209,69,8583,69,12776,157,69,11445,69,10696
0.113,6,3,128,2,0,113,0,84,1,0,0,0,44
3.038,2,2,64,2,8,3038,8,64,0,0,0,0,0
0.077,6,9,1002,5,213,19,213,417,4,421,16,421,585
4.978,6,39,7285,20,218,262,314,3423,19,516,262,1179,3862
1.82,6,3,127,1,0,0,0,40,2,7,0,7,87
1787.301,17,87,3648,86,14,21027,14,3612,1,8,0,8,36
0.069,17,2,152,1,48,0,48,76,1,48,0,48,76
1796.459,1,208,11648,208,28,8678,28,11648,0,0,0,0,0
0.423,6,21,7203,12,318,36,600,1906,9,964,50,1471,5297
119.287,17,19,1444,19,48,6627,48,1444,0,0,0,0,0
95.954,17,4,352,2,60,95953,60,176,2,60,95953,60,176
1.223,6,6,255,3,0,611,0,124,3,7,155,7,131
39.489,17,22,1672,22,48,1880,48,1672,0,0,0,0,0
299.649,6,218,170431,143,1276,2109,1360,161472,75,282,4046,2667,8959
1791.162,6,401,26920,213,100,8448,469,14936,188,44,9578,69,11984
130.898,6,9,515,2,0,218,0,112,7,7,21787,7,403
1.385,6,49,19252,26,891,55,1460,13556,23,433,55,1460,5696
0.94,6,11,1727,7,100,156,100,384,4,589,228,1152,1343
1656.092,1,8,448,8,28,236584,28,448,0,0,0,0,0
2.021,17,2,925,1,548,0,548,576,1,321,0,321,349
1438.556,6,87,8812,52,65,26544,65,3770,35,104,42306,279,5042
1798.903,17,768,46308,768,32,2345,37,46308,0,0,0,0,0
1.061,6,26,5700,13,125,88,267,1275,13,780,79,1460,4425
0.052,6,10,1495,5,507,12,507,727,5,556,13,556,768
1775.3,17,138,11040,69,48,26107,48,5244,69,56,26107,56,5796
240.379,6,42,8796,21,524,12018,1418,5816,21,235,12018,639,2980
1781.762,6,364,23047,211,69,8484,69,12787,153,69,11722,69,10260
0.123,6,3,151,2,31,3,31,111,1,0,0,0,40
3.502,6,2,88,2,0,0,0,88,0,0,0,0,0
5.961,17,3,1008,3,308,2980,308,1008,0,0,0,0,0
0.548,6,14,1745,7,288,63,288,600,7,426,63,434,1145
1790.311,6,310,79935,186,715,9677,722,54025,124,156,14555,271,25910
88.634,6,42,9843,15,290,2790,1189,2644,27,339,3408,1420,7199
1.641,6,30,10405,18,367,96,833,1825,12,1012,141,1420,8580
1618.149,1,7,392,7,28,269691,28,392,0,0,0,0,0
0.182,6,11,1373,5,585,45,585,841,6,212,26,212,532
1679.099,1,67,3752,67,28,25440,28,3752,0,0,0,0,0
280.387,6,30,7432,13,158,23365,267,1317,17,543,17516,1400,6115
280.226,6,29,7392,13,158,23352,267,1317,16,603,18679,2036,6075
1.662,6,26,8743,16,275,110,557,1469,10,981,165,1420,7274
20.819,6,32,9771,18,220,1224,517,2033,14,700,1586,1288,7738
0.134,17,4,414,2,40,1,40,136,2,111,92,117,278
0.243,6,151,147890,103,183,2,230,6217,48,3025,3,15488,141673
1798.546,1,158,8848,158,28,11455,28,8848,0,0,0,0,0
69.759,6,30,7366,13,155,5813,267,1306,17,413,4355,1420,6060
1787.505,6,102,8296,68,65,26679,65,4930,34,59,54162,59,3366
101.087,6,11,719,11,31,10108,31,719,0,0,0,0,0
31.596,6,7,396,1,0,0,0,60,6,0,6278,0,336
841.678,6,54,4502,39,64,22149,64,3032,15,58,54144,58,1470
1.31,6,38,9848,21,440,65,1360,4392,17,529,71,4075,5456
185.014,17,4,352,2,60,185013,60,176,2,60,185013,60,176
4.218,6,35,6209,19,206,234,314,2824,16,548,265,1179,3385
756.022,2,6,192,6,8,151204,8,192,0,0,0,0,0
227.199,17,4,352,2,60,227198,60,176,2,60,227198,60,176
0.212,17,2,152,1,48,0,48,76,1,48,0,48,76
295.963,6,36,8086,13,158,24663,267,1317,23,365,13451,1400,6769
1789.744,17,142,11360,71,48,25567,48,5396,71,56,25567,56,5964
0.008,17,2,554,2,249,8,249,554,0,0,0,0,0
114.16,17,4,240,2,32,114159,32,120,2,32,114159,32,120
1745.304,6,95,7203,63,38,28150,205,4476,32,33,56293,98,2727
34.35,17,6,1236,3,48,17169,48,228,3,308,17169,308,1008
366.91,6,27,2579,15,183,26207,183,815,12,424,2801,434,1764
333.73,1,14,784,14,28,25671,28,784,0,0,0,0,0
23.538,6,13,1954,7,196,3923,196,508,6,398,4652,419,1446
0.701,6,13,1096,7,256,114,256,544,6,304,137,304,552
1773.96,6,242,17981,121,69,14783,69,8980,121,34,14782,48,9001
0.484,6,14,3149,7,92,80,92,464,7,463,37,1408,2685
1.526,6,51,21597,29,921,54,1360,15941,22,433,62,1360,5656
8.961,6,14,2242,8,210,1274,210,844,6,545,1790,904,1398
1775.544,17,85,3564,84,14,21392,14,3528,1,8,0,8,36
5.563,6,482,405894,292,1324,18,1368,391350,190,776,28,1473,14544
0.099,6,10,1671,6,552,19,948,1348,4,159,33,159,323
1791.516,1,222,12432,222,28,8106,28,12432,0,0,0,0,0
1754.0,1,80,6720,0,0,0,0,0,80,56,22202,56,6720
1094.42,17,762,53559,684,40,1602,41,46962,78,56,496,57,6597
369.421,6,25,1651,17,177,23088,177,1117,8,110,9219,110,534
125.35,2,2,64,2,8,125350,8,64,0,0,0,0,0
212.199,6,31,6806,13,189,9176,516,1470,18,307,12477,1452,5336
1786.479,6,103,8404,68,66,26663,66,4964,35,60,52540,60,3440
1792.552,17,87,3648,86,14,21088,14,3612,1,8,0,8,36
2.999,17,4,296,4,46,999,46,296,0,0,0,0,0
0.064,6,9,1343,5,145,16,145,349,4,830,14,830,994
140.881,17,4,240,2,32,140880,32,120,2,32,140880,32,120
0.182,6,46,22295,27,1080,7,1420,17314,19,467,9,1883,4981
91.846,6,34,23871,19,840,33,1360,5835,15,2178,6551,5440,18036
0.814,17,4,1108,2,30,803,30,116,2,468,800,468,992
1687.889,1,7,742,7,78,281314,78,742,0,0,0,0,0
240.279,6,54,18044,28,794,8898,1418,14978,26,213,9610,580,3066
0.009,17,2,154,1,33,0,33,61,1,65,0,65,93
63.263,6,16,2291,9,325,7907,587,1127,7,396,10425,580,1164
1751.297,6,99,7814,65,45,27364,205,4850,34,35,53060,98,2964
1788.701,17,87,3648,86,14,21043,14,3612,1,8,0,8,36
52.138,6,10,1114,4,483,17379,483,687,6,83,9994,83,427
1796.979,6,367,25250,213,93,8476,469,14605,154,69,11744,69,10645
6.287,6,1027,871409,611,1381,10,1420,850548,416,467,15,1883,20861
55.217,6,22,4470,12,398,5019,705,2892,10,291,6116,338,1578
1797.324,17,448,39896,403,35,4470,288,25676,45,288,40019,288,14220
33.565,6,31,5107,15,180,2385,722,1872,16,299,2226,1448,3235
280.255,6,27,7312,12,158,25477,267,1277,15,678,20015,2045,6035
1790.338,6,365,25501,212,100,8485,469,14896,153,69,11777,69,10605
1101.498,6,149,20267,95,117,11718,469,10036,54,161,19631,3423,10231
1767.492,6,78,4108,39,26,46511,26,2054,39,26,46511,26,2054
64.082,6,26,7137,13,155,5340,267,1306,13,589,5339,4837,5831
3.041,17,8,688,4,47,1012,47,300,4,69,1012,75,388
0.179,17,2,238,1,59,0,59,87,1,123,0,123,151
280.641,6,32,7853,14,158,21587,267,1357,18,524,16507,1400,6496
0.408,1,10,280,10,0,0,0,280,0,0,0,0,0
1800.0,6,215,16494,80,67,22404,295,7820,135,48,13432,78,8674
1.21,6,25,8056,12,164,93,267,1288,13,869,85,1402,6768
1756.114,6,107,6374,60,27,29763,27,3525,47,27,38175,27,2849
1783.12,17,83,3480,82,14,22013,14,3444,1,8,0,8,36
1786.812,6,356,22520,208,69,8631,69,12460,148,69,12152,69,10060
280.316,6,29,7392,13,158,23359,267,1317,16,543,18686,1400,6075
1779.592,17,140,11200,70,48,25791,48,5320,70,56,25791,56,5880
1.958,17,6,460,3,40,978,41,206,3,56,977,57,254
0.371,17,19,7326,9,502,46,1350,4770,10,227,35,1350,2556
122.391,6,25,8074,12,366,68,797,1624,13,657,10186,1360,6450
10.77,6,18,5610,10,275,1196,275,958,8,1440,859,1440,4652
1787.247,6,104,8376,68,65,26675,65,4930,36,59,51061,59,3446
146.241,17,6,488,3,53,73120,64,244,3,53,73120,64,244
3.626,6,24,12233,9,400,449,608,1992,15,1069,246,1612,10241
0.275,6,14,4877,7,75,45,75,459,7,1348,45,1448,4418
170.489,17,13,4368,13,308,14207,308,4368,0,0,0,0,0
1788.595,6,4836,4290525,1961,125,912,332,126587,2875,1434,622,2836,4163938
0.958,17,4,624,2,64,956,64,184,2,192,837,192,440
3.559,17,3,1167,3,361,1779,361,1167,0,0,0,0,0
301.547,6,53,10216,24,160,13103,721,3205,29,365,10763,2840,7011
12.066,6,83,24541,42,533,294,1152,18760,41,459,295,1179,5781
300.634,6,37,8526,19,315,16701,882,2053,18,441,496,1440,6473
0.018,6,4,208,2,0,9,0,104,2,0,13,0,104
1647.917,1,8,848,8,78,235416,78,848,0,0,0,0,0
380.051,6,56,7286,30,121,13105,721,3151,26,172,15194,1448,4135
0.022,17,2,425,1,36,0,36,64,1,333,0,333,361
240.832,6,57,18097,31,750,8027,1402,15155,26,175,9633,580,2942
0.253,6,23,4519,11,165,25,456,1394,12,498,21,888,3125
3.419,17,4,1568,4,364,1139,364,1568,0,0,0,0,0
1786.738,6,102,8296,68,65,26667,65,4930,34,59,54141,59,3366
1775.733,1,192,20352,192,78,9297,78,20352,0,0,0,0,0
32.138,6,9,540,2,0,1024,0,120,7,0,5327,0,420
108.358,6,64,41289,40,1155,2778,1408,33299,24,748,2670,1408,7990
1789.783,17,87,3648,86,14,21056,14,3612,1,8,0,8,36
1.067,17,4,352,2,60,1066,60,176,2,60,1066,60,176
460.505,1,22,1232,22,28,21928,28,1232,0,0,0,0,0
3.744,6,33,6129,17,206,234,314,2744,16,456,231,1152,3385
13.149,17,2,672,2,308,13149,308,672,0,0,0,0,0
1772.566,6,180,15480,120,69,14895,69,8940,60,69,30036,69,6540
0.133,6,22,10013,11,136,13,136,716,11,1089,13,1448,9297
1710.819,1,91,5096,91,28,19009,28,5096,0,0,0,0,0
1796.443,6,363,23007,211,69,8554,69,12787,152,69,11896,69,10220
1793.834,6,373,25559,216,92,8343,469,14863,157,69,11497,69,10696
1771.93,6,180,15480,120,69,14890,69,8940,60,69,30032,69,6540
0.01,17,2,439,1,43,0,43,71,1,340,0,340,368
0.417,6,26,8991,13,252,34,647,1692,13,945,32,1438,7299
10.87,6,35,8389,19,401,603,889,1996,16,521,599,4380,6393
1780.784,6,355,28715,203,75,8815,267,13184,152,131,11793,1460,15531
240.315,6,45,9238,22,523,11443,1408,5875,23,239,10923,618,3363
20.271,17,45,9987,20,207,1065,1350,4702,25,183,843,1350,5285
62.02,6,18,5839,10,784,6891,1360,3538,8,247,8820,272,2301
0.073,17,2,558,1,32,0,32,60,1,470,0,470,498
1775.295,6,180,15480,120,69,14918,69,8940,60,69,30082,69,6540
61.346,1,5,140,5,0,0,0,140,0,0,0,0,0
0.117,17,2,304,1,60,0,60,88,1,188,0,188,216
240.203,6,62,18254,30,745,8282,1402,14994,32,176,7748,580,3260
7.323,6,11,640,5,0,1830,0,280,6,0,1408,0,360
1787.216,6,105,8475,68,65,26674,65,4930,37,59,49642,59,3545
1.041,17,4,694,3,32,511,32,180,1,486,0,486,514
1799.266,17,449,39928,404,35,4464,288,25708,45,288,40018,288,14220
0.521,17,2,672,2,308,521,308,672,0,0,0,0,0
463.326,17,17,5705,17,307,28957,342,5705,0,0,0,0,0
48.411,6,34,8435,18,410,515,882,2042,16,574,3217,4848,6393
4.007,17,4,288,2,36,3991,36,128,2,52,3992,52,160
188.452,17,4,352,2,60,188451,60,176,2,60,188451,60,176
0.241,17,5,1626,5,297,60,332,1626,0,0,0,0,0
281.423,6,28,7352,13,158,23451,267,1317,15,603,20086,2036,6035
1.286,6,9,1002,5,213,321,213,417,4,421,245,421,585
17.611,6,6,1257,4,327,5870,414,815,2,181,17438,270,442
1.121,17,4,694,3,32,512,32,180,1,486,0,486,514
280.396,6,30,7432,13,158,23366,267,1317,17,543,17520,1400,6115
0.894,6,23,6393,13,309,74,887,2073,10,979,98,1791,4320
29.98,6,23,4620,11,205,2998,722,1593,12,399,2682,1408,3027
0.854,6,31,21783,13,274,71,517,1506,18,1380,37,2896,20277
1784.726,6,360,24156,210,88,8539,469,13878,150,69,11975,69,10278
1798.384,6,366,24603,213,87,8482,469,14136,153,69,11829,69,10467
2.855,17,8,1730,4,47,947,47,300,4,329,946,341,1430
0.059,17,2,118,1,31,0,31,59,1,31,0,31,59
1725.775,17,13,534,11,14,172558,14,462,2,8,1725581,8,72
0.167,17,4,560,2,64,166,64,184,2,160,48,160,376
0.976,17,4,502,2,31,967,31,118,2,164,966,164,384
14.753,6,2021,1838196,1286,1373,11,1380,1799922,735,421,20,1923,38274
33.631,6,31,5291,15,154,2402,722,1859,16,370,2228,1402,3432
0.136,17,2,144,1,36,0,36,64,1,52,0,52,80
10.814,6,21,3905,11,234,1081,564,1516,10,463,1052,1343,2389
0.346,17,2,152,1,48,0,48,76,1,48,0,48,76
0.728,1,30,840,30,0,0,0,840,0,0,0,0,0
4.896,6,16,2435,8,188,699,245,700,8,1407,660,1407,1735
1.422,6,9,379,5,0,355,0,204,4,7,410,7,175
214.713,17,6,488,3,53,107355,64,244,3,53,107356,64,244
369.588,6,18,1242,14,180,28429,180,916,4,110,20058,110,326
1699.866,17,12,498,11,14,169986,14,462,1,8,0,8,36
1744.639,2,15,480,15,8,124617,8,480,0,0,0,0,0
1799.997,6,154,15988,83,67,21951,721,6557,71,164,25711,2840,9431
16.984,6,26,4702,14,275,1306,275,1126,12,768,1113,1440,3576
74.794,6,32,7881,9,152,9349,267,1284,23,333,3392,1460,6597
838.836,17,10,880,5,60,209708,60,440,5,60,209708,60,440
3.225,17,23,6794,9,252,403,1350,2527,14,276,125,1350,4267
1798.785,17,449,39928,404,35,4463,288,25708,45,288,40022,288,14220
1746.012,6,96,7286,63,38,28161,205,4476,33,33,54554,98,2810
1.305,6,26,5887,13,156,108,267,1462,13,780,99,1460,4425
0.467,6,10,968,5,256,104,256,460,5,304,107,304,508
16.405,17,21,12379,12,814,1488,1350,10111,9,224,2046,1350,2268
281.396,6,29,7392,13,158,23449,267,1317,16,603,18741,2036,6075
0.023,17,2,214,1,47,0,47,75,1,111,0,111,139
0.857,6,2,1175,1,0,0,0,40,1,1095,0,1095,1135
36.019,17,20,1760,10,48,4001,48,760,10,72,4000,72,1000
1788.778,6,102,8296,68,65,26698,65,4930,34,59,54202,59,3366
1.462,6,50,18910,27,864,56,1360,13214,23,433,57,1360,5696
1781.607,17,140,11200,70,48,25820,48,5320,70,56,25820,56,5880
421.154,2,5,160,5,8,105288,8,160,0,0,0,0,0
0.57,6,22,6107,11,284,56,517,1716,11,762,56,1448,4391
4.935,6,38,7229,19,218,274,314,3383,19,440,259,1152,3846
1796.146,6,365,23087,211,69,8553,69,12787,154,69,11739,69,10300
11.875,6,1877,1628787,1149,1363,10,1380,1595425,728,468,16,3303,33362
5.2,6,42,7389,21,201,260,314,3463,21,440,247,1152,3926
0.999,17,4,560,2,64,997,64,184,2,160,885,160,376
0.992,17,4,368,2,64,989,64,184,2,64,990,64,184
1754.026,6,100,7866,66,45,26985,205,4902,34,35,53139,98,2964
300.609,6,43,8969,19,308,16700,889,2039,24,313,1415,2128,6930
0.035,17,4,288,2,33,0,33,122,2,55,0,61,166
147.094,6,34,7914,11,155,48,267,1226,23,320,6685,1460,6688
0.013,17,2,439,2,191,13,336,439,0,0,0,0,0
1.366,6,48,18884,27,868,52,1360,13268,21,476,59,2715,5616
72.844,17,6,2016,6,308,14568,308,2016,0,0,0,0,0
1782.363,17,83,3480,82,14,22004,14,3444,1,8,0,8,36
1793.028,17,144,11520,72,48,25253,48,5472,72,56,25253,56,6048
429.202,6,28,2174,14,65,24984,65,1015,14,46,33004,59,1159
102.439,6,42,9818,21,635,783,1360,4083,21,348,5112,2667,5735
0.268,17,2,440,1,39,0,39,67,1,345,0,345,373
36.612,6,40,8046,21,151,1778,190,1670,19,401,1458,1460,6376
1212.512,17,9,372,8,14,173216,14,336,1,8,0,8,36
1772.991,1,59,4956,59,56,30568,56,4956,0,0,0,0,0
60.372,6,164,13170,144,132,422,174,6694,20,472,3172,1420,6476
280.21,6,30,7432,13,158,23350,267,1317,17,543,17510,1400,6115
10.168,17,4,5480,4,1342,3389,1347,5480,0,0,0,0,0
14.128,6,14,2242,8,210,2017,210,844,6,545,2626,904,1398
0.257,6,20,4960,9,137,31,267,1052,11,692,25,1467,3908
1680.512,17,12,498,11,14,168051,14,462,1,8,0,8,36
31.517,6,14,5609,5,106,7876,106,314,9,985,3938,1420,5295
5.068,6,44,8385,22,227,241,314,4062,22,491,228,1179,4323
0.905,17,4,624,2,64,523,64,184,2,192,554,192,440
1797.525,1,56,4704,56,56,32682,56,4704,0,0,0,0,0
1770.081,1,58,4872,0,0,0,0,0,58,56,31054,56,4872
73.448,6,14,580,6,0,4877,0,244,8,0,10490,0,336
1.381,6,47,18694,27,857,53,1360,13118,20,476,63,2720,5576
10.595,6,23,9462,12,275,963,275,763,11,1178,845,1440,8699
0.947,6,28,8503,15,225,55,561,1985,13,997,64,1791,6518
0.311,6,22,4442,11,165,31,456,1394,11,493,29,888,3048
416.305,2,3,96,3,8,208152,8,96,0,0,0,0,0
1609.205,1,8,848,8,78,229886,78,848,0,0,0,0,0
0.239,17,4,304,2,48,120,48,152,2,48,120,48,152
1798.369,17,533,46468,406,36,4440,288,26100,127,132,14174,288,20368
1786.443,6,102,8364,68,66,26663,66,4964,34,60,54132,60,3400
1793.502,1,58,4872,58,56,31464,56,4872,0,0,0,0,0
280.452,6,29,7392,13,158,23371,267,1317,16,678,18693,2760,6075
0.207,6,23,7325,12,177,18,337,1342,11,1080,19,1588,5983
8.669,6,16,1113,8,222,1237,222,546,8,231,1237,231,567
1794.133,6,371,25948,215,99,8383,469,15085,156,69,11572,69,10863
280.44,6,28,7352,13,158,23370,267,1317,15,678,20027,3456,6035
1799.488,1,272,15232,272,28,6640,28,15232,0,0,0,0,0
3.437,17,12,5512,6,490,687,1350,3112,6,372,604,1350,2400
1793.077,17,87,3648,86,14,21095,14,3612,1,8,0,8,36
0.482,6,23,6000,12,108,43,147,919,11,927,44,1608,5081
1786.866,6,108,8736,70,66,25896,66,5176,38,60,48289,60,3560
0.25,17,2,152,1,48,0,48,76,1,48,0,48,76
1.351,6,49,20322,28,903,50,1360,14706,21,476,57,2715,5616
1092.262,17,216,16416,216,48,5080,48,16416,0,0,0,0,0
290.526,6,369,306292,239,1320,1220,1408,283076,130,587,2118,3847,23216
13.726,6,27,4868,13,154,1125,722,1767,14,394,1041,1408,3101
0.126,6,9,1343,5,145,31,145,349,4,830,35,830,994
1764.417,17,169,14179,157,30,11310,37,9155,12,390,155060,463,5024
1.39,6,49,19142,27,883,53,1360,13486,22,433,56,1360,5656
83.025,6,25,11358,12,433,73,990,1823,13,1000,6907,1360,9535
1745.202,6,111,9062,71,50,24931,205,5454,40,38,44740,98,3608
1783.808,6,369,23040,208,69,8617,69,12460,161,56,11148,69,10580
1780.523,17,140,11200,70,48,25804,48,5320,70,56,25804,56,5880
225.308,17,6,2016,6,308,45061,308,2016,0,0,0,0,0
1757.365,6,4458,4271634,1541,160,1141,952,95780,2917,1415,602,4254,4175854
0.114,17,2,152,1,48,0,48,76,1,48,0,48,76
149.166,17,5,676,5,107,37291,352,676,0,0,0,0,0
15.539,6,7,380,2,0,15539,0,100,5,0,3843,0,280
0.329,6,26,9017,13,261,27,683,1728,13,943,26,1408,7289
1773.252,6,180,15480,120,69,14901,69,8940,60,69,30047,69,6540
1796.061,17,448,39896,403,35,4467,288,25676,45,288,40017,288,14220
0.526,17,3,451,2,39,498,39,134,1,289,0,289,317
30.049,6,2,166,2,31,30049,31,166,0,0,0,0,0
5.985,6,38,7229,20,218,315,314,3423,18,513,334,1179,3806
4.191,6,6,340,3,0,2005,0,164,3,0,2005,0,176
1744.637,2,19,608,19,8,96924,8,608,0,0,0,0,0
5.944,6,40,7416,20,218,312,314,3423,20,455,299,1179,3993
4.043,1,10,1040,0,0,0,0,0,10,76,449,76,1040
1.212,17,3,1164,3,360,606,360,1164,0,0,0,0,0
1786.68,6,104,8444,68,66,26666,66,4964,36,60,51045,60,3480
1772.066,6,99,9240,66,65,27262,65,5577,33,59,55374,59,3663
1795.896,6,380,26515,219,97,8238,469,15590,161,69,11221,69,10925
0.921,6,11,1727,7,100,153,100,384,4,589,222,1152,1343
0.558,1,2,112,2,28,558,28,112,0,0,0,0,0
91.653,6,26,6484,12,220,8332,516,1365,14,455,7039,1452,5119
1777.673,17,141,11276,71,48,25394,48,5396,70,56,25743,56,5880
209.41,6,82,56936,51,1207,4188,1368,48563,31,844,2059,2519,8373
165.26,6,19,780,7,0,3012,0,284,12,0,15022,0,496
1769.804,6,99,9306,66,66,27227,66,5610,33,60,55303,60,3696
1.855,6,1512,1630861,432,337,4,348,24849,1080,1447,1,7240,1606012
8.83,2,3,128,3,18,4415,24,128,0,0,0,0,0
3.178,6,13,3463,7,188,529,245,660,6,1279,585,1407,2803
1798.529,6,455,27909,251,69,7194,69,14594,204,48,8859,69,13315
0.031,6,2,350,1,0,0,0,40,1,258,0,258,310
1740.511,17,30,7050,30,207,60017,207,7050,0,0,0,0,0
2.091,6,20,6474,11,150,209,174,744,9,894,224,1452,5730
0.013,17,2,154,1,41,0,41,69,1,57,0,57,85
0.016,17,8,1670,8,180,2,219,1670,0,0,0,0,0
0.867,6,35,8293,19,277,48,761,1900,16,521,49,3488,6393
717.923,2,6,192,6,8,143584,8,192,0,0,0,0,0
11.779,6,1887,1634192,1139,1380,10,1420,1599907,748,467,15,1883,34285
15.172,6,2525,2364892,1631,1372,9,1408,2313740,894,776,16,1408,51152
4.711,6,35,6209,19,206,261,314,2824,16,548,296,1179,3385
0.161,6,10,584,5,44,40,44,312,5,0,38,0,272
0.02,6,13,3980,7,88,3,88,388,6,1670,4,1880,3592
1781.792,6,80,4250,40,26,45685,26,2132,40,26,45685,26,2118
40.021,6,44,8776,21,363,513,774,2009,23,364,1812,1460,6767
73.272,6,6956,6982426,2393,297,30,297,125629,4563,1451,16,2896,6856797
19.172,17,2,152,2,48,19172,48,152,0,0,0,0,0
3.165,17,4,1556,4,361,1055,361,1556,0,0,0,0,0
3.798,17,4,352,2,48,3788,48,152,2,72,3787,72,200
1794.991,1,175,9800,175,28,10316,28,9800,0,0,0,0,0
110.005,6,35,9667,15,292,7857,721,3234,20,562,5267,1440,6433
615.827,6,124,24172,52,288,12075,1360,11701,72,184,8606,2720,12471
1.406,6,48,20237,27,964,54,1460,14621,21,433,60,1460,5616
1688.077,1,26,3112,26,91,67523,173,3112,0,0,0,0,0
1794.357,1,272,15232,272,28,6621,28,15232,0,0,0,0,0
27.532,6,3998,3783788,2661,1346,10,1368,3709564,1337,931,20,2841,74224
162.482,6,29,7392,13,158,13540,267,1317,16,603,10830,1400,6075
1744.684,6,95,7203,63,38,28140,205,4476,32,33,56269,98,2727
1787.21,6,104,8444,68,66,26674,66,4964,36,60,51059,60,3480
1796.758,1,240,25440,240,78,7517,78,25440,0,0,0,0,0
88.276,6,26,6797,12,181,8025,267,1212,14,627,6789,1400,5585
0.015,6,11,3285,6,80,2,80,400,5,872,3,1448,2885
1771.051,6,103,9448,66,65,27246,65,5577,37,59,49193,59,3871
1786.95,6,102,8364,68,66,26670,66,4964,34,60,54146,60,3400
1778.92,1,342,28728,342,56,5216,56,28728,0,0,0,0,0
280.469,6,30,7432,13,158,23372,267,1317,17,603,17526,2076,6115
242.213,6,47,11184,19,248,13456,582,2761,28,497,8970,1197,8423
1.586,6,30,10317,18,368,93,837,1829,12,1000,135,1452,8488
0.994,6,10,861,5,222,246,222,426,5,231,246,231,435
1783.433,17,84,3516,82,14,22015,14,3444,2,8,1783240,8,72
15.353,17,10,760,10,48,1705,48,760,0,0,0,0,0
71.141,17,4,352,2,60,71139,60,176,2,60,71140,60,176
104.007,6,19,4942,10,686,135,1360,3188,9,345,12974,539,1754
1741.449,17,266,53617,266,173,6571,422,53617,0,0,0,0,0
1741.789,6,91,6604,59,31,30030,31,3998,32,31,56186,31,2606
1794.015,1,8,848,8,78,256287,78,848,0,0,0,0,0
1792.351,1,339,28476,339,56,5302,56,28476,0,0,0,0,0
0.094,17,4,420,2,33,1,33,122,2,121,81,145,298
1775.279,1,58,4872,58,56,31145,56,4872,0,0,0,0,0
1792.027,6,128,12524,78,62,23273,722,6422,50,87,36564,1402,6102
13.56,17,16,3236,8,33,1933,33,488,8,315,1935,327,2748
1783.265,17,83,3480,82,14,22015,14,3444,1,8,0,8,36
1745.305,6,95,7203,63,38,28150,205,4476,32,33,56286,98,2727
8.166,6,18,6767,9,275,1020,275,643,9,1150,929,1414,6124
1744.667,2,13,416,13,8,145388,8,416,0,0,0,0,0
273.338,1,2,120,2,32,273338,32,120,0,0,0,0,0
1788.829,6,355,22480,207,69,8683,69,12420,148,69,12166,69,10060
587.797,1,6,336,6,28,117559,28,336,0,0,0,0,0
120.478,1,38,3952,0,0,0,0,0,38,76,3256,76,3952
276.377,1,6,336,6,28,55275,28,336,0,0,0,0,0
0.747,6,9,1345,5,145,186,145,349,4,832,206,832,996
1791.612,6,113,7398,68,50,26740,208,4575,45,31,40711,31,2823
0.007,17,2,190,1,35,0,35,63,1,99,0,99,127
1793.097,6,361,24196,211,88,8538,469,13918,150,69,12033,69,10278
129.518,6,30,7432,13,158,10793,267,1317,17,603,8089,2076,6115
2.203,6,14,2351,8,188,314,245,700,6,703,388,1152,1651
0.05,6,14,4329,7,127,7,127,499,7,864,7,1448,3830
0.018,17,4,944,2,60,13,60,176,2,356,12,356,768
18.234,6,14,2245,8,211,2602,211,846,6,545,3646,904,1399
59.829,17,3,2910,3,942,29914,1444,2910,0,0,0,0,0
1772.967,6,180,15480,120,69,14898,69,8940,60,69,30046,69,6540
4.18,6,14,2482,9,169,522,245,871,5,1407,974,1407,1611
431.623,1,8,1026,8,100,61660,105,1026,0,0,0,0,0
37.999,17,22,1936,11,48,3798,48,836,11,72,3798,72,1100
15.778,6,8,456,2,0,15590,0,112,6,0,3118,0,344
3.905,6,12,977,7,182,650,182,542,5,77,943,134,435
3.01,17,6,450,3,37,1501,37,195,3,57,1501,65,255
74.563,6,21,860,10,0,5995,0,404,11,0,7455,0,456
0.179,6,22,11008,13,144,14,186,1407,9,1303,21,2235,9601
0.992,6,31,12103,17,525,62,1360,3350,14,818,62,1360,8753
1679.693,17,12,498,11,14,167969,14,462,1,8,0,8,36
0.031,17,4,859,2,37,19,37,130,2,336,18,348,729
61.944,6,553,259404,292,821,212,1152,243443,261,424,237,1179,15961
2.445,1,3,168,3,28,1222,28,168,0,0,0,0,0
0.029,17,2,158,1,34,0,34,62,1,68,0,68,96
0.037,17,2,415,1,43,0,43,71,1,316,0,316,344
9.159,6,96,52797,51,867,183,1440,18550,45,982,205,1456,34247
65.152,6,25,7006,5,156,16288,267,678,20,368,3424,1420,6328
310.395,6,33,8462,20,142,16336,516,1945,13,544,23170,1452,6517
1783.341,17,83,3480,82,14,22016,14,3444,1,8,0,8,36
2.318,6,13,2311,8,188,331,245,700,5,1407,515,1407,1611
184.665,6,1701,845071,936,837,197,1152,806563,765,395,241,1179,38508
1721.194,17,12,498,11,14,172119,14,462,1,8,0,8,36
742.815,6,137,18245,61,147,12380,469,7020,76,115,9896,1460,11225
1796.605,17,544,48908,411,35,4381,288,26240,133,142,13375,308,22668
1788.001,1,200,21200,200,78,8984,78,21200,0,0,0,0,0
574.295,6,141,37011,74,158,7867,267,7428,67,689,8700,3445,29583
1772.275,6,180,15480,120,69,14893,69,8940,60,69,30034,69,6540
0.014,17,2,326,1,36,0,36,64,1,234,0,234,262
0.511,6,10,1677,6,555,102,951,1354,4,159,104,159,323
1770.602,6,101,9344,66,65,27240,65,5577,35,59,52073,59,3767
2.105,6,117,87744,51,131,42,232,2569,66,1375,28,2860,85175
345.61,6,585,509908,226,176,1535,703,13545,359,1400,964,4254,496363
1248.988,6,98,12090,52,90,21242,501,4250,46,153,27753,1420,7840
0.395,6,12,1653,6,288,77,288,548,6,426,45,434,1105
40.639,6,42,10071,25,135,1693,377,2382,17,699,1774,3302,7689
348.877,1,20,2120,20,78,18361,78,2120,0,0,0,0,0
27.883,17,4,304,4,48,9294,48,304,0,0,0,0,0
1756.659,6,95,7203,63,38,28333,205,4476,32,33,56653,98,2727
34.818,6,23,7088,9,156,4352,267,838,14,568,2673,1420,6250
2.959,6,72,18234,36,551,84,1429,5428,36,420,77,1460,12806
7.628,6,14,2570,9,275,953,275,918,5,1440,1391,1440,1652
3.599,17,5,340,5,40,899,40,340,0,0,0,0,0
11.851,6,20,5523,10,275,1316,275,687,10,1104,1120,1440,4836
0.403,17,8,2766,8,317,57,356,2766,0,0,0,0,0
4.461,6,13,1824,8,483,637,483,1390,5,83,1113,83,434
74.771,6,4238,3680821,2555,1355,29,1448,3585561,1683,776,44,1448,95260
31.925,6,24,9952,8,154,4560,267,792,16,773,2126,1452,9160
84.854,6,32,8952,15,158,6061,267,1397,17,687,5303,2800,7555
15.278,17,20,12142,12,807,1385,1350,10025,8,236,2177,1350,2117
0.997,6,2,120,2,0,0,0,120,0,0,0,0,0
5.575,6,10,2985,5,583,1351,996,2532,5,253,1337,253,453
3.014,17,4,372,2,33,3007,33,122,2,97,3006,97,250
180.816,6,24,9082,12,657,96,1360,3141,12,908,16418,1747,5941
0.0,1,1,355,1,327,0,327,355,0,0,0,0,0
0.184,6,46,20335,26,1018,7,1420,15314,20,467,9,1883,5021
16.076,6,22,6727,6,138,3212,267,803,16,527,1071,1460,5924
0.206,6,10,1840,5,901,51,901,1169,5,403,51,403,671
1795.543,6,336,29384,196,90,9207,1077,13981,140,139,12917,1926,15403
0.937,6,28,8460,15,222,54,540,1964,13,994,63,2720,6496
1574.279,1,18,1008,18,28,92604,28,1008,0,0,0,0,0
0.04,17,2,152,1,48,0,48,76,1,48,0,48,76
276.153,17,4,240,2,32,276152,32,120,2,32,276152,32,120
1.649,6,18,3257,10,99,164,182,924,8,477,211,1343,2333
1772.178,6,180,15480,120,69,14892,69,8940,60,69,30032,69,6540
0.103,17,2,529,1,40,0,40,68,1,433,0,433,461
1773.475,1,229,12824,229,28,7778,28,12824,0,0,0,0,0
120.452,6,58,30444,36,950,3439,1368,23741,22,505,5728,2736,6703
3.167,6,2,88,2,0,0,0,88,0,0,0,0,0
0.413,6,48,21043,27,1058,15,1380,15961,21,421,18,1923,5082
18.831,17,38,12846,20,469,989,1350,9940,18,133,1105,1350,2906
16.319,17,18,6441,9,428,2035,1350,4111,9,230,2035,1350,2330
1.258,6,48,18841,26,931,50,1460,13185,22,433,51,1460,5656
0.144,6,10,1569,5,627,35,627,895,5,406,35,406,674
1789.452,17,139,11108,71,48,25563,48,5396,68,56,25566,56,5712
1795.917,17,446,39548,402,35,4478,288,25644,44,288,40946,288,13904
32.691,6,45,25257,21,884,1634,1360,6201,24,1063,1415,1360,19056
33.854,6,34,5461,17,154,2101,721,1973,17,371,2103,2026,3488
8.947,6,17,6735,9,275,1118,275,643,8,1440,1058,1440,6092
0.115,17,5,1757,5,323,28,354,1757,0,0,0,0,0
1786.425,6,102,8364,68,66,26663,66,4964,34,60,54131,60,3400
1582.018,6,190,14450,71,68,22171,314,6831,119,48,13406,78,7619
1796.537,6,1123,126474,390,110,4618,114,56678,733,109,2454,110,69796
9.587,6,24,4597,12,225,871,383,2065,12,512,849,1179,2532
1796.033,17,446,39548,402,35,4478,288,25644,44,288,40955,288,13904
122.511,17,3,181,3,32,61255,33,181,0,0,0,0,0
81.25,6,143,101939,83,1264,990,1368,90323,60,676,1373,1368,11616
0.057,17,4,780,2,32,29,32,120,2,302,31,308,660
1769.773,6,103,9448,66,65,27227,65,5577,37,59,49156,59,3871
8.722,6,37,8387,18,333,513,685,1812,19,414,470,1928,6575
0.169,6,46,21704,27,1040,6,1420,16723,19,467,8,1883,4981
3.597,6,36,8588,14,384,276,1162,2540,22,343,161,1440,6048
0.149,6,16,6197,8,128,21,128,552,8,1044,21,1448,5645
1787.922,6,106,7140,66,56,27506,208,4610,40,31,45836,31,2530
1155.767,17,58,2433,57,13,20638,14,2389,1,16,0,16,44
1797.342,17,448,39896,403,35,4471,288,25676,45,288,40017,288,14220
12.037,6,25,8473,13,275,1003,275,1078,12,986,929,1440,7395
0.12,17,2,157,1,31,0,31,59,1,70,0,70,98
1798.99,1,182,10192,182,28,9939,28,10192,0,0,0,0,0
1794.95,1,100,5600,100,28,18130,28,5600,0,0,0,0,0
157.903,6,39,9793,14,290,12145,1189,2604,25,309,6578,1460,7189
0.258,6,25,6116,12,181,23,537,1526,13,651,20,1448,4590
1.384,6,51,13829,24,551,60,1429,4840,27,464,52,1986,8989
6.321,6,1309,1218670,833,1387,7,1408,1189242,476,931,12,2801,29428
299.609,17,4,240,2,32,299608,32,120,2,32,299607,32,120
2.704,6,9,527,5,43,676,43,311,4,0,899,0,216
1796.118,17,449,39928,404,35,4456,288,25708,45,288,40019,288,14220
1795.21,17,449,39928,404,35,4454,288,25708,45,288,40016,288,14220
10.101,6,10,436,4,0,3367,0,172,6,0,1744,0,264
280.377,6,29,7392,13,158,23364,267,1317,16,603,18688,2236,6075
37.826,6,18,5743,11,267,3782,501,1245,7,842,123,1420,4498
281.349,6,32,7853,14,158,21642,267,1357,18,524,16539,1400,6496
60.743,17,4,352,2,60,60742,60,176,2,60,60742,60,176
0.747,17,2,685,1,308,0,308,336,1,321,0,321,349
4.011,17,8,616,4,33,1331,33,244,4,65,1329,65,372
0.151,17,2,158,1,34,0,34,62,1,68,0,68,96
6.937,6,2,149,0,0,0,0,0,2,69,6937,69,149
1.137,6,25,9512,13,164,80,267,1388,12,1248,87,4224,8124
1759.194,1,198,11088,198,28,8929,28,11088,0,0,0,0,0
269.058,6,30,7432,13,158,22421,267,1317,17,543,16814,1400,6115
1771.597,6,138,12080,80,93,22425,208,9357,58,31,13729,31,2723
1.133,6,25,8068,12,164,87,267,1300,13,869,80,1408,6768
1.25,6,38,8254,19,321,69,1164,2718,19,476,60,2715,5536
1741.168,6,96,6962,62,31,28543,31,4209,34,31,52762,31,2753
280.05,6,29,7392,14,158,21542,267,1357,15,678,19999,3436,6035
570.333,6,51,8480,30,111,19666,501,2655,21,276,28035,1420,5825
269.186,17,2,150,2,47,269186,47,150,0,0,0,0,0
4.802,6,38,7245,20,218,252,314,3423,18,516,267,1179,3822
1.975,6,50,20776,28,931,73,1440,15120,22,433,85,1440,5656
0.055,17,2,152,1,48,0,48,76,1,48,0,48,76
0.351,6,24,4571,12,165,31,456,1446,12,415,30,888,3125
1760.025,6,126,7814,68,26,26268,26,4140,58,26,30876,26,3674
0.001,17,2,150,1,39,0,39,67,1,55,0,55,83
1772.647,6,180,15480,120,69,14896,69,8940,60,69,30038,69,6540
1680.444,2,26,832,26,8,67217,8,832,0,0,0,0,0
4.997,6,43,7429,23,218,227,314,3543,20,440,249,1152,3886
1.264,6,50,18710,27,850,48,1360,13014,23,476,49,2715,5696
299.882,1,4,224,4,28,99960,28,224,0,0,0,0,0
35.013,17,5,5500,5,1072,8753,1072,5500,0,0,0,0,0
72.804,17,4,352,2,60,72803,60,176,2,60,72803,60,176
4.297,6,14,2351,8,188,613,245,700,6,703,805,1152,1651
0.962,17,2,685,1,308,0,308,336,1,321,0,321,349
0.232,17,2,136,1,32,0,32,60,1,48,0,48,76
0.235,6,9,1002,5,213,58,213,417,4,421,69,421,585
316.967,6,104,34453,58,483,5560,1360,23630,46,358,7040,4649,10823
52.278,6,40,9955,19,541,492,910,2971,21,408,2606,2720,6984
0.512,17,2,448,1,39,0,39,67,1,353,0,353,381
6.316,6,21,6360,10,262,693,517,1316,11,893,624,2451,5044
1793.699,6,355,22480,207,69,8707,69,12420,148,69,12201,69,10060
0.037,17,8,2454,8,278,5,317,2454,0,0,0,0,0
0.461,6,24,6041,13,108,38,147,959,11,773,43,1608,5082
1789.101,6,366,23196,211,69,8519,69,12856,155,69,11617,69,10340
11.615,6,25,8473,13,275,967,275,1078,12,986,764,1440,7395
0.013,17,2,128,1,36,0,36,64,1,36,0,36,64
35.762,17,40,5880,20,48,1881,48,1520,20,190,1881,308,4360
1786.482,6,104,8376,68,65,26663,65,4930,36,59,51038,59,3446
0.013,17,2,435,1,37,0,37,65,1,342,0,342,370
1797.271,17,448,39896,403,35,4470,288,25676,45,288,40022,288,14220
1774.506,6,212,24937,131,75,13650,267,10097,81,150,22177,1452,14840
280.462,6,27,7312,13,158,23371,267,1317,14,775,21566,3465,5995
1786.751,6,104,8376,68,65,26667,65,4930,36,59,51046,59,3446
1744.486,6,96,7288,63,38,28136,205,4476,33,33,54509,98,2812
1792.1,6,356,22520,208,69,8657,69,12460,148,69,12191,69,10060
1786.725,17,87,3648,86,14,21020,14,3612,1,8,0,8,36
1798.577,6,374,25599,216,92,8365,469,14863,158,69,11453,69,10736
255.083,17,4,352,2,60,255081,60,176,2,60,255082,60,176
0.071,6,12,3704,6,171,11,171,491,6,964,9,1448,3213
125.974,17,4,352,2,60,125973,60,176,2,60,125973,60,176
4.409,6,38,7229,19,218,244,314,3383,19,513,231,1179,3846
13.753,6,89,26805,44,551,319,1152,20523,45,447,307,1179,6282
1799.801,1,58,4872,0,0,0,0,0,58,56,31575,56,4872
84.698,6,20,4509,7,341,14116,722,1383,13,271,7041,1408,3126
33.225,6,43,8180,18,140,1954,267,1861,25,441,1371,1460,6319
3.072,6,49,29153,30,955,105,1360,11799,19,2072,163,5294,17354
0.352,6,22,7333,12,334,31,663,1969,10,1209,38,1906,5364
980.021,6,187,11827,107,69,8707,69,6488,80,69,12401,69,5339
419.471,2,5,160,5,8,104867,8,160,0,0,0,0,0
158.451,6,25,9573,12,465,63,1460,2374,13,952,13193,1460,7199
0.138,6,45,20243,26,1012,5,1420,15262,19,420,7,1420,4981
1795.59,17,448,39896,403,35,4466,288,25676,45,288,40019,288,14220
0.175,17,2,148,1,32,0,32,60,1,60,0,60,88
3.907,17,5,290,5,30,976,30,290,0,0,0,0,0
0.233,6,3,120,1,0,0,0,40,2,0,112,0,80
1772.435,6,180,15480,120,69,14894,69,8940,60,69,30037,69,6540
378.187,2,3,96,3,8,189093,8,96,0,0,0,0,0
1.295,6,41,11378,21,616,64,1440,5802,20,433,59,1440,5576
4.501,6,37,7189,19,218,250,314,3383,18,513,248,1179,3806
0.638,17,24,16987,11,523,63,1350,6068,13,811,47,1350,10919
11.824,6,1872,1633610,1134,1386,10,1420,1599857,738,467,16,1883,33753
7.239,6,1616,1509581,1009,1419,7,1448,1473341,607,776,11,1448,36240
1770.802,17,285,68145,285,211,6235,422,68145,0,0,0,0,0
1.472,6,31,6467,15,164,105,267,1922,16,780,86,1460,4545
83.06,6,43,7429,18,218,4885,314,3343,25,513,3449,1179,4086
1781.552,17,142,11360,71,48,25450,48,5396,71,56,25450,56,5964
277.634,6,79,54350,49,1208,5784,1368,46055,30,747,2134,1368,8295
1795.357,17,447,39864,402,35,4477,288,25644,45,288,40019,288,14220
17.833,17,4,1344,4,308,5944,308,1344,0,0,0,0,0
85.064,6,55,33137,34,1119,2577,1448,25290,21,749,3070,1448,7847
1786.78,17,87,3648,86,14,21020,14,3612,1,8,0,8,36
0.111,17,4,588,2,48,104,48,152,2,190,102,308,436
5.222,6,40,7400,20,218,274,314,3423,20,396,261,1152,3977
0.487,17,2,167,1,39,0,39,67,1,72,0,72,100
355.137,6,45,6360,22,119,12394,722,2465,23,207,16134,1408,3895
1798.372,6,368,23276,212,69,8523,69,12896,156,69,11602,69,10380
35.633,17,10,760,10,48,3959,48,760,0,0,0,0,0
1793.488,1,296,31376,296,78,6079,78,31376,0,0,0,0,0
240.318,6,44,8468,22,449,11443,1418,5648,22,208,11443,580,2820
0.114,6,9,1340,5,145,28,145,349,4,827,25,827,991
60.399,6,9,514,3,106,30190,106,234,6,0,12076,0,280
1.712,1,2,163,2,53,1712,78,163,0,0,0,0,0
38.911,6,5,228,0,0,0,0,0,5,7,9727,7,228
12.118,6,8,336,4,0,4038,0,164,4,0,4037,0,172
105.336,6,52,10408,26,198,2470,1189,3429,26,370,4212,1460,6979
0.035,17,2,279,1,36,0,36,64,1,187,0,187,215
0.065,17,2,322,1,33,0,33,61,1,233,0,233,261
1.068,6,27,8506,15,229,64,583,2007,12,1201,80,2720,6499
1649.729,1,8,448,8,28,235675,28,448,0,0,0,0,0
0.046,17,2,904,1,300,0,300,328,1,548,0,548,576
3.965,17,8,1216,4,60,1319,60,352,4,188,1318,188,864
14.462,6,1021,897909,648,1312,22,1368,873837,373,776,38,1473,24072
2.028,6,13,2311,8,188,289,245,700,5,1407,440,1407,1611
0.205,17,2,2754,2,1349,205,1349,2754,0,0,0,0,0
0.492,6,12,1653,6,288,92,288,548,6,426,53,434,1105
1.453,17,3,238,2,30,1418,30,116,1,94,0,94,122
0.453,6,13,1693,7,288,72,288,588,6,426,49,434,1105
1770.143,6,384,118448,177,625,10056,1440,91060,207,203,8592,1440,27388
372.097,6,25,1651,17,177,23256,177,1117,8,110,9237,110,534
1.264,6,10,1687,7,100,210,100,384,3,1179,498,1179,1303
0.166,17,4,352,2,37,0,37,130,2,83,1,89,222
286.117,6,37,8777,14,220,22005,517,2277,23,440,13003,2412,6500
8.161,1,9,756,9,56,1020,56,756,0,0,0,0,0
470.272,17,16,6296,16,365,31351,373,6296,0,0,0,0,0
194.976,6,14,784,6,0,38994,0,312,8,56,27853,56,472
1770.114,6,99,9174,66,64,27232,64,5544,33,58,55313,58,3630
1787.313,6,102,8296,68,65,26676,65,4930,34,59,54157,59,3366
1786.584,6,104,8444,68,66,26665,66,4964,36,60,51042,60,3480
1772.005,1,126,7056,126,28,14176,28,7056,0,0,0,0,0
280.041,6,30,7432,15,158,20002,267,1397,15,678,19999,2800,6035
190.337,17,4,272,2,32,190329,32,120,2,48,190329,48,152
2.919,6,30,7683,14,174,224,267,1608,16,543,193,1400,6075
1787.908,6,370,23494,214,69,8393,69,13114,156,69,11534,69,10380
8.129,17,6,456,6,48,1625,48,456,0,0,0,0,0
1796.654,17,448,39896,403,35,4469,288,25676,45,288,40016,288,14220
0.04,6,13,4276,7,126,6,126,498,6,1152,7,1845,3778
6.221,6,3,300,1,0,0,0,40,2,90,6144,90,260
0.014,6,10,5359,2,106,0,106,186,8,970,0,1460,5173
1798.378,17,450,39960,405,35,4451,288,25740,45,288,40021,288,14220
281.257,6,32,7650,13,158,23438,267,1317,19,464,15603,1300,6333
15.542,17,12,5918,6,584,3063,1350,3674,6,346,3056,1350,2244
1794.858,1,48,2688,48,28,38188,28,2688,0,0,0,0,0
0.552,6,23,7271,12,257,50,748,1663,11,1005,50,2365,5608
1789.963,6,356,22520,208,69,8647,69,12460,148,69,12176,69,10060
36.843,17,4,1344,4,308,12281,308,1344,0,0,0,0,0
0.138,6,41,16681,23,981,6,1420,11740,18,420,7,1420,4941
0.36,6,9,1346,5,145,90,145,349,4,833,63,833,997
17.738,17,29,10179,15,299,1264,1350,4907,14,348,1361,1350,5272
1681.496,1,15,840,15,28,120106,28,840,0,0,0,0,0
0.06,17,2,178,1,29,0,29,57,1,93,0,93,121
0.069,6,19,9114,10,121,7,121,649,9,1332,8,1817,8465
300.805,2,4,128,4,8,100268,8,128,0,0,0,0,0
4.04,17,8,8457,2,723,4040,1350,1503,6,1131,642,1350,6954
0.602,17,4,608,2,60,338,60,176,2,188,269,188,432
2.868,17,3,222,3,46,1434,46,222,0,0,0,0,0
245.141,6,62,7548,28,192,9079,585,3436,34,146,7428,580,4112
1770.805,6,105,9759,68,65,26429,65,5758,37,59,49186,59,4001
1.072,17,2,152,1,48,0,48,76,1,48,0,48,76
42.837,17,24,1824,24,48,1862,48,1824,0,0,0,0,0
0.094,6,4,191,2,0,94,0,80,2,31,0,31,111
4.916,6,38,8381,17,218,307,314,3303,21,604,233,1179,5078
0.37,17,2,266,1,41,0,41,69,1,169,0,169,197
280.193,6,30,7432,13,158,23349,267,1317,17,543,17509,1400,6115
180.466,2,3,96,3,8,90233,8,96,0,0,0,0,0
368.773,6,18,1239,14,177,28367,177,913,4,110,20056,110,326
280.307,6,29,7392,13,158,23358,267,1317,16,603,18683,2036,6075
0.016,17,6,462,3,33,0,33,183,3,65,0,65,279
2.494,17,4,1560,4,362,831,362,1560,0,0,0,0,0
1792.144,1,342,28728,342,56,5255,56,28728,0,0,0,0,0
115.022,6,23,6102,13,217,9585,502,1392,10,615,12770,1420,4710
286.852,1,4,224,4,28,95617,28,224,0,0,0,0,0
1681.801,17,14,1036,7,30,280297,30,406,7,62,280297,62,630
3.018,17,2,136,2,40,3018,47,136,0,0,0,0,0
0.008,17,2,241,1,52,0,52,80,1,133,0,133,161
1740.39,1,15,840,15,28,124313,28,840,0,0,0,0,0
151.611,17,4,352,2,60,151610,60,176,2,60,151610,60,176
291.208,17,87,27115,87,283,3386,422,27115,0,0,0,0,0
0.06,17,2,144,1,36,0,36,64,1,52,0,52,80
1776.752,6,292,36068,118,137,15184,1460,16825,174,139,10269,1642,19243
0.046,17,2,120,1,32,0,32,60,1,32,0,32,60
382.992,6,28,4392,18,182,22528,182,990,10,595,2717,853,3402
1719.44,17,12,498,11,14,171944,14,462,1,8,0,8,36
242.859,6,160,130205,58,464,4260,1402,7724,102,1346,2404,2423,122481
1792.39,6,356,22520,208,69,8658,69,12460,148,69,12192,69,10060
503.338,2,4,128,4,8,167779,8,128,0,0,0,0,0
1681.627,17,14,1036,7,30,280265,30,406,7,62,280265,62,630
60.221,2,2,64,2,8,60221,8,64,0,0,0,0,0
4.254,6,9,527,5,43,1063,43,311,4,0,1413,0,216
0.137,6,3,152,2,0,137,0,100,1,0,0,0,52
280.383,6,25,7094,11,181,28038,267,1168,14,595,21565,1400,5926
1137.809,6,71,5577,40,66,26328,66,2920,31,52,37923,60,2657
1763.413,17,255,55574,255,189,6942,422,55574,0,0,0,0,0
36.021,17,20,1760,10,48,4001,48,760,10,72,4001,72,1000
17.356,17,4,352,2,48,17346,48,152,2,72,17348,72,200
1784.942,6,353,22400,206,69,8707,69,12380,147,69,12225,69,10020
1790.951,6,443,26192,232,69,7753,69,13420,211,35,8528,64,12772
539.866,1,24,1344,24,28,23472,28,1344,0,0,0,0,0
0.015,6,12,1843,7,138,2,138,510,5,532,3,891,1333
0.215,6,27,7296,13,155,17,267,1301,14,603,14,2036,5995
104.538,6,25,9743,12,386,89,844,1696,13,939,8699,1360,8047
1.378,6,45,18080,26,882,55,1360,12544,19,476,65,2720,5536
0.854,6,10,1102,6,483,170,483,803,4,83,281,83,299
1.992,17,5,1144,3,40,996,41,206,2,441,989,441,938
1797.602,1,74,4144,74,28,24624,28,4144,0,0,0,0,0
20.155,6,22,5470,12,107,1832,159,1074,10,773,2238,1418,4396
1770.418,6,101,9344,66,65,27237,65,5577,35,59,52068,59,3767
0.157,6,12,1938,7,209,26,209,581,5,544,35,891,1357
280.529,17,4,296,2,30,280478,30,116,2,62,280480,62,180
0.944,6,10,1687,7,100,157,100,384,3,1179,341,1179,1303
0.0,6,1,667,1,615,0,615,667,0,0,0,0,0
0.098,17,2,180,1,30,0,30,58,1,94,0,94,122
1764.129,2,23,736,23,8,80187,8,736,0,0,0,0,0
280.479,6,30,7432,13,158,23373,267,1317,17,678,17523,2085,6115
0.296,17,2,144,1,36,0,36,64,1,52,0,52,80
1773.207,6,180,15480,120,69,14900,69,8940,60,69,30048,69,6540
3.158,6,18,2358,10,304,350,304,1744,8,83,445,83,614
1682.947,17,16,1265,8,30,240412,37,471,8,71,240415,136,794
1772.296,6,180,15480,120,69,14893,69,8940,60,69,30035,69,6540
4.368,17,2,152,2,48,4368,48,152,0,0,0,0,0
366.988,6,25,1654,17,180,22936,180,1120,8,110,9188,110,534
0.47,6,56,24925,32,1069,15,1380,16375,24,630,18,3303,8550
300.71,6,46,8907,23,266,13668,720,2078,23,327,574,1460,6829
91.189,17,4,352,2,60,91188,60,176,2,60,91187,60,176
299.062,17,4,352,2,60,299061,60,176,2,60,299061,60,176
168.359,17,4,1320,4,302,56119,308,1320,0,0,0,0,0
18.676,6,31,8912,14,158,1436,267,1357,17,687,1164,1400,7555
1791.526,17,180,14040,180,50,10008,50,14040,0,0,0,0,0
5.028,6,8,460,4,0,1676,0,220,4,0,996,0,240
300.093,6,50,10762,26,616,11996,1360,4845,24,309,13039,2667,5917
0.061,17,2,309,1,40,0,40,68,1,213,0,213,241
1744.502,6,103,8109,67,45,26431,205,4979,36,34,49836,98,3130
0.402,6,10,967,5,256,97,256,460,5,303,97,303,507
58.078,17,10,580,10,30,6453,30,580,0,0,0,0,0
6.277,6,1601,1489722,1018,1387,6,1408,1454742,583,931,10,2801,34980
1770.804,6,101,9344,66,65,27243,65,5577,35,59,52079,59,3767
0.371,6,10,1185,6,279,74,279,587,4,191,67,272,598
0.155,17,5,4254,3,909,77,1350,2812,2,693,50,1350,1442
2.131,6,1547,1353171,789,218,2,230,44819,758,1678,2,5632,1308352
0.173,17,2,154,1,33,0,33,61,1,65,0,65,93
0.403,6,26,8991,13,252,33,647,1692,13,945,29,1438,7299
1.454,6,46,18680,26,925,58,1460,13104,20,476,65,2615,5576
1.432,6,47,18375,27,834,55,1360,12799,20,476,65,2715,5576
0.749,6,26,5649,14,140,57,267,1264,12,650,62,1414,4385
0.076,17,2,144,1,36,0,36,64,1,52,0,52,80
1792.76,17,180,11520,180,36,10015,36,11520,0,0,0,0,0
29.284,2,2,64,2,8,29284,8,64,0,0,0,0,0
14.827,6,24,6993,13,275,1235,275,1078,11,910,980,1440,5915
1784.737,6,102,8296,68,65,26637,65,4930,34,59,54079,59,3366
125.259,6,33,7757,13,155,10438,267,1306,20,376,6592,3417,6451
1.869,6,14,2351,8,188,267,245,700,6,703,324,1152,1651
0.303,6,26,9017,13,261,25,683,1728,13,1100,24,2816,7289
0.158,17,4,284,2,32,82,32,120,2,54,80,60,164
1797.211,6,307,24337,150,266,12061,516,10393,157,38,11497,76,13944
3.514,17,4,240,4,32,1171,32,240,0,0,0,0,0
20.125,6,19,3078,11,183,2012,517,1509,8,381,2873,499,1569
1772.236,6,180,15480,120,69,14892,69,8940,60,69,30033,69,6540
5.236,6,42,7405,22,201,249,314,3503,20,516,261,1179,3902
0.07,17,2,180,1,30,0,30,58,1,94,0,94,122
681.95,6,56,7685,31,105,22731,501,2825,25,175,28010,1420,4860
240.202,6,56,19120,30,810,8282,1418,16160,26,200,9607,580,2960
0.408,6,7,295,4,0,136,0,164,3,7,100,7,131
1.494,6,46,18418,26,905,59,1460,12842,20,476,66,2615,5576
0.018,6,3,144,1,0,0,0,40,2,0,0,0,104
0.879,17,4,912,2,60,869,60,176,2,340,867,340,736
2.604,6,115,87689,50,131,53,232,2529,65,1375,34,2860,85160
1789.955,6,385,26922,221,97,8136,469,15601,164,69,10981,69,11321
370.838,6,20,1358,15,180,26488,180,980,5,110,15171,110,378
1772.836,6,180,15480,120,69,14897,69,8940,60,69,30040,69,6540
130.988,6,22,9557,12,372,67,802,1630,10,1503,14538,4477,7927
1785.087,17,298,22648,298,48,6010,48,22648,0,0,0,0,0
17.937,17,76,63466,49,1129,373,1350,56727,27,221,688,1350,6739
1484.348,6,160,13736,103,69,14552,69,7846,57,68,26505,69,5890
45.902,17,4,352,2,60,45901,60,176,2,60,45901,60,176
192.391,6,47,6730,21,148,4825,722,2589,26,163,7687,1408,4141
5.391,6,40,7309,21,218,269,314,3463,19,440,285,1152,3846
485.873,6,95,14688,57,302,8676,302,10522,38,83,13131,83,4166
48.389,6,12,492,7,0,8064,0,284,5,0,9180,0,208
4.957,6,16,3271,6,92,991,92,400,10,464,502,1408,2871
240.694,2,3,96,3,8,120347,8,96,0,0,0,0,0
5.019,17,4,558,2,36,5015,36,128,2,187,5015,187,430
6.067,17,12,1032,6,47,1212,47,450,6,69,1212,75,582
1788.196,1,226,12656,226,28,7947,28,12656,0,0,0,0,0
1772.467,1,58,4872,58,56,31095,56,4872,0,0,0,0,0
1679.722,17,13,534,11,14,167953,14,462,2,8,1679530,8,72
1791.97,6,79,4160,40,26,45940,26,2106,39,26,47151,26,2054
1744.968,6,105,8529,69,52,25661,205,5328,36,36,49849,98,3201
316.04,6,84,20300,40,308,8103,1360,10283,44,284,7170,1929,10017
1154.074,6,47,3278,27,33,44384,33,1866,20,31,60731,31,1412
0.032,6,2,1175,1,0,0,0,40,1,1095,0,1095,1135
103.321,17,10,800,5,48,25828,48,380,5,56,25828,56,420
47.339,17,4,352,2,60,47338,60,176,2,60,47337,60,176
88.724,6,40,9865,20,679,679,1360,4263,20,479,4660,4027,5602
0.18,6,2,80,1,0,0,0,40,1,0,0,0,40
0.37,6,11,1007,6,256,70,256,500,5,303,87,303,507
0.038,17,2,241,1,36,0,36,64,1,149,0,149,177
2.998,2,2,64,2,8,2998,8,64,0,0,0,0,0
149.588,17,6,2016,6,308,29917,312,2016,0,0,0,0,0
0.981,6,28,8558,15,229,58,583,2019,13,1001,66,1791,6539
251.834,2,2,64,2,8,251834,8,64,0,0,0,0,0
1742.363,6,145,9311,79,52,22337,208,5772,66,31,26801,31,3539
0.214,6,10,1673,6,553,42,949,1350,4,159,62,159,323
0.537,17,2,384,1,39,0,39,67,1,289,0,289,317
0.145,6,5,321,4,113,48,113,277,1,0,0,0,44
0.266,6,28,6254,13,181,22,537,1578,15,486,18,1402,4676
1740.455,17,30,20190,30,645,60015,645,20190,0,0,0,0,0
3.906,17,5,290,5,30,976,30,290,0,0,0,0,0
300.907,6,47,13945,25,891,12537,1460,8201,22,346,422,1460,5744
1.677,17,3,286,2,46,987,46,148,1,110,0,110,138
1797.616,17,83,3480,82,14,22192,14,3444,1,8,0,8,36
1.652,6,39,8294,19,321,91,1164,2718,20,433,74,1360,5576
106.313,17,4,352,2,60,106311,60,176,2,60,106312,60,176
1771.659,6,200,13888,72,46,24951,46,5824,128,46,13949,46,8064
1.345,6,47,19211,27,894,51,1360,13635,20,433,61,1360,5576
1626.507,1,8,448,8,28,232358,28,448,0,0,0,0,0
0.018,17,2,206,1,44,0,44,72,1,106,0,106,134
240.235,6,65,18619,33,670,7507,1402,15134,32,151,7749,580,3485
1.479,6,10,1687,7,100,246,100,384,3,1179,608,1179,1303
5.819,6,42,7389,22,218,277,314,3503,20,513,290,1179,3886
1740.37,1,67,5628,67,56,26369,56,5628,0,0,0,0,0
2.922,17,6,1450,3,32,1459,32,180,3,395,24,470,1270
13.588,6,27,5065,13,154,1114,722,1768,14,427,1032,2026,3297
1798.124,6,351,22320,203,69,8901,69,12260,148,69,12232,69,10060
125.179,6,191,150363,118,1334,1069,1448,135584,73,609,1735,1448,14779
1794.914,1,58,4872,58,56,31489,56,4872,0,0,0,0,0
1772.573,6,180,15480,120,69,14895,69,8940,60,69,30037,69,6540
1684.535,2,27,864,27,8,64789,8,864,0,0,0,0,0
280.51,6,31,7472,13,158,23375,267,1317,18,543,16494,1380,6155
291.017,6,36,3657,18,324,17118,585,1653,18,153,17118,580,2004
1750.518,6,95,7203,63,38,28234,205,4476,32,33,56456,98,2727
93.947,6,43,8924,21,401,698,889,2136,22,368,4466,3488,6788
64.341,6,22,6733,6,140,12868,267,809,16,479,4288,1420,5924
3.067,6,26,10976,12,350,278,1089,2236,14,1022,235,1420,8740
1796.851,17,142,11360,71,48,25669,48,5396,71,56,25668,56,5964
107.802,17,40,10360,40,231,2764,388,10360,0,0,0,0,0
0.01,17,2,362,1,30,0,30,58,1,276,0,276,304
1740.615,6,87,6322,58,31,30537,31,3915,29,31,62164,31,2407
0.484,6,13,5033,6,517,96,517,825,7,1914,73,2420,4208
1.337,6,48,18593,26,912,53,1460,12937,22,433,55,1460,5656
14.748,6,28,7562,10,155,13,267,1186,18,403,867,3426,6376
317.028,6,71,18738,35,370,9324,1460,9579,36,321,9053,1460,9159
2.681,6,23,3513,12,162,243,293,1458,11,537,238,1179,2055
1749.775,1,78,6552,78,56,22724,56,6552,0,0,0,0,0
0.018,17,2,144,1,36,0,36,64,1,52,0,52,80
76.266,6,30,7432,13,158,6355,267,1317,17,543,4761,1400,6115
155.518,17,4,352,2,60,155517,60,176,2,60,155517,60,176
1.26,6,47,18554,27,847,48,1360,12978,20,433,57,1360,5576
1.598,6,49,20102,28,888,59,1360,14486,21,433,69,1360,5616
0.441,6,10,1840,5,901,110,901,1169,5,403,110,403,671
1787.45,6,103,8268,68,64,26678,64,4896,35,58,52568,58,3372
0.377,6,10,1992,5,288,86,288,508,5,424,53,434,1484
1139.038,2,10,320,10,8,126559,8,320,0,0,0,0,0
280.517,6,29,7392,13,158,23376,267,1317,16,678,18692,2760,6075
0.359,6,27,9069,13,261,29,683,1728,14,943,26,1408,7341
1.454,6,19,3781,10,234,161,564,1452,9,463,159,1343,2329
11.629,6,1826,1594142,1102,1391,10,1420,1560961,724,467,16,1883,33181
31.546,6,7,308,1,0,0,0,44,6,0,6274,0,264
300.56,6,36,8486,19,315,16697,882,2053,17,478,527,1928,6433
60.48,6,8,348,2,0,60480,0,84,6,0,6320,0,264
280.423,6,30,7432,13,158,23368,267,1317,17,603,17523,2076,6115
1.38,6,47,18522,27,845,53,1360,12946,20,476,62,2715,5576
1680.309,1,15,840,15,28,120022,28,840,0,0,0,0,0
4.01,17,8,1288,4,33,1333,33,244,4,233,912,233,1044
2.279,6,14,2351,8,188,325,245,700,6,703,406,1152,1651
0.991,6,13,3565,7,126,165,126,498,6,1373,198,1448,3067
0.88,6,11,1727,7,100,146,100,384,4,589,208,1152,1343
1.891,17,4,252,3,31,944,31,177,1,47,0,47,75
1794.055,17,87,3648,86,14,21106,14,3612,1,8,0,8,36
8.998,6,4,240,4,0,0,0,240,0,0,0,0,0
38.997,17,20,8209,9,433,4871,1350,4150,11,341,3896,1350,4059
1785.956,6,152,16156,76,72,23812,721,6091,76,130,23805,2840,10065
9.994,6,16,3911,9,275,1249,275,643,7,992,832,1440,3268
3.181,17,2,322,1,33,0,33,61,1,233,0,233,261
1772.513,6,180,15480,120,69,14895,69,8940,60,69,30034,69,6540
1791.488,17,180,14040,180,50,10008,50,14040,0,0,0,0,0
0.343,17,2,152,1,48,0,48,76,1,48,0,48,76
1756.039,6,106,6322,60,27,29762,27,3525,46,27,39022,27,2797
6.679,6,24,4530,13,213,556,597,1741,11,441,649,1448,2789
376.259,17,8,2736,8,314,53751,320,2736,0,0,0,0,0
1745.01,6,106,9501,64,83,27698,722,6019,42,38,42548,98,3482
1370.342,17,108,8640,54,48,25855,48,4104,54,56,25855,56,4536
65.852,6,38,10122,12,155,185,267,1266,26,354,2633,1420,8856
94.57,17,4,724,2,32,94565,32,120,2,274,94565,296,604
1792.57,17,179,11456,179,36,10070,36,11456,0,0,0,0,0
1786.295,17,139,11116,70,48,25888,48,5320,69,56,26268,56,5796
0.043,6,6,716,3,302,13,302,458,3,102,12,102,258
48.001,6,4,270,4,31,16000,31,270,0,0,0,0,0
1799.823,17,4341,208368,2170,20,829,20,104160,2171,20,828,20,104208
1740.652,17,30,7050,30,207,60022,207,7050,0,0,0,0,0
0.031,17,2,138,1,33,0,33,61,1,49,0,49,77
1786.83,6,104,8376,68,65,26669,65,4930,36,59,51049,59,3446
61.27,6,10,648,10,31,6807,31,648,0,0,0,0,0
1799.323,17,439,147504,439,308,4108,308,147504,0,0,0,0,0
5.112,6,40,7325,20,218,269,314,3423,20,516,254,1179,3902
1761.866,17,77,25616,77,304,23182,308,25616,0,0,0,0,0
2.967,17,2,204,1,34,0,34,62,1,114,0,114,142
78.544,17,3,522,3,146,39272,346,522,0,0,0,0,0
10.061,6,84,25130,44,568,233,1152,19389,40,459,251,1179,5741
4.048,17,4,240,2,32,4048,32,120,2,32,4047,32,120
0.502,17,3,705,3,207,251,207,705,0,0,0,0,0
0.829,6,5,1077,3,0,307,0,144,2,853,614,853,933
1720.697,17,13,534,11,14,172051,14,462,2,8,1720512,8,72
0.828,6,28,5967,13,156,69,267,1462,15,650,54,1420,4505
470.305,6,82,12530,41,152,11753,721,5168,41,380,11753,1440,7362
0.876,17,2,144,1,36,0,36,64,1,52,0,52,80
1770.552,6,103,9448,66,65,27239,65,5577,37,59,49179,59,3871
240.326,6,43,8907,21,519,12016,1402,5775,22,220,11443,618,3132
145.07,6,33,14895,16,899,69,1460,6081,17,812,9056,1460,8814
156.589,6,28,15243,15,648,49,1360,3224,13,1641,13039,4416,12019
39.018,17,11,836,11,48,3901,48,836,0,0,0,0,0
1.495,17,2,778,2,361,1495,361,778,0,0,0,0,0
3.834,6,14,4089,8,49,547,92,523,6,1625,730,2329,3566
540.477,6,48,7943,29,115,19302,501,2550,19,289,30021,1420,5393
1794.613,17,87,3658,84,14,21621,15,3530,3,14,738334,18,128
1797.505,17,759,45786,759,32,2371,37,45786,0,0,0,0,0
1781.295,6,355,22549,205,69,8731,69,12340,150,69,11954,69,10209
1.075,6,25,8056,12,164,83,267,1288,13,869,76,1408,6768
0.259,17,4,368,2,32,257,32,120,2,96,247,96,248
1773.044,6,180,15480,120,69,14899,69,8940,60,69,30049,69,6540
0.905,6,10,1687,7,100,150,100,384,3,1179,320,1179,1303
20.906,6,24,5007,13,211,1740,211,1353,11,617,2090,904,3654
1684.537,2,28,896,28,8,62390,8,896,0,0,0,0,0
300.387,6,27,8512,14,401,23106,1050,2354,13,684,3198,1448,6158
179.017,17,4,352,2,60,179016,60,176,2,60,179016,60,176
1786.616,6,102,8296,68,65,26665,65,4930,34,59,54137,59,3366
3.978,17,18,7161,8,445,568,1350,3791,10,309,431,1350,3370
1797.453,17,448,39896,403,35,4471,288,25676,45,288,40023,288,14220
1181.915,1,6,336,6,28,236383,28,336,0,0,0,0,0
46.846,6,41,9221,20,371,794,766,1981,21,425,2334,2128,7240
1789.463,6,356,22520,208,69,8644,69,12460,148,69,12171,69,10060
1785.857,6,353,22262,206,69,8711,69,12311,147,69,12231,69,9951
240.277,6,46,9222,24,197,10445,751,2637,22,543,11439,2378,6585
2.015,17,6,462,3,33,999,33,183,3,65,999,65,279
29.357,17,15,7805,8,655,4193,1350,5471,7,305,49,1350,2334
8.827,6,35,8425,18,401,519,888,1991,17,478,537,1928,6434
0.062,6,10,2047,6,740,12,1323,1724,4,159,19,159,323
240.176,6,94,99019,44,184,5585,518,3584,50,2159,4901,5632,95435
1762.977,6,148,14278,75,61,23823,517,5443,73,198,24485,1418,8835
1786.762,6,102,8296,68,65,26668,65,4930,34,59,54140,59,3366
1772.542,6,180,15480,120,69,14895,69,8940,60,69,30036,69,6540
0.319,17,2,152,1,48,0,48,76,1,48,0,48,76
1.355,6,49,19091,27,880,52,1360,13435,22,476,55,2715,5656
72.521,6,9,372,4,0,24173,0,164,5,0,17633,0,208
1462.414,6,124,7807,64,48,23210,208,4539,60,31,24783,31,3268
1.886,17,2,120,2,32,1886,32,120,0,0,0,0,0
1008.493,17,200,15200,200,48,5067,48,15200,0,0,0,0,0
1564.215,2,15,480,15,8,111729,8,480,0,0,0,0,0
1763.608,2,15,480,15,8,125972,8,480,0,0,0,0,0
2.189,6,14,2351,8,188,312,245,700,6,703,388,1152,1651
1.166,6,24,8004,12,164,90,267,1288,12,1014,89,2331,6716
60.417,6,9,771,5,177,15104,177,445,4,110,20061,110,326
0.006,17,2,294,1,32,0,32,60,1,206,0,206,234
1770.288,17,272,62133,272,200,6532,422,62133,0,0,0,0,0
0.921,6,28,8472,15,222,54,540,1976,13,994,62,1791,6496
1.266,6,23,7952,12,164,97,267,1288,11,1216,107,3819,6664
0.081,6,8,432,4,0,27,0,216,4,0,3,0,216
0.15,6,15,5246,9,247,18,424,1217,6,927,20,1452,4029
280.361,6,30,7432,13,158,23363,267,1317,17,543,17513,1400,6115
28.36,6,3938,3700257,2570,1362,10,1408,3624457,1368,931,20,2801,75800
0.192,6,17,5530,9,601,24,1193,2279,8,942,26,2160,3251
11.396,6,4,432,2,0,11391,0,128,2,212,11392,212,304
1739.244,6,91,6604,59,31,29986,31,3998,32,31,56104,31,2606
4.249,17,8,1940,4,40,1412,40,272,4,389,1412,423,1668
1793.479,1,58,4872,58,56,31464,56,4872,0,0,0,0,0
1.677,6,14,2351,8,188,239,245,700,6,703,284,1152,1651
286.323,6,198,154476,123,1294,2346,1368,140986,75,684,1885,2519,13490
1794.601,6,360,22818,209,69,8627,69,12569,151,69,11963,69,10249
0.009,17,2,378,1,30,0,30,58,1,292,0,292,320
786.491,1,16,896,16,28,52432,28,896,0,0,0,0,0
1786.982,6,359,22709,209,69,8591,69,12569,150,69,11993,69,10140
1772.269,6,183,15738,121,69,14768,69,8980,62,69,29046,69,6758
0.881,17,2,148,2,46,881,46,148,0,0,0,0,0
1793.283,6,273,25425,163,77,11069,267,11712,110,132,16451,1452,13713
13.225,6,30,9316,14,241,1017,722,1772,16,690,523,2760,7544
370.878,6,20,1358,15,180,26491,180,980,5,110,15166,110,378
2.069,17,3,3140,3,1018,1034,1438,3140,0,0,0,0,0
1764.147,2,15,480,15,8,126010,8,480,0,0,0,0,0
0.03,17,8,2446,8,277,4,316,2446,0,0,0,0,0
1.301,6,38,8254,19,321,72,1164,2718,19,476,62,2715,5536
0.632,6,126,91151,75,1299,8,1432,84890,51,420,12,1432,6261
2.15,17,2,334,1,39,0,39,67,1,239,0,239,267
1793.199,6,356,22520,208,69,8662,69,12460,148,69,12198,69,10060
0.628,6,10,924,5,283,108,283,551,5,105,106,105,373
1711.625,17,16,3103,16,165,114108,166,3103,0,0,0,0,0
1788.716,17,87,3648,86,14,21043,14,3612,1,8,0,8,36
0.06,6,2,116,1,0,0,0,52,1,0,0,0,64
369.562,6,23,1538,16,180,24637,180,1056,7,110,10612,110,482
240.277,6,51,17214,27,775,9241,1402,14597,24,170,10446,580,2617
1793.343,1,268,15008,268,28,6716,28,15008,0,0,0,0,0
15.239,17,19,6748,9,433,1895,1350,4150,10,231,1685,1350,2598
0.355,6,10,1669,6,551,71,947,1346,4,159,118,159,323
0.012,17,4,384,2,60,12,60,176,2,76,11,76,208
62.523,6,14,5617,4,106,20836,106,274,10,985,6945,1420,5343
0.403,17,8,2926,8,337,57,360,2926,0,0,0,0,0
1788.394,17,87,3648,86,14,21039,14,3612,1,8,0,8,36
2.371,6,35,12551,18,442,139,1360,3421,17,767,99,1380,9130
242.83,6,47,6478,22,331,11563,1056,3523,25,149,10117,580,2955
1755.076,6,122,9070,72,37,24719,205,5099,50,32,35813,98,3971
1777.884,17,140,11200,70,48,25766,48,5320,70,56,25766,56,5880
56.234,6,7,2478,7,302,9372,302,2478,0,0,0,0,0
64.562,6,61,20935,32,615,2082,815,7466,29,723,2296,4080,13469
1746.436,6,95,7203,63,38,28168,205,4476,32,33,56326,98,2727
7.121,17,2,1430,2,687,7121,687,1430,0,0,0,0,0
0.165,6,16,6056,9,70,19,133,504,7,1756,26,2828,5552
20.066,17,3,3300,3,1072,10033,1072,3300,0,0,0,0,0
5.044,1,10,280,10,0,0,0,280,0,0,0,0,0
0.079,17,2,245,1,32,0,32,60,1,157,0,157,185
1796.53,17,448,39384,403,35,4468,288,25412,45,282,40018,288,13972
251.604,2,2,64,2,8,251604,8,64,0,0,0,0,0
1798.012,17,142,11360,71,48,25685,48,5396,71,56,25685,56,5964
1.248,6,50,18772,27,854,48,1360,13076,23,433,49,1360,5696
3.905,6,14,3143,8,49,557,92,511,6,579,61,1448,2632
7.211,6,5,240,1,0,0,0,48,4,0,2399,0,192
1782.495,17,83,3480,82,14,22006,14,3444,1,8,0,8,36
57.578,17,6,456,6,48,11515,48,456,0,0,0,0,0
0.009,17,2,466,1,34,0,34,62,1,376,0,376,404
65.155,6,67,47417,44,1199,1515,1448,39493,23,746,2801,1448,7924
1795.664,6,368,29511,204,75,8845,267,13224,164,127,11016,1460,16287
1795.597,17,180,14040,180,50,10031,50,14040,0,0,0,0,0
1783.91,6,356,22520,208,69,8617,69,12460,148,69,12133,69,10060
1.285,6,40,9264,22,399,61,1360,3723,18,437,64,2715,5541
1772.427,6,182,15560,120,69,14894,69,8940,62,69,29052,69,6620
0.016,17,2,425,1,48,0,48,76,1,321,0,321,349
240.232,6,54,15279,28,679,8895,1418,12343,26,197,9608,580,2936
1788.498,17,142,11360,71,48,25549,48,5396,71,56,25549,56,5964
1799.969,6,208,14438,76,46,23999,46,6076,132,46,13739,46,8362
1796.944,17,449,39928,404,35,4458,288,25708,45,288,40015,288,14220
240.44,6,48,9119,24,517,10453,1418,5917,24,216,10452,618,3202
0.073,6,12,3462,6,75,14,75,395,6,1373,14,1448,3067
1738.058,1,58,4872,0,0,0,0,0,58,56,30492,56,4872
393.029,6,93,5583,47,69,8544,69,2846,46,34,8733,64,2737
0.916,6,11,1727,7,100,152,100,384,4,589,223,1152,1343
1.247,6,10,1687,7,100,207,100,384,3,1179,493,1179,1303
0.107,6,9,1002,5,213,26,213,417,4,421,28,421,585
1740.448,17,29,19517,29,645,62158,645,19517,0,0,0,0,0
3.482,6,6,324,4,0,1160,0,216,2,0,3276,0,108
1672.363,1,8,848,8,78,238909,78,848,0,0,0,0,0
69.528,6,29,7326,13,155,5794,267,1306,16,447,4634,2840,6020
283.853,6,35,7774,14,158,21834,267,1357,21,464,14191,1400,6417
13.693,6,27,4865,13,154,1123,722,1766,14,394,1039,1448,3099
504.742,2,4,128,4,8,168247,8,128,0,0,0,0,0
0.427,6,10,968,5,256,105,256,460,5,304,104,304,508
0.308,6,26,9017,13,261,25,683,1728,13,943,24,1438,7289
1784.091,6,104,8376,68,65,26628,65,4930,36,59,50971,59,3446
1.825,6,13,2311,8,188,260,245,700,5,1407,389,1407,1611
0.001,6,3,120,0,0,0,0,0,3,0,0,0,120
1766.192,1,56,4704,56,56,32112,56,4704,0,0,0,0,0
0.869,6,16,2690,8,288,98,288,652,8,568,98,853,2038
247.617,6,36,6191,16,153,10879,516,1720,20,244,13028,1452,4471
11.259,6,12,700,5,0,2814,0,280,7,0,1840,0,420
1782.412,17,83,3480,82,14,22005,14,3444,1,8,0,8,36
0.25,17,4,304,2,48,137,48,152,2,48,136,48,152
0.817,6,5,260,2,0,770,0,104,3,0,389,0,156
1792.865,6,366,23265,211,69,8537,69,12718,155,69,11641,69,10547
1787.478,6,104,8376,68,65,26678,65,4930,36,59,51068,59,3446
1775.867,6,103,8395,68,65,26505,65,4930,35,59,52228,59,3465
241.971,6,56,9846,25,126,10082,267,2398,31,248,8063,1452,7448
65.123,17,4,240,2,32,65122,32,120,2,32,65122,32,120
0.006,17,2,394,1,37,0,37,65,1,301,0,301,329
1.196,6,44,10145,23,440,54,1360,4484,21,400,51,1360,5661
68.647,6,12,984,11,43,6864,43,924,1,0,0,0,60
88.349,17,42,10878,42,231,2154,388,10878,0,0,0,0,0
1.253,17,19,6778,9,471,155,1350,4495,10,200,135,1350,2283
1.213,17,13,5309,6,470,234,1350,2990,7,303,190,1350,2319
1786.509,6,365,25432,213,100,8426,469,14936,152,69,11828,69,10496
1681.916,1,15,840,15,28,120136,28,840,0,0,0,0,0
174.477,6,22,9783,12,410,58,922,1742,10,1271,19370,4416,8041
1796.472,1,242,13552,242,28,7454,28,13552,0,0,0,0,0
0.016,17,2,195,1,32,0,32,60,1,107,0,107,135
1681.225,17,14,3843,7,30,280203,30,406,7,463,280203,463,3437
1792.8,17,87,3648,86,14,21091,14,3612,1,8,0,8,36
42.692,17,8,704,4,48,14227,48,304,4,72,14227,72,400
0.232,6,46,20300,26,1015,9,1420,15279,20,467,11,1883,5021
1.209,6,11,1427,6,145,241,145,389,5,830,296,830,1038
2.857,17,8,1048,4,39,942,39,268,4,167,941,167,780
1696.516,17,16,1265,8,30,242357,37,471,8,71,242357,136,794
0.006,6,2,100,1,0,0,0,60,1,0,0,0,40
1799.214,17,449,39928,404,35,4464,288,25708,45,288,40021,288,14220
30.651,17,9,684,9,48,3831,48,684,0,0,0,0,0
4.669,6,23,6596,13,350,387,1089,2276,10,979,517,1731,4320
125.483,6,14,3144,7,92,20913,92,452,7,464,20877,1408,2692
3.662,17,4,368,4,64,1220,64,368,0,0,0,0,0
5.008,17,4,288,2,36,5008,36,128,2,52,5007,52,160
6.01,17,3,1008,3,308,3005,308,1008,0,0,0,0,0
11.729,6,1871,1616790,1139,1363,10,1380,1582761,732,467,16,1923,34029
0.432,6,51,21845,28,1035,16,1380,16683,23,383,17,1380,5162
332.377,6,36,3096,23,74,15108,138,1817,13,69,27697,69,1279
0.006,17,2,550,1,33,0,33,61,1,461,0,461,489
76.57,6,33,7693,12,155,25,267,1266,21,348,3828,1420,6427
4.186,17,5,295,5,31,1046,31,295,0,0,0,0,0
19.044,6,6,498,6,31,3808,31,498,0,0,0,0,0
73.341,6,18,1299,9,177,9167,177,713,9,110,9140,110,586
41.5,6,24,9161,9,197,5187,501,1155,15,740,2890,3151,8006
132.062,6,14,1887,8,302,18866,302,1318,6,83,26409,83,569
0.004,17,2,434,1,43,0,43,71,1,335,0,335,363
0.049,17,4,284,2,32,0,32,120,2,54,14,60,164
28.444,6,43,13747,21,315,1422,721,3371,22,791,1305,2840,10376
36.327,17,4,240,2,32,36326,32,120,2,32,36326,32,120
251.365,6,558,547198,358,186,704,283,20436,200,2675,1263,11264,526762
1771.243,6,99,9306,66,66,27249,66,5610,33,60,55348,60,3696
0.054,17,4,284,2,32,0,32,120,2,54,10,60,164
0.208,17,15,5380,7,355,34,1350,2686,8,308,21,1350,2694
280.478,6,29,7392,13,158,23373,267,1317,16,678,18694,3456,6075
2.946,17,4,624,4,128,982,128,624,0,0,0,0,0
1795.794,1,58,4872,0,0,0,0,0,58,56,31505,56,4872
1066.49,17,746,52494,666,40,1603,41,45727,80,56,511,57,6767
0.603,17,2,144,1,36,0,36,64,1,52,0,52,80
0.26,17,8,1670,8,180,37,219,1670,0,0,0,0,0
202.325,6,81,57961,52,1205,3967,1368,49717,29,961,2207,3887,8244
1795.471,1,58,4872,58,56,31499,56,4872,0,0,0,0,0
0.027,17,2,283,1,31,0,31,59,1,196,0,196,224
237.995,6,163,128260,105,1282,2288,1408,115734,58,730,1603,3847,12526
1680.482,17,12,498,11,14,168048,14,462,1,8,0,8,36
1751.885,1,75,6300,75,56,23674,56,6300,0,0,0,0,0
280.531,6,30,7432,13,158,23377,267,1317,17,678,17527,2085,6115
84.063,17,4,558,2,36,84058,36,128,2,187,84058,187,430
233.448,17,4,304,2,48,233447,64,152,2,48,233447,64,152
1795.682,1,263,14728,263,28,6853,28,14728,0,0,0,0,0
121.243,1,23,2392,0,0,0,0,0,23,76,5511,76,2392
1797.173,6,1741,2165540,516,127,3489,340,34294,1225,1793,1468,5608,2131246
15.187,17,19,4950,8,221,2165,1350,1999,11,240,1515,1350,2951
1794.322,1,272,15232,272,28,6621,28,15232,0,0,0,0,0
2.087,17,26,19965,14,916,160,1350,13217,12,534,152,1350,6748
0.104,6,12,1697,7,253,17,500,878,5,551,25,551,819
0.395,6,14,1733,7,288,65,288,588,7,284,38,434,1145
0.121,17,2,166,1,28,0,28,56,1,82,0,82,110
0.801,6,36,8215,18,241,47,619,1741,18,441,38,1360,6474
7.706,6,1243,1069191,748,1381,10,1420,1045170,495,467,15,1883,24021
364.106,6,46,10606,29,302,13003,1360,5124,17,435,541,2667,5482
33.588,6,34,5262,16,154,2227,722,1923,18,299,1965,1448,3339
0.025,17,2,543,1,34,0,34,62,1,453,0,453,481
1799.805,17,432,56579,204,176,8829,1350,41734,228,37,7928,1350,14845
592.991,6,8,475,6,31,118598,31,333,2,31,299514,31,142
0.174,17,2,152,1,48,0,48,76,1,48,0,48,76
31.214,17,2,152,2,48,31214,48,152,0,0,0,0,0
5.172,6,35,11470,14,155,54,267,1346,21,545,258,1420,10124
1791.047,17,144,11520,72,48,25225,48,5472,72,56,25225,56,6048
0.171,17,57,49025,21,169,8,1350,4154,36,1218,2,1350,44871
0.373,6,20,4960,10,137,41,267,1092,10,692,39,1467,3868
70.963,6,73,49135,45,1206,1612,1448,40954,28,746,2284,1448,8181
124.198,17,4,296,2,34,124184,36,124,2,58,124196,68,172
1786.779,6,104,8376,68,65,26668,65,4930,36,59,51048,59,3446
33.962,6,25,4782,13,180,2830,722,1755,12,599,3069,2317,3027
0.317,6,21,7203,12,318,27,600,1906,9,964,38,1471,5297
4.571,6,39,7269,20,218,240,314,3423,19,513,239,1179,3846
1.265,17,32,20808,18,830,74,1350,15455,14,354,75,1350,5353
1621.539,1,50,4200,0,0,0,0,0,50,56,33092,56,4200
20.058,17,30,2220,20,40,1055,41,1373,10,56,1903,57,847
1798.139,17,144,11520,72,48,25325,48,5472,72,56,25325,56,6048
1785.152,1,174,9744,174,28,10318,28,9744,0,0,0,0,0
1.186,6,10,924,5,283,208,283,551,5,105,198,105,373
0.437,6,12,1653,6,288,86,288,548,6,426,52,434,1105
1792.222,6,356,22520,208,69,8658,69,12460,148,69,12191,69,10060
0.735,6,17,5132,9,150,91,174,664,8,828,93,1420,4468
1682.587,17,14,1036,7,30,280423,30,406,7,62,280423,62,630
397.189,1,12,672,12,28,36108,28,672,0,0,0,0,0
0.134,17,4,288,2,33,0,33,122,2,55,125,61,166
36.513,6,4848,4579791,3101,1397,11,1448,4484283,1747,776,20,1448,95508
7.369,6,75,23617,39,560,193,1152,18393,36,472,203,1179,5224
1790.013,6,408,36334,182,72,9888,1091,13789,226,88,7955,1360,22545
33.696,6,34,5448,18,154,1982,721,2062,16,364,2233,2026,3386
0.01,17,2,322,1,33,0,33,61,1,233,0,233,261
1751.477,6,95,7203,63,38,28249,205,4476,32,33,56491,98,2727
1781.763,6,369,25730,215,99,8325,469,15154,154,69,11645,69,10576
1787.286,6,104,8376,68,65,26675,65,4930,36,59,51061,59,3446
112.964,1,36,3776,4,84,25789,84,448,32,76,878,76,3328
4.609,6,39,7285,20,218,242,314,3423,19,516,242,1179,3862
10.499,6,63,21465,32,729,338,1380,15895,31,467,348,1924,5570
120.273,2,2,64,2,8,120273,8,64,0,0,0,0,0
11.529,6,25,8453,13,275,960,275,1078,12,983,739,1420,7375
0.276,17,4,798,2,39,266,39,134,2,304,264,304,664
1684.516,2,16,512,16,8,112301,8,512,0,0,0,0,0
14.867,17,4,824,2,48,14848,48,152,2,308,14848,308,672
1785.984,6,102,8296,68,65,26656,65,4930,34,59,54117,59,3366
3.022,17,2,279,1,36,0,36,64,1,187,0,187,215
15.408,17,10,880,5,48,3847,48,380,5,72,3847,72,500
0.075,17,2,549,1,30,0,30,58,1,463,0,463,491
1788.856,6,357,22629,208,69,8641,69,12460,149,69,12084,69,10169
1285.402,17,98,7840,49,48,26779,48,3724,49,56,26779,56,4116
0.486,6,52,22680,28,1088,18,1380,17478,24,421,18,1923,5202
3.267,6,12,507,7,0,544,0,288,5,7,751,7,219
1763.857,2,12,384,12,8,160350,8,384,0,0,0,0,0
0.888,6,11,1727,7,100,148,100,384,4,589,211,1152,1343
0.049,17,3,1007,1,137,0,137,165,2,393,48,393,842
56.755,6,557,252480,286,817,199,1152,236119,271,424,209,1179,16361
1.405,17,2,144,1,36,0,36,64,1,52,0,52,80
0.234,1,2,112,2,28,234,28,112,0,0,0,0,0
16.44,6,33,11939,15,211,1174,569,1880,18,909,918,1438,10059
0.018,17,2,167,1,39,0,39,67,1,72,0,72,100
0.029,6,12,3705,6,171,4,171,491,6,964,4,1448,3214
1795.065,17,447,39864,402,35,4476,288,25644,45,288,40019,288,14220
1681.748,17,14,1036,7,30,280285,30,406,7,62,280285,62,630
97.409,6,22,8457,11,316,70,639,1420,11,940,9727,1460,7037
240.193,6,55,18899,30,794,8282,1402,15875,25,214,10007,580,3024
3.995,17,3,180,3,32,1997,32,180,0,0,0,0,0
1786.181,6,106,8584,69,66,26267,66,5004,37,60,49612,60,3580
6.099,1,9,5184,9,548,762,548,5184,0,0,0,0,0
1781.118,1,58,4872,58,56,31247,56,4872,0,0,0,0,0
1772.721,6,181,15589,120,69,14896,69,8940,61,69,29541,69,6649
4.703,6,25,8793,15,290,335,602,1474,10,987,492,1452,7319
0.887,6,10,1687,7,100,147,100,384,3,1179,317,1179,1303
30.396,17,4,352,2,60,30395,60,176,2,60,30394,60,176
0.379,6,29,7078,17,242,23,646,2384,12,701,34,2840,4694
3.564,6,32,8261,11,384,356,1162,2408,21,357,168,1440,5853
27.146,17,4,240,2,32,27145,32,120,2,32,27145,32,120
293.997,1,4,224,4,28,97999,28,224,0,0,0,0,0
3.393,17,4,304,2,48,3130,48,152,2,48,3121,48,152
0.614,6,12,976,8,181,87,181,605,4,77,188,134,371
660.279,6,40,5148,24,302,28707,302,3652,16,83,44018,83,1496
7.657,17,6,528,3,48,3822,48,228,3,72,3822,72,300
0.88,6,28,5780,14,125,67,267,1315,14,650,62,1420,4465
14.537,6,23,6953,13,275,1211,275,1078,10,1092,1057,2391,5875
62.903,6,26,8176,13,366,57,796,1675,13,663,5231,2720,6501
240.207,6,57,20499,31,833,8006,1408,17459,26,210,9608,580,3040
2.071,17,4,352,2,60,2070,60,176,2,60,2065,60,176
10.757,6,20,4402,11,275,1075,275,998,9,758,747,1420,3404
4.081,17,10,2802,5,30,1018,30,290,5,474,1017,484,2512
1794.274,17,175,11200,175,36,10311,36,11200,0,0,0,0,0
0.613,6,14,1733,7,288,70,288,588,7,426,72,434,1145
1.606,6,47,20114,28,895,59,1360,14578,19,476,77,2715,5536
9.173,17,8,1684,4,47,3053,47,300,4,318,3053,318,1384
0.306,6,45,20115,26,1005,12,1420,15134,19,526,16,3303,4981
1.355,6,50,20288,27,962,52,1460,14592,23,476,52,2920,5696
159.219,6,6,1257,4,327,53073,414,815,2,181,159040,270,442
39.437,6,18,2477,10,211,4377,211,958,8,545,5633,904,1519
1770.567,6,101,9344,66,65,27239,65,5577,35,59,52072,59,3767
1773.106,6,181,15589,120,69,14900,69,8940,61,69,29545,69,6649
12.144,17,10,2085,5,34,3032,34,310,5,327,3032,327,1775
1.009,6,12,2069,7,324,168,585,1009,5,396,139,580,1060
1790.096,6,5438,4633142,2539,133,705,351,151147,2899,1531,617,5632,4481995
3.266,6,9,2799,6,100,653,100,344,3,1165,1394,1179,2455
1669.917,1,7,742,7,78,278319,78,742,0,0,0,0,0
12.07,17,3,208,2,36,5005,36,128,1,52,0,52,80
0.474,6,54,24269,30,1056,16,1380,17144,24,511,18,1923,7125
163.514,17,4,240,2,32,163512,32,120,2,32,163513,32,120
0.808,6,33,13229,19,886,44,1460,7007,14,627,48,1460,6222
0.09,17,2,184,1,32,0,32,60,1,96,0,96,124
1679.386,1,15,840,15,28,119956,28,840,0,0,0,0,0
1784.824,1,342,28728,342,56,5234,56,28728,0,0,0,0,0
1.331,6,25,8056,12,164,102,267,1288,13,869,95,1448,6768
0.049,17,2,136,1,40,0,40,68,1,40,0,40,68
1797.859,17,342,25992,342,48,5272,48,25992,0,0,0,0,0
1787.889,6,356,22520,208,69,8637,69,12460,148,69,12162,69,10060
154.468,6,35,7960,11,156,60,267,1232,24,303,6715,1420,6728
1795.353,17,446,39832,401,35,4488,288,25612,45,288,40021,288,14220
1772.002,6,204,22330,130,75,13736,267,10057,74,132,24273,1420,12273
23.116,17,37,13736,18,301,1353,1350,5922,19,383,1279,1350,7814
5.092,17,144,189498,142,1305,34,1472,189418,2,12,5013,12,80
300.844,6,39,9955,21,593,15042,1460,4433,18,399,506,1460,5522
901.078,6,56,4378,30,66,26152,66,2190,26,49,36038,60,2188
0.831,6,37,8232,19,241,46,619,1758,18,441,40,1460,6474
1779.543,6,102,8296,68,65,26560,65,4930,34,59,53922,59,3366
1.218,6,3,168,1,0,0,0,52,2,0,1218,0,116
1793.905,17,144,11520,72,48,25266,48,5472,72,56,25266,56,6048
1740.494,17,27,6345,27,207,66942,207,6345,0,0,0,0,0
1.126,6,29,8200,15,222,67,540,1964,14,809,72,1460,6236
1681.729,17,16,1265,8,30,240244,37,471,8,71,240245,136,794
0.141,6,6,240,3,0,38,0,120,3,0,70,0,120
1787.909,6,383,27035,219,102,8201,469,16059,164,69,10968,69,10976
0.781,6,4,208,2,0,781,0,104,2,0,778,0,104
757.595,6,59,9255,38,102,20475,516,3264,21,270,37874,2642,5991
14.713,17,6,456,6,48,2942,48,456,0,0,0,0,0
1741.66,6,100,7256,64,31,27645,31,4356,36,31,49761,31,2900
0.227,17,2,154,1,33,0,33,61,1,65,0,65,93
162.185,6,74,14662,35,316,4770,1189,6473,39,264,4259,1917,8189
0.361,17,2,152,1,48,0,48,76,1,48,0,48,76
0.072,6,11,911,6,181,14,181,489,5,77,4,133,422
1772.388,6,180,15480,120,69,14894,69,8940,60,69,30039,69,6540
1199.399,1,234,19656,234,56,5147,56,19656,0,0,0,0,0
0.319,6,22,7333,12,334,28,663,1969,10,806,34,1408,5364
0.011,17,2,588,1,39,0,39,67,1,493,0,493,521
4.218,17,5,295,5,31,1054,31,295,0,0,0,0,0
15.123,17,24,13048,13,741,1257,1350,10005,11,248,1509,1350,3043
267.812,6,24,3922,11,172,26781,267,1128,13,284,22293,512,2794
3.133,17,4,610,3,39,812,39,201,1,381,0,381,409
102.033,17,2,154,2,49,102033,49,154,0,0,0,0,0
1744.337,6,104,7807,67,38,26429,205,4715,37,33,48429,98,3092
0.039,17,2,479,1,41,0,41,69,1,382,0,382,410
6.669,6,90,56413,50,1148,136,1368,48552,40,958,166,2519,7861
244.863,6,49,6239,23,223,11129,584,2828,26,170,9793,580,3411
1636.216,1,7,742,7,78,272702,78,742,0,0,0,0,0
9.868,6,89,28719,46,573,219,1152,22501,43,449,228,1179,6218
1765.797,6,100,5988,55,26,32699,26,3248,45,26,40130,26,2740
4.329,17,8,736,4,32,1206,32,240,4,96,0,96,496
0.89,6,10,1687,7,100,148,100,384,3,1179,318,1179,1303
296.022,1,4,224,4,28,98674,28,224,0,0,0,0,0
1767.114,6,159,13721,87,111,20547,208,9849,72,31,24885,31,3872
2.013,17,6,1804,3,40,1001,41,206,3,504,1000,505,1598
26.21,6,2,172,2,46,26210,46,172,0,0,0,0,0
6.883,17,29,10144,13,413,573,1350,5744,16,247,267,1350,4400
1682.85,17,14,1036,7,30,280467,30,406,7,62,280467,62,630
50.233,17,16,18199,16,1109,3348,1451,18199,0,0,0,0,0
62.274,6,14,3888,8,127,8896,127,467,6,1056,12448,1704,3421
0.007,6,6,374,3,31,3,31,187,3,31,0,31,187
34.324,6,35,6131,17,154,2145,722,1975,18,357,2008,1408,4156
0.06,6,3,182,2,31,60,31,111,1,31,0,31,71
0.008,17,4,344,2,47,5,47,150,2,69,5,75,194
2.064,17,4,360,2,30,2017,30,116,2,94,2019,94,244
4.438,6,37,7205,19,218,246,314,3383,18,516,245,1179,3822
0.182,17,2,2382,2,1163,182,1163,2382,0,0,0,0,0
280.464,6,29,7392,13,158,23372,267,1317,16,678,18693,2760,6075
1620.659,1,8,448,8,28,231522,28,448,0,0,0,0,0
1.374,6,48,18205,26,882,54,1460,12549,22,476,56,2920,5656
0.197,17,4,560,2,64,196,64,184,2,160,78,160,376
3.96,17,8,1216,4,60,1319,60,352,4,188,1319,188,864
23.845,6,3522,3309321,2290,1367,10,1408,3240593,1232,931,19,2816,68728
0.756,6,30,7559,17,305,47,1086,2825,13,601,61,1420,4734
436.394,17,8,704,4,60,145464,60,352,4,60,145464,60,352
1779.483,17,142,11360,71,48,25421,48,5396,71,56,25421,56,5964
40.348,6,35,8160,21,534,2017,1244,4832,14,216,3103,1282,3328
11.602,6,93,30276,46,586,257,1152,23541,47,441,246,1179,6735
1799.288,1,16,896,16,28,119952,28,896,0,0,0,0,0
1740.574,17,30,31680,30,1028,60019,1028,31680,0,0,0,0,0
1785.854,6,360,24156,210,88,8544,469,13878,150,69,11985,69,10278
0.022,17,2,304,1,60,0,60,88,1,188,0,188,216
346.963,6,36,3165,20,69,14286,69,1490,16,69,23126,69,1675
0.01,17,2,460,1,53,0,53,81,1,351,0,351,379
1699.582,17,12,498,11,14,169958,14,462,1,8,0,8,36
1795.681,17,448,39896,403,35,4466,288,25676,45,288,40021,288,14220
1721.291,1,8,448,8,28,245898,28,448,0,0,0,0,0
1681.052,1,15,870,15,30,120075,30,870,0,0,0,0,0
1744.644,2,29,928,29,8,62308,8,928,0,0,0,0,0
615.979,6,116,22846,54,268,11622,1360,11097,62,220,10095,3289,11749
1740.024,6,90,6521,59,31,30000,31,3998,31,31,58000,31,2523
13.633,6,7,380,4,0,4544,0,216,3,0,6813,0,164
1766.134,17,168,14022,156,30,11394,37,9090,12,383,155127,463,4932
0.503,17,3,451,2,39,293,39,134,1,289,0,289,317
1.346,6,40,9928,21,440,67,1360,4392,19,476,63,2715,5536
2.017,17,4,952,2,60,1915,60,176,2,360,0,368,776
1771.781,6,99,9240,66,65,27258,65,5577,33,59,55364,59,3663
34.055,6,32,5146,15,154,2432,721,1858,17,342,2113,1368,3288
20.321,6,20,3130,12,183,1847,517,1561,8,381,2901,499,1569
36.848,17,44,11418,44,231,856,389,11418,0,0,0,0,0
0.048,17,2,158,1,34,0,34,62,1,68,0,68,96
0.035,1,2,212,2,78,35,78,212,0,0,0,0,0
1781.765,6,362,25312,211,100,8484,469,14856,151,69,11878,69,10456
2.843,17,23,7952,9,272,355,1350,2706,14,346,120,1350,5246
1799.608,17,448,39896,403,35,4476,288,25676,45,288,40018,288,14220
1743.122,6,97,7307,63,38,28114,205,4476,34,33,52812,98,2831
86.529,6,116,88643,74,1261,1185,1448,78281,42,627,2102,1448,10362
9.041,6,17,3436,9,92,1130,92,676,8,1162,1175,1408,2760
0.256,17,3,451,2,39,93,39,134,1,289,0,289,317
362.56,6,25,6333,11,216,5476,501,1310,14,371,27882,1420,5023
34.3,6,29,5073,15,163,2450,722,1942,14,399,2617,2026,3131
5.359,6,40,7309,21,218,267,314,3463,19,513,283,1179,3846
0.047,17,2,152,1,48,0,48,76,1,48,0,48,76
0.311,17,7,2124,7,275,51,316,2124,0,0,0,0,0
0.049,17,3,265,2,39,0,39,134,1,103,0,103,131
1788.584,17,142,11360,71,48,25551,48,5396,71,56,25551,56,5964
1786.667,6,104,8444,68,66,26666,66,4964,36,60,51045,60,3480
1.265,6,47,19239,27,896,48,1360,13663,20,476,57,2715,5576
0.075,17,2,362,1,46,0,46,74,1,260,0,260,288
35.575,6,44,8959,20,410,723,882,2122,24,345,1540,1440,6837
0.428,17,2,152,1,48,0,48,76,1,48,0,48,76
1742.732,6,147,9214,79,48,22342,208,5595,68,31,26005,31,3619
9.994,17,2,128,2,36,9994,36,128,0,0,0,0,0
1787.81,6,102,8228,68,64,26683,64,4896,34,58,54173,58,3332
0.15,6,21,4958,12,89,13,147,1000,9,696,17,1418,3958
0.234,6,9,1340,5,145,58,145,349,4,827,38,827,991
9.96,17,4,272,2,32,9955,32,120,2,48,9954,48,152
377.939,2,4,128,4,8,125979,8,128,0,0,0,0,0
94.019,6,139,103952,83,1302,1146,1448,92876,56,679,1705,1448,11076
0.489,17,2,152,1,48,0,48,76,1,48,0,48,76
1681.265,1,14,784,14,28,129328,28,784,0,0,0,0,0
26.733,17,4,304,2,48,26732,64,152,2,48,26732,64,152
1.607,6,50,18972,29,862,57,1360,13311,21,437,69,2715,5661
1681.563,17,14,3843,7,30,280259,30,406,7,463,280259,463,3437
1699.415,17,12,498,11,14,169941,14,462,1,8,0,8,36
0.199,6,45,20657,26,1044,7,1432,15676,19,420,10,1432,4981
1794.914,6,375,29446,212,75,8506,267,13613,163,132,11079,1420,15833
1746.347,6,97,7307,63,38,28166,205,4476,34,33,52907,98,2831
120.105,17,4,358,2,33,120091,34,123,2,89,120089,114,235
4.985,17,4,558,2,36,4979,36,128,2,187,4980,187,430
0.699,6,3,416,1,0,0,0,40,2,272,632,272,376
0.007,17,2,192,1,37,0,37,65,1,99,0,99,127
1786.671,6,105,8406,68,64,26666,64,4896,37,58,49627,58,3510
1.869,17,6,432,3,36,910,36,192,3,52,899,52,240
8.857,6,79,24349,39,549,233,1152,18608,40,459,219,1179,5741
1787.905,6,386,27293,221,101,8126,469,16277,165,69,10901,69,11016
1794.925,1,235,13160,235,28,7670,28,13160,0,0,0,0,0
0.179,6,26,7256,13,155,14,267,1301,13,603,14,2036,5955
1790.755,17,303,66478,303,191,5929,422,66478,0,0,0,0,0
1783.732,17,20,6992,20,321,93880,1438,6992,0,0,0,0,0
0.774,6,32,8385,17,315,48,882,2033,15,574,43,4848,6352
1680.518,17,12,498,11,14,168051,14,462,1,8,0,8,36
3.463,17,5,295,5,31,865,31,295,0,0,0,0,0
1.293,6,10,1687,7,100,215,100,384,3,1179,523,1179,1303
184.047,6,1254,675723,750,844,245,1152,651886,504,365,365,1152,23837
379.738,6,18,1242,14,180,29210,180,916,4,110,20057,110,326
1787.549,6,400,24328,209,69,8593,69,12500,191,40,9408,69,11828
0.375,6,299,241278,167,183,2,230,9529,132,1729,2,5632,231749
1786.449,6,356,22520,208,69,8630,69,12460,148,69,12152,69,10060
1792.944,6,360,23025,207,69,8703,69,12420,153,69,11794,69,10605
280.09,6,29,7392,13,158,23340,267,1317,16,543,18667,1400,6075
8.375,6,23,4478,12,213,761,597,1689,11,441,819,1440,2789
362.779,6,46,10135,29,266,12956,1360,4653,17,435,545,2667,5482
1541.351,6,303500,306120834,112189,298,13,301,6264284,191311,1515,8,8688,299856550
0.952,6,5,322,3,106,476,106,226,2,0,4,0,96
560.534,17,6,444,3,30,280259,30,174,3,62,280260,62,270
1729.194,6,62,4504,40,33,44338,33,2740,22,31,82334,31,1764
0.818,6,21,5988,12,281,74,544,1328,9,716,93,1420,4660
1770.154,6,99,9306,66,66,27233,66,5610,33,60,55314,60,3696
1786.575,6,158,20624,92,304,19632,304,14512,66,83,27485,83,6112
0.318,2,2,96,2,24,318,24,96,0,0,0,0,0
3.653,17,5,290,5,30,913,30,290,0,0,0,0,0
0.528,1,4,224,4,28,176,28,224,0,0,0,0,0
1785.193,6,102,8364,68,66,26644,66,4964,34,60,54094,60,3400
8.217,6,1458,1344902,900,1415,8,1448,1311210,558,776,14,1448,33692
82.053,6,15,8602,3,214,13605,214,374,12,1287,7447,1702,8228
0.394,6,10,968,5,256,96,256,460,5,304,96,304,508
4.9,6,681,608945,430,1348,10,1368,591229,251,776,18,1473,17716
1771.958,6,180,15480,120,69,14890,69,8940,60,69,30032,69,6540
173.995,17,4,1364,4,313,57998,320,1364,0,0,0,0,0
210.609,6,75,12008,36,194,6017,1189,4164,39,298,5540,1420,7844
1773.136,6,181,15589,120,69,14900,69,8940,61,69,29551,69,6649
1149.008,6,12,1308,12,69,104455,69,1308,0,0,0,0,0
1774.761,6,180,15480,120,69,14913,69,8940,60,69,30074,69,6540
1786.257,6,106,8388,68,64,26660,64,4896,38,58,48274,58,3492
7.481,6,6,260,2,0,558,0,84,4,0,2485,0,176
20.828,17,4,352,2,60,20827,60,176,2,60,20827,60,176
1.307,6,47,18576,26,914,52,1460,12960,21,433,56,1460,5616
1.01,17,2,677,1,300,0,300,328,1,321,0,321,349
1799.694,6,365,25032,213,94,8489,469,14536,152,69,11918,69,10496
140.444,6,51,10789,21,263,7022,1189,2953,30,331,4838,1420,7836
294.987,1,4,224,4,28,98329,28,224,0,0,0,0,0
0.094,17,2,2754,2,1349,94,1349,2754,0,0,0,0,0
11.667,6,1843,1599007,1113,1380,10,1420,1565586,730,467,15,1883,33421
165.62,17,24,4000,12,48,15055,48,912,12,229,15054,308,3088
0.311,17,2,144,1,36,0,36,64,1,52,0,52,80
412.838,6,95,6224,46,46,9114,46,2746,49,46,8600,46,3478
163.135,6,25,10764,14,612,45,1360,3654,11,1109,16301,3068,7110
4.166,1,8,832,0,0,0,0,0,8,76,595,76,832
1793.105,17,340,72122,340,184,5289,422,72122,0,0,0,0,0
11.336,17,12,13737,12,1116,1030,1449,13737,0,0,0,0,0
12.928,6,2023,1780033,1255,1363,10,1380,1745071,768,468,16,3303,34962
0.415,6,51,23190,29,1054,14,1380,18068,22,468,18,3303,5122
262.729,17,4,1344,4,308,87576,308,1344,0,0,0,0,0
1748.463,6,98,7359,62,38,28663,205,4424,36,33,49945,98,2935
46.722,17,4,352,2,60,46721,60,176,2,60,46721,60,176
7.847,6,1576,1412260,940,1421,8,1448,1373984,636,646,12,1448,38276
94.296,6,852,435773,485,839,194,1152,416302,367,398,256,1152,19471
9.117,6,44,13426,24,825,396,1360,7595,20,386,467,2667,5831
1.894,6,38,8475,19,357,105,1385,2939,19,433,91,1440,5536
280.488,6,29,7392,13,158,23374,267,1317,16,603,18691,2760,6075
0.819,6,60,25913,33,1041,25,1380,19142,27,434,30,1380,6771
2.597,17,2,778,2,361,2597,361,778,0,0,0,0,0
1.336,6,33,6547,16,164,89,267,1962,17,650,73,1452,4585
1786.251,6,102,8296,68,65,26660,65,4930,34,59,54126,59,3366
1744.97,6,97,7307,63,38,28144,205,4476,34,33,52870,98,2831
0.387,17,3,451,2,39,107,39,134,1,289,0,289,317
5.181,17,3,208,2,36,5008,36,128,1,52,0,52,80
19.927,17,31,8023,13,240,1658,1350,3492,18,223,1170,1350,4531
0.958,6,27,8251,15,263,58,586,2210,12,1109,71,3132,6041
15.773,6,24,6993,13,275,1314,275,1078,11,910,1074,1420,5915
35.837,6,72,17247,36,368,1023,1360,8115,36,404,1019,1360,9132
0.038,17,4,368,2,32,20,32,120,2,96,21,96,248
1.537,17,24,8823,10,363,170,1350,3912,14,322,71,1350,4911
2.244,6,26,8868,13,227,187,547,1592,13,941,158,1438,7276
1.004,6,12,1653,6,288,195,288,548,6,426,104,434,1105
240.447,6,56,17991,28,788,8904,1418,14864,28,207,8902,580,3127
0.013,17,4,865,2,47,7,47,150,2,329,8,341,715
153.754,17,4,352,2,60,153753,60,176,2,60,153753,60,176
8.718,6,2,142,2,31,8718,31,142,0,0,0,0,0
280.277,6,30,7432,13,158,23356,267,1317,17,543,17511,1400,6115
32.857,17,20,1760,10,48,3649,48,760,10,72,3643,72,1000
1772.063,6,180,15480,120,69,14891,69,8940,60,69,30030,69,6540
282.31,6,31,7563,14,147,21716,267,1448,17,543,17641,1400,6115
52.537,17,4,1344,4,308,17512,308,1344,0,0,0,0,0
174.791,17,4,352,2,60,174790,60,176,2,60,174790,60,176
0.102,17,4,352,2,37,54,37,130,2,83,49,89,222
1.319,6,10,1687,7,100,219,100,384,3,1179,529,1179,1303
0.154,17,4,588,2,48,125,48,152,2,190,132,308,436
263.486,17,4,352,2,60,263485,60,176,2,60,263485,60,176
0.086,17,4,368,2,32,85,32,120,2,96,44,96,248
316.078,6,108,34556,60,471,5357,1360,23653,48,358,6722,4649,10903
1783.604,17,84,3516,82,14,22017,14,3444,2,8,1783394,8,72
125.551,2,2,64,2,8,125551,8,64,0,0,0,0,0
4.175,17,10,1450,5,40,1035,40,340,5,194,1035,194,1110
34.645,6,15,6082,4,106,11548,106,274,11,595,3463,3417,5808
280.405,6,30,7432,13,158,23367,267,1317,17,543,17517,1400,6115
282.241,6,30,7432,13,158,23520,267,1317,17,543,17635,1400,6115
0.198,6,52,24921,29,1093,7,1420,19768,23,467,8,1883,5153
19.96,6,14,1143,6,275,3992,275,519,8,96,2368,96,624
16.463,17,27,12642,15,653,1173,1350,10218,12,174,1493,1350,2424
1758.537,6,4737,4419208,1707,148,1030,925,101084,3030,1407,580,2836,4318124
0.016,17,4,859,2,37,1,37,130,2,336,3,348,729
1777.244,17,73,3060,72,14,25031,14,3024,1,8,0,8,36
1798.931,6,356,22520,208,69,8690,69,12460,148,69,12237,69,10060
1744.668,2,29,928,29,8,62309,8,928,0,0,0,0,0
1789.818,17,87,3648,86,14,21056,14,3612,1,8,0,8,36
1794.236,17,128,10240,64,48,28479,48,4864,64,56,28479,56,5376
10.705,6,20,4442,11,275,1070,275,998,9,768,741,1440,3444
267.101,17,32,3302,28,30,9892,37,1638,4,388,69129,463,1664
29.288,6,39,9334,20,322,1541,722,3062,19,687,1571,1380,6272
1.652,6,14,2351,8,188,236,245,700,6,703,279,1152,1651
15.11,17,12,5285,6,490,3016,1350,3110,6,334,3016,1350,2175
130.805,6,18,2522,13,210,10817,210,1176,5,1090,20479,1090,1346
2.473,6,52,19162,27,872,95,1360,13335,25,370,94,1360,5827
33.617,6,4495,4141780,2769,1409,12,1448,4037612,1726,776,19,1448,104168
1680.81,17,12,498,11,14,168081,14,462,1,8,0,8,36
8.541,6,80,24725,39,560,224,1152,18928,41,461,207,1179,5797
1744.733,6,95,7203,63,38,28140,205,4476,32,33,56268,98,2727
0.859,17,20,9082,9,587,107,1350,5537,11,294,48,1350,3545
8.901,6,4,240,4,0,0,0,240,0,0,0,0,0
0.053,6,10,1514,5,503,13,503,771,5,475,13,475,743
1681.072,1,15,840,15,28,120076,28,840,0,0,0,0,0
0.121,6,2,88,1,0,0,0,40,1,0,0,0,48
1.508,6,48,18805,27,862,58,1360,13189,21,476,66,2715,5616
75.433,6,743,348941,386,837,195,1152,328815,357,417,211,1179,20126
269.375,17,46,53139,46,1127,5986,1451,53139,0,0,0,0,0
1747.33,1,128,10752,128,56,13758,56,10752,0,0,0,0,0
1117.997,1,21,2773,21,104,55899,176,2773,0,0,0,0,0
54.86,6,19,4281,9,187,6857,293,1115,10,460,6066,1179,3166
1786.415,17,87,3648,86,14,21016,14,3612,1,8,0,8,36
1.976,17,2,146,1,37,0,37,65,1,53,0,53,81
1.029,6,2,100,1,0,0,0,60,1,0,0,0,40
0.0,6,1,44,0,0,0,0,0,1,0,0,0,44
1.632,2,2,64,2,8,1632,8,64,0,0,0,0,0
1.438,6,24,8004,12,164,112,267,1288,12,1014,110,2491,6716
280.229,6,32,7512,15,158,20016,267,1397,17,543,17511,1400,6115
88.465,6,23,10128,12,549,60,1360,2709,11,1393,8833,3934,7419
1.332,6,12,1767,8,100,190,100,424,4,589,357,1152,1343
1771.962,6,180,15480,120,69,14890,69,8940,60,69,30031,69,6540
10.766,6,2,87,1,0,0,0,40,1,7,0,7,47
149.174,17,14,1064,14,48,11474,48,1064,0,0,0,0,0
1798.75,17,142,11360,71,48,25696,48,5396,71,56,25696,56,5964
0.395,6,24,7970,13,337,32,674,2044,11,1069,38,1906,5926
0.405,6,4,1037,2,0,230,0,104,2,853,181,853,933
28.437,17,229,126402,137,800,209,1350,113509,92,112,312,1350,12893
1771.66,6,99,9306,66,66,27256,66,5610,33,60,55360,60,3696
8.02,6,1583,1512913,1056,1360,7,1368,1480845,527,776,14,1473,32068
0.074,6,13,4282,7,111,12,111,483,6,1159,14,1863,3799
1790.213,17,87,3648,86,14,21061,14,3612,1,8,0,8,36
0.134,1,2,112,2,28,134,28,112,0,0,0,0,0
324.729,6,5559,6154833,1438,970,225,1002,137850,4121,1422,78,5760,6016983
0.206,6,10,1671,6,552,41,948,1348,4,159,68,159,323
502.41,1,20,2120,20,78,26442,78,2120,0,0,0,0,0
69.56,6,28,7286,13,155,5796,267,1306,15,488,4967,3417,5980
1.998,17,2,312,2,128,1998,128,312,0,0,0,0,0
0.497,17,2,204,1,34,0,34,62,1,114,0,114,142
162.974,6,21,3569,6,92,79,92,412,15,197,11628,1408,3157
28.882,17,4,304,2,48,28865,48,152,2,48,28864,48,152
1.765,6,26,9299,14,350,135,1041,1992,12,973,128,1460,7307
1687.162,17,15,2910,15,166,120511,166,2910,0,0,0,0,0
1786.231,1,339,28476,339,56,5284,56,28476,0,0,0,0,0
1738.659,6,87,6322,58,31,30502,31,3915,29,31,62093,31,2407
325.383,6,43,8773,27,309,12509,331,4814,16,275,21684,276,3959
262.801,1,16,1664,0,0,0,0,0,16,76,17520,76,1664
1.634,6,25,8769,15,286,116,590,1462,10,986,162,1420,7307
166.669,17,4,240,2,32,166667,32,120,2,32,166668,32,120
0.496,17,2,144,1,36,0,36,64,1,52,0,52,80
0.463,6,12,1653,6,288,92,288,548,6,426,57,434,1105
150.985,6,102,76949,65,1295,2359,1448,66863,37,679,1974,1448,10086
0.078,17,2,1922,2,933,78,933,1922,0,0,0,0,0
902.779,6,93,11785,51,89,18055,516,4290,42,181,21831,1452,7495
11.411,6,1807,1577636,1094,1388,10,1420,1544883,713,467,16,1883,32753
86.394,17,4,352,2,60,86393,60,176,2,60,86392,60,176
601.726,6,36,6579,19,250,33429,1314,2516,17,307,37607,1420,4063
1792.002,6,386,24410,218,69,8258,69,13550,168,69,10730,69,10860
1786.609,1,56,4704,56,56,32483,56,4704,0,0,0,0,0
0.044,17,2,192,1,44,0,44,72,1,92,0,92,120
137.988,6,25,10208,12,549,60,1360,2709,13,995,11488,1360,7499
1683.145,17,14,1036,7,30,280516,30,406,7,62,280516,62,630
0.603,6,126,92758,76,1304,8,1420,86537,50,467,12,1883,6221
1773.509,6,181,15589,120,69,14903,69,8940,61,69,29550,69,6649
232.057,17,10,585,10,30,25784,31,585,0,0,0,0,0
280.404,6,30,7432,13,158,23367,267,1317,17,603,17523,2760,6115
1787.448,6,102,8296,68,65,26678,65,4930,34,59,54160,59,3366
11.588,6,22,6817,12,275,1053,275,1038,10,1073,727,1440,5779
167.057,6,33,7319,21,155,8352,267,1810,12,1004,15183,3445,5509
235.763,1,6,336,6,28,47152,28,336,0,0,0,0,0
0.168,17,2,157,1,31,0,31,59,1,70,0,70,98
4.421,6,35,6209,18,206,260,314,2784,17,456,259,1152,3425
43.415,17,12,912,12,48,3946,48,912,0,0,0,0,0
10.092,6,34,12120,19,726,560,1408,7531,15,473,622,1408,4589
3.007,17,4,232,4,30,1002,30,232,0,0,0,0,0
1738.623,6,88,6417,58,31,30502,31,3927,30,31,59952,31,2490
13.701,6,26,4815,13,154,1122,722,1767,13,473,1125,2026,3048
0.206,6,28,7336,13,155,17,267,1301,15,543,13,1400,6035
0.166,17,2,2382,2,1163,166,1163,2382,0,0,0,0,0
17.829,17,38,18537,18,620,1047,1350,11669,20,315,936,1350,6868
2.327,17,2,178,1,29,0,29,57,1,93,0,93,121
1773.132,6,180,15480,120,69,14900,69,8940,60,69,30051,69,6540
1786.202,6,104,8444,68,66,26659,66,4964,36,60,51031,60,3480
1799.005,17,858,76304,772,35,2333,288,49128,86,288,20818,288,27176
1798.54,17,87,3648,86,14,21159,14,3612,1,8,0,8,36
1751.873,6,126,12361,77,61,23050,722,6338,49,88,36493,1440,6023
0.05,6,2,116,1,0,0,0,52,1,0,0,0,64
1796.935,6,127,7998,72,44,25308,208,4589,55,31,33272,31,3409
1790.657,1,58,4872,58,56,31415,56,4872,0,0,0,0,0
1635.142,17,16,4125,8,30,233590,37,471,8,428,233590,463,3654
0.025,6,12,1846,7,139,4,139,511,5,533,4,905,1335
82.213,6,53,18115,28,643,3044,1460,10168,25,577,3416,1460,7947
535.13,6,80,7810,30,81,18448,339,2998,50,104,10921,1062,4812
1.199,6,40,9952,21,440,59,1360,4416,19,433,57,1360,5536
286.431,6,30,3670,15,411,20456,585,2034,15,282,20456,580,1636
0.037,17,4,352,2,37,29,37,130,2,83,28,89,222
2.993,6,2,120,2,0,0,0,120,0,0,0,0,0
280.381,6,28,7352,12,158,25489,267,1277,16,603,18689,1400,6075
3.476,17,3,1170,3,362,1738,362,1170,0,0,0,0,0
1777.369,17,73,3060,72,14,25033,14,3024,1,8,0,8,36
902.449,2,10,320,10,8,100272,8,320,0,0,0,0,0
0.185,6,343,264416,174,198,1,285,9651,169,1490,0,4344,254765
295.641,17,4,352,2,60,295640,60,176,2,60,295640,60,176
0.766,6,26,5680,14,121,58,267,1295,12,650,64,1420,4385
69.949,6,3389,2953528,2179,1277,32,1368,2885932,1210,776,57,2736,67596
0.354,6,27,8920,13,227,29,547,1592,14,941,26,1438,7328
11.017,6,20,7050,11,275,1101,275,998,9,1420,780,1420,6052
1755.008,1,90,9540,90,78,19719,78,9540,0,0,0,0,0
31.272,17,11,929,11,56,3127,82,929,0,0,0,0,0
281.382,6,30,7432,13,158,23448,267,1317,17,543,17574,1400,6115
0.908,17,12,5956,6,568,181,1350,3577,6,368,162,1350,2379
0.433,6,19,6417,10,141,48,275,686,9,766,25,1420,5731
94.061,6,51,10560,18,290,5533,1189,2764,33,248,2934,1460,7796
9.739,6,1543,1338835,947,1362,10,1380,1310753,596,421,16,1923,28082
0.005,17,2,407,1,43,0,43,71,1,308,0,308,336
61.308,6,36,16027,22,814,2919,1402,9301,14,748,4697,2804,6726
1.117,6,220,161665,121,1363,9,1432,153460,99,420,11,1432,8205
1745.305,6,137,8544,76,46,23270,208,5205,61,31,29084,31,3339
1745.509,6,95,7203,63,38,28153,205,4476,32,33,56300,98,2727
1.777,6,15,3632,8,150,253,174,624,7,681,267,1420,3008
0.85,6,2,1253,1,0,0,0,40,1,1173,0,1173,1213
0.091,6,15,4534,8,135,13,136,695,7,869,15,1448,3839
113.701,6,1041,529741,587,844,194,1152,506449,454,394,250,1152,23292
280.44,6,30,7432,14,158,21572,267,1357,16,678,18692,3456,6075
1785.027,6,356,22520,208,69,8623,69,12460,148,69,12141,69,10060
5.425,6,41,7349,20,218,285,314,3423,21,440,258,1152,3926
7.344,6,1525,1417624,969,1386,7,1408,1384036,556,931,12,2816,33588
1668.491,1,8,448,8,28,238355,28,448,0,0,0,0,0
1781.428,6,219,17368,82,75,21990,337,8479,137,50,13097,143,8889
281.035,6,30,8137,13,158,23419,267,1317,17,681,17557,2085,6820
55.26,17,2,72,1,8,0,8,36,1,8,0,8,36
1788.474,17,83,3480,82,14,22079,14,3444,1,8,0,8,36
1786.881,6,107,8630,69,66,26277,66,5070,38,60,48285,60,3560
3.818,6,34,6185,17,206,238,314,2744,17,551,222,1179,3441
168.087,6,33,8093,10,174,343,267,1453,23,336,7639,1917,6640
0.124,17,4,284,2,32,60,32,120,2,54,70,60,164
1788.739,17,140,11200,70,48,25923,48,5320,70,56,25923,56,5880
0.173,17,2,2072,2,1008,173,1008,2072,0,0,0,0,0
0.017,6,14,4020,7,88,2,88,388,7,1113,2,1460,3632
1754.358,6,102,7964,66,45,26990,205,4896,36,35,50114,98,3068
1795.527,17,450,40528,403,35,4466,288,25676,47,288,38280,288,14852
1.245,6,60,18135,29,707,44,1360,8977,31,416,41,1360,9158
1791.328,6,364,23047,211,69,8530,69,12787,153,69,11782,69,10260
1681.21,17,16,4241,8,30,240172,37,471,8,443,240172,463,3770
0.413,6,22,7345,12,334,36,663,1981,10,806,44,1402,5364
1.032,6,25,5660,13,125,86,267,1275,12,650,88,1420,4385
1401.943,17,12,888,6,30,280386,30,348,6,62,280386,62,540
58.572,17,4,352,2,60,58571,60,176,2,60,58571,60,176
413.798,17,82,15240,41,48,10344,48,3116,41,267,10344,308,12124
1488.492,1,16,896,16,28,99232,28,896,0,0,0,0,0
174.662,1,8,448,8,28,24951,28,448,0,0,0,0,0
1788.732,17,73,3060,72,14,25193,14,3024,1,8,0,8,36
1751.11,6,145,14957,87,83,20361,722,7938,58,83,30716,1408,7019
1798.112,1,82,11225,82,108,22198,320,11225,0,0,0,0,0
32.655,6,4326,4106334,2757,1409,11,1448,4019326,1569,776,20,1448,87008
48.064,17,3,1488,1,308,0,308,336,2,548,100,548,1152
1772.042,6,180,15480,120,69,14891,69,8940,60,69,30033,69,6540
1791.41,6,244,35804,152,302,11863,302,26032,92,83,19685,83,9772
0.003,6,3,175,2,31,1,31,135,1,0,0,0,40
66.018,6,37,9331,15,328,247,1189,2581,22,418,3142,1917,6750
0.972,6,27,8463,14,270,62,561,1945,13,997,65,1791,6518
0.296,17,4,588,2,48,284,48,152,2,190,283,308,436
280.9,6,19,1391,9,31,35112,31,592,10,31,18817,31,799
13.236,17,8,1686,4,37,4396,37,260,4,328,4408,348,1426
1714.847,17,18,7452,18,386,100873,1437,7452,0,0,0,0,0
300.52,6,303,313480,98,145,3098,230,5684,205,1470,1473,4344,307796
1772.583,6,181,15589,120,69,14895,69,8940,61,69,29541,69,6649
1793.777,6,361,22927,211,69,8541,69,12649,150,69,12037,69,10278
11.469,17,4,352,2,48,11461,48,152,2,72,11460,72,200
1760.957,6,133,9617,79,31,22576,31,5449,54,31,33225,31,4168
0.193,6,9,1002,5,213,48,213,417,4,421,61,421,585
1783.057,6,356,22520,208,69,8613,69,12460,148,69,12129,69,10060
0.255,17,3,451,2,39,62,39,134,1,289,0,289,317
80.799,2,3,96,3,8,40399,8,96,0,0,0,0,0
1751.078,17,12,498,11,14,175107,14,462,1,8,0,8,36
318.808,6,38,7414,21,143,15940,516,1990,17,338,19919,1452,5424
95.639,17,6,2016,6,308,19127,308,2016,0,0,0,0,0
79.325,6,71,49089,46,1171,1762,1408,41057,25,960,2568,3847,8032
0.013,17,2,371,1,35,0,35,63,1,280,0,280,308
0.009,17,2,191,1,36,0,36,64,1,99,0,99,127
1744.819,6,95,7203,63,38,28142,205,4476,32,33,56272,98,2727
0.021,17,2,128,1,28,0,28,56,1,44,0,44,72
1772.105,6,181,15589,121,69,14767,69,9049,60,69,30035,69,6540
117.94,1,6,636,6,78,23588,78,636,0,0,0,0,0
5.01,17,4,558,2,36,5005,36,128,2,187,5006,187,430
0.382,17,2,136,1,32,0,32,60,1,48,0,48,76
280.388,6,30,7432,13,158,23365,267,1317,17,543,17522,1380,6115
52.252,17,4,352,2,60,52251,60,176,2,60,52250,60,176
0.657,17,8,2750,8,315,93,354,2750,0,0,0,0,0
1770.5,6,101,9344,66,65,27238,65,5577,35,59,52070,59,3767
0.179,6,46,21545,27,1030,6,1420,16564,19,467,9,1883,4981
1796.502,17,448,39612,404,35,4457,288,25708,44,288,40948,288,13904
1788.936,17,87,3648,86,14,21046,14,3612,1,8,0,8,36
1.152,6,239,161078,119,335,9,336,8311,120,1296,9,1460,152767
69.673,6,32,8952,14,158,5359,267,1357,18,624,4096,1400,7595
49.316,6,82,11967,44,304,1146,304,8152,38,83,1297,83,3815
1772.868,6,180,15480,120,69,14898,69,8940,60,69,30045,69,6540
4.953,6,40,7325,20,218,260,314,3423,20,516,247,1179,3902
0.554,6,14,1745,7,288,64,288,600,7,426,63,434,1145
590.838,1,6,336,6,28,118167,28,336,0,0,0,0,0
9.047,6,1918,1876005,1315,1355,6,1368,1839985,603,776,14,1473,36020
209.053,17,4,352,2,60,209052,60,176,2,60,209052,60,176
126.045,2,2,64,2,8,126045,8,64,0,0,0,0,0
0.367,6,21,4991,12,117,32,179,954,9,734,45,1728,4037
0.496,17,2,136,1,32,0,32,60,1,48,0,48,76
1134.761,2,9,288,9,8,141845,8,288,0,0,0,0,0
0.081,6,12,965,6,182,16,182,490,6,77,14,134,475
3.488,17,5,290,5,30,872,30,290,0,0,0,0,0
314.946,6,26,5635,9,133,39367,159,887,17,967,19683,1669,4748
0.453,6,24,6041,13,108,37,147,959,11,773,43,1608,5082
1795.319,17,449,39928,404,35,4454,288,25708,45,288,40016,288,14220
1.515,6,10,1687,7,100,252,100,384,3,1179,630,1179,1303
1783.712,17,83,3480,82,14,22021,14,3444,1,8,0,8,36
1764.137,6,189,33858,123,304,14460,304,25256,66,83,27140,83,8602
0.074,6,2,116,1,0,0,0,64,1,0,0,0,52
2.111,17,2,233,1,48,0,48,76,1,129,0,129,157
1793.36,17,87,3648,86,14,21098,14,3612,1,8,0,8,36
1684.476,2,16,512,16,8,112298,8,512,0,0,0,0,0
3.361,6,4,342,1,0,0,0,40,3,91,1591,91,302
1744.887,6,96,7286,63,38,28143,205,4476,33,33,54514,98,2810
0.032,17,4,624,2,64,13,64,184,2,192,8,192,440
1681.226,17,14,1036,7,30,280200,30,406,7,62,280200,62,630
0.998,6,25,8805,14,290,76,802,1753,11,1100,78,2370,7052
0.416,6,12,1653,6,288,80,288,548,6,426,48,434,1105
66.937,6,106,71310,61,1201,67,1408,63270,45,569,1518,1408,8040
0.312,6,22,7333,13,334,25,663,2021,9,967,37,1471,5312
12.194,17,10,830,5,47,3047,47,375,5,63,3046,63,455
0.506,17,16,6258,7,424,84,1350,3168,9,315,53,1350,3090
8.066,6,1482,1353938,910,1408,8,1448,1319530,572,776,13,1448,34408
1.034,17,4,454,3,32,510,32,180,1,246,0,246,274
0.793,6,27,5927,13,156,66,267,1462,14,650,56,1420,4465
0.073,6,2,80,1,0,0,0,40,1,0,0,0,40
0.672,17,4,820,2,36,667,36,128,2,318,667,318,692
0.072,6,7,423,4,43,12,43,259,3,0,21,0,164
1.333,6,46,18339,27,835,51,1360,12803,19,476,63,2715,5536
280.463,6,28,7352,12,158,25496,267,1277,16,678,18690,2760,6075
1791.548,17,180,14040,180,50,10008,50,14040,0,0,0,0,0
1.008,6,28,8503,15,225,59,561,1985,13,997,68,2720,6518
79.543,6,36,9423,15,327,152,1189,2575,21,375,3976,1997,6848
0.274,6,23,5080,12,137,24,267,1172,11,692,26,2800,3908
1.751,6,12,2271,7,188,291,245,660,5,1407,370,1407,1611
0.063,6,12,1843,7,138,10,138,510,5,532,14,891,1333
2.307,2,2,64,2,8,2307,8,64,0,0,0,0,0
0.876,6,2,1175,1,0,0,0,40,1,1095,0,1095,1135
37.651,17,22,1936,11,48,3764,48,836,11,72,3763,72,1100
1730.19,6,60,4400,40,33,44363,33,2740,20,31,91053,31,1660
0.389,6,10,1669,6,551,77,947,1346,4,159,129,159,323
1749.14,17,32,10888,32,312,56423,382,10888,0,0,0,0,0
232.751,17,4,304,2,48,232743,48,152,2,48,232743,48,152
0.293,17,2,154,1,33,0,33,61,1,65,0,65,93
0.206,6,48,22798,27,1108,7,1420,17725,21,467,9,1883,5073
3.075,17,4,304,2,48,3025,48,152,2,48,3026,48,152
0.275,6,18,3189,10,282,30,531,1670,8,273,26,777,1519
0.032,6,10,1514,5,503,7,503,771,5,475,8,475,743
1777.205,1,210,22260,210,78,8503,78,22260,0,0,0,0,0
2.451,6,29,6175,15,338,175,1314,2294,14,368,187,1420,3881
2.233,17,36,13449,17,548,139,1350,9800,19,164,117,1350,3649
55.757,6,7168,6654731,4339,1444,12,1448,6483339,2829,776,19,1448,171392
10.999,6,20,4442,11,275,1099,275,998,9,768,778,1440,3444
82.492,6,774,371268,413,834,200,1152,352037,361,435,228,1179,19231
1798.442,6,367,25650,214,99,8443,469,15045,153,69,11830,69,10605
0.312,17,8,2758,8,316,44,355,2758,0,0,0,0,0
1745.931,6,95,7203,63,38,28160,205,4476,32,33,56312,98,2727
0.051,17,4,284,2,32,0,32,120,2,54,13,60,164
207.8,17,10,585,10,30,23088,31,585,0,0,0,0,0
281.627,6,34,8274,15,158,20116,267,1397,19,509,15644,1400,6877
1.403,6,37,9808,20,502,73,1460,4352,17,476,76,2615,5456
0.547,6,26,7927,16,364,36,1125,3193,10,721,59,1420,4734
1787.455,6,186,15996,124,69,14532,69,9238,62,69,29293,69,6758
144.591,6,27,6523,11,220,5534,516,1326,16,350,9632,1452,5197
115.013,17,6,528,3,48,57502,48,228,3,72,57502,72,300
1786.712,6,107,8496,68,65,26667,65,4930,39,59,47016,59,3566
2.902,6,31,6289,16,338,193,1314,2334,15,335,205,1460,3955
0.417,17,2,586,1,46,0,46,74,1,484,0,484,512
4.992,17,4,288,2,36,4992,36,128,2,52,4991,52,160
1785.39,6,104,8435,69,65,26255,65,4970,35,59,52508,59,3465
1757.811,6,4533,4241172,2190,149,803,951,139173,2343,1754,750,9856,4101999
0.037,6,12,3705,6,171,6,171,491,6,964,5,1448,3214
0.079,17,2,192,1,60,0,60,88,1,76,0,76,104
1798.436,6,115,7624,69,53,26444,208,4854,46,31,39960,31,2770
1745.142,6,95,7203,62,38,28608,205,4424,33,33,54522,98,2779
1679.342,17,17,714,17,14,104958,14,714,0,0,0,0,0
0.47,6,24,7480,14,273,36,663,2104,10,967,46,1946,5376
34.175,17,10,760,10,48,3797,48,760,0,0,0,0,0
0.395,6,10,1992,5,288,91,288,508,5,424,55,434,1484
1781.882,6,124,11250,75,65,24079,65,6365,49,59,37118,59,4885
249.071,1,2,112,2,28,249071,28,112,0,0,0,0,0
4.092,17,5,290,5,30,1023,30,290,0,0,0,0,0
1745.158,17,74,6853,37,33,48475,37,2265,37,96,48475,136,4588
1.265,6,47,19008,27,880,48,1360,13432,20,476,57,2715,5576
1786.812,6,102,8228,68,64,26668,64,4896,34,58,54143,58,3332
33.676,17,12,1764,6,48,6731,48,456,6,190,6730,308,1308
0.906,17,4,240,2,32,905,32,120,2,32,905,32,120
3.647,6,28,13696,17,959,227,1360,6470,11,1129,347,4445,7226
1784.165,17,138,11040,69,48,26237,48,5244,69,56,26237,56,5796
1774.891,6,180,15480,120,69,14915,69,8940,60,69,30078,69,6540
0.034,17,4,284,2,32,0,32,120,2,54,0,60,164
363.717,6,25,1651,17,177,22732,177,1117,8,110,9141,110,534
1799.822,6,362,23105,212,69,8529,69,12896,150,69,12078,69,10209
0.382,6,89,59878,55,1239,7,1420,54297,34,467,11,1883,5581
1795.507,6,356,22520,208,69,8673,69,12460,148,69,12213,69,10060
248.084,6,31,6866,18,154,14593,516,1804,13,453,20299,1452,5062
756.634,2,6,192,6,8,151326,8,192,0,0,0,0,0
15.226,6,6,328,4,0,5075,0,216,2,0,15216,0,112
1740.522,17,30,31650,30,1027,60018,1027,31650,0,0,0,0,0
1785.86,6,356,22520,208,69,8627,69,12460,148,69,12148,69,10060
34.389,6,31,5095,15,154,2456,722,1859,16,342,2259,1448,3236
280.525,6,30,7432,13,158,23377,267,1317,17,603,17526,2760,6115
19.535,6,3462,3288362,2263,1376,8,1408,3221350,1199,931,16,2801,67012
5.335,6,18,3473,8,92,762,92,596,10,581,570,2026,2877
741.392,1,18,1008,18,28,43611,28,1008,0,0,0,0,0
31.503,6,9,392,8,0,4500,0,348,1,0,0,0,44
1744.494,6,154,9587,82,47,21536,208,5808,72,31,24565,31,3779
240.304,6,43,8798,21,519,12014,1402,5777,22,207,11442,619,3021
106.372,17,4,352,2,60,106370,60,176,2,60,106371,60,176
0.301,17,4,284,2,32,255,32,120,2,54,254,60,164
1.757,17,4,344,2,47,1750,47,150,2,69,1748,75,194
1786.442,6,122,12306,76,113,23819,1231,7336,46,82,39696,341,4970
1.283,6,29,10109,17,373,80,853,1805,12,977,108,1420,8304
1793.592,6,370,25839,215,99,8381,469,15154,155,69,11645,69,10685
1795.63,1,58,4872,0,0,0,0,0,58,56,31502,56,4872
1.294,6,51,20852,28,933,47,1460,15156,23,433,51,1460,5696
71.215,6,26,6797,12,181,6474,267,1212,14,627,5476,1400,5585
1798.223,17,87,3648,86,14,21155,14,3612,1,8,0,8,36
0.058,17,4,352,2,37,5,37,130,2,83,9,89,222
299.997,6,47,10858,23,654,13628,1460,4941,24,290,13035,1460,5917
1786.64,6,104,8494,68,65,26666,65,4930,36,59,51044,59,3564
1792.075,6,359,22709,209,69,8615,69,12569,150,69,12024,69,10140
8.683,6,80,24970,39,568,228,1152,19189,41,459,210,1179,5781
1772.41,6,136,9774,76,73,23629,208,6413,60,31,30038,31,3361
20.151,17,34,21574,19,624,1117,1350,12398,15,583,1436,1350,9176
1.31,6,50,30920,29,973,46,1360,11899,21,1297,57,2720,19021
15.501,1,21,2184,0,0,0,0,0,21,76,775,76,2184
5.926,6,1365,1307976,891,1394,6,1408,1278664,474,931,12,2816,29312
1.01,6,10,1687,7,100,168,100,384,3,1179,373,1179,1303
0.178,17,2,193,1,46,0,46,74,1,91,0,91,119
29.453,17,21,12116,11,606,2945,1350,6980,10,485,44,1350,5136
1788.465,6,357,22767,206,69,8724,69,12449,151,69,11922,69,10318
0.017,17,2,212,1,46,0,46,74,1,110,0,110,138
1740.185,6,87,6322,58,31,30529,31,3915,29,31,62149,31,2407
0.173,6,9,527,5,43,43,43,311,4,0,55,0,216
1794.09,6,356,22520,208,69,8667,69,12460,148,69,12204,69,10060
2.002,17,2,120,2,32,2002,32,120,0,0,0,0,0
1796.896,6,367,25650,214,99,8436,469,15045,153,69,11819,69,10605
1.723,6,844,1145294,352,194,4,230,19091,492,2246,3,9856,1126203
0.002,6,4,191,1,0,0,0,40,3,31,1,31,151
171.786,17,4,352,2,60,171784,60,176,2,60,171785,60,176
691.163,6,29,1928,20,321,36377,321,1369,9,83,30002,83,559
63.96,6,12,828,3,112,31980,112,240,9,90,7978,90,588
250.947,17,11,704,11,36,25094,36,704,0,0,0,0,0
0.08,17,7,2375,7,311,13,355,2375,0,0,0,0,0
1679.498,17,12,498,11,14,167949,14,462,1,8,0,8,36
7.417,6,718,612563,307,243,24,517,20119,411,1406,17,1440,592444
137.921,17,4,352,2,60,137920,60,176,2,60,137920,60,176
1076.008,1,26,1456,26,28,43040,28,1456,0,0,0,0,0
0.343,6,27,9054,13,247,28,624,1684,14,947,25,1408,7370
1.982,17,3,1167,3,361,991,361,1167,0,0,0,0,0
1772.471,6,180,15480,120,69,14894,69,8940,60,69,30040,69,6540
1077.305,1,76,8056,76,78,14364,78,8056,0,0,0,0,0
156.999,17,4,240,2,32,156998,32,120,2,32,156997,32,120
93.414,6,8,2375,2,223,13,223,303,6,458,18632,458,2072
280.312,6,30,7432,13,158,23359,267,1317,17,543,17514,1400,6115
0.046,17,2,152,2,48,46,48,152,0,0,0,0,0
1772.288,6,180,15480,120,69,14893,69,8940,60,69,30035,69,6540
0.206,6,2,116,1,0,0,0,64,1,0,0,0,52
0.059,17,2,154,1,33,0,33,61,1,65,0,65,93
11.807,6,1772,1622015,1148,1362,10,1380,1592813,624,421,18,1923,29202
1734.461,17,211,44371,211,182,8259,357,44371,0,0,0,0,0
0.007,17,4,352,2,60,6,60,176,2,60,5,60,176
1772.895,6,180,15480,120,69,14898,69,8940,60,69,30043,69,6540
0.01,17,2,475,1,40,0,40,68,1,379,0,379,407
1.095,6,206,156537,120,1333,9,1420,148806,86,427,12,1420,7731
1.861,17,2,176,2,60,1861,60,176,0,0,0,0,0
111.562,17,4,304,4,48,37187,48,304,0,0,0,0,0
0.023,17,2,230,1,40,0,40,68,1,134,0,134,162
1793.983,17,144,11520,72,48,25263,48,5472,72,56,25263,56,6048
547.897,6,69,20284,33,187,17121,267,3769,36,792,15653,3436,16515
91.943,6,32,7659,11,156,9194,267,1232,21,348,4589,1420,6427
0.514,17,3,451,2,39,452,39,134,1,289,0,289,317
475.151,2,7,224,7,8,79191,8,224,0,0,0,0,0
1.525,6,48,19133,27,886,58,1360,13517,21,433,65,1360,5616
0.332,6,27,9090,13,262,27,690,1735,14,945,24,1408,7355
240.281,6,45,8500,24,449,10446,1408,5752,21,206,12013,580,2748
0.14,17,2,167,1,39,0,39,67,1,72,0,72,100
226.877,6,37,8036,18,213,13345,517,2437,19,575,12603,1695,5599
0.043,17,2,144,1,36,0,36,64,1,52,0,52,80
0.048,17,2,256,1,49,0,49,77,1,151,0,151,179
11.781,6,1859,1627507,1131,1385,10,1420,1594166,728,467,16,1883,33341
15.774,17,17,2703,17,131,985,243,2703,0,0,0,0,0
1.315,6,47,19261,27,898,50,1360,13685,20,476,59,2715,5576
12.046,6,15,1894,7,304,2007,304,1272,8,83,1718,83,622
1.824,6,27,10261,16,284,121,586,1498,11,1039,164,1420,8763
12.214,6,1932,1686805,1193,1362,10,1380,1652958,739,387,16,1923,33847
1789.336,17,142,11360,71,48,25561,48,5396,71,56,25561,56,5964
1796.032,6,359,22709,209,69,8634,69,12569,150,69,12051,69,10140
1795.903,1,142,7952,142,28,12736,28,7952,0,0,0,0,0
8.09,6,53,19817,28,403,299,1460,4478,25,842,327,1460,15339
681.476,17,10,821,5,31,170364,37,297,5,76,170365,136,524
2.69,6,11,686,6,43,538,43,406,5,0,671,0,280
0.574,6,26,8991,13,252,47,647,1692,13,945,44,1438,7299
1.358,6,53,18804,29,843,48,1360,13023,24,400,51,1360,5781
1789.984,1,336,28224,336,56,5343,56,28224,0,0,0,0,0
0.196,6,9,1144,5,145,49,145,349,4,631,46,631,795
1790.071,6,355,22480,207,69,8689,69,12420,148,69,12177,69,10060
29.449,6,4,433,1,0,0,0,40,3,91,14720,91,393
0.542,6,12,2084,6,288,75,288,560,6,424,75,434,1524
373.871,6,21,1419,15,177,26705,177,989,6,110,12250,110,430
0.263,17,2,162,1,34,0,34,62,1,72,0,72,100
1787.336,6,356,22520,208,69,8634,69,12460,148,69,12158,69,10060
3.123,17,15,8475,8,706,446,1350,5872,7,343,511,1350,2603
1796.615,6,249,48171,154,483,11742,483,37978,95,83,19109,83,10193
308.59,17,19,6336,19,305,17143,308,6336,0,0,0,0,0
110.14,1,3,470,3,128,55070,159,470,0,0,0,0,0
0.222,6,23,6673,10,181,19,267,1128,13,627,17,1400,5545
1793.335,17,361,121288,361,307,4981,308,121288,0,0,0,0,0
1786.262,17,87,3648,86,14,21014,14,3612,1,8,0,8,36
221.588,17,4,352,2,60,221587,60,176,2,60,221587,60,176
222.743,17,4,352,2,60,222740,60,176,2,60,222742,60,176
44.518,6,1489,1363427,948,1361,46,1368,1328819,541,776,82,1473,34608
15.626,17,26,14829,15,797,1114,1350,12385,11,194,1559,1350,2444
181.257,17,4,240,2,32,181256,32,120,2,32,181256,32,120
61.749,6,74,45990,42,1180,1506,1448,37597,32,746,1985,1448,8393
3.909,17,2,176,2,60,3909,60,176,0,0,0,0,0
3.47,17,20,5727,9,323,430,1350,3164,11,205,344,1350,2563
1.599,6,286,225498,169,1335,9,1420,216515,117,534,13,3303,8983
255.526,6,75,8997,31,135,8517,630,3549,44,142,5942,580,5448
1798.173,17,136,45680,136,307,13319,318,45680,0,0,0,0,0
3.459,6,2,88,2,0,0,0,88,0,0,0,0,0
93.765,17,4,352,2,60,93764,60,176,2,60,93763,60,176
1785.84,6,106,8426,69,63,26262,64,4926,37,57,49604,58,3500
34.295,17,36,5292,18,48,2016,48,1368,18,190,2016,308,3924
16.671,6,2639,2304415,1531,1416,10,1448,2236971,1108,776,14,1448,67444
1786.483,6,102,8228,68,64,26663,64,4896,34,58,54133,58,3332
0.043,17,4,284,2,32,29,32,120,2,54,24,60,164
1680.41,1,14,812,14,30,129262,30,812,0,0,0,0,0
56.435,17,4,240,2,32,56434,32,120,2,32,56434,32,120
42.325,6,26,6797,12,181,3847,267,1212,14,627,3255,1400,5585
123.472,6,24,10407,13,721,5128,1309,3437,11,931,12329,1591,6970
5.95,6,39,7610,19,218,330,314,3383,20,489,289,1179,4227
1786.736,6,108,8642,71,64,25524,64,5016,37,58,49629,58,3626
1741.074,6,93,6720,60,31,29509,31,4062,33,31,54408,31,2658
1795.066,6,359,22709,209,69,8630,69,12569,150,69,12047,69,10140
213.555,1,6,336,6,28,42711,28,336,0,0,0,0,0
1780.991,6,354,22440,207,69,8645,69,12420,147,69,12198,69,10020
1681.736,1,15,840,15,28,120124,28,840,0,0,0,0,0
743.982,6,60,3663,32,27,23998,27,1901,28,26,27553,27,1762
0.339,6,7,716,4,226,113,226,442,3,110,86,110,274
1515.056,6,237,18523,79,56,19423,131,5441,158,53,9639,276,13082
3.96,17,2,656,2,300,3960,300,656,0,0,0,0,0
1786.051,17,87,3648,86,14,21012,14,3612,1,8,0,8,36
1787.671,17,87,3648,86,14,21031,14,3612,1,8,0,8,36
1.498,17,6,552,3,32,748,32,180,3,96,742,96,372
1798.543,17,449,39928,404,35,4462,288,25708,45,288,40016,288,14220
1772.8,6,180,15480,120,69,14897,69,8940,60,69,30041,69,6540
1681.659,17,14,1036,7,30,280271,30,406,7,62,280270,62,630
1788.114,17,83,3480,82,14,22075,14,3444,1,8,0,8,36
0.013,17,2,231,1,34,0,34,62,1,141,0,141,169
1786.492,6,104,8444,68,66,26664,66,4964,36,60,51039,60,3480
2.846,6,54,20690,28,964,105,1440,14682,26,381,106,1440,6008
0.16,6,27,7296,14,155,12,267,1341,13,678,12,2800,5955
1.104,6,2,84,1,0,0,0,44,1,0,0,0,40
1424.254,17,140,11727,130,30,11040,37,7575,10,387,151612,463,4152
1788.783,1,342,28728,342,56,5245,56,28728,0,0,0,0,0
280.25,6,27,7312,13,158,23354,267,1317,14,775,21554,4836,5995
26.527,6,39,8490,19,171,1473,721,2135,20,555,1385,2840,6355
0.595,17,4,344,2,47,0,47,150,2,69,0,75,194
50.924,6,37,8495,18,410,508,882,1982,19,441,2821,1460,6513
1770.14,6,205,14180,75,46,23918,46,5990,130,46,13722,46,8190
1789.138,6,358,22738,208,69,8643,69,12460,150,69,12007,69,10278
6.264,6,10,1053,7,181,1044,181,734,3,155,3048,155,319
1.091,6,23,7918,12,294,99,818,1677,11,1157,91,2720,6241
192.138,17,6,2361,6,365,38427,373,2361,0,0,0,0,0
1783.679,6,362,22898,210,69,8534,69,12678,152,69,11810,69,10220
0.373,17,8,2750,8,315,53,354,2750,0,0,0,0,0
1.0,6,16,2970,8,324,142,585,1722,8,396,130,580,1248
0.478,6,22,7345,13,334,39,663,2021,9,1209,54,1946,5324
5.879,6,535,477282,343,1327,16,1368,462634,192,931,29,2736,14648
234.84,1,6,336,6,28,46968,28,336,0,0,0,0,0
1766.537,6,289,46828,163,304,10904,304,33056,126,83,14132,83,13772
0.667,6,4,196,2,0,463,0,92,2,0,211,0,104
1797.196,1,59,4956,59,56,30986,56,4956,0,0,0,0,0
240.191,6,54,18094,29,801,8578,1408,15148,25,204,10007,580,2946
1742.189,1,56,4704,56,56,31676,56,4704,0,0,0,0,0
31.923,6,9,396,2,0,3483,0,88,7,0,5305,0,308
51.835,17,16,18199,16,1109,3455,1451,18199,0,0,0,0,0
1795.05,6,240,35580,150,302,12047,302,25920,90,83,20168,83,9660
1102.055,6,228,55131,97,847,11479,1408,42400,131,79,8477,580,12731
3.428,6,2,88,2,0,0,0,88,0,0,0,0,0
1792.652,6,314,20150,184,69,9795,69,11155,130,69,13896,69,8995
0.834,6,21,5988,12,281,75,544,1328,9,716,93,1420,4660
300.894,6,50,10526,25,433,12537,910,3258,25,312,539,1460,7268
15.361,17,28,7518,12,331,1393,1350,4313,16,172,1022,1350,3205
42.172,17,24,2112,12,48,3833,48,912,12,72,3833,72,1200
1786.914,6,104,8504,69,66,26278,66,5004,35,60,52553,60,3500
1795.274,17,142,11360,71,48,25646,48,5396,71,56,25646,56,5964
11.042,6,27,11355,13,275,920,275,1078,14,1078,813,1414,10277
85.052,6,60,16774,28,264,3128,721,5889,32,738,2737,1440,10885
0.156,1,5,420,5,56,39,56,420,0,0,0,0,0
1789.962,17,365,45406,174,165,10346,1350,33656,191,33,9420,61,11750
8.499,6,13,5585,4,106,2830,106,274,9,823,1061,1420,5311
3.998,17,5,738,4,32,1328,32,240,1,470,0,470,498
0.003,17,4,240,2,32,2,32,120,2,32,1,32,120
0.045,6,33,8043,17,131,2,131,1023,16,441,2,500,7020
1694.742,1,8,448,8,28,242106,28,448,0,0,0,0,0
1744.692,2,26,832,26,8,69787,8,832,0,0,0,0,0
1649.67,6,24,3624,16,241,109978,241,2568,8,92,235639,92,1056
0.043,6,2,80,1,0,0,0,40,1,0,0,0,40
0.974,6,23,6397,13,310,80,891,2077,10,979,107,1731,4320
1.296,6,47,18508,26,909,51,1440,12892,21,433,56,1440,5616
195.136,17,4,352,2,60,195135,60,176,2,60,195135,60,176
1793.014,6,127,12472,79,62,22987,722,6474,48,87,38141,1440,5998
62.057,6,78,54092,48,1202,1320,1368,45796,30,841,2131,2519,8296
122.008,6,30,7432,13,158,10167,267,1317,17,543,7613,1400,6115
1.257,6,47,18646,27,854,48,1360,13070,20,476,57,2715,5576
1725.019,1,8,848,8,78,246431,78,848,0,0,0,0,0
1786.042,17,86,3606,85,14,21262,14,3570,1,8,0,8,36
1.455,6,40,11338,22,547,69,1360,5842,18,476,74,2715,5496
1777.296,1,256,14336,256,28,6969,28,14336,0,0,0,0,0
6.232,6,25,7632,14,142,479,267,1722,11,1326,603,2736,5910
1.405,6,50,20216,27,957,54,1460,14520,23,476,54,2615,5696
2.359,17,4,518,3,39,546,39,201,1,289,0,289,317
1787.092,6,106,8584,69,66,26280,66,5004,37,60,49638,60,3580
0.131,17,4,420,2,33,0,33,122,2,121,127,145,298
280.057,6,31,7472,14,158,21542,267,1357,17,543,17500,1400,6115
102.757,17,4,352,2,60,102756,60,176,2,60,102756,60,176
17.517,6,18,1193,9,222,2188,222,586,9,231,2188,231,607
0.008,6,2,171,1,0,0,0,40,1,91,0,91,131
203.546,17,4,352,2,60,203545,60,176,2,60,203545,60,176
0.18,17,2,212,1,46,0,46,74,1,110,0,110,138
0.001,17,4,368,2,32,0,32,120,2,96,1,96,248
0.026,17,2,152,1,48,0,48,76,1,48,0,48,76
0.574,6,3,120,2,0,574,0,80,1,0,0,0,40
1.173,6,25,8056,12,164,90,267,1288,13,869,83,1408,6768
240.173,6,55,17694,30,742,8281,1402,14924,25,182,10006,580,2770
300.297,6,54,45794,30,145,10354,230,2244,24,2014,13056,7040,43550
110.025,17,4,352,2,60,110024,60,176,2,60,110024,60,176
0.063,17,4,588,2,48,54,48,152,2,190,54,308,436
0.653,6,18,7947,10,321,72,619,1492,8,1005,73,2518,6455
1792.857,17,142,11360,71,48,25611,48,5396,71,56,25611,56,5964
1774.496,6,180,15480,120,69,14911,69,8940,60,69,30074,69,6540
240.923,6,48,10673,25,539,10035,1418,7777,23,206,10947,580,2896
1773.231,6,78,4108,39,26,46662,26,2054,39,26,46662,26,2054
125.147,17,4,240,2,32,125146,32,120,2,32,125146,32,120
0.015,17,2,586,1,46,0,46,74,1,484,0,484,512
1799.086,17,142,11360,71,48,25701,48,5396,71,56,25701,56,5964
1771.489,6,105,9552,66,65,27253,65,5577,39,59,46615,59,3975
618.068,6,110,20005,46,237,13734,1460,8301,64,202,9808,3098,11704
175.457,6,24,11354,12,433,69,990,1859,12,1125,15938,2720,9495
9.407,6,12,945,6,222,1880,222,466,6,231,1880,231,479
1771.149,6,105,9759,68,65,26435,65,5758,37,59,49196,59,4001
1500.423,2,11,352,11,8,150042,8,352,0,0,0,0,0
0.233,17,2,172,1,50,0,50,78,1,66,0,66,94
782.095,2,6,192,6,8,156419,8,192,0,0,0,0,0
0.285,6,28,9013,13,227,23,547,1604,15,827,20,1408,7409
6.718,6,609,591308,421,1343,15,1368,576856,188,776,34,2736,14452
1.282,6,40,11338,21,616,64,1440,5802,19,433,61,1440,5536
1798.647,1,345,28980,345,56,5228,56,28980,0,0,0,0,0
240.285,6,61,20628,31,790,8008,1418,17426,30,204,8285,580,3202
3.159,6,10,1102,6,483,631,483,803,4,83,1051,83,299
1.04,6,25,6448,13,297,86,830,2011,12,790,92,1420,4437
1784.247,6,372,23574,212,69,8456,69,12965,160,69,11218,69,10609
13.169,6,2101,1819719,1265,1382,10,1420,1782034,836,467,15,1883,37685
18.621,17,44,23219,21,608,929,1350,13361,23,400,844,1350,9858
87.201,6,5,228,0,0,0,0,0,5,7,21800,7,228
0.033,17,4,284,2,32,14,32,120,2,54,20,60,164
64.112,6,20,5900,11,271,6411,515,1259,9,712,7995,1452,4641
1779.179,17,140,11200,70,48,25785,48,5320,70,56,25785,56,5880
15.617,6,703,614313,432,1350,35,1368,594973,271,776,57,2736,19340
66.694,6,619,279903,313,822,213,1152,261801,306,418,217,1179,18102
1772.116,6,100,9292,66,65,27263,65,5577,34,59,53697,59,3715
424.539,6,79,5363,41,74,10613,138,2606,38,68,11473,69,2757
10.76,6,20,4442,11,275,1076,275,998,9,768,735,1440,3444
4.273,17,8,616,4,33,1341,33,244,4,65,1353,65,372
1773.372,6,182,15629,121,69,14778,69,8980,61,69,29551,69,6649
108.835,6,68,46611,44,1171,2531,1408,38627,24,961,2679,3847,7984
16.435,6,9,492,4,0,5478,0,216,5,0,4053,0,276
1795.205,17,448,39896,403,35,4465,288,25676,45,288,40016,288,14220
1.596,6,40,9928,21,440,79,1360,4392,19,433,77,1360,5536
1795.846,17,448,39896,403,35,4467,288,25676,45,288,40020,288,14220
69.121,6,25,1020,13,0,5737,0,524,12,0,6282,0,496
280.219,6,27,7312,13,158,23351,267,1317,14,775,21551,4836,5995
178.307,2,3,96,3,8,89153,8,96,0,0,0,0,0
4.215,6,40,7309,19,218,234,314,3383,21,440,198,1152,3926
1784.439,6,360,25537,209,92,8579,1077,14025,151,85,11896,437,11512
1728.762,17,231,48199,231,180,7516,358,48199,0,0,0,0,0
187.079,2,4,192,4,24,62359,24,192,0,0,0,0,0
1777.542,17,79,3312,78,14,23084,14,3276,1,8,0,8,36
1778.974,6,273,34452,113,147,15881,1360,17120,160,133,11187,2720,17332
1770.892,6,103,9514,66,66,27244,66,5610,37,60,49188,60,3904
550.71,2,10,320,10,8,61190,8,320,0,0,0,0,0
0.414,6,20,7151,12,318,37,600,1906,8,1205,57,1891,5245
1799.024,1,345,28980,345,56,5229,56,28980,0,0,0,0,0
1782.282,17,203,48820,203,212,8823,422,48820,0,0,0,0,0
15.302,6,28,13341,14,257,1177,463,1365,14,1140,1167,1360,11976
0.391,6,12,1653,6,288,76,288,548,6,426,42,434,1105
3.956,17,4,240,4,32,1318,32,240,0,0,0,0,0
3.027,17,4,240,4,32,1009,32,240,0,0,0,0,0
426.575,2,4,128,4,8,142191,8,128,0,0,0,0,0
1.291,6,49,19346,27,898,49,1360,13690,22,433,53,1360,5656
0.438,6,51,20184,28,923,16,1380,15022,23,421,17,1923,5162
2.073,17,6,432,3,36,1019,36,192,3,52,1020,52,240
12.145,6,1964,1679607,1162,1389,10,1420,1643294,802,467,15,1883,36313
3.463,6,2,88,2,0,0,0,88,0,0,0,0,0
1.358,6,25,8056,12,164,105,267,1288,13,869,96,1368,6768
121.198,17,4,352,2,60,121197,60,176,2,60,121197,60,176
5.279,6,11,2070,8,241,754,241,1766,3,92,130,92,304
34.753,6,28,4938,14,180,2673,722,1808,14,399,2636,1448,3130
61.9,6,76,51637,46,1204,1375,1448,43353,30,746,2125,1448,8284
280.425,6,28,7352,13,158,23368,267,1317,15,678,20026,3456,6035
12.133,17,6,408,3,32,6063,32,180,3,48,6063,48,228
479.407,1,10,560,10,28,53267,28,560,0,0,0,0,0
1797.206,1,58,4872,0,0,0,0,0,58,56,31529,56,4872
1.615,6,49,19265,27,892,62,1360,13609,22,433,66,1360,5656
2.629,6,14,2351,8,188,375,245,700,6,703,476,1152,1651
18.812,6,3097,2757974,1817,1427,10,1448,2678662,1280,776,14,1448,79312
153.581,6,14,2245,8,211,21935,211,846,6,545,30697,904,1399
209.818,17,4,352,2,60,209817,60,176,2,60,209817,60,176
11.455,6,13,2190,7,210,1909,210,792,6,545,2290,904,1398
40.547,17,3,228,3,48,20273,48,228,0,0,0,0,0
1.083,6,25,5643,12,140,98,267,1184,13,787,83,1460,4459
111.82,6,25,6265,9,266,92,498,1162,16,343,7449,1420,5103
1.681,6,25,8763,15,285,120,587,1459,10,985,167,1420,7304
655.908,6,53,8608,33,110,20497,516,2866,20,290,34516,1452,5742
0.785,6,7,352,4,0,261,0,196,3,0,321,0,156
4.988,17,4,288,2,36,4987,36,128,2,52,4987,52,160
3.532,17,4,368,4,64,1177,64,368,0,0,0,0,0
146.912,17,4,352,2,60,146910,60,176,2,60,146911,60,176
1.13,6,24,8004,12,164,87,267,1288,12,1014,87,2816,6716
300.554,6,18,1227,5,177,75096,177,445,13,110,25031,110,782
278.13,17,4,352,2,60,278129,60,176,2,60,278129,60,176
175.244,17,2,72,1,8,0,8,36,1,8,0,8,36
1783.562,17,83,3480,82,14,22019,14,3444,1,8,0,8,36
1786.395,6,109,9097,70,70,25889,274,5284,39,64,47008,247,3813
1680.727,17,12,498,11,14,168072,14,462,1,8,0,8,36
3.074,17,3,228,2,48,3008,48,152,1,48,0,48,76
278.025,6,37,6984,17,166,10167,501,1680,20,264,14628,1420,5304
8.963,6,1429,1239707,862,1387,10,1420,1212806,567,467,15,1883,26901
0.495,17,3,451,2,39,121,39,134,1,289,0,289,317
1.021,17,4,308,2,33,989,33,122,2,65,861,65,186
9.834,6,82,24805,43,560,234,1152,19088,39,461,251,1179,5717
6.901,6,546,476025,345,1314,19,1368,460909,201,931,33,2841,15116
0.212,6,56,91823,40,183,5,230,2649,16,6309,8,19625,89174
170.614,17,6,528,3,60,85306,60,264,3,60,85306,60,264
30.708,6,13,1197,3,517,15350,517,681,10,0,3411,0,516
114.079,17,3,222,3,46,57039,46,222,0,0,0,0,0
280.737,6,28,7352,12,158,25521,267,1277,16,603,18698,1400,6075
1772.143,6,182,15698,120,69,14891,69,8940,62,69,29046,69,6758
0.307,1,10,840,10,56,34,56,840,0,0,0,0,0
17.756,6,22,4742,8,341,2536,722,1435,14,320,1351,1408,3307
1748.973,1,57,4788,57,56,31231,56,4788,0,0,0,0,0
192.931,17,4,352,2,60,192930,60,176,2,60,192930,60,176
0.034,6,17,6068,10,88,3,88,556,7,1740,5,1880,5512
0.034,6,19,4192,10,101,3,101,629,9,441,4,500,3563
277.42,17,4,352,2,60,277419,60,176,2,60,277419,60,176
1791.156,1,58,4872,0,0,0,0,0,58,56,31423,56,4872
19.912,17,2,152,2,48,19912,48,152,0,0,0,0,0
1786.615,6,108,8731,71,65,25514,65,5245,37,59,49562,59,3486
1782.255,6,103,8395,68,65,26600,65,4930,35,59,52416,59,3465
4.143,1,5,420,5,56,1035,56,420,0,0,0,0,0
4.245,6,47,15162,24,199,176,561,2470,23,903,184,1440,12692
0.086,17,2,2754,2,1349,86,1349,2754,0,0,0,0,0
1773.864,6,284,34722,118,137,15159,1360,17148,166,131,10749,2720,17574
1743.731,6,98,7421,64,38,27678,205,4528,34,33,52829,98,2893
0.068,17,2,158,1,34,0,34,62,1,68,0,68,96
0.11,17,2,172,1,50,0,50,78,1,66,0,66,94
10.845,6,18,5610,10,275,1205,275,958,8,1440,822,1440,4652
0.54,6,10,1671,6,552,108,948,1348,4,159,179,159,323
0.212,17,2,245,1,32,0,32,60,1,157,0,157,185
1797.274,6,356,22520,208,69,8682,69,12460,148,69,12225,69,10060
240.193,6,174,191541,69,197,3532,581,4976,105,1947,2309,4206,186565
8.235,6,1396,1257069,866,1373,9,1408,1224845,530,776,15,1408,32224
1743.479,1,56,4704,56,56,31699,56,4704,0,0,0,0,0
1793.163,17,144,11520,72,48,25255,48,5472,72,56,25255,56,6048
0.574,6,117,87835,52,131,11,232,2609,65,1377,8,2305,85226
1744.61,6,99,7473,65,38,27259,205,4580,34,33,52854,98,2893
305.301,6,555,481000,367,1323,834,1360,466159,188,221,70,2667,14841
1737.094,1,56,4704,56,56,31583,56,4704,0,0,0,0,0
1.467,6,47,19197,27,893,56,1360,13621,20,476,66,2715,5576
1799.059,1,56,4704,56,56,32710,56,4704,0,0,0,0,0
0.45,17,4,288,2,36,418,36,128,2,52,418,52,160
1744.76,6,98,7390,64,38,27694,205,4559,34,33,52856,98,2831
1783.805,6,362,24305,211,88,8494,469,13918,151,69,11892,69,10387
0.02,17,2,243,1,53,0,53,81,1,134,0,134,162
0.008,17,2,383,1,34,0,34,62,1,293,0,293,321
10.88,6,20,4442,11,275,1088,275,998,9,768,763,1440,3444
1799.843,17,449,39928,404,35,4466,288,25708,45,288,40017,288,14220
1.572,6,25,8056,12,164,124,267,1288,13,869,113,1368,6768
1202.334,6,257,19166,147,119,8235,469,11592,110,69,11030,69,7574
0.817,6,14,1745,7,288,108,288,600,7,426,107,434,1145
368.341,6,18,1242,14,180,28333,180,916,4,110,20057,110,326
1785.964,6,104,8444,68,66,26656,66,4964,36,60,51024,60,3480
2.989,17,3,201,3,39,1494,39,201,0,0,0,0,0
4.039,17,7,7079,2,723,4039,1350,1503,5,1087,927,1350,5576
1794.958,6,423,25365,211,69,8547,69,12649,212,34,8506,48,12716
396.529,6,18,1242,14,180,30502,180,916,4,110,20072,110,326
1.252,6,50,18993,27,870,48,1360,13297,23,433,48,1360,5696
0.014,6,13,3980,7,88,2,88,388,6,1670,2,2920,3592
8.864,6,81,25010,41,550,221,1152,19269,40,459,221,1179,5741
51.612,6,6,848,2,0,51612,0,80,4,152,16042,160,768
32.101,6,387,320625,171,126,188,301,11227,216,1406,149,1418,309398
1740.689,17,30,31680,30,1028,60023,1028,31680,0,0,0,0,0
11.799,6,1873,1630305,1128,1391,10,1414,1596272,745,467,15,1889,34033
1787.167,6,102,8296,68,65,26674,65,4930,34,59,54152,59,3366
1779.328,6,198,16821,127,69,14121,69,9427,71,69,25385,69,7394
1.874,6,37,13580,18,446,110,1360,3457,19,779,82,1360,10123
1719.695,1,94,9964,94,78,18491,78,9964,0,0,0,0,0
0.33,17,2,144,1,36,0,36,64,1,52,0,52,80
1.929,17,15,5438,7,361,321,1350,2724,8,311,255,1350,2714
149.306,6,6,1225,4,319,49768,398,799,2,173,149122,254,426
0.568,6,23,7420,13,337,47,674,2032,10,1212,57,1946,5388
8.834,6,1873,1827239,1239,1400,6,1408,1789571,634,776,13,1408,37668
127.679,6,5964,5428987,3890,1315,32,1368,5309761,2074,899,61,1473,119226
1795.796,17,449,39928,404,35,4456,288,25708,45,288,40017,288,14220
1784.876,6,110,8876,71,66,25498,66,5216,39,60,46964,60,3660
1787.16,6,113,12215,74,81,24481,501,5910,39,128,47028,1420,6305
2.614,6,18,3257,10,99,269,182,924,8,477,347,1343,2333
8.062,6,18,6871,9,275,1007,275,643,9,1171,709,1440,6228
217.99,17,6,456,6,48,43598,48,456,0,0,0,0,0
20.519,17,6,1236,3,48,10255,48,228,3,308,10251,308,1008
165.919,6,23,6462,12,392,15083,594,2596,11,654,16587,1328,3866
1.361,6,46,19789,28,876,50,1360,14293,18,529,68,4075,5496
73.182,6,23,10588,12,499,146,1193,2023,11,1352,7299,3639,8565
0.019,6,3,327,2,103,0,138,287,1,0,0,0,40
1779.924,17,136,10880,68,48,26565,48,5168,68,56,26565,56,5712
1.363,6,37,8304,19,336,75,1254,2808,18,529,69,4075,5496
0.01,17,2,366,1,33,0,33,61,1,277,0,277,305
353.443,6,60,7549,31,115,11776,722,3233,29,156,12616,1408,4316
1682.372,17,16,1265,8,30,240332,37,471,8,71,240329,136,794
0.004,6,2,92,1,0,0,0,40,1,0,0,0,52
1.543,6,32,10808,16,436,102,1271,3293,16,980,91,1460,7515
0.352,6,28,7336,13,155,29,267,1301,15,543,23,1400,6035
56.19,1,4,224,4,28,18730,28,224,0,0,0,0,0
15.724,17,16,6309,8,480,2236,1350,4069,8,252,2233,1350,2240
0.689,6,12,1653,6,288,134,288,548,6,426,73,434,1105
7.596,6,1033,879907,617,1348,12,1402,853611,416,776,17,1405,26296
26.49,17,16,6004,7,469,4409,1350,3484,9,252,3307,1350,2520
0.431,6,47,18382,26,940,17,1380,13300,21,421,19,1923,5082
1795.433,17,136,10880,68,48,26797,48,5168,68,56,26797,56,5712
258.388,17,4,352,2,60,258387,60,176,2,60,258383,60,176
1785.863,6,361,24734,211,94,8504,469,14387,150,69,11985,69,10347
0.087,6,9,1343,5,145,21,145,349,4,830,21,830,994
1770.432,17,284,55312,284,166,6255,356,55312,0,0,0,0,0
1783.232,17,73,3060,72,14,25115,14,3024,1,8,0,8,36
1744.621,2,17,544,17,8,109038,8,544,0,0,0,0,0
1783.579,17,83,3480,82,14,22019,14,3444,1,8,0,8,36
1798.159,17,448,39612,404,35,4461,288,25708,44,288,40953,288,13904
571.321,6,60,5160,40,69,14649,69,2980,20,69,30049,69,2180
302.23,2,3,96,3,8,151115,8,96,0,0,0,0,0
1670.326,1,14,1141,14,53,128486,78,1141,0,0,0,0,0
6.318,6,950,937639,644,1389,9,1408,917063,306,931,20,2801,20576
209.392,17,4,352,2,60,209391,60,176,2,60,209390,60,176
1771.908,6,180,15480,120,69,14889,69,8940,60,69,30031,69,6540
1795.255,17,447,39580,403,35,4465,288,25676,44,288,40949,288,13904
1794.433,6,356,22520,208,69,8668,69,12460,148,69,12206,69,10060
200.584,6,14,3205,3,245,139,245,369,11,299,20033,299,2836
45.019,17,2,672,2,308,45019,308,672,0,0,0,0,0
259.3,17,4,352,2,60,259299,60,176,2,60,259298,60,176
0.132,17,2,193,1,46,0,46,74,1,91,0,91,119
1.745,6,67,45140,31,143,58,253,2218,36,1415,47,2816,42922
1789.922,1,339,28476,339,56,5295,56,28476,0,0,0,0,0
1783.763,17,83,3480,82,14,22021,14,3444,1,8,0,8,36
5.742,6,14,4655,7,188,957,245,660,7,1237,909,1407,3995
2.198,17,2,780,2,362,2198,362,780,0,0,0,0,0
1795.762,17,447,39864,402,35,4478,288,25644,45,288,40021,288,14220
45.896,6,43,8961,20,412,686,889,2164,23,366,2079,2720,6797
212.781,17,4,352,2,60,212778,60,176,2,60,212780,60,176
1776.295,17,73,3060,72,14,25018,14,3024,1,8,0,8,36
0.13,17,2,376,1,41,0,41,69,1,279,0,279,307
64.405,6,27,7177,13,155,5367,267,1306,14,530,4953,3417,5871
0.433,6,55,25729,30,1070,14,1380,20484,25,467,16,1923,5245
119.426,17,4,1344,4,308,39808,308,1344,0,0,0,0,0
0.16,17,3,1008,3,308,80,308,1008,0,0,0,0,0
61.919,6,68,50445,46,1181,1375,1408,42567,22,960,2937,3847,7878
0.292,6,10,1671,6,552,58,948,1348,4,159,97,159,323
1.499,17,28,22970,16,1008,98,1350,16590,12,503,132,1350,6380
1.427,6,52,23862,30,998,49,1360,18206,22,433,58,1360,5656
0.011,17,2,144,1,36,0,36,64,1,52,0,52,80
7.411,6,38,8474,21,281,370,780,2010,17,524,455,4848,6464
1769.644,1,59,4956,0,0,0,0,0,59,56,30511,56,4956
0.362,17,2,178,1,29,0,29,57,1,93,0,93,121
1783.84,6,357,22629,208,69,8617,69,12460,149,69,12052,69,10169
0.122,17,2,246,1,67,0,67,95,1,123,0,123,151
300.71,6,38,8566,20,315,15826,882,2093,18,441,504,1440,6473
5.903,17,12,912,6,37,1179,37,390,6,59,1178,65,522
10.753,6,20,4442,11,275,1075,275,998,9,768,725,1440,3444
1.458,6,24,8004,12,164,114,267,1288,12,1014,114,2491,6716
14.023,6,19,2529,9,211,1752,211,922,10,545,1556,904,1607
5.953,17,3,228,3,48,2976,48,228,0,0,0,0,0
126.976,17,4,352,2,60,126975,60,176,2,60,126975,60,176
303.689,6,34,6437,18,286,17864,1314,2445,16,334,20244,2673,3992
0.496,1,3,540,3,152,248,152,540,0,0,0,0,0
0.381,17,4,624,2,64,380,64,184,2,192,261,192,440
1507.026,6,359,33328,201,134,7535,869,17205,158,137,9596,1917,16123
25.838,6,30,7432,13,158,2153,267,1317,17,543,1612,1400,6115
0.604,6,21,7220,13,319,50,602,1960,8,967,81,1471,5260
64.51,6,26,7040,5,154,16127,267,672,21,345,3221,1420,6368
3.961,17,4,352,2,48,3947,48,152,2,72,3947,72,200
373.819,6,27,1767,18,177,21989,177,1181,9,110,8669,110,586
95.43,6,9,11592,9,1390,11928,1448,11592,0,0,0,0,0
1.34,6,37,9808,20,502,70,1460,4352,17,476,72,2615,5456
7.096,6,1409,1274000,874,1379,7,1408,1241516,535,931,12,2816,32484
0.047,1,2,112,2,28,47,28,112,0,0,0,0,0
33.443,6,30,5042,15,180,2388,722,1859,15,342,2375,1408,3183
282.321,17,4,240,2,32,282320,32,120,2,32,282320,32,120
11.561,17,8,704,4,48,3849,48,304,4,72,3849,72,400
0.014,17,2,194,1,61,0,61,89,1,77,0,77,105
0.173,6,9,1002,5,213,43,213,417,4,421,40,421,585
0.956,17,5,728,3,32,475,32,180,2,246,5,246,548
154.317,17,3,1008,3,308,77158,308,1008,0,0,0,0,0
9.435,6,451,401378,285,1346,32,1368,387794,166,776,55,1473,13584
1785.377,17,142,11360,71,48,25505,48,5396,71,56,25505,56,5964
13.708,6,2449,2250921,1554,1370,8,1408,2199717,895,931,15,2816,51204
120.716,6,22,8278,11,511,90,1194,2049,11,825,12052,1360,6229
5.042,6,38,7229,19,218,280,314,3383,19,513,265,1179,3846
27.48,17,6,528,3,48,13735,48,228,3,72,13735,72,300
2.509,6,49,9467,25,332,104,1234,3088,24,337,95,1460,6379
1786.709,6,102,8296,68,65,26667,65,4930,34,59,54139,59,3366
1739.469,6,131,8242,74,46,23828,208,5063,57,31,31058,31,3179
5.95,6,14,2245,8,211,849,211,846,6,545,1189,904,1399
2.474,6,8,440,5,0,618,0,268,3,0,1213,0,172
394.822,17,14,4640,14,303,30370,308,4640,0,0,0,0,0
1786.106,6,115,9182,74,65,24467,65,5300,41,59,44650,59,3882
1744.608,2,30,960,30,8,60158,8,960,0,0,0,0,0
1799.846,6,2944,3515470,1081,146,1666,940,66904,1863,1872,966,11216,3448566
1796.966,17,361,47339,183,173,9873,1350,36801,178,31,10151,60,10538
7.719,6,12,2919,6,100,1543,100,344,6,1165,1492,1179,2575
1798.373,17,450,39960,405,35,4451,288,25740,45,288,40022,288,14220
1767.223,17,49,16398,49,306,36817,308,16398,0,0,0,0,0
1796.06,17,414,36820,373,35,4828,288,23864,41,288,44014,288,12956
1791.377,6,209,42901,116,410,15576,1251,27636,93,189,19470,1420,15265
1143.621,17,786,55113,714,40,1603,41,49023,72,56,473,57,6090
258.163,17,6,456,3,48,129072,48,228,3,48,129073,48,228
1787.653,17,87,3648,86,14,21031,14,3612,1,8,0,8,36
0.0,1,1,56,1,28,0,28,56,0,0,0,0,0
1794.571,1,58,4872,58,56,31483,56,4872,0,0,0,0,0
0.01,17,2,330,1,30,0,30,58,1,244,0,244,272
1790.795,1,342,28728,342,56,5251,56,28728,0,0,0,0,0
1773.788,6,182,15629,121,69,14781,69,8980,61,69,29558,69,6649
1793.445,6,209,48164,121,525,14945,1302,34810,88,169,20613,1452,13354
3.275,6,2,88,2,0,0,0,88,0,0,0,0,0
79.11,6,29,7528,9,155,9888,267,1146,20,348,4155,1460,6382
1744.654,6,97,7338,64,38,27692,205,4528,33,33,54514,98,2810
1797.578,17,448,39896,403,35,4471,288,25676,45,288,40023,288,14220
1682.118,1,15,840,15,28,120151,28,840,0,0,0,0,0
1761.302,6,140,8592,74,26,24126,26,4504,66,26,27096,26,4088
0.881,6,10,1687,7,100,146,100,384,3,1179,315,1179,1303
1772.796,6,183,15738,121,69,14773,69,8980,62,69,29059,69,6758
1792.683,17,142,11360,71,48,25562,48,5396,71,56,25608,56,5964
5.739,6,44,8369,23,227,260,314,4102,21,489,273,1179,4267
1.187,6,24,8004,12,164,91,267,1288,12,1014,91,2411,6716
365.825,6,18,1242,14,180,28140,180,916,4,110,20065,110,326
0.339,17,2,136,1,32,0,32,60,1,48,0,48,76
1776.274,17,73,3060,72,14,25017,14,3024,1,8,0,8,36
22.667,6,637,532496,372,1354,61,1368,512514,265,899,85,1473,19982
104.643,6,40,22963,21,487,83,1460,2846,19,1488,5797,4380,20117
22.659,6,32,7853,15,158,1618,267,1397,17,524,1415,1400,6456
97.578,17,4,352,2,60,97577,60,176,2,60,97577,60,176
0.065,17,2,245,1,32,0,32,60,1,157,0,157,185
3.041,17,4,368,4,64,1013,64,368,0,0,0,0,0
13.964,6,23,7390,13,298,1163,517,1137,10,730,620,1452,6253
688.014,17,8,3876,8,456,98287,1451,3876,0,0,0,0,0
11.715,6,1885,1610841,1136,1363,10,1380,1576639,749,421,15,1923,34202
0.019,6,11,3410,6,75,3,75,395,5,2747,4,2747,3015
1619.362,1,8,848,8,78,231337,78,848,0,0,0,0,0
4.062,17,5,295,5,31,1015,31,295,0,0,0,0,0
0.84,17,4,352,2,60,839,60,176,2,60,839,60,176
10.437,17,18,7061,8,501,1491,1350,4235,10,254,1156,1350,2826
302.083,6,53,21397,31,947,10063,1360,15486,22,386,14376,2667,5911
1786.459,6,102,8364,68,66,26663,66,4964,34,60,54132,60,3400
1772.622,6,285,36190,116,138,15413,1360,16972,169,148,10550,3302,19218
5.012,17,4,530,2,36,5006,36,128,2,173,5007,187,402
2.511,6,31,8129,17,657,156,1418,5532,14,232,191,580,2597
0.293,17,2,152,1,48,0,48,76,1,48,0,48,76
1795.158,17,80,3354,79,14,23014,14,3318,1,8,0,8,36
1328.444,17,247,18772,247,48,5400,48,18772,0,0,0,0,0
1.196,6,25,8056,12,164,91,267,1288,13,869,85,1440,6768
0.027,17,2,338,1,33,0,33,61,1,249,0,249,277
119.275,6,76,49010,45,1197,2710,1448,40669,31,746,2053,1448,8341
0.142,17,2,154,1,33,0,33,61,1,65,0,65,93
0.928,6,27,8569,14,203,71,467,1549,13,1056,68,1408,7020
1799.218,6,359,22709,209,69,8650,69,12569,150,69,12075,69,10140
6.996,6,30,7504,12,155,636,267,1266,18,393,410,1997,6238
0.573,17,2,152,2,48,573,48,152,0,0,0,0,0
29.311,17,15,7784,8,655,4187,1350,5471,7,302,43,1350,2313
0.621,6,345,348775,107,194,5,230,6351,238,1398,1,1476,342424
681.644,17,16,1216,16,48,45442,48,1216,0,0,0,0,0
1.305,6,51,20462,28,907,48,1360,14766,23,476,51,2715,5696
1096.195,6,1127,1063058,431,162,2549,864,28597,696,1533,1577,8508,1034461
1.435,6,41,10662,21,526,71,1460,5086,20,433,65,1460,5576
56.763,6,28,7217,13,155,4730,267,1306,15,482,4053,1997,5911
59.478,6,45,9042,22,410,669,915,2214,23,368,2697,3488,6828
280.467,6,28,7352,13,158,23372,267,1317,15,603,20030,2076,6035
131.062,17,10,880,5,48,32763,48,380,5,72,32763,72,500
1656.111,1,8,448,8,28,236587,28,448,0,0,0,0,0
1760.752,1,91,5096,91,28,19563,28,5096,0,0,0,0,0
1.323,6,41,10603,21,517,66,1360,5027,20,433,60,1360,5576
1680.412,1,14,812,14,30,129262,30,812,0,0,0,0,0
94.946,6,36,8320,18,349,516,731,1847,18,521,5575,3488,6473
142.751,6,25,9968,12,549,60,1440,2709,13,961,11885,1440,7259
319.548,6,1965,2884025,1091,99,293,596,64523,874,3420,366,14080,2819502
240.237,6,58,18920,30,756,8283,1418,15948,28,188,8897,580,2972
8.927,6,76,23353,39,551,234,1152,18105,37,470,239,1179,5248
11.801,17,8,1176,4,48,3929,48,304,4,190,3929,308,872
0.126,17,2,602,1,46,0,46,74,1,500,0,500,528
0.017,6,3,189,1,0,0,0,40,2,69,0,69,149
1769.779,6,101,9344,66,65,27227,65,5577,35,59,52047,59,3767
0.812,17,17,7731,8,522,108,1350,4405,9,341,93,1350,3326
37.914,17,22,1936,11,48,3790,48,836,11,72,3790,72,1100
180.563,2,3,96,3,8,90281,8,96,0,0,0,0,0
0.929,6,3,127,1,0,0,0,40,2,7,0,7,87
294.531,2,3,96,3,8,147265,8,96,0,0,0,0,0
18.597,6,3478,3318525,2318,1356,7,1368,3253529,1160,931,15,2736,64996
294.058,6,11,631,6,31,58523,31,307,5,31,500,31,324
0.944,6,13,1693,7,288,155,288,588,6,426,104,434,1105
36.035,17,11,836,11,48,3603,48,836,0,0,0,0,0
300.272,6,33,11944,18,593,17663,1408,4517,15,829,17165,1408,7427
240.155,6,42,4955,22,181,11435,517,2255,20,183,12639,851,2700
1744.677,2,15,480,15,8,124619,8,480,0,0,0,0,0
1777.261,1,339,28476,339,56,5258,56,28476,0,0,0,0,0
370.703,6,17,1190,13,180,30891,180,864,4,110,20177,110,326
1745.152,6,97,7307,63,38,28147,205,4476,34,33,52873,98,2831
755.908,2,7,224,7,8,125984,8,224,0,0,0,0,0
0.191,6,3,152,2,0,191,0,100,1,0,0,0,52
5.975,6,620,570420,404,1344,14,1368,553260,216,776,26,2736,17160
0.082,6,11,1709,6,97,16,97,357,5,1148,18,1148,1352
1.114,6,25,8056,12,164,86,267,1288,13,869,78,1448,6768
248.385,6,13,5585,4,106,82791,106,274,9,823,31046,1420,5311
0.74,17,3,1164,3,360,370,360,1164,0,0,0,0,0
1758.211,6,120,7284,66,27,27048,27,3939,54,27,33173,27,3345
0.213,6,16,2993,9,282,26,531,1606,7,338,30,777,1387
50.761,17,4,352,2,60,50759,60,176,2,60,50760,60,176
1799.451,17,142,11360,71,48,25706,48,5396,71,56,25706,56,5964
44.674,6,19,7021,8,324,6382,722,1710,11,942,4450,1408,5311
0.396,6,22,7255,12,318,36,600,1906,10,964,41,1471,5349
0.014,17,2,444,1,39,0,39,67,1,349,0,349,377
5.209,1,2,112,2,28,5209,28,112,0,0,0,0,0
1772.132,6,180,15480,120,69,14891,69,8940,60,69,30034,69,6540
1794.746,6,296,36474,122,149,14831,1460,18980,174,126,10373,1642,17494
0.031,17,2,347,1,29,0,29,57,1,262,0,262,290
1745.311,1,8,448,8,28,249330,28,448,0,0,0,0,0
1785.844,1,248,13888,248,28,7230,28,13888,0,0,0,0,0
159.163,6,6,323,3,0,79581,0,152,3,7,79481,7,171
0.512,6,20,7165,12,318,45,599,1905,8,1209,72,1906,5260
373.412,6,18,1242,14,180,28724,180,916,4,110,20062,110,326
1786.309,6,106,8574,70,65,25888,65,5010,36,59,51034,59,3564
4.213,17,5,295,5,31,1053,31,295,0,0,0,0,0
1770.97,6,101,9344,66,65,27245,65,5577,35,59,52083,59,3767
1771.457,6,99,9306,66,66,27253,66,5610,33,60,55355,60,3696
902.485,2,7,224,7,8,150414,8,224,0,0,0,0,0
1.562,6,46,19002,26,950,62,1460,13426,20,529,72,4075,5576
174.805,17,4,352,2,60,174803,60,176,2,60,174803,60,176
0.707,17,4,368,2,32,690,32,120,2,96,695,96,248
0.007,17,2,380,1,59,0,59,87,1,265,0,265,293
0.316,17,8,2750,8,315,45,354,2750,0,0,0,0,0
0.42,6,11,913,6,182,84,182,490,5,77,97,134,423
204.492,17,4,352,2,60,204491,60,176,2,60,204491,60,176
4.032,17,6,5701,2,723,4032,1350,1503,4,1021,977,1350,4198
307.771,6,17,1758,10,180,34176,180,1068,7,110,51265,110,690
12.205,17,10,965,5,46,3049,46,370,5,91,3049,91,595
9.857,6,79,24493,39,552,259,1152,18704,40,465,246,1179,5789
10.938,6,19,4402,11,275,1093,275,998,8,768,884,1440,3404
35.713,17,3,228,3,48,17856,48,228,0,0,0,0,0
1784.476,6,356,22520,208,69,8620,69,12460,148,69,12138,69,10060
0.308,17,2,152,1,48,0,48,76,1,48,0,48,76
1.563,6,20,3833,11,234,156,564,1504,9,463,169,1343,2329
1.268,6,49,19579,27,915,48,1360,13923,22,433,52,1360,5656
2.162,6,13,2311,8,188,308,245,700,5,1407,475,1407,1611
12.125,17,20,1750,10,34,1346,34,620,10,85,1346,91,1130
0.072,17,2,362,1,46,0,46,74,1,260,0,260,288
0.141,17,2,194,1,61,0,61,89,1,77,0,77,105
15.937,6,195,155572,129,1307,124,1360,147672,66,349,240,2720,7900
1.362,6,39,8294,19,321,75,1164,2718,20,433,62,1440,5576
60.196,6,68,18279,32,301,487,766,2675,36,505,1715,1460,15604
3.842,6,3,127,1,0,0,0,40,2,7,0,7,87
271.652,6,286,238449,186,1312,1468,1368,220953,100,614,1994,2736,17496
0.015,17,2,216,1,34,0,34,62,1,126,0,126,154
1.556,6,48,19317,27,899,59,1360,13701,21,476,65,2720,5616
280.634,6,28,7352,12,158,25512,267,1277,16,603,18707,1400,6075
1.329,6,50,18830,27,857,51,1360,13134,23,433,52,1360,5696
1.157,6,24,8004,13,164,82,267,1340,11,1014,98,2816,6664
1239.724,1,13,1203,13,64,103310,197,1203,0,0,0,0,0
69.407,6,32,8005,15,164,4957,267,1593,17,477,4325,1997,6412
82.942,6,26,5677,11,107,8293,159,1034,15,966,5924,1668,4643
1.962,17,35,20187,18,874,115,1350,16239,17,204,98,1350,3948
1778.716,1,58,4872,58,56,31205,56,4872,0,0,0,0,0
35.638,1,40,4160,0,0,0,0,0,40,76,913,76,4160
0.099,17,2,223,1,54,0,54,82,1,113,0,113,141
0.894,6,10,1687,7,100,149,100,384,3,1179,325,1179,1303
39.069,17,22,1672,22,48,1860,48,1672,0,0,0,0,0
1770.113,6,133,16625,81,153,22126,823,10339,52,87,34706,223,6286
1792.954,17,180,11520,180,36,10016,36,11520,0,0,0,0,0
1.127,6,25,8056,12,164,87,267,1288,13,869,80,1408,6768
15.046,6,1824,1652446,1106,1410,13,1448,1607854,718,776,20,1448,44592
1.184,6,25,8056,12,164,91,267,1288,13,869,83,1448,6768
0.088,17,4,284,2,32,81,32,120,2,54,81,60,164
544.495,6,95,14681,50,136,11112,1189,5424,45,196,12374,1420,9257
152.293,17,4,240,2,32,152292,32,120,2,32,152292,32,120
962.605,2,9,288,9,8,120325,8,288,0,0,0,0,0
3.004,17,5,354,4,30,1001,30,232,1,94,0,94,122
334.462,6,258,109666,126,808,1199,1152,99622,132,340,2550,1179,10044
950.529,17,13,1307,13,72,79210,355,1307,0,0,0,0,0
1763.345,17,150,25202,150,140,11834,373,25202,0,0,0,0,0
1772.831,17,138,11040,69,48,26070,48,5244,69,56,26070,56,5796
1787.061,6,123,14556,79,84,22911,498,6386,44,160,41557,1420,8170
858.312,6,70,10996,38,321,21072,1290,7619,32,77,27684,241,3377
0.904,6,10,1687,7,100,150,100,384,3,1179,324,1179,1303
60.334,6,36,7672,19,138,3351,174,1316,17,472,3763,1420,6356
2.649,6,41,8596,22,213,126,564,1993,19,448,134,2720,6603
570.856,1,6,489,6,53,114171,78,489,0,0,0,0,0
1794.286,6,363,23007,211,69,8544,69,12787,152,69,11881,69,10220
546.967,17,4,1424,4,328,182322,1030,1424,0,0,0,0,0
539.312,6,54,8377,28,117,19971,517,2400,26,419,21569,2448,5977
1772.28,6,180,15480,120,69,14893,69,8940,60,69,30031,69,6540
1738.354,2,24,768,24,8,75580,8,768,0,0,0,0,0
370.985,6,18,1242,14,180,28537,180,916,4,110,20065,110,326
1790.249,6,358,22669,209,69,8606,69,12569,149,69,12094,69,10100
1796.138,6,356,22520,208,69,8676,69,12460,148,69,12218,69,10060
0.269,17,2,586,1,46,0,46,74,1,484,0,484,512
0.387,17,2,194,1,61,0,61,89,1,77,0,77,105
1680.48,1,15,840,15,28,120034,28,840,0,0,0,0,0
1793.732,17,144,11520,72,48,25263,48,5472,72,56,25263,56,6048
125.248,6,25,11003,12,414,78,935,1768,13,967,10425,1460,9235
1797.472,17,140,11200,70,48,26050,48,5320,70,56,26050,56,5880
4.526,6,37,7189,19,218,251,314,3383,18,513,249,1179,3806
1118.578,17,220,16720,220,48,5107,48,16720,0,0,0,0,0
11.063,6,13,923,6,275,2212,275,527,7,96,1516,96,396
0.033,6,14,3448,8,106,4,106,530,6,866,4,1448,2918
300.637,6,143,148583,87,233,3495,517,6423,56,2730,5465,14020,142160
0.467,6,7,371,4,0,155,0,204,3,7,119,7,167
1798.082,17,450,39960,405,35,4450,288,25740,45,288,40013,288,14220
1800.0,6,313,20984,134,46,13308,46,10002,179,46,10112,46,10982
0.29,17,6,1112,4,64,95,64,368,2,344,283,344,744
10.998,6,20,4442,11,275,1099,275,998,9,768,776,1440,3444
1787.286,6,103,8377,68,64,26675,65,4921,35,58,52564,59,3456
1788.306,17,83,3480,82,14,22077,14,3444,1,8,0,8,36
1776.859,17,73,3060,72,14,25026,14,3024,1,8,0,8,36
0.332,6,26,9013,13,257,27,669,1714,13,945,26,1402,7299
327.604,1,6,390,6,37,65520,37,390,0,0,0,0,0
1.022,1,10,840,10,56,113,56,840,0,0,0,0,0
0.004,17,2,340,1,32,0,32,60,1,252,0,252,280
280.388,6,30,7432,14,158,21568,267,1357,16,678,18689,3456,6075
1744.606,2,28,896,28,8,64615,8,896,0,0,0,0,0
4.851,6,42,7389,21,218,242,314,3463,21,440,230,1152,3926
0.05,6,2,173,2,46,50,62,173,0,0,0,0,0
0.165,17,2,230,1,40,0,40,68,1,134,0,134,162
1794.837,1,58,4872,58,56,31488,56,4872,0,0,0,0,0
0.472,6,20,7165,12,318,42,599,1905,8,1209,66,1906,5260
100.725,6,40,10435,18,769,1563,1360,4598,22,329,4788,4027,5837
43.997,2,2,64,2,8,43997,8,64,0,0,0,0,0
317.044,6,64,19229,37,359,8806,1360,10490,27,588,12187,1929,8739
1772.658,6,180,15480,120,69,14896,69,8940,60,69,30039,69,6540
1758.486,17,118,9440,59,48,30318,48,4484,59,56,30318,56,4956
1.568,17,20,6933,8,303,224,1350,2649,12,329,72,1350,4284
1.401,6,22,6048,11,273,139,517,1672,11,759,139,1408,4376
1787.516,6,104,8376,68,65,26679,65,4930,36,59,51068,59,3446
0.01,17,2,351,1,39,0,39,67,1,256,0,256,284
352.828,6,265,28212,110,108,3236,110,13806,155,110,2291,110,14406
1684.07,17,12,498,11,14,168407,14,462,1,8,0,8,36
0.738,6,2,1175,1,0,0,0,40,1,1095,0,1095,1135
1746.008,1,74,6216,74,56,23917,56,6216,0,0,0,0,0
26.925,6,36,8229,19,188,1495,721,2088,17,908,1669,2840,6141
1796.272,6,356,22520,208,69,8677,69,12460,148,69,12219,69,10060
360.425,1,5,475,5,67,90106,121,475,0,0,0,0,0
274.144,1,2,120,2,32,274144,32,120,0,0,0,0,0
1790.889,6,364,23047,211,69,8528,69,12787,153,69,11782,69,10260
0.489,6,22,7345,13,334,40,663,2021,9,1209,57,1946,5324
1799.999,6,213,17105,78,77,22987,374,8328,135,49,13432,143,8777
2.11,17,6,540,3,30,581,30,174,3,94,0,94,366
1.151,6,23,7952,12,164,89,267,1288,11,1216,97,2816,6664
10.763,6,18,5550,10,275,1195,275,958,8,1420,856,1420,4592
0.211,17,2,685,1,308,0,308,336,1,321,0,321,349
0.05,17,4,284,2,32,22,32,120,2,54,29,60,164
79.83,1,2,112,2,28,79830,28,112,0,0,0,0,0
1.03,17,2,322,1,33,0,33,61,1,233,0,233,261
11.755,6,1871,1624587,1129,1384,10,1420,1590674,742,467,15,1883,33913
1774.73,17,140,11200,70,48,25720,48,5320,70,56,25720,56,5880
3.901,6,26,11021,13,185,325,275,1081,13,1345,308,1414,9940
2.325,6,28,5893,14,123,178,267,1428,14,780,166,1460,4465
1773.622,6,181,15589,120,69,14904,69,8940,61,69,29555,69,6649
63.472,6,37,9256,16,327,128,1189,2615,21,445,3172,1917,6641
1788.522,17,87,3648,86,14,21041,14,3612,1,8,0,8,36
35.39,6,30,5078,16,154,2359,722,1946,14,480,2680,2026,3132
1.308,6,49,19948,27,941,50,1460,14292,22,476,53,2615,5656
2.904,17,37,16542,19,564,155,1350,11262,18,265,167,1350,5280
1793.57,6,367,25650,214,99,8420,469,15045,153,69,11798,69,10605
8.357,6,46,8449,24,211,363,314,4142,22,489,381,1179,4307
0.226,6,3,132,2,0,88,0,92,1,0,0,0,40
50.97,6,36,8455,18,410,522,882,1982,18,478,2989,2128,6473
1778.042,17,142,11360,71,48,25400,48,5396,71,56,25400,56,5964
59.032,6,25,7097,12,155,5366,267,1266,13,589,4917,3426,5831
295.788,6,36,8086,13,158,24649,267,1317,23,365,13444,1400,6769
1792.934,1,251,14056,251,28,7171,28,14056,0,0,0,0,0
0.017,17,4,865,2,47,0,47,150,2,329,6,341,715
1785.952,17,87,3648,86,14,21011,14,3612,1,8,0,8,36
8.319,6,1801,1677078,1151,1380,7,1408,1638614,650,931,12,2801,38464
1786.618,6,102,8296,68,65,26665,65,4930,34,59,54137,59,3366
1786.799,6,102,8296,68,65,26668,65,4930,34,59,54142,59,3366
1770.146,1,172,9632,172,28,10351,28,9632,0,0,0,0,0
61.854,6,66,48067,44,1184,1438,1408,40187,22,961,2934,3847,7880
0.475,6,6,324,4,0,158,0,216,2,0,239,0,108
1776.025,17,73,3060,72,14,25014,14,3024,1,8,0,8,36
0.175,6,23,7608,12,176,15,334,1339,11,1137,16,1648,6269
153.032,6,32,13316,17,488,307,1440,3155,15,954,10921,1440,10161
0.006,17,2,309,1,42,0,42,70,1,211,0,211,239
0.062,17,4,368,2,32,0,32,120,2,96,0,96,248
246.936,17,4,352,2,60,246935,60,176,2,60,246935,60,176
55.354,6,9,516,2,0,15019,0,112,7,0,9224,0,404
20.051,6,16,11933,3,193,21,193,357,13,1089,1670,1408,11576
3.688,6,2,88,2,0,0,0,88,0,0,0,0,0
0.023,17,2,672,2,308,23,308,672,0,0,0,0,0
16.914,6,12,2596,5,821,4225,1420,1846,7,231,2817,231,750
129.937,6,23,10771,13,736,1981,1350,3498,10,1143,14417,3151,7273
48.137,6,3,396,3,138,24068,138,396,0,0,0,0,0
3.822,6,17,2483,9,188,477,245,744,8,703,508,1152,1739
1.228,6,23,6509,13,333,102,1003,2189,10,979,135,1731,4320
3.982,17,8,736,4,64,1327,64,368,4,64,1327,64,368
1.028,6,23,6460,13,323,85,954,2140,10,979,113,1731,4320
1739.042,6,143,16206,81,91,21738,721,7267,62,169,28504,2840,8939
26.697,17,17,7745,8,606,3804,1350,5072,9,269,3328,1350,2673
86.173,17,4,352,2,60,86172,60,176,2,60,86172,60,176
33.657,6,33,5220,16,180,2232,722,1923,17,267,2092,1402,3297
0.236,6,46,20107,26,1001,9,1420,15086,20,467,11,1883,5021
1782.481,6,1083,324006,472,921,3784,1418,274894,611,49,2922,124,49112
0.127,17,2,157,1,31,0,31,59,1,70,0,70,98
25.37,6,12,9640,3,204,12685,204,368,9,1256,1526,1438,9272
7.798,6,15,2666,7,152,1299,267,742,8,320,1076,1152,1924
267.904,6,29,7392,13,158,22325,267,1317,16,603,17857,1400,6075
6.761,17,6,528,3,48,3374,48,228,3,72,3373,72,300
0.473,6,10,968,5,256,114,256,460,5,304,114,304,508
0.47,6,51,23261,29,1068,16,1380,16216,22,558,20,1923,7045
42.316,17,12,912,12,48,3846,48,912,0,0,0,0,0
18.86,17,12,912,12,48,1714,48,912,0,0,0,0,0
1772.994,6,180,15480,120,69,14899,69,8940,60,69,30048,69,6540
14.823,6,14,2242,8,210,2116,210,844,6,545,2958,904,1398
1775.708,17,140,11200,70,48,25734,48,5320,70,56,25734,56,5880
0.17,6,25,7216,13,155,14,267,1301,12,678,14,4200,5915
0.624,6,22,7312,13,325,52,626,1984,9,1210,72,1946,5328
1.017,1,3,168,3,28,508,28,168,0,0,0,0,0
1780.991,1,70,5880,0,0,0,0,0,70,56,25811,56,5880
291.866,17,4,352,2,60,291865,60,176,2,60,291865,60,176
280.18,6,27,7312,12,158,25470,267,1277,15,678,20011,2045,6035
0.197,6,11,913,6,182,39,182,490,5,77,44,134,423
1794.998,6,124,7900,72,47,25281,208,4890,52,31,35187,31,3010
300.744,6,49,13231,25,777,12531,1360,7314,24,309,631,2667,5917
0.22,6,2,104,1,0,0,0,40,1,0,0,0,64
1796.845,6,240,35580,150,302,12059,302,25920,90,83,20189,83,9660
0.502,17,15,8406,8,705,71,1350,5869,7,334,74,1350,2537
11.719,6,1835,1599546,1129,1363,10,1380,1567064,706,421,16,1923,32482
7.928,6,67,20182,34,541,240,1152,15435,33,489,238,1179,4747
0.384,6,27,8942,13,232,32,569,1614,14,941,26,1438,7328
0.337,6,27,9069,13,261,28,683,1728,14,943,25,1408,7341
16.075,1,8,4608,8,548,2296,548,4608,0,0,0,0,0
1.477,6,46,18926,26,942,59,1460,13350,20,476,67,2615,5576
4.322,6,21,7609,13,634,360,1368,3221,8,991,597,1573,4388
1794.106,17,66,2766,65,14,28032,14,2730,1,8,0,8,36
78.464,6,112,85580,72,1256,1105,1408,75376,40,811,2006,3847,10204
1783.809,6,366,25541,211,100,8494,469,14856,155,69,11583,69,10685
0.012,6,3,327,2,103,2,138,287,1,0,0,0,40
1772.909,6,180,15480,120,69,14898,69,8940,60,69,30042,69,6540
1640.704,17,133,13314,133,72,12429,346,13314,0,0,0,0,0
10.963,6,20,4442,11,275,1096,275,998,9,768,777,1440,3444
0.041,17,2,679,2,311,41,331,679,0,0,0,0,0
0.05,6,18,9084,10,127,5,127,655,8,1601,6,4344,8429
120.124,17,4,332,2,31,120111,33,118,2,79,120122,93,214
0.09,17,2,572,1,39,0,39,67,1,477,0,477,505
0.156,6,44,17522,24,960,6,1420,12501,20,420,7,1420,5021
1786.685,6,102,8228,68,64,26666,64,4896,34,58,54139,58,3332
360.988,2,5,160,5,8,90247,8,160,0,0,0,0,0
1.825,6,9,527,5,43,456,43,311,4,0,606,0,216
13.597,6,19,3427,8,49,1942,92,523,11,1164,1340,1408,2904
151.398,6,24,10758,13,745,56,1460,3534,11,1128,15125,2380,7224
1679.614,1,15,840,15,28,119972,28,840,0,0,0,0,0
146.793,6,21,8279,11,525,93,1237,2048,10,1163,16290,3151,6231
0.429,6,50,20174,28,925,15,1380,15052,22,421,18,1923,5122
1742.73,1,68,5712,68,56,26010,56,5712,0,0,0,0,0
15.205,17,28,8453,11,332,1520,1350,3970,17,235,911,1350,4483
476.036,1,31,3286,31,78,15867,78,3286,0,0,0,0,0
0.318,17,2,152,1,48,0,48,76,1,48,0,48,76
248.615,6,76,50453,46,1204,5524,1368,42158,30,840,2128,2519,8295
1443.842,2,13,416,13,8,120320,8,416,0,0,0,0,0
1797.359,17,438,147168,438,308,4112,308,147168,0,0,0,0,0
1.306,6,49,18240,26,882,52,1460,12544,23,433,51,1460,5696
2.038,17,6,460,3,40,1002,41,206,3,56,914,57,254
1.204,6,11,1572,5,503,301,503,771,6,473,240,473,801
3.798,17,8,704,4,37,1016,37,260,4,83,1,89,444
125.419,6,35,7975,13,155,10451,267,1306,22,340,5972,3417,6669
2.976,1,2,112,2,28,2976,28,112,0,0,0,0,0
240.289,6,46,9125,24,523,10447,1408,5968,22,222,11442,618,3157
1770.894,6,101,9410,66,66,27244,66,5610,35,60,52082,60,3800
180.5,2,3,96,3,8,90250,8,96,0,0,0,0,0
0.003,17,8,2758,8,316,0,355,2758,0,0,0,0,0
70.608,6,26,7522,14,321,5431,517,1427,12,1092,6336,2688,6095
0.898,6,10,1687,7,100,149,100,384,3,1179,314,1179,1303
369.615,6,18,1242,14,180,28431,180,916,4,110,20064,110,326
0.523,6,23,7428,14,273,40,663,2104,9,1209,61,1946,5324
278.567,6,28,2981,14,324,21428,585,1397,14,282,18484,580,1584
34.432,6,16,2120,10,251,3825,564,1298,6,170,5021,258,822
80.485,6,75,18738,40,421,2063,1360,9694,35,346,2363,1360,9044
1.143,6,11,1727,7,100,190,100,384,4,589,300,1152,1343
1791.69,6,357,22629,208,69,8655,69,12460,149,69,12105,69,10169
252.165,17,4,352,2,60,252164,60,176,2,60,252164,60,176
33.352,6,25,7258,9,156,4169,267,838,16,524,2220,1420,6420
0.19,6,3,182,2,31,190,31,111,1,31,0,31,71
0.129,17,2,154,1,33,0,33,61,1,65,0,65,93
6.157,6,39,9371,18,321,362,722,2976,21,504,297,1380,6395
0.919,17,4,368,2,64,918,64,184,2,64,916,64,184
0.228,6,21,5831,12,164,20,453,1442,9,782,27,2231,4389
471.757,1,3,168,3,28,235878,28,168,0,0,0,0,0
504.834,2,3,96,3,8,252417,8,96,0,0,0,0,0
2.373,6,29,10366,17,367,148,833,1785,12,1012,207,1420,8581
657.72,6,62,7734,28,97,24352,722,2932,34,126,19925,1408,4802
300.303,6,10,746,6,36,60060,38,458,4,40,100046,40,288
3.98,17,4,268,4,39,1326,39,268,0,0,0,0,0
0.074,6,16,5719,8,134,10,134,474,8,1228,10,1460,5245
11.548,6,4,220,1,0,0,0,52,3,0,5774,0,168
11.273,6,26,9953,13,275,939,275,1078,13,1042,754,1440,8875
75.217,6,19,780,9,0,5998,0,364,10,0,8356,0,416
0.24,2,3,120,3,16,120,16,120,0,0,0,0,0
1796.454,17,449,39928,404,35,4457,288,25708,45,288,40018,288,14220
0.089,17,4,624,2,64,57,64,184,2,192,46,192,440
1774.062,17,140,11200,70,48,25710,48,5320,70,56,25710,56,5880
0.048,17,2,158,1,34,0,34,62,1,68,0,68,96
154.553,6,26,10851,13,405,63,907,1815,13,944,12867,2720,9036
1772.252,6,180,15480,120,69,14892,69,8940,60,69,30035,69,6540
1799.999,6,219,17442,82,76,21851,375,8475,137,50,13234,143,8967
0.248,17,2,384,1,39,0,39,67,1,289,0,289,317
418.638,17,40,3520,20,48,22032,48,1520,20,72,22032,72,2000
1758.764,6,105,6270,60,27,29808,27,3525,45,27,39970,27,2745
1.324,6,42,11442,22,547,63,1360,5866,20,433,60,1360,5576
119.462,17,4,352,2,60,119461,60,176,2,60,119461,60,176
4.186,6,7,487,4,69,1395,69,298,3,69,229,69,189
0.027,17,2,148,1,32,0,32,60,1,60,0,60,88
1.522,17,5,1252,3,64,747,64,276,2,460,0,472,976
1712.838,17,47,1968,46,14,38063,14,1932,1,8,0,8,36
5.241,6,11,2070,8,241,748,241,1766,3,92,99,92,304
1323.547,2,20,640,20,8,69660,8,640,0,0,0,0,0
1775.058,1,60,5040,60,56,30085,56,5040,0,0,0,0,0
167.341,6,66,41581,40,1163,4290,1408,33489,26,748,2456,1408,8092
5.76,6,581,514269,366,1339,15,1368,498425,215,776,25,2736,15844
0.333,17,2,152,1,48,0,48,76,1,48,0,48,76
1.416,6,48,19044,26,947,56,1460,13388,22,433,56,1460,5656
96.64,6,42,8842,21,412,480,889,2156,21,416,4825,3488,6686
0.092,6,9,1340,5,145,23,145,349,4,827,25,827,991
0.007,17,2,2750,2,1347,7,1347,2750,0,0,0,0,0
300.233,6,49,17748,23,976,13638,1360,11689,26,278,12002,2667,6059
280.205,6,30,7432,14,158,21554,267,1357,16,603,18677,2800,6075
143.09,6,16,4242,9,264,17886,722,1533,7,1164,7840,1448,2709
86.55,17,4,1344,4,308,28850,308,1344,0,0,0,0,0
0.021,17,3,208,2,36,13,36,128,1,52,0,52,80
25.962,6,38,9411,18,291,1527,721,3056,20,555,1312,1440,6355
1789.337,17,140,11200,70,48,25932,48,5320,70,56,25932,56,5880
1777.401,6,102,8296,68,65,26528,65,4930,34,59,53857,59,3366
1.628,6,14,2351,8,188,232,245,700,6,703,275,1152,1651
1782.664,1,170,9520,170,28,10548,28,9520,0,0,0,0,0
0.351,6,24,5980,12,164,31,453,1442,12,651,29,1448,4538
0.808,17,8,2750,8,315,115,354,2750,0,0,0,0,0
1796.887,1,131,7336,131,28,13822,28,7336,0,0,0,0,0
1781.763,6,388,23848,208,69,8607,69,12460,180,45,9953,69,11388
13.778,6,21,4398,11,275,1377,275,1002,10,992,999,1440,3396
1785.832,6,104,8444,68,66,26654,66,4964,36,60,51021,60,3480
0.468,6,11,1503,6,213,93,213,457,5,421,112,421,1046
1799.116,17,449,39928,404,35,4464,288,25708,45,288,40018,288,14220
0.973,6,23,5705,13,158,77,370,1315,10,996,102,1771,4390
0.209,6,20,9025,10,121,23,121,649,10,1121,23,1448,8376
1772.196,6,180,15480,120,69,14892,69,8940,60,69,30032,69,6540
1793.397,17,180,11520,180,36,10018,36,11520,0,0,0,0,0
280.222,6,29,7392,13,158,23351,267,1317,16,603,18676,2036,6075
1793.76,17,180,11520,180,36,10021,36,11520,0,0,0,0,0
1791.392,17,144,11520,72,48,25230,48,5472,72,56,25230,56,6048
0.056,6,2,100,1,0,0,0,60,1,0,0,0,40
0.06,17,4,308,2,33,0,33,122,2,65,0,65,186
30.481,6,25,7341,13,268,2540,517,1534,12,646,2767,2417,5807
0.014,17,2,535,1,37,0,37,65,1,442,0,442,470
11.053,17,16,17873,16,1089,736,1450,17873,0,0,0,0,0
1785.665,6,416,24920,208,69,8626,69,12460,208,34,8626,48,12460
1786.796,1,185,10360,185,28,9710,28,10360,0,0,0,0,0
61.3,6,37,15871,22,794,2919,1408,9093,15,665,4360,1408,6778
369.6,6,18,1242,14,180,28430,180,916,4,110,20059,110,326
1773.169,6,180,15480,120,69,14900,69,8940,60,69,30045,69,6540
0.008,6,3,144,1,0,0,0,40,2,0,0,0,104
0.329,17,2,167,1,39,0,39,67,1,72,0,72,100
0.2,6,46,20152,26,1005,8,1420,15131,20,467,10,1883,5021
240.217,6,53,18308,28,813,8896,1418,15299,25,212,10008,580,3009
0.254,17,2,152,1,48,0,48,76,1,48,0,48,76
1.644,6,30,10405,18,367,96,833,1825,12,1012,141,1420,8580
1301.272,6,76,6095,50,66,26556,66,3584,26,58,52047,60,2511
1783.584,1,100,5600,100,28,18016,28,5600,0,0,0,0,0
15.131,1,8,832,0,0,0,0,0,8,76,2161,76,832
0.532,6,10,968,5,256,120,256,460,5,304,120,304,508
5.011,17,4,558,2,36,5007,36,128,2,187,5006,187,430
4.305,6,39,7269,20,218,226,314,3423,19,513,225,1179,3846
5.576,6,39,7285,20,218,293,314,3423,19,516,295,1179,3862
1773.128,6,181,15589,120,69,14900,69,8940,61,69,29546,69,6649
1799.42,17,142,11360,71,48,25705,48,5396,71,56,25705,56,5964
1741.291,17,30,31680,30,1028,60044,1028,31680,0,0,0,0,0
1795.257,17,29,9512,29,300,64116,300,9512,0,0,0,0,0
4.749,6,40,7309,20,218,249,314,3423,20,440,237,1152,3886
1.382,6,37,9808,20,502,72,1460,4352,17,476,74,2615,5456
250.814,1,6,336,6,28,50162,28,336,0,0,0,0,0
151.575,17,4,352,2,60,151574,60,176,2,60,151574,60,176
0.407,6,21,7203,13,318,33,600,1958,8,1205,57,1891,5245
65.8,17,4,352,2,60,65799,60,176,2,60,65799,60,176
0.54,17,2,136,1,32,0,32,60,1,48,0,48,76
66.959,6,14,3840,4,171,22304,171,387,10,964,7439,1448,3453
0.255,6,10,1671,6,552,50,948,1348,4,159,84,159,323
5.011,17,4,514,2,36,5006,36,128,2,165,5006,171,386
842.226,2,7,224,7,8,140371,8,224,0,0,0,0,0
280.262,6,29,7392,13,158,23355,267,1317,16,543,18682,1400,6075
2.004,17,6,460,3,40,995,41,206,3,56,970,57,254
0.783,17,4,588,2,48,773,48,152,2,190,770,308,436
1781.06,17,142,11360,71,48,25443,48,5396,71,56,25443,56,5964
0.083,6,11,1709,6,97,16,97,357,5,1148,19,1148,1352
10.772,6,20,4442,11,275,1077,275,998,9,768,748,1440,3444
1.253,6,52,19311,27,886,48,1360,13523,25,433,45,1360,5788
1791.112,6,135,12594,82,66,22112,66,7066,53,60,34442,60,5528
280.327,6,29,7392,13,158,23360,267,1317,16,603,18680,1400,6075
1798.153,17,450,39960,405,35,4450,288,25740,45,288,40015,288,14220
1303.844,1,22,1232,22,28,62087,28,1232,0,0,0,0,0
1772.084,1,54,4536,54,56,33435,56,4536,0,0,0,0,0
0.766,6,10,1687,7,100,127,100,384,3,1179,257,1179,1303
56.326,6,36,8455,18,410,513,882,1982,18,521,3304,2720,6473
17.505,6,46,14599,23,552,795,1152,10865,23,468,783,1179,3734
8.237,6,15,2214,9,666,1029,666,1150,6,728,1647,728,1064
1783.81,6,416,24920,208,69,8617,69,12460,208,34,8617,64,12460
212.652,1,6,336,6,28,42530,28,336,0,0,0,0,0
190.308,6,1086,516037,562,848,339,1152,490920,524,461,363,1179,25117
7.761,6,15,1362,8,275,1108,275,878,7,96,982,96,484
0.934,6,10,1687,7,100,155,100,384,3,1179,332,1179,1303
40.121,17,22,1936,11,48,4010,48,836,11,72,4010,72,1100
254.42,17,6,8256,6,1348,50884,1348,8256,0,0,0,0,0
1792.484,17,179,13962,179,50,10070,50,13962,0,0,0,0,0
15.783,6,2,87,1,0,0,0,40,1,7,0,7,47
1796.21,17,87,3648,86,14,21131,14,3612,1,8,0,8,36
255.295,6,9,528,2,112,255281,112,200,7,0,42546,0,328
1793.76,17,87,3648,86,14,21103,14,3612,1,8,0,8,36
169.004,17,8,2688,8,308,24143,308,2688,0,0,0,0,0
1684.549,2,17,544,17,8,105284,8,544,0,0,0,0,0
1741.375,6,91,6616,60,31,29514,31,4043,31,31,58035,31,2573
1800.0,6,386,65438,168,276,10777,1360,45648,218,124,8294,1872,19790
11.745,6,1863,1622982,1125,1388,10,1420,1589241,738,467,15,1883,33741
0.021,6,13,3514,7,75,3,75,447,6,1373,4,1448,3067
10.537,6,2164,2005293,1377,1378,7,1408,1959705,787,931,13,2816,45588
121.42,17,4,352,2,60,121419,60,176,2,60,121419,60,176
1798.868,6,395,34684,220,118,8214,1189,17329,175,130,10337,1420,17355
0.459,6,12,1653,6,288,87,288,548,6,426,53,434,1105
19.956,17,5,1680,5,308,4989,308,1680,0,0,0,0,0
15.883,17,19,12644,11,931,1585,1350,10549,8,233,2264,1350,2095
242.527,6,70,29709,36,118,6929,310,2913,34,1191,7349,3743,26796
0.024,17,2,384,1,39,0,39,67,1,289,0,289,317
240.305,6,41,8664,21,524,12014,1418,5817,20,257,12647,619,2847
280.033,6,28,7352,13,158,23336,267,1317,15,678,19999,3436,6035
1783.003,6,356,22520,208,69,8613,69,12460,148,69,12129,69,10060
47.821,6,488,224842,254,819,189,1152,211016,234,446,204,1179,13826
0.118,17,2,157,1,31,0,31,59,1,70,0,70,98
1785.861,6,364,25461,211,100,8504,469,14856,153,69,11749,69,10605
1746.032,6,94,7151,62,38,28623,205,4424,32,33,56308,98,2727
0.048,17,2,252,1,128,0,128,156,1,68,0,68,96
0.163,17,2,2344,2,1144,163,1258,2344,0,0,0,0,0
280.251,6,29,7392,13,158,23354,267,1317,16,603,18680,2036,6075
782.151,2,6,192,6,8,156430,8,192,0,0,0,0,0
1.484,6,49,19087,28,879,54,1360,13471,21,476,62,2715,5616
103.594,6,26,8389,14,523,7968,1050,2317,12,680,2737,2816,6072
1694.413,17,18,4611,9,31,211800,37,536,9,424,211800,463,4075
1799.438,6,358,22738,208,69,8692,69,12460,150,69,12076,69,10278
1.088,17,2,148,1,32,0,32,60,1,60,0,60,88
280.18,6,28,7352,13,158,23348,267,1317,15,678,20010,2045,6035
252.265,2,2,64,2,8,252265,8,64,0,0,0,0,0
2.212,17,4,518,3,39,840,39,201,1,289,0,289,317
0.515,6,22,7345,13,334,42,663,2021,9,1209,57,1946,5324
3.578,6,81,68035,46,1053,79,1360,17686,35,1882,101,5440,50349
0.177,17,2,206,1,47,0,47,75,1,103,0,103,131
67.675,6,28,7352,13,158,5639,267,1317,15,603,4830,2076,6035
1681.499,17,14,1036,7,30,280246,30,406,7,62,280246,62,630
1659.521,1,7,392,7,28,276586,28,392,0,0,0,0,0
782.943,6,54,4327,32,66,25256,66,2336,22,58,37278,60,1991
7.162,6,22,4426,13,213,596,597,1741,9,552,872,1767,2685
1.275,6,41,10619,23,514,57,1360,5078,18,400,64,1360,5541
300.857,2,3,96,3,8,150428,8,96,0,0,0,0,0
281.6,6,30,7432,13,158,23466,267,1317,17,543,17582,1400,6115
29.877,6,20,5854,11,267,2987,501,1245,9,707,3722,1420,4609
0.128,17,2,146,1,37,0,37,65,1,53,0,53,81
126.843,6,45,10130,23,681,691,1360,4417,22,438,6031,4027,5713
8.392,6,35,11872,16,158,559,267,1437,19,805,404,2036,10435
0.882,6,5,248,3,0,441,0,144,2,0,387,0,104
60.161,6,20,3725,12,529,5469,918,2761,8,105,8587,296,964
1741.36,17,30,31680,30,1028,60046,1028,31680,0,0,0,0,0
142.993,6,32,8952,14,158,10999,267,1357,18,624,8408,1400,7595
1084.044,17,612,210705,281,621,3680,1350,182395,331,57,3284,1350,28310
1786.414,6,102,8364,68,66,26662,66,4964,34,60,54131,60,3400
1772.426,6,180,15480,120,69,14894,69,8940,60,69,30034,69,6540
3.198,17,5,290,5,30,799,30,290,0,0,0,0,0
15.227,17,16,5202,7,354,2523,1350,2679,9,252,1892,1350,2523
842.263,2,7,224,7,8,140377,8,224,0,0,0,0,0
1719.12,17,310,69719,310,196,5563,422,69719,0,0,0,0,0
1798.647,17,449,39928,404,35,4463,288,25708,45,288,40018,288,14220
0.346,17,2,180,1,30,0,30,58,1,94,0,94,122
1637.343,2,11,352,11,8,163734,8,352,0,0,0,0,0
0.115,6,10,1669,6,551,22,947,1346,4,159,38,159,323
1750.083,17,12,498,11,14,175008,14,462,1,8,0,8,36
0.115,17,2,904,2,424,115,548,904,0,0,0,0,0
123.929,17,4,1344,4,308,41309,308,1344,0,0,0,0,0
0.054,17,2,572,1,39,0,39,67,1,477,0,477,505
133.737,17,2,120,2,32,133737,32,120,0,0,0,0,0
1.421,6,41,8431,21,321,71,1164,2810,20,400,65,1440,5621
0.921,6,32,12832,16,511,61,1460,3239,16,812,49,1460,9593
3.012,17,2,186,1,41,0,41,69,1,89,0,89,117
1786.639,6,105,8484,68,66,26666,66,4964,37,60,49626,60,3520
1582.058,17,34,11446,34,308,47941,336,11446,0,0,0,0,0
1.029,17,6,2334,6,361,205,361,2334,0,0,0,0,0
1756.675,6,105,6270,60,27,29774,27,3525,45,27,39922,27,2745
125.913,6,70,49610,46,1188,2798,1368,41626,24,961,2694,3887,7984
1.289,6,37,8212,19,320,71,1162,2716,18,476,66,2715,5496
4.007,17,8,736,4,32,1328,32,240,4,96,1329,96,496
138.55,6,20,2588,11,304,13855,304,1776,9,83,17283,83,812
4.898,6,40,7309,21,218,244,314,3463,19,513,258,1179,3846
187.992,17,4,352,2,60,187991,60,176,2,60,187991,60,176
375.065,6,18,1239,14,177,28851,177,913,4,110,20063,110,326
0.001,1,2,212,2,78,1,80,212,0,0,0,0,0
5.242,6,33,6133,17,206,327,314,2744,16,548,330,1179,3389
0.44,6,20,4960,10,137,48,267,1092,10,692,43,1467,3868
4.943,6,34,7000,17,231,308,314,3234,17,513,291,1179,3766
1.411,6,48,19516,27,913,54,1360,13900,21,476,60,2720,5616
27.272,6,22,2373,11,195,2727,195,727,11,398,2708,419,1646
5.694,6,40,7309,20,218,299,314,3423,20,513,286,1179,3886
1773.024,6,180,15480,120,69,14899,69,8940,60,69,30049,69,6540
23.758,17,37,12540,18,364,1395,1350,7073,19,259,1318,1350,5467
6.076,6,9,520,4,0,2025,0,220,5,0,1255,0,300
51.222,6,16,1690,6,275,10244,275,798,10,96,5348,96,892
0.376,6,12,1653,6,288,74,288,548,6,426,43,434,1105
1787.659,1,58,4872,0,0,0,0,0,58,56,31362,56,4872
1.095,6,5,212,3,0,547,0,124,2,0,1079,0,88
11.033,6,20,4442,11,275,1103,275,998,9,768,780,1440,3444
371.93,6,19,1303,14,177,28610,177,925,5,110,17677,110,378
1786.484,6,102,8296,68,65,26663,65,4930,34,59,54133,59,3366
0.246,17,3,451,2,39,59,39,134,1,289,0,289,317
240.683,2,4,128,4,8,80227,8,128,0,0,0,0,0
1.673,6,14,2351,8,188,239,245,700,6,703,284,1152,1651
119.427,6,24,11318,12,433,67,990,1823,12,1125,10845,2720,9495
134.45,17,4,352,2,60,134449,60,176,2,60,134449,60,176
1700.309,17,12,498,11,14,170030,14,462,1,8,0,8,36
1.141,6,64,63491,36,153,32,258,2085,28,2410,36,11312,61406
0.17,17,2,172,1,50,0,50,78,1,66,0,66,94
0.383,6,9,1340,5,145,95,145,349,4,827,87,827,991
450.432,17,22,7376,22,307,21449,308,7376,0,0,0,0,0
17.552,6,7,328,2,0,17552,0,88,5,0,4363,0,240
1773.209,6,180,15480,120,69,14900,69,8940,60,69,30048,69,6540
1.622,6,48,19165,27,888,62,1360,13549,21,433,72,1360,5616
0.045,6,2,421,1,0,0,0,40,1,341,0,341,381
294.355,17,4,240,2,32,294354,32,120,2,32,294354,32,120
1771.738,6,99,9306,66,66,27257,66,5610,33,60,55364,60,3696
0.005,17,2,262,1,39,0,39,67,1,167,0,167,195
55.194,6,7,368,4,0,18386,0,216,3,0,27580,0,152
0.787,17,4,560,2,64,785,64,184,2,160,661,160,376
0.024,6,10,912,5,121,5,121,389,5,259,6,259,523
0.141,6,17,5963,10,133,15,159,963,7,925,20,3077,5000
155.431,6,22,9920,11,433,73,990,1771,11,1099,15529,1440,8149
19.898,6,19,4024,8,142,2842,174,750,11,471,1393,1452,3274
0.79,6,24,6015,13,108,65,147,959,11,922,74,2602,5056
1791.988,1,58,4872,58,56,31438,56,4872,0,0,0,0,0
1787.276,6,102,8296,68,65,26675,65,4930,34,59,54156,59,3366
1799.977,17,318,72994,318,201,5678,422,72994,0,0,0,0,0
311.749,6,1597,1562684,1154,1340,270,1360,1534115,443,164,44,2720,28569
11.028,6,1794,1523185,1076,1361,10,1380,1490211,718,421,15,1923,32974
0.276,6,7,838,4,250,92,250,430,3,276,71,276,408
1.066,6,24,4804,13,203,88,498,1689,11,507,98,1448,3115
241.336,6,58,18060,31,752,8044,1408,15180,27,181,9281,580,2880
31.166,17,4,352,2,48,31156,48,152,2,72,31156,72,200
0.082,17,4,344,2,47,44,47,150,2,69,40,75,194
181.878,17,4,1544,4,358,60626,548,1544,0,0,0,0,0
1782.218,6,354,22509,206,69,8693,69,12380,148,69,12123,69,10129
31.462,6,4326,4132018,2780,1406,11,1448,4046938,1546,776,20,1448,85080
0.393,17,3,543,2,39,387,39,134,1,381,0,381,409
83.544,6,17,4777,5,92,214,92,372,12,1259,7578,1448,4405
260.473,17,4,352,2,60,260472,60,176,2,60,260470,60,176
32.198,6,37,8344,18,345,1221,721,1800,19,444,1781,2128,6544
1740.513,17,29,6815,29,207,62161,207,6815,0,0,0,0,0
300.181,6,35,17841,22,244,14294,630,2128,13,1878,20013,8047,15713
1.132,17,2,384,1,32,0,32,60,1,296,0,296,324
281.86,6,30,7432,13,158,23488,267,1317,17,543,17598,1400,6115
1799.055,17,764,46104,764,32,2357,37,46104,0,0,0,0,0
12.407,6,24,4089,13,234,1033,564,1640,11,463,1193,1343,2449
1.363,6,50,19877,28,869,50,1360,14221,22,433,55,1360,5656
0.125,17,2,154,1,33,0,33,61,1,65,0,65,93
0.748,6,6,328,4,0,249,0,216,2,0,708,0,112
0.075,17,3,208,2,36,40,36,128,1,52,0,52,80
297.347,1,4,224,4,28,99115,28,224,0,0,0,0,0
0.211,6,22,5040,10,137,23,267,1092,12,577,18,1400,3948
0.779,17,4,624,2,64,778,64,184,2,192,661,192,440
0.007,17,2,136,1,32,0,32,60,1,48,0,48,76
1682.025,17,14,1036,7,30,280332,30,406,7,62,280331,62,630
1790.333,6,356,22520,208,69,8648,69,12460,148,69,12178,69,10060
193.322,6,27,6586,15,154,13808,516,1684,12,552,16685,1452,4902
1749.799,17,258,55859,258,188,6808,422,55859,0,0,0,0,0
169.723,2,4,128,4,8,56574,8,128,0,0,0,0,0
249.617,6,61,9578,32,114,8052,502,3120,29,264,8881,2642,6458
1787.036,6,389,31685,220,91,8159,1189,15053,169,137,10637,1420,16632
12.55,17,2,122,2,33,12550,33,122,0,0,0,0,0
1740.737,6,87,6322,58,31,30539,31,3915,29,31,62167,31,2407
31.551,6,10,580,3,0,15775,0,160,7,0,5228,0,420
379.925,6,23,1633,15,177,27137,177,989,8,110,10189,110,644
1771.717,6,99,9306,66,66,27257,66,5610,33,60,55363,60,3696
0.231,6,6,331,5,31,23,31,291,1,0,0,0,40
0.838,17,4,1108,2,30,826,30,116,2,468,793,468,992
0.687,17,4,624,2,64,629,64,184,2,192,595,192,440
11.801,6,1868,1616757,1141,1363,10,1380,1583327,727,421,16,1923,33430
10.046,1,9,756,0,0,0,0,0,9,56,1255,56,756
0.031,6,2,80,1,0,0,0,40,1,0,0,0,40
0.453,6,51,21392,29,942,16,1380,16270,22,421,19,1923,5122
0.171,6,46,21343,26,1090,6,1420,16322,20,467,8,1883,5021
10.41,6,19,6426,6,154,2082,267,712,13,740,834,4837,5714
28.187,6,38,8269,17,188,1761,721,2003,21,677,1357,1440,6266
1768.113,1,124,13144,124,78,14374,78,13144,0,0,0,0,0
1.395,6,38,9848,20,502,73,1460,4352,18,433,70,1460,5496
1.537,6,14,2351,8,188,219,245,700,6,703,257,1152,1651
325.523,17,6,528,3,60,162761,60,264,3,60,162761,60,264
1798.336,17,448,39896,403,35,4473,288,25676,45,288,40016,288,14220
206.439,17,2,150,2,47,206439,47,150,0,0,0,0,0
0.411,6,51,23297,29,1000,14,1380,16252,22,558,17,1923,7045
0.061,17,2,602,1,46,0,46,74,1,500,0,500,528
1786.94,6,180,15480,120,69,15016,69,8940,60,69,30283,69,6540
0.752,6,12,3488,6,101,150,101,421,6,1373,150,1448,3067
1771.893,6,180,15480,120,69,14889,69,8940,60,69,30031,69,6540
178.614,6,26,13025,12,279,66,527,1349,14,1110,13729,1460,11676
203.986,17,4,240,2,32,203985,32,120,2,32,203985,32,120
17.321,6,17,6278,4,106,5773,106,274,13,497,1442,2840,6004
0.908,6,2,80,1,0,0,0,40,1,0,0,0,40
1742.915,6,95,7203,63,38,28111,205,4476,32,33,56214,98,2727
251.843,6,45,9284,19,119,13991,267,1960,26,330,5772,1452,7324
1785.17,6,358,22738,208,69,8623,69,12460,150,69,11977,69,10278
51.662,6,23,6677,11,181,5166,267,1172,12,836,4695,2045,5505
61.819,6,70,48369,44,1187,1437,1408,40283,26,960,2463,3847,8086
1.033,6,178,136388,106,1315,9,1432,129217,72,475,14,1871,7171
50.032,17,4,304,2,48,50024,48,152,2,48,50023,48,152
46.848,6,15,1432,3,106,23424,106,234,12,86,4241,90,1198
147.671,6,18,6388,2,106,190,106,194,16,396,9844,1460,6194
183.323,17,4,352,2,60,183321,60,176,2,60,183322,60,176
1.326,6,29,10024,17,377,82,864,1816,12,965,112,1452,8208
101.713,6,78,53802,49,1194,2119,1408,45552,29,841,2200,2439,8250
177.149,1,4,224,4,28,59049,28,224,0,0,0,0,0
0.273,6,10,1671,6,552,54,948,1348,4,159,91,159,323
25.399,6,36,14251,19,258,1411,764,2103,17,938,1586,1408,12148
1738.833,6,107,7749,67,31,26345,31,4567,40,31,44585,31,3182
1.079,17,6,360,3,32,539,32,180,3,32,538,32,180
1.276,6,54,21754,29,923,45,1360,15978,25,433,46,1360,5776
1.776,17,412,418961,109,130,16,1350,17263,303,1297,5,1350,401698
21.386,17,2,152,2,48,21386,48,152,0,0,0,0,0
15.565,17,22,14537,12,984,1411,1350,12151,10,210,1725,1350,2386
4.936,6,40,7309,19,218,274,314,3383,21,440,232,1152,3926
1.221,17,2,348,1,39,0,39,67,1,253,0,253,281
0.155,17,2,152,1,48,0,48,76,1,48,0,48,76
6.282,6,39,7269,21,218,314,314,3463,18,513,346,1179,3806
11.663,6,1880,1595416,1125,1363,10,1380,1560974,755,383,15,1380,34442
1.405,6,38,8254,19,321,78,1164,2718,19,433,67,1460,5536
0.275,17,2,672,2,308,275,308,672,0,0,0,0,0
1787.459,6,102,8228,68,64,26678,64,4896,34,58,54163,58,3332
280.227,6,28,7352,13,158,23352,267,1317,15,678,20013,2800,6035
1795.697,6,285,36581,116,145,15613,1360,17363,169,144,10687,1360,19218
1.794,6,32,10377,19,284,99,586,1618,13,1029,135,1420,8759
0.61,6,10,1671,6,552,121,948,1348,4,159,203,159,323
1796.725,17,448,39896,403,35,4469,288,25676,45,288,40019,288,14220
409.128,1,10,560,10,28,45458,28,560,0,0,0,0,0
1.668,6,25,8763,15,285,119,587,1459,10,985,165,1420,7304
0.019,17,4,368,2,32,17,32,120,2,96,4,96,248
73.038,6,8,428,3,0,36519,0,152,5,0,18208,0,276
5.287,17,3,208,2,36,5000,36,128,1,52,0,52,80
2.208,6,13,2311,8,188,315,245,700,5,1407,487,1407,1611
456.587,17,6,360,3,32,228293,32,180,3,32,228293,32,180
11.038,6,18,5610,10,275,1226,275,958,8,1440,847,1440,4652
1680.543,17,12,498,11,14,168054,14,462,1,8,0,8,36
0.022,17,6,912,3,60,5,60,264,3,188,5,188,648
18.601,6,8,440,5,0,4650,0,268,3,0,8419,0,172
0.474,6,20,7229,13,334,39,663,2021,7,1209,74,1946,5208
1792.234,6,472,114250,206,495,8741,1440,82713,266,184,6762,1702,31537
1.493,6,48,19040,26,947,59,1460,13384,22,476,60,2615,5656
0.147,6,47,20220,26,1005,5,1420,15159,21,420,6,1420,5061
0.059,17,2,290,1,40,0,40,68,1,194,0,194,222
305.668,6,89,16585,44,270,7108,1107,6150,45,310,6946,2816,10435
33.467,6,28,4863,13,201,2788,722,1681,15,342,2376,1408,3182
12.885,6,3,120,1,0,0,0,40,2,0,9119,0,80
2.113,6,19,3781,10,234,234,564,1452,9,463,230,1343,2329
39.851,17,22,1672,22,48,1897,48,1672,0,0,0,0,0
1743.501,6,95,7203,63,38,28120,205,4476,32,33,56228,98,2727
300.572,6,40,8670,21,315,15028,882,2157,19,478,511,1928,6513
22.013,17,4,288,2,36,22012,36,128,2,52,22013,52,160
454.751,6,58,8670,27,110,17488,517,2430,31,417,15156,1418,6240
2.299,6,22,3473,12,162,209,293,1458,10,537,226,1179,2015
1786.588,6,104,8444,68,66,26665,66,4964,36,60,51042,60,3480
0.354,6,24,5980,12,164,32,453,1442,12,651,30,1448,4538
1736.894,1,56,4704,56,56,31579,56,4704,0,0,0,0,0
1771.193,6,105,9552,66,65,27249,65,5577,39,59,46607,59,3975
105.681,6,12933,12390187,8640,1356,12,1408,12162287,4293,776,24,1408,227900
1797.569,6,356,22520,208,69,8683,69,12460,148,69,12227,69,10060
5.172,6,3,218,3,31,2586,31,218,0,0,0,0,0
166.24,6,27,10802,13,741,52,1360,3542,14,836,12777,1360,7260
1792.672,1,191,10696,191,28,9435,28,10696,0,0,0,0,0
116.814,6,24,980,10,0,5970,0,404,14,0,8985,0,576
281.978,6,27,7312,12,158,25634,267,1277,15,678,20118,2045,6035
280.221,6,28,7352,12,158,25474,267,1277,16,603,18678,1400,6075
6.929,6,2,120,2,0,0,0,120,0,0,0,0,0
1786.589,6,104,8444,68,66,26665,66,4964,36,60,51042,60,3480
1.01,17,2,782,2,363,1010,363,782,0,0,0,0,0
666.188,6,12,1812,8,241,95169,241,1284,4,92,221999,92,528
1790.409,6,356,22520,208,69,8649,69,12460,148,69,12178,69,10060
0.334,17,8,2742,8,314,47,353,2742,0,0,0,0,0
1.275,6,49,20532,28,917,47,1360,14916,21,529,55,4075,5616
280.324,6,30,7432,13,158,23360,267,1317,17,543,17513,1400,6115
48.821,6,46,12953,23,876,450,1360,7138,23,348,2211,2720,5815
281.693,6,33,7647,14,158,21668,267,1357,19,502,15648,1400,6290
13.989,6,21,4486,12,275,1271,275,1042,9,768,784,1440,3444
1715.412,1,8,448,8,28,245058,28,448,0,0,0,0,0
1794.26,17,180,14040,180,50,10023,50,14040,0,0,0,0,0
9.595,6,83,24845,41,542,239,1152,19008,42,461,227,1179,5837
2.738,6,14,2351,8,188,391,245,700,6,703,498,1152,1651
232.965,6,31,8912,14,158,17920,267,1357,17,763,14554,2076,7555
0.251,17,2,167,1,39,0,39,67,1,72,0,72,100
0.845,17,2,225,1,37,0,37,65,1,132,0,132,160
0.093,6,9,1346,5,145,23,145,349,4,833,21,833,997
1777.846,1,58,4872,58,56,31190,56,4872,0,0,0,0,0
51.681,2,2,64,2,8,51681,8,64,0,0,0,0,0
0.243,17,4,288,2,36,243,36,128,2,52,242,52,160
0.268,6,20,4960,10,137,29,267,1092,10,692,27,1467,3868
8.944,6,43,14318,21,327,447,667,1866,22,680,417,1360,12452
0.452,6,6,324,4,0,150,0,216,2,0,250,0,108
49.783,6,18,4829,10,730,5531,1360,3343,8,384,7093,501,1486
1797.187,17,448,39896,403,35,4470,288,25676,45,288,40020,288,14220
0.736,17,8,2750,8,315,105,354,2750,0,0,0,0,0
100.154,6,38,26275,24,745,33,1360,3974,14,2414,7694,5440,22301
1552.187,6,191,14429,73,66,21556,293,6850,118,48,13266,78,7579
3.816,6,2,87,1,0,0,0,40,1,7,0,7,47
1254.243,17,96,7664,50,48,25596,48,3800,46,56,25615,56,3864
1740.482,1,12,696,12,30,158225,30,696,0,0,0,0,0
1.164,6,10,1687,7,100,194,100,384,3,1179,456,1179,1303
280.195,6,26,7272,12,158,25472,267,1277,14,775,21551,2800,5995
962.594,2,8,256,8,8,137513,8,256,0,0,0,0,0
0.007,17,2,378,1,39,0,39,67,1,283,0,283,311
36.673,17,22,1672,22,48,1746,48,1672,0,0,0,0,0
0.024,17,2,350,1,39,0,39,67,1,255,0,255,283
61.729,6,59,38453,37,1144,1714,1448,30556,22,843,2928,2359,7897
116.106,1,3,382,3,99,58053,117,382,0,0,0,0,0
1786.613,6,356,22520,208,69,8630,69,12460,148,69,12153,69,10060
302.986,6,44,7858,18,143,8111,516,1870,26,247,12115,1452,5988
937.983,17,68,5440,34,48,28423,48,2584,34,56,28423,56,2856
1.943,17,2,176,2,60,1943,60,176,0,0,0,0,0
239.994,17,8,2688,8,308,34284,308,2688,0,0,0,0,0
1799.694,17,450,39960,405,35,4454,288,25740,45,288,40019,288,14220
1786.475,6,104,8444,68,66,26663,66,4964,36,60,51039,60,3480
1792.614,1,224,12544,224,28,8038,28,12544,0,0,0,0,0
1.262,6,44,15120,24,777,54,1460,9544,20,433,57,1460,5576
1.292,6,50,19203,27,885,49,1360,13507,23,433,50,1360,5696
78.412,6,31,22075,17,549,52,1360,2920,14,2322,6020,9520,19155
1008.456,2,7,224,7,8,168076,8,224,0,0,0,0,0
4.498,6,37,7189,19,218,249,314,3383,18,513,249,1179,3806
0.352,17,2,152,1,48,0,48,76,1,48,0,48,76
280.379,6,30,7432,13,158,23364,267,1317,17,603,17521,2076,6115
1792.673,1,56,4704,56,56,32594,56,4704,0,0,0,0,0
1.008,6,7,295,4,0,336,0,164,3,7,297,7,131
0.391,6,10,887,5,248,95,248,452,5,231,95,231,435
11.847,6,1879,1630782,1152,1362,10,1380,1597448,727,421,16,2760,33334
263.933,6,21,6602,5,156,65983,267,678,16,479,17586,1420,5924
3.991,17,8,480,4,32,1329,32,240,4,32,1330,32,240
179.419,6,158,51727,81,668,2242,1360,37482,77,285,2358,1360,14245
333.498,6,250,195804,158,1300,2124,1408,177303,92,571,2403,1408,18501
1.459,6,25,8056,12,164,114,267,1288,13,1014,103,2736,6768
1770.06,6,101,9410,66,66,27231,66,5610,35,60,52057,60,3800
0.0,17,1,65,1,37,0,37,65,0,0,0,0,0
1785.115,6,104,8444,68,66,26643,66,4964,36,60,51000,60,3480
0.386,6,82,53600,50,1242,7,1432,48020,32,389,11,1432,5580
1632.761,1,8,448,8,28,233251,28,448,0,0,0,0,0
17.544,17,31,12887,15,582,1251,1350,9156,16,205,1167,1350,3731
192.275,17,6,360,3,32,96136,32,180,3,32,96136,32,180
1798.388,6,366,24603,213,87,8482,469,14136,153,69,11829,69,10467
1.784,17,4,580,2,40,1459,40,136,2,194,1508,194,444
114.075,6,21,9714,12,410,54,922,1742,9,1520,14245,4416,7972
1794.583,6,361,22858,210,69,8586,69,12678,151,69,11963,69,10180
1093.643,17,755,52967,684,40,1601,41,46962,71,56,585,57,6005
1763.698,2,14,448,14,8,135669,8,448,0,0,0,0,0
11.629,6,40,26618,27,1060,447,1368,20486,13,1072,952,2736,6132
1789.044,17,83,3480,82,14,22086,14,3444,1,8,0,8,36
5.021,17,4,288,2,36,5002,36,128,2,52,5000,52,160
1720.47,17,12,498,11,14,172047,14,462,1,8,0,8,36
66.362,6,9,517,5,45,16590,45,301,4,0,22116,0,216
8.527,6,1590,1326675,870,1428,9,1448,1277919,720,776,11,1448,48756
1.074,17,14,6585,7,582,179,1350,4270,7,302,170,1350,2315
69.176,17,4,1344,4,308,23058,308,1344,0,0,0,0,0
0.94,6,13,2100,7,329,156,500,1030,6,375,188,500,1070
0.515,17,3,451,2,39,44,39,134,1,289,0,289,317
1656.089,1,7,392,7,28,276014,28,392,0,0,0,0,0
14.747,6,21,5922,10,275,1638,275,958,11,902,1205,1440,4964
1.1,2,3,120,3,16,550,16,120,0,0,0,0,0
280.06,6,30,7432,13,158,23338,267,1317,17,603,17499,2760,6115
245.512,6,74,25455,29,647,2324,1152,17348,45,349,5573,1152,8107
9.758,6,24,6702,9,156,1219,267,838,15,525,684,1460,5864
1796.377,1,342,28728,342,56,5267,56,28728,0,0,0,0,0
207.848,6,46,6307,18,132,4441,722,2134,28,150,7691,1408,4173
1673.028,2,14,448,14,8,128694,8,448,0,0,0,0,0
129.571,17,4,240,2,32,129569,32,120,2,32,129570,32,120
65.239,6,32,7653,13,155,5436,267,1306,19,398,3623,3417,6347
174.169,17,4,352,2,60,174167,60,176,2,60,174168,60,176
48.876,17,6,2016,6,308,9775,308,2016,0,0,0,0,0
6.006,17,4,724,2,41,6002,41,138,2,265,6001,265,586
0.287,17,8,2758,8,316,41,355,2758,0,0,0,0,0
3.816,17,2,204,1,34,0,34,62,1,114,0,114,142
0.5,6,9,527,5,43,125,43,311,4,0,164,0,216
3.008,6,6,340,3,0,1271,0,164,3,0,1265,0,176
477.128,1,14,784,14,28,36702,28,784,0,0,0,0,0
300.565,6,18,1227,5,177,75097,177,445,13,110,25032,110,782
1786.756,17,88,3684,86,14,21018,14,3612,2,8,1786580,8,72
1336.069,6,179,11922,82,46,9322,46,4914,97,46,13916,46,7008
14.679,6,6,328,4,0,4893,0,216,2,0,14459,0,112
240.19,6,62,20506,32,776,7747,1402,17209,30,216,8282,580,3297
0.534,17,3,451,2,39,340,39,134,1,289,0,289,317
11.825,6,25,8473,13,275,985,275,1078,12,986,851,1440,7395
1766.915,6,102,7970,66,45,27183,205,4902,36,35,50478,98,3068
318.45,6,8,548,7,106,53075,106,500,1,0,0,0,48
7.983,6,28,7834,14,214,614,721,1852,14,774,480,1414,5982
17.467,17,34,25793,16,755,1158,1350,12535,18,708,1022,1350,13258
1787.319,6,364,23047,211,69,8511,69,12787,153,69,11758,69,10260
1.528,6,59,17271,34,321,46,1360,9118,25,595,57,1360,8153
37.417,6,9,570,6,43,7483,43,406,3,0,18705,0,164
1788.91,17,142,11360,71,48,25555,48,5396,71,56,25555,56,5964
368.928,6,23,1535,16,177,24595,177,1053,7,110,10374,110,482
1.233,17,6,1674,3,32,614,32,180,3,470,614,470,1494
0.04,17,2,912,1,308,0,308,336,1,548,0,548,576
629.501,2,4,128,4,8,209833,8,128,0,0,0,0,0
0.103,2,3,96,3,8,51,8,96,0,0,0,0,0
0.028,17,2,195,1,32,0,32,60,1,107,0,107,135
1791.342,17,144,11520,72,48,25229,48,5472,72,56,25229,56,6048
20.542,17,4,352,2,60,20541,60,176,2,60,20541,60,176
44.507,6,41,11330,20,795,740,1360,5626,21,373,2217,2667,5704
0.009,17,2,410,1,50,0,50,78,1,304,0,304,332
0.726,17,4,963,2,33,714,37,123,2,392,715,463,840
1795.768,6,361,23327,211,75,8551,469,13049,150,69,12050,69,10278
0.051,17,2,912,1,308,0,308,336,1,548,0,548,576
166.639,6,15,3830,7,170,27773,210,884,8,502,6454,1408,2946
1261.187,6,109,11301,60,73,21373,722,5188,49,91,26271,1408,6113
378.725,2,4,128,4,8,126241,8,128,0,0,0,0,0
1771.688,6,103,9763,68,69,26443,233,5914,35,59,52105,82,3849
281.173,6,30,7432,13,158,23431,267,1317,17,543,17560,1400,6115
1743.558,6,95,7203,63,38,28121,205,4476,32,33,56235,98,2727
4.203,6,38,7245,19,218,233,314,3383,19,516,219,1179,3862
20.312,6,23,5533,13,107,1692,159,1126,10,966,2250,1708,4407
9.568,6,86,26397,43,559,227,1152,20179,43,449,221,1179,6218
142.873,6,24,9991,12,496,62,1360,2532,12,1161,12976,2720,7459
0.01,17,2,391,1,44,0,44,72,1,291,0,291,319
1781.944,6,355,22480,207,69,8650,69,12420,148,69,12122,69,10060
32.046,6,9,396,2,0,3390,0,88,7,0,5325,0,308
1070.038,6,66,5244,38,65,26245,65,2755,28,50,39627,59,2489
1789.321,1,288,16128,288,28,6234,28,16128,0,0,0,0,0
0.125,6,3,120,0,0,0,0,0,3,0,0,0,120
275.658,6,9,515,5,43,68914,43,299,4,0,91884,0,216
721.938,2,8,256,8,8,103134,8,256,0,0,0,0,0
0.01,17,2,308,1,34,0,34,62,1,218,0,218,246
1740.155,6,87,6322,58,31,30529,31,3915,29,31,62148,31,2407
1792.718,6,294,36783,122,140,14814,1460,17664,172,140,10482,1642,19119
8.204,1,8,832,0,0,0,0,0,8,76,1172,76,832
6.335,6,8,573,5,245,1583,245,449,3,0,2610,0,124
1785.858,6,373,23614,214,69,8384,69,13114,159,69,11302,69,10500
0.39,6,10,968,5,256,93,256,460,5,304,93,304,508
41.647,17,16,1216,16,48,2776,48,1216,0,0,0,0,0
0.049,17,3,634,2,32,0,32,120,1,486,0,486,514
1772.974,6,180,15480,120,69,14898,69,8940,60,69,30048,69,6540
0.043,17,2,144,1,36,0,36,64,1,52,0,52,80
0.059,1,2,112,2,28,59,28,112,0,0,0,0,0
40.849,17,42,6056,21,48,2041,48,1596,21,184,2041,308,4460
1.47,6,36,8178,19,321,81,1168,2722,17,529,80,4075,5456
0.891,17,6,2084,6,319,178,355,2084,0,0,0,0,0
0.216,6,35,24009,14,273,16,517,1569,21,1255,9,1448,22440
10.031,17,4,740,2,46,10020,46,148,2,268,10021,284,592
33.703,6,32,5145,15,154,2407,722,1858,17,299,2093,1408,3287
0.679,1,30,840,30,0,0,0,840,0,0,0,0,0
2.244,17,2,178,1,29,0,29,57,1,93,0,93,121
0.257,6,9,1002,5,213,64,213,417,4,421,66,421,585
220.154,17,4,352,2,60,220153,60,176,2,60,220152,60,176
153.603,17,4,352,2,60,153602,60,176,2,60,153602,60,176
1799.814,1,57,4788,0,0,0,0,0,57,56,32139,56,4788
61.255,6,45,8999,21,410,674,882,2162,24,345,2657,1360,6837
1684.517,2,15,480,15,8,120322,8,480,0,0,0,0,0
15.073,6,24,8104,13,275,1256,275,1078,11,1314,1454,1420,7026
300.641,6,38,8272,20,241,15823,619,1798,18,441,499,1440,6474
369.386,6,27,1767,18,177,21728,177,1181,9,110,8632,110,586
124.347,6,33,7757,12,155,29,267,1266,21,352,6217,1997,6491
1791.356,6,130,9357,74,70,24539,208,6125,56,31,32566,31,3232
0.028,17,2,184,1,32,0,32,60,1,96,0,96,124
1781.397,6,110,8924,70,66,25817,66,5044,40,60,45674,60,3880
0.465,17,8,2750,8,315,66,354,2750,0,0,0,0,0
11.61,6,25,9873,13,275,967,275,1078,12,1186,905,2840,8795
60.15,17,28,2355,26,30,2405,37,1515,2,392,343,463,840
0.903,6,55,14070,26,551,36,1429,4932,29,419,31,1460,9138
0.015,17,4,368,2,32,3,32,120,2,96,0,96,248
15.132,17,12,5258,6,490,3020,1350,3108,6,330,3020,1350,2150
59.442,6,987,826941,608,1342,97,1360,804231,379,209,156,1360,22710
0.251,17,2,476,1,39,0,39,67,1,381,0,381,409
61.852,6,71,48662,44,1194,1438,1448,40528,27,746,2370,1448,8134
0.143,6,3,151,2,31,1,31,111,1,0,0,0,40
1792.182,1,282,15792,282,28,6377,28,15792,0,0,0,0,0
1791.176,6,367,23167,211,69,8529,69,12787,156,69,11554,69,10380
1787.175,6,104,8444,68,66,26674,66,4964,36,60,51059,60,3480
31.11,17,36,5292,18,48,1829,48,1368,18,190,1829,308,3924
0.251,17,2,572,1,39,0,39,67,1,477,0,477,505
1786.744,6,200,47737,114,564,15811,1302,36714,86,133,21019,241,11023
1795.936,17,448,39896,403,35,4467,288,25676,45,288,40021,288,14220
0.476,6,29,7376,13,155,39,267,1301,16,603,31,2036,6075
300.626,6,38,8567,20,315,15822,882,2093,18,441,499,1440,6474
0.165,6,5,264,3,0,82,0,160,2,0,1,0,104
240.406,6,46,8603,24,449,10451,1418,5764,22,187,11446,580,2839
4.755,6,42,7389,22,218,226,314,3503,20,440,237,1152,3886
24.227,6,66,19507,38,484,654,1152,15573,28,401,829,1072,3934
1798.975,17,142,11360,71,48,25699,48,5396,71,56,25699,56,5964
6.012,6,1252,1138391,761,1417,7,1448,1108195,491,776,11,1448,30196
0.332,6,4,160,2,0,332,0,80,2,0,0,0,80
10.988,6,20,4442,11,275,1098,275,998,9,768,789,1440,3444
376.274,6,23,1499,14,177,28944,177,913,9,110,11480,110,586
1.835,6,27,8793,16,276,122,562,1474,11,859,163,1380,7319
147.493,6,22,8510,11,333,72,692,1473,11,940,14735,1460,7037
1741.507,17,29,19517,29,645,62196,645,19517,0,0,0,0,0
0.334,6,27,8963,13,237,27,590,1635,14,941,25,1408,7328
0.252,17,4,304,2,48,127,48,152,2,48,127,48,152
53.349,17,4,352,2,60,53348,60,176,2,60,53348,60,176
661.81,2,8,256,8,8,94544,8,256,0,0,0,0,0
0.075,6,10,1380,6,145,15,145,389,4,827,22,827,991
126.142,2,2,64,2,8,126142,8,64,0,0,0,0,0
4.809,6,15,2399,7,188,801,245,660,8,703,648,1152,1739
1740.465,17,29,19517,29,645,62159,645,19517,0,0,0,0,0
1791.397,1,164,17384,164,78,10990,78,17384,0,0,0,0,0
1799.54,17,776,46786,776,32,2321,37,46786,0,0,0,0,0
1.607,6,44,18074,26,885,64,1360,12578,18,476,81,2715,5496
0.084,17,2,322,1,33,0,33,61,1,233,0,233,261
0.325,6,22,4467,11,165,32,456,1394,11,498,30,888,3073
3.242,17,2,656,2,300,3242,300,656,0,0,0,0,0
0.93,6,26,10521,15,517,66,1360,3221,11,978,76,3921,7300
0.033,17,2,154,1,33,0,33,61,1,65,0,65,93
11.758,6,2071,1970929,1388,1346,8,1368,1930749,683,931,16,2841,40180
10.994,6,19,7067,7,275,1832,275,1109,12,683,679,1420,5958
0.418,6,25,7439,16,300,27,677,2745,9,721,51,1420,4694
0.344,17,2,198,1,63,0,63,91,1,79,0,79,107
13.917,6,8,506,0,0,0,0,0,8,31,1988,31,506
0.292,6,9,1002,5,213,73,213,417,4,421,87,421,585
17.453,17,43,14217,22,454,829,1350,10623,21,143,870,1350,3594
1787.903,6,363,24814,212,94,8473,469,14427,151,69,11919,69,10387
890.516,6,12,728,8,31,127216,31,444,4,31,296833,31,284
12.758,6,38,9466,21,138,637,466,1850,17,629,787,2720,7616
0.056,17,2,212,1,46,0,46,74,1,110,0,110,138
142.114,6,19,3450,6,92,135,92,412,13,235,11817,1448,3038
360.964,2,3,96,3,8,180482,8,96,0,0,0,0,0
378.769,6,22,1459,14,177,29136,177,925,8,110,9335,110,534
1797.644,17,142,11360,71,48,25680,48,5396,71,56,25680,56,5964
0.125,1,6,624,0,0,0,0,0,6,76,25,76,624
0.401,6,12,1653,6,288,76,288,548,6,426,42,434,1105
14.72,6,23,11165,12,275,1338,275,1038,11,1612,1260,2840,10127
1785.819,6,279,36673,112,151,16086,1360,17535,167,149,10757,3302,19138
280.297,6,30,7432,13,158,23358,267,1317,17,543,17514,1400,6115
292.403,1,4,326,4,53,97467,78,326,0,0,0,0,0
1794.515,17,190,43484,190,200,9494,422,43484,0,0,0,0,0
1.378,6,51,20511,30,907,47,1360,14850,21,437,59,2715,5661
2.687,6,21,6366,10,268,293,517,1333,11,744,264,1418,5033
0.531,17,2,476,1,39,0,39,67,1,381,0,381,409
1.006,6,51,13845,24,553,43,1429,4856,27,464,37,1986,8989
1773.543,6,180,15480,120,69,14903,69,8940,60,69,30054,69,6540
0.478,6,51,20918,28,969,17,1380,15756,23,383,19,1380,5162
0.135,17,2,417,1,34,0,34,62,1,327,0,327,355
11.177,6,11,1420,4,299,3720,299,515,7,175,1860,459,905
0.358,6,10,968,5,256,87,256,460,5,304,87,304,508
1.736,6,13,2311,8,188,248,245,700,5,1407,366,1407,1611
41.53,17,44,6468,22,48,1977,48,1672,22,190,1977,308,4796
11.955,6,104,33307,52,601,234,1152,26729,52,408,229,1152,6578
2.655,6,20,6300,9,262,326,517,1264,11,744,260,1418,5036
84.194,17,4,288,2,36,84162,36,128,2,52,84146,52,160
1.227,6,11,1003,6,332,245,332,652,5,83,302,83,351
0.337,6,9,1340,5,145,84,145,349,4,827,76,827,991
241.26,6,49,12342,25,638,10051,1368,9623,24,175,10487,580,2719
40.734,17,44,6468,22,48,1939,48,1672,22,190,1939,308,4796
148.627,6,25,10208,12,549,69,1360,2709,13,995,12374,1360,7499
415.649,6,75,11779,36,104,11875,267,3321,39,202,10933,1452,8458
628.551,1,32,3328,0,0,0,0,0,32,76,20275,76,3328
62.64,1,4,224,4,28,20880,28,224,0,0,0,0,0
1740.025,17,28,1596,28,29,64445,29,1596,0,0,0,0,0
4.032,1,5,420,5,56,1008,56,420,0,0,0,0,0
0.15,17,2,574,1,32,0,32,60,1,486,0,486,514
70.275,6,25,7599,14,321,5405,517,1463,11,793,6783,4096,6136
0.379,17,4,352,2,37,372,37,130,2,83,372,89,222
0.039,17,2,489,1,34,0,34,62,1,399,0,399,427
251.929,2,3,96,3,8,125964,8,96,0,0,0,0,0
0.058,17,2,187,1,45,0,45,73,1,86,0,86,114
1740.233,6,87,6322,58,31,30530,31,3915,29,31,62150,31,2407
0.323,6,20,7238,12,335,28,668,1974,8,1210,45,1906,5264
0.071,17,2,167,1,39,0,39,67,1,72,0,72,100
0.978,6,29,12012,16,525,65,1360,3298,13,909,66,1380,8714
1783.748,6,346,31472,196,75,9147,267,12910,150,165,11971,1452,18562
0.103,17,2,196,1,62,0,62,90,1,78,0,78,106
1.574,6,41,10061,23,440,71,1360,4520,18,437,80,2715,5541
1799.12,1,70,5880,0,0,0,0,0,70,56,26074,56,5880
155.013,6,23,9741,12,430,89,1360,2234,11,1411,15483,3639,7507
17.345,17,24,16645,10,571,1922,1350,5993,14,732,1331,1350,10652
60.802,6,27,15087,17,827,3800,1408,5892,10,1238,6747,2816,9195
6.913,6,153,104359,85,1049,82,1460,44363,68,1244,101,1621,59996
10.564,6,20,4442,11,275,1056,275,998,9,768,724,1440,3444
2.057,17,6,460,3,40,998,41,206,3,56,1020,57,254
1765.384,6,383,24290,215,69,8249,69,13361,168,69,10571,69,10929
64.055,1,2,340,2,142,64055,142,340,0,0,0,0,0
1797.542,6,391,27631,222,101,8133,469,16317,169,69,10697,69,11314
1797.078,17,240,138000,1,308,0,308,336,239,548,7550,548,137664
0.061,17,2,2380,2,1162,61,1162,2380,0,0,0,0,0
240.163,6,53,17827,28,801,8894,1408,15082,25,179,10006,580,2745
1.657,6,36,8902,19,150,75,380,1706,17,650,76,2920,7196
2.075,6,24,6208,13,264,172,662,1848,11,783,206,1420,4360
7.66,6,15,2309,8,211,1093,211,858,7,545,1276,904,1451
1626.642,1,18,1008,18,28,95684,28,1008,0,0,0,0,0
364.771,2,3,96,3,8,182385,8,96,0,0,0,0,0
1799.917,6,364,24992,212,94,8530,469,14496,152,69,11919,69,10496
0.078,17,2,304,1,60,0,60,88,1,188,0,188,216
335.446,6,11,866,6,180,67054,180,500,5,110,83818,110,366
1770.754,6,99,9306,66,66,27242,66,5610,33,60,55333,60,3696
1739.808,1,62,3472,62,28,28521,28,3472,0,0,0,0,0
280.469,6,28,7352,12,158,25497,267,1277,16,678,18693,2085,6075
281.387,1,4,224,4,28,93795,28,224,0,0,0,0,0
2.32,17,29,10007,14,316,176,1350,4826,15,317,163,1350,5181
1772.374,6,180,15480,120,69,14893,69,8940,60,69,30035,69,6540
1778.962,17,142,11360,71,48,25413,48,5396,71,56,25413,56,5964
899.685,6,12,728,8,31,128526,31,444,4,31,299825,31,284
1.354,6,51,19726,29,915,48,1460,14025,22,400,56,1460,5701
1.167,17,4,296,3,30,582,30,174,1,94,0,94,122
8.381,6,1549,1470972,988,1412,8,1448,1437124,561,776,14,1448,33848
31.95,6,9,396,2,0,3483,0,88,7,0,5310,0,308
3.051,6,14,2606,7,188,508,245,660,7,554,415,1152,1946
1741.366,17,30,6930,30,203,60047,203,6930,0,0,0,0,0
0.129,17,4,680,2,33,0,33,122,2,251,120,323,558
1792.291,1,342,28728,342,56,5255,56,28728,0,0,0,0,0
127.655,17,12,960,6,48,25529,48,456,6,56,25529,56,504
117.947,2,2,64,2,8,117947,8,64,0,0,0,0,0
0.498,6,28,7336,13,155,41,267,1301,15,543,33,1400,6035
1793.037,17,142,11360,71,48,25614,48,5396,71,56,25614,56,5964
1795.348,17,447,39864,402,35,4477,288,25644,45,288,40019,288,14220
11.783,6,1906,1627888,1148,1363,10,1380,1591403,758,558,15,1923,36485
0.507,6,10,968,5,256,114,256,460,5,304,120,304,508
1787.393,6,102,8296,68,65,26677,65,4930,34,59,54159,59,3366
90.481,2,10,448,10,20,10053,32,448,0,0,0,0,0
1772.453,6,180,15480,120,69,14894,69,8940,60,69,30038,69,6540
96.781,6,36,7951,13,155,8065,267,1306,23,317,4392,1420,6645
840.734,17,8,592,4,30,280239,30,232,4,62,280240,62,360
0.302,17,12,6332,6,614,60,1350,3857,6,384,38,1350,2475
6.361,17,4,240,2,32,6360,32,120,2,32,6360,32,120
1.642,6,50,17917,28,850,60,1460,12216,22,400,69,1460,5701
87.699,6,16,664,6,0,7466,0,244,10,0,9743,0,420
27.96,6,47,13025,23,182,1270,721,2569,24,730,1206,2840,10456
35.397,17,10,760,10,48,3933,48,760,0,0,0,0,0
1.39,6,47,18160,26,882,55,1360,12544,21,433,60,1360,5616
1796.576,17,448,39896,403,35,4469,288,25676,45,288,40020,288,14220
1773.35,6,180,15480,120,69,14902,69,8940,60,69,30052,69,6540
171.301,17,8,2688,8,308,24471,308,2688,0,0,0,0,0
281.349,6,30,7432,14,158,21642,267,1357,16,603,18744,2036,6075
336.132,6,89,12236,48,304,7151,304,8364,41,83,8402,83,3872
1795.067,17,448,39896,403,35,4465,288,25676,45,288,40024,288,14220
1786.722,6,102,8364,68,66,26667,66,4964,34,60,54140,60,3400
1741.714,6,87,6322,58,31,30556,31,3915,29,31,62203,31,2407
1.289,6,49,20441,28,911,47,1360,14825,21,476,55,2715,5616
0.376,6,20,7151,13,318,31,600,1958,7,1205,58,1851,5193
0.046,6,10,1174,6,160,9,160,480,4,478,12,478,694
59.437,6,156,63732,77,770,782,1152,56985,79,398,758,1179,6747
0.01,6,10,1514,5,503,2,503,771,5,475,2,475,743
227.69,17,4,352,2,60,227689,60,176,2,60,227689,60,176
1793.462,6,368,23276,212,69,8499,69,12896,156,69,11569,69,10380
0.3,6,6,897,3,483,75,483,639,3,102,76,102,258
1797.556,17,449,39928,404,35,4460,288,25708,45,288,40022,288,14220
0.07,17,2,201,1,50,0,50,78,1,95,0,95,123
1.352,6,27,8945,14,288,104,796,1747,13,952,94,1460,7198
1791.987,6,381,24141,216,69,8334,69,13401,165,69,10926,69,10740
6.049,6,41,7349,21,218,302,314,3463,20,513,302,1179,3886
11.841,6,1881,1636416,1137,1385,10,1420,1602423,744,467,15,1883,33993
0.519,17,2,152,1,48,0,48,76,1,48,0,48,76
9.892,17,4,5484,4,1343,3297,1348,5484,0,0,0,0,0
11.806,6,25,8473,13,275,983,275,1078,12,986,848,1440,7395
0.0,17,1,1071,1,1043,0,1043,1071,0,0,0,0,0
1740.786,17,30,31680,30,1028,60027,1028,31680,0,0,0,0,0
0.01,6,11,913,6,182,2,182,490,5,77,2,134,423
6.43,6,43,8329,21,227,321,314,4022,22,489,293,1179,4307
0.036,6,10,1512,5,503,9,503,771,5,473,8,473,741
300.583,6,11,863,6,177,60081,177,497,5,110,75099,110,366
1784.835,1,58,4872,58,56,31312,56,4872,0,0,0,0,0
0.191,6,4,529,2,259,191,259,339,2,110,4,110,190
0.421,6,28,7336,13,155,35,267,1301,15,543,25,1400,6035
1792.409,6,376,23803,214,69,8415,69,13183,162,69,11132,69,10620
166.032,6,33,26075,18,745,40,1360,3734,15,2414,11851,6085,22341
1798.722,17,144,11624,72,49,25334,136,5560,72,56,25334,72,6064
1.207,6,24,8004,12,164,93,267,1288,12,1014,93,2804,6716
1774.203,1,8,448,8,28,253457,28,448,0,0,0,0,0
180.609,2,2,64,2,8,180609,8,64,0,0,0,0,0
0.466,6,4,1037,2,0,221,0,104,2,853,250,853,933
11.687,6,1852,1605612,1123,1374,10,1420,1572231,729,467,16,1883,33381
5.325,6,75,68986,47,184,115,309,3408,28,2564,196,8448,65578
0.439,6,25,7711,16,339,29,949,3017,9,721,52,1420,4694
240.276,6,52,19059,27,872,9241,1418,16243,25,188,10011,580,2816
1797.331,1,224,12544,224,28,8059,28,12544,0,0,0,0,0
11.191,6,1789,1547794,1086,1371,10,1420,1515453,703,467,15,1883,32341
9.907,6,82,24485,43,550,235,1152,18784,39,459,253,1179,5701
0.853,6,10,1687,7,100,142,100,384,3,1179,295,1179,1303
1740.696,17,30,6930,30,203,60024,203,6930,0,0,0,0,0
1798.184,6,376,26217,217,98,8324,469,15372,159,69,11380,69,10845
1771.955,6,180,15480,120,69,14890,69,8940,60,69,30031,69,6540
1772.397,6,180,15480,120,69,14894,69,8940,60,69,30034,69,6540
2.771,17,2,677,1,300,0,300,328,1,321,0,321,349
214.752,6,28,12929,15,824,5172,1308,4753,13,849,17880,1360,8176
1.55,6,52,19405,29,887,55,1360,13664,23,437,61,2715,5741
1796.21,17,448,39896,403,35,4468,288,25676,45,288,40015,288,14220
376.603,6,22,1447,14,177,28969,177,913,8,110,11887,110,534
0.822,17,3,1167,3,361,411,361,1167,0,0,0,0,0
0.683,17,3,228,1,48,0,48,76,2,48,393,48,152
3.707,6,2,88,2,0,0,0,88,0,0,0,0,0
37.441,17,22,1936,11,48,3743,48,836,11,72,3743,72,1100
0.551,17,3,451,2,39,265,39,134,1,289,0,289,317
1795.108,6,360,22887,208,69,8672,69,12529,152,69,11888,69,10358
8.255,6,70,20766,37,538,229,1152,16019,33,489,249,1179,4747
68.366,6,35,19632,19,702,41,1360,5043,16,1267,4549,4887,14589
9.955,6,28,7217,13,155,829,267,1306,15,482,710,1997,5911
162.991,6,21,9714,12,410,52,922,1742,9,1520,20358,4416,7972
64.428,6,17,700,8,0,7062,0,328,9,0,8052,0,372
6.709,6,709,610636,431,1339,15,1368,589136,278,776,23,1473,21500
373.409,6,18,1242,14,180,28723,180,916,4,110,20070,110,326
0.302,6,26,7256,13,155,25,267,1301,13,603,24,2036,5955
31.198,17,9,684,9,48,3899,48,684,0,0,0,0,0
7.263,6,48,8870,25,227,302,314,4182,23,470,317,1179,4688
1793.024,17,66,2766,65,14,28016,14,2730,1,8,0,8,36
1.058,6,4,184,2,0,1058,0,88,2,0,1031,0,96
42.562,17,12,912,12,48,3869,48,912,0,0,0,0,0
3.87,17,4,352,2,48,3859,48,152,2,72,3859,72,200
1786.458,6,102,8364,68,66,26663,66,4964,34,60,54132,60,3400
1798.191,1,327,27468,327,56,5515,56,27468,0,0,0,0,0
0.802,6,26,5887,13,156,66,267,1462,13,650,60,1420,4425
4.31,17,4,352,2,48,4287,48,152,2,72,4283,72,200
112.012,6,28,12800,13,549,65,1460,2761,15,1047,7991,1460,10039
301.129,6,45,13677,23,750,13680,1360,7704,22,338,14331,2667,5973
7.221,6,1438,1291778,887,1377,7,1408,1258462,551,776,12,1408,33316
1797.244,17,448,39896,403,35,4470,288,25676,45,288,40022,288,14220
1786.639,6,106,8524,68,66,26666,66,4964,38,60,48285,60,3560
1786.157,6,291,36749,119,147,15135,1440,17550,172,139,10444,1440,19199
29.983,6,9,488,5,0,7495,0,280,4,0,2349,0,208
1520.723,6,108,10970,69,57,22363,722,5670,39,105,35276,2026,5300
1789.636,1,168,9408,168,28,10716,28,9408,0,0,0,0,0
21.52,17,39,8216,16,255,1432,1350,4529,23,132,976,1350,3687
282.862,2,4,128,4,8,94287,8,128,0,0,0,0,0
1798.124,17,448,39896,403,35,4472,288,25676,45,288,40022,288,14220
369.742,6,30,2700,16,184,24649,184,856,14,424,4128,434,1844
1772.202,6,180,15480,120,69,14892,69,8940,60,69,30033,69,6540
0.112,17,2,164,1,46,0,46,74,1,62,0,62,90
0.367,17,8,2774,8,318,52,357,2774,0,0,0,0,0
2.925,17,4,580,2,40,2147,40,136,2,194,1991,194,444
1793.33,1,194,10864,194,28,9291,28,10864,0,0,0,0,0
3.647,17,5,295,5,31,911,31,295,0,0,0,0,0
0.005,17,3,442,2,32,0,32,120,1,294,0,294,322
1796.441,6,367,25650,214,99,8433,469,15045,153,69,11816,69,10605
1795.55,17,447,39864,402,35,4477,288,25644,45,288,40019,288,14220
1666.979,1,7,392,7,28,277829,28,392,0,0,0,0,0
4.796,17,5,320,5,36,1199,36,320,0,0,0,0,0
240.372,6,60,20168,32,856,7753,1418,17101,28,178,8901,580,3067
1684.811,17,14,1036,7,30,280796,30,406,7,62,280796,62,630
85.284,6,40,9445,18,290,1823,1189,2764,22,445,4059,1917,6681
0.06,17,2,904,1,300,0,300,328,1,548,0,548,576
71.32,6,57,20738,26,724,2842,869,17714,31,296,2368,1179,3024
30.082,6,41,9552,21,330,1504,721,3164,20,619,1560,1414,6388
0.133,17,8,2758,8,316,19,355,2758,0,0,0,0,0
1786.207,6,356,22520,208,69,8629,69,12460,148,69,12150,69,10060
35.745,17,20,1520,20,48,1881,48,1520,0,0,0,0,0
58.84,6,18,5975,9,290,7355,517,1069,9,884,6459,1408,4906
0.521,6,51,20557,28,949,19,1380,15395,23,421,21,1923,5162
2.761,6,12,1163,6,222,550,222,688,6,231,550,231,475
246.093,6,28,7352,13,158,20507,267,1317,15,603,17577,2036,6035
23.326,6,35,8176,17,188,1457,722,2003,18,681,1359,2760,6173
118.155,6,31,13264,15,489,343,1440,3080,16,953,7867,1440,10184
7.446,6,1632,1413259,922,1437,7,1448,1363175,710,776,10,1448,50084
13.082,6,6,1257,4,327,4360,414,815,2,181,12884,270,442
27.876,6,36,8308,16,188,1858,721,1962,20,503,1435,2840,6346
0.036,17,2,904,1,300,0,300,328,1,548,0,548,576
33.314,6,30,5055,15,180,2366,722,1871,15,342,2366,1440,3184
907.404,17,636,44796,565,40,1608,41,38791,71,56,625,57,6005
94.892,6,39,6385,17,206,255,314,2744,22,551,4506,1179,3641
1740.51,1,15,870,15,30,124322,30,870,0,0,0,0,0
0.464,6,12,1653,6,288,87,288,548,6,426,55,434,1105
67.283,6,30,8872,13,158,5606,267,1317,17,687,4197,1400,7555
39.264,17,183,92339,76,371,523,1350,30356,107,551,369,1350,61983
1785.469,6,102,8228,68,64,26648,64,4896,34,58,54102,58,3332
280.407,6,26,7272,12,158,25491,267,1277,14,678,21567,2085,5995
1786.68,6,356,22520,208,69,8631,69,12460,148,69,12154,69,10060
1.744,6,14,2351,8,188,249,245,700,6,703,295,1152,1651
145.109,6,151,23940,83,304,1769,304,16616,68,83,2143,83,7324
0.077,6,2,355,2,275,77,275,355,0,0,0,0,0
0.79,6,27,5740,13,125,65,267,1275,14,650,56,1420,4465
270.054,1,4,224,4,28,90018,28,224,0,0,0,0,0
1.59,2,3,96,3,8,795,8,96,0,0,0,0,0
12.992,17,2,908,2,426,12992,687,908,0,0,0,0,0
1794.925,17,80,3354,79,14,23011,14,3318,1,8,0,8,36
320.217,6,717,552160,408,1423,786,1460,531685,309,188,92,1460,20475
960.427,17,75,5996,38,48,25953,48,2888,37,56,26676,56,3108
2.455,17,2,476,1,39,0,39,67,1,381,0,381,409
472.01,6,21,6522,3,106,86565,106,234,18,370,27764,1420,6288
1772.767,6,181,15589,120,69,14897,69,8940,61,69,29538,69,6649
300.374,6,53,35210,34,1194,9102,1408,29246,19,828,1442,1491,5964
280.373,6,28,7352,12,158,25488,267,1277,16,603,18686,1400,6075
1.455,6,48,19615,27,920,55,1360,13999,21,476,63,2715,5616
1794.963,1,202,21412,202,78,8930,78,21412,0,0,0,0,0
1774.519,1,58,4872,58,56,31131,56,4872,0,0,0,0,0
31.989,6,9,396,2,0,3479,0,88,7,0,5318,0,308
0.265,17,3,451,2,39,173,39,134,1,289,0,289,317
1773.168,6,180,15480,120,69,14900,69,8940,60,69,30045,69,6540
1771.594,6,101,9410,66,66,27255,66,5610,35,60,52103,60,3800
0.77,6,10,1687,7,100,128,100,384,3,1179,259,1179,1303
0.417,6,14,1733,7,288,65,288,588,7,284,37,434,1145
1786.885,6,355,22480,207,69,8674,69,12420,148,69,12155,69,10060
300.812,6,31,8281,14,204,23139,467,1552,17,416,6700,1402,6729
594.002,1,11,1475,11,106,59400,320,1475,0,0,0,0,0
75.561,6,14,580,7,0,12593,0,284,7,0,12586,0,296
423.372,2,3,96,3,8,211686,8,96,0,0,0,0,0
0.177,6,2,1500,1,1408,0,1408,1460,1,0,0,0,40
0.009,17,3,853,1,137,0,137,165,2,316,4,316,688
152.183,6,31,8912,14,158,11706,267,1357,17,687,9507,2036,7555
0.49,17,2,384,1,39,0,39,67,1,289,0,289,317
1772.323,6,180,15480,120,69,14893,69,8940,60,69,30033,69,6540
1.098,6,46,11239,28,147,40,615,3546,18,773,53,2720,7693
906.73,17,180,13680,180,48,5065,48,13680,0,0,0,0,0
1.291,17,2,154,1,33,0,33,61,1,65,0,65,93
1767.261,1,47,3948,47,56,38418,56,3948,0,0,0,0,0
1737.128,1,56,4704,56,56,31584,56,4704,0,0,0,0,0
0.916,6,171,123426,98,1313,9,1432,114344,73,559,12,1871,9082
152.776,17,4,352,2,60,152775,60,176,2,60,152775,60,176
154.25,17,72,12064,36,205,4407,1350,8420,36,73,4405,1350,3644
333.98,6,98,74000,65,1239,5218,1408,64147,33,739,2534,2439,9853
371.162,6,27,1767,18,177,21833,177,1181,9,110,9253,110,586
0.035,1,4,416,0,0,0,0,0,4,76,11,76,416
0.329,6,20,7238,12,335,29,668,1974,8,1210,46,1906,5264
280.422,6,29,7392,13,158,23368,267,1317,16,678,18691,3456,6075
41.091,17,22,1672,22,48,1956,48,1672,0,0,0,0,0
81.113,6,58,35755,36,1129,2317,1448,27857,22,749,2991,1448,7898
75.152,1,3,168,3,28,37576,28,168,0,0,0,0,0
1.912,6,28,11320,13,265,159,764,1795,15,873,135,1418,9525
23.961,6,33,8819,15,340,1711,722,2646,18,605,1396,1380,6173
1082.898,2,12,384,12,8,98445,8,384,0,0,0,0,0
1789.307,1,113,6328,113,28,15975,28,6328,0,0,0,0,0
0.475,17,4,240,2,32,474,32,120,2,32,474,32,120
1774.499,6,243,33486,151,154,11829,965,17805,92,139,19496,1420,15681
909.444,17,76,6488,76,57,12125,355,6488,0,0,0,0,0
2.584,17,29,13125,13,517,215,1350,7091,16,349,125,1350,6034
0.062,17,2,412,1,48,0,48,76,1,308,0,308,336
1740.069,6,87,6322,58,31,30527,31,3915,29,31,62145,31,2407
1741.29,1,15,840,15,28,124377,28,840,0,0,0,0,0
1744.641,2,27,864,27,8,67101,8,864,0,0,0,0,0
1760.637,1,8,848,8,78,251519,78,848,0,0,0,0,0
7.917,6,20,9218,8,275,1131,275,603,12,1015,698,1380,8615
0.513,6,12,1653,6,288,98,288,548,6,426,55,434,1105
1798.007,1,58,4872,58,56,31543,56,4872,0,0,0,0,0
9.415,6,1623,1524075,1023,1412,9,1448,1488211,600,776,15,1448,35864
483.907,17,10,2443,5,32,120975,37,304,5,399,120975,463,2139
913.92,6,122,18362,74,302,12519,302,13210,48,83,19435,83,5152
1700.477,17,12,498,11,14,170047,14,462,1,8,0,8,36
1795.649,6,356,22520,208,69,8674,69,12460,148,69,12214,69,10060
599.513,6,9,546,6,31,119902,31,333,3,31,299669,31,213
369.926,6,27,1767,18,177,21760,177,1181,9,110,8828,110,586
24.568,6,34,8970,16,303,1637,721,2766,18,608,1419,1440,6204
2.129,6,27,10179,16,285,141,587,1499,11,1029,195,1420,8680
4.829,6,39,7285,20,218,254,314,3423,19,516,253,1179,3862
0.353,6,27,9093,13,252,29,646,1694,14,832,25,1438,7399
599.323,1,16,896,16,28,39954,28,896,0,0,0,0,0
1791.511,1,234,24804,234,78,7688,78,24804,0,0,0,0,0
1787.443,6,131,8481,70,51,25901,208,5049,61,31,29787,31,3432
1.611,6,45,18080,26,882,64,1360,12544,19,476,77,2715,5536
8.135,6,77,24605,40,560,208,1152,18968,37,461,218,1179,5637
1795.734,6,482,30457,260,98,6933,469,17092,222,34,8125,64,13365
1744.069,6,97,7307,63,38,28130,205,4476,34,33,52843,98,2831
1.022,6,23,6510,13,333,84,1004,2190,10,979,112,1699,4320
2.764,6,13,3086,7,92,460,92,452,6,579,51,1448,2634
1108.144,1,82,4592,82,28,13680,28,4592,0,0,0,0,0
1.602,6,51,19473,29,897,57,1360,13772,22,400,66,1360,5701
1787.901,6,362,24774,211,94,8513,469,14387,151,69,11919,69,10387
1786.413,6,104,8376,68,65,26662,65,4930,36,59,51037,59,3446
0.193,6,28,7336,13,155,16,267,1301,15,543,13,1400,6035
1793.944,17,66,2766,65,14,28030,14,2730,1,8,0,8,36
24.641,17,4,352,2,60,24640,60,176,2,60,24640,60,176
1740.763,17,30,7050,30,207,60026,207,7050,0,0,0,0,0
81.985,6,720,336585,378,831,217,1152,317059,342,417,239,1179,19526
270.788,1,4,367,4,63,90262,88,367,0,0,0,0,0
1791.395,1,232,12992,232,28,7754,28,12992,0,0,0,0,0
1.39,6,51,20054,27,943,53,1460,14318,24,476,52,2615,5736
1.343,6,51,13813,24,549,58,1429,4824,27,464,45,1986,8989
15.182,17,25,13020,13,740,1262,1350,9996,12,224,1377,1350,3024
7.971,6,18,6871,9,275,996,275,643,9,1171,641,1440,6228
0.171,6,50,23571,28,1082,6,1420,18458,22,467,7,1883,5113
6.975,17,2,768,2,356,6975,356,768,0,0,0,0,0
3.406,17,5,340,5,40,851,40,340,0,0,0,0,0
1733.607,6,109,8601,70,65,25124,65,4945,39,58,45618,59,3656
1775.237,6,180,15480,120,69,14917,69,8940,60,69,30079,69,6540
115.626,6,21,2493,6,242,22,517,1059,15,323,8258,499,1434
1769.617,6,101,9410,66,66,27224,66,5610,35,60,52045,60,3800
0.284,17,8,2750,8,315,40,354,2750,0,0,0,0,0
43.805,6,34,9136,14,327,94,1189,2535,20,445,2305,1997,6601
283.276,6,28,7352,12,158,25752,267,1277,16,603,18872,1400,6075
268.377,17,6,3907,6,623,53675,861,3907,0,0,0,0,0
1752.875,1,88,9328,88,78,20147,78,9328,0,0,0,0,0
1772.501,6,202,22250,129,75,13847,267,10017,73,134,24616,1460,12233
0.409,6,25,6116,12,181,37,537,1526,13,558,31,1448,4590
240.186,6,52,17900,27,804,9237,1402,15085,25,188,10007,580,2815
1786.96,6,102,8296,68,65,26671,65,4930,34,59,54146,59,3366
1796.298,17,262,54596,262,180,6882,422,54596,0,0,0,0,0
0.59,6,137,91409,75,1303,7,1420,81326,62,632,9,3303,10083
0.226,17,4,420,2,33,0,33,122,2,121,1,145,298
1799.252,6,362,23399,211,75,8567,501,13150,151,69,11994,69,10249
339.757,6,83,13941,33,251,10617,1189,5105,50,235,6933,1420,8836
0.291,6,2,92,1,0,0,0,52,1,0,0,0,40
1.253,6,24,8004,12,164,96,267,1288,12,1014,96,2331,6716
0.048,6,10,1327,5,299,11,299,567,5,246,10,459,760
0.421,6,51,22573,29,1019,15,1380,15528,22,558,17,1923,7045
2.643,6,2,88,2,0,0,0,88,0,0,0,0,0
0.556,17,2,782,2,363,556,363,782,0,0,0,0,0
4.739,6,39,7269,20,218,249,314,3423,19,513,248,1179,3846
0.05,17,4,352,2,37,1,37,130,2,83,2,89,222
0.024,17,2,192,1,37,0,37,65,1,99,0,99,127
102.401,6,46,10064,22,635,979,1360,4147,24,309,4444,2667,5917
317.061,6,59,18200,36,354,9058,1360,9621,23,695,14404,4649,8579
3.263,6,13,547,7,0,543,0,288,6,7,612,7,259
240.301,6,43,9154,21,523,12014,1418,5815,22,243,11442,617,3339
1.617,17,24,6374,11,293,158,1350,3540,13,190,131,1350,2834
0.904,6,12,1172,6,222,179,222,466,6,231,178,231,706
1.508,6,43,10240,22,440,71,1360,4469,21,409,66,1360,5771
1786.296,6,98,7421,65,38,27910,205,4611,33,33,55815,98,2810
1772.422,6,182,15629,121,69,14770,69,8980,61,69,29532,69,6649
280.227,6,26,7272,12,158,25475,267,1277,14,775,21550,3445,5995
300.303,6,45,28375,28,1153,11122,1440,21088,17,913,1683,1440,7287
305.038,6,33,6986,15,169,11616,516,1618,18,309,17937,1452,5368
53.057,6,27,11513,15,692,3789,1408,4273,12,1101,4822,1578,7240
4.417,6,10,1102,6,483,883,483,803,4,83,1449,83,299
1752.002,6,97,7307,63,38,28258,205,4476,34,33,53080,98,2831
1744.667,2,28,896,28,8,64617,8,896,0,0,0,0,0
0.063,17,4,352,2,37,0,37,130,2,83,1,89,222
0.254,6,24,5962,12,164,23,453,1442,12,648,21,1448,4520
1680.918,1,15,840,15,28,120065,28,840,0,0,0,0,0
0.45,6,4,208,1,0,0,0,52,3,0,225,0,156
1660.615,1,7,392,7,28,276769,28,392,0,0,0,0,0
74.214,1,5,530,5,78,18553,78,530,0,0,0,0,0
0.267,17,8,2758,8,316,38,355,2758,0,0,0,0,0
0.088,17,2,198,1,39,0,39,67,1,103,0,103,131
16.344,17,22,5652,11,277,1630,1350,3363,11,180,1630,1350,2289
27.257,6,36,8375,18,184,1603,722,2202,18,778,1590,2760,6173
599.076,6,9,546,6,31,119815,31,333,3,31,299526,31,213
242.688,6,35,3647,16,193,16178,585,1648,19,165,13482,580,1999
282.126,17,24,1920,12,48,25647,48,912,12,56,25647,56,1008
1781.765,6,357,22629,208,69,8607,69,12460,149,69,12038,69,10169
1778.175,17,142,11360,71,48,25402,48,5396,71,56,25402,56,5964
7.88,17,6,456,6,48,1576,48,456,0,0,0,0,0
1795.706,1,292,16352,292,28,6170,28,16352,0,0,0,0,0
1787.227,6,102,8296,68,65,26675,65,4930,34,59,54155,59,3366
0.793,6,10,1687,7,100,132,100,384,3,1179,267,1179,1303
1785.981,6,104,8376,68,65,26656,65,4930,36,59,51025,59,3446
33.719,6,33,5212,16,154,2236,722,1924,17,342,2096,1448,3288
1786.72,6,106,8515,69,65,26275,65,4970,37,59,49628,59,3545
0.187,6,9,1002,5,213,46,213,417,4,421,48,421,585
1783.805,6,389,33267,226,151,7928,1189,19630,163,97,11011,485,13637
1741.88,17,30,7050,30,207,60064,207,7050,0,0,0,0,0
371.984,6,25,1651,17,177,23249,177,1117,8,110,9252,110,534
1786.701,6,177,32596,107,306,16855,1287,19915,70,182,25893,1420,12681
1744.694,2,26,832,26,8,69787,8,832,0,0,0,0,0
0.421,6,24,7525,14,335,32,668,2090,10,981,45,2816,5435
83.423,1,66,6864,0,0,0,0,0,66,76,1283,76,6864
21.24,6,30,8872,14,158,1633,267,1357,16,763,1413,1781,7515
0.497,17,3,451,2,39,423,39,134,1,289,0,289,317
0.453,6,12,1653,6,288,84,288,548,6,426,48,434,1105
1.12,6,24,8004,12,164,86,267,1288,12,1014,86,2816,6716
251.912,2,3,96,3,8,125956,8,96,0,0,0,0,0
5.827,6,10,427,5,0,1456,0,208,5,7,714,7,219
1762.574,1,56,4704,56,56,32046,56,4704,0,0,0,0,0
1786.366,6,370,23425,213,69,8426,69,13005,157,69,11450,69,10420
0.165,1,2,112,2,28,165,28,112,0,0,0,0,0
1774.786,6,180,15480,120,69,14914,69,8940,60,69,30078,69,6540
53.289,17,4,352,2,60,53288,60,176,2,60,53288,60,176
0.65,17,4,624,2,64,649,64,184,2,192,534,192,440
7.38,17,6,528,3,48,3683,48,228,3,72,3683,72,300
29.998,6,105,22553,52,357,588,1440,12482,53,328,560,1702,10071
281.164,6,29,7530,13,158,23430,267,1317,16,618,18710,4836,6213
69.499,6,21,7979,11,525,83,1237,2048,10,919,7703,1591,5931
1.012,17,2,925,1,548,0,548,576,1,321,0,321,349
4.684,17,2,668,2,306,4684,306,668,0,0,0,0,0
1.571,6,26,8108,13,164,107,267,1340,13,869,109,1448,6768
8.133,6,16,1036,9,92,1016,92,564,7,92,1120,92,472
280.497,6,27,7312,12,158,25499,267,1277,15,678,20031,2045,6035
84.585,6,14,1031,4,177,155,177,393,10,110,9374,110,638
0.315,17,2,204,1,34,0,34,62,1,114,0,114,142
1775.36,1,58,4872,0,0,0,0,0,58,56,31146,56,4872
1009.06,6,49,2588,25,26,42042,26,1326,24,26,43870,26,1262
0.15,6,46,21868,27,1052,5,1420,16887,19,467,7,1883,4981
1774.485,6,182,15629,121,69,14787,69,8980,61,69,29573,69,6649
15.308,17,23,9106,11,521,1526,1350,6041,12,227,1387,1350,3065
1786.506,6,102,8364,68,66,26664,66,4964,34,60,54133,60,3400
60.198,2,2,64,2,8,60198,8,64,0,0,0,0,0
240.341,6,44,8901,23,523,10924,1408,5914,21,209,12016,618,2987
0.53,17,2,672,2,308,530,308,672,0,0,0,0,0
456.558,6,100,15220,46,102,10145,267,4204,54,239,8613,1420,11016
1773.563,6,117,13825,76,88,23647,485,7217,41,120,44336,1440,6608
300.543,6,71,53446,46,1243,6678,1368,47170,25,709,2053,1368,6276
70.514,6,13,1466,8,304,10073,304,1032,5,83,17625,83,434
1786.916,6,356,22520,208,69,8632,69,12460,148,69,12155,69,10060
0.511,17,2,152,1,48,0,48,76,1,48,0,48,76
172.538,2,2,64,2,8,172538,8,64,0,0,0,0,0
0.633,17,2,778,2,361,633,361,778,0,0,0,0,0
1741.378,6,95,6867,61,31,29022,31,4145,34,31,52768,31,2722
1774.285,6,186,15996,122,69,14663,69,9020,64,69,28162,69,6976
1788.773,6,489,41891,258,118,6960,1189,22227,231,128,7776,1460,19664
1798.744,6,356,22520,208,69,8689,69,12460,148,69,12236,69,10060
1786.43,6,362,22898,210,69,8547,69,12678,152,69,11830,69,10220
1785.231,17,87,3648,86,14,21002,14,3612,1,8,0,8,36
0.028,17,2,383,1,33,0,33,61,1,294,0,294,322
33.804,6,49,10726,24,727,670,1360,4724,25,277,1400,1360,6002
1.316,6,38,9848,20,502,69,1440,4352,18,433,67,1440,5496
1786.236,6,361,24196,211,88,8505,469,13918,150,69,11986,69,10278
11.809,6,1865,1631058,1128,1392,10,1420,1597357,737,467,16,1883,33701
1.464,6,51,19353,29,889,52,1460,13652,22,400,60,1460,5701
1740.629,17,25,5775,25,203,72526,203,5775,0,0,0,0,0
10.927,6,767,666425,481,1314,22,1368,646889,286,776,37,1473,19536
1770.393,6,108,9934,70,64,25657,64,5904,38,58,47846,58,4030
0.031,17,2,212,1,46,0,46,74,1,110,0,110,138
1.373,6,49,19401,27,902,52,1360,13745,22,433,56,1360,5656
1196.034,6,57,3004,29,26,42713,26,1534,28,26,44295,26,1470
0.038,6,3,327,2,103,0,138,287,1,0,0,0,40
1.485,6,10,1687,7,100,247,100,384,3,1179,613,1179,1303
0.049,17,2,339,1,33,0,33,61,1,250,0,250,278
246.111,17,4,240,2,32,246110,32,120,2,32,246110,32,120
0.016,17,4,360,2,30,1,30,116,2,94,2,94,244
0.059,6,101,129388,35,137,1,334,2232,66,1933,0,4206,127156
28.533,6,17,2172,5,304,7133,304,864,12,83,2589,83,1308
85.099,6,40,10565,17,403,1951,1189,3913,23,477,3867,1420,6652
0.786,6,23,6168,13,264,65,662,1848,10,979,86,1731,4320
141.485,6,77,53778,49,1195,2947,1368,45586,28,747,2293,1368,8192
0.294,6,19,4286,11,165,29,456,1394,8,493,39,888,2892
0.055,6,2,1273,1,1193,0,1193,1233,1,0,0,0,40
150.874,6,23,1675,17,43,9429,43,1315,6,0,30173,0,360
62.8,17,4,1344,4,308,20933,308,1344,0,0,0,0,0
0.135,17,2,152,1,48,0,48,76,1,48,0,48,76
0.837,6,7,295,4,0,279,0,164,3,7,306,7,131
1781.53,6,102,8228,68,64,26590,64,4896,34,58,53983,58,3332
2.938,6,29,8832,13,158,244,267,1317,16,858,185,2085,7515
874.603,6,76,5028,44,50,20339,270,3283,32,31,28204,31,1745
1.0,6,12,979,7,181,166,181,549,5,77,150,133,430
211.148,1,2,237,2,90,211148,93,237,0,0,0,0,0
8.083,6,14,4837,8,170,1154,170,630,6,1295,1575,1368,4207
1.289,6,14,4944,7,125,214,125,497,7,1018,204,1448,4447
4.085,17,15,15475,5,836,1021,1350,4323,10,1087,272,1350,11152
1782.191,6,107,8744,68,66,26599,66,4964,39,60,46897,60,3780
300.213,6,50,10281,25,641,12501,1460,4310,25,291,12501,1460,5971
5.657,6,40,7325,21,218,282,314,3463,19,516,299,1179,3862
0.015,6,10,861,6,182,3,182,490,4,77,4,134,371
1783.135,6,223,40574,125,333,14379,827,27528,98,126,18381,233,13046
150.825,17,6,528,3,60,75412,60,264,3,60,75412,60,264
1791.548,1,342,28728,342,56,5253,56,28728,0,0,0,0,0
208.175,2,8,256,8,8,29739,8,256,0,0,0,0,0
0.011,17,2,322,1,39,0,39,67,1,227,0,227,255
240.192,6,55,15007,29,701,8578,1402,12036,26,201,9607,580,2971
74.799,6,19,780,9,0,5247,0,364,10,0,8310,0,416
1729.216,6,62,4504,40,33,44338,33,2740,22,31,82335,31,1764
72.199,6,31,7544,13,155,6016,267,1306,18,423,4246,3417,6238
61.405,6,42,8669,17,401,415,889,1916,25,521,2552,3488,6753
126.981,6,14,5634,5,106,31745,106,322,9,822,15832,1460,5312
62.267,6,77,56035,49,1223,1297,1368,47843,28,841,2297,2736,8192
1748.58,6,95,7203,63,38,28202,205,4476,32,33,56391,98,2727
0.056,17,2,912,1,308,0,308,336,1,548,0,548,576
1.288,6,25,8056,12,164,99,267,1288,13,869,91,1408,6768
0.473,6,26,7068,12,155,43,267,1266,14,523,35,2840,5802
75.727,6,34,7739,13,156,6310,267,1312,21,348,3785,1420,6427
1782.637,17,73,3060,72,14,25107,14,3024,1,8,0,8,36
125.712,2,2,64,2,8,125712,8,64,0,0,0,0,0
0.91,17,3,1170,3,362,455,362,1170,0,0,0,0,0
0.515,6,20,7229,13,334,42,663,2021,7,1209,76,1946,5208
1781.762,6,364,25392,212,100,8444,469,14896,152,69,11799,69,10496
0.05,17,2,385,1,44,0,44,72,1,285,0,285,313
61.402,6,36,7882,16,140,4093,267,1771,20,441,3231,1420,6111
132.564,6,59,37903,37,1169,3682,1448,30007,22,749,2930,1448,7896
1681.569,1,15,840,15,28,120112,28,840,0,0,0,0,0
0.035,17,2,326,1,36,0,36,64,1,234,0,234,262
76.272,17,8,704,4,48,25421,48,304,4,72,25421,72,400
0.393,6,54,21704,30,1017,13,1380,14534,24,475,15,1923,7170
151.283,6,129,95567,81,1258,1891,1408,83536,48,635,3214,1408,12031
0.566,17,8,2750,8,315,80,354,2750,0,0,0,0,0
0.218,6,27,13460,14,138,16,138,874,13,1190,13,1448,12586
1738.811,6,91,6604,59,31,29979,31,3998,32,31,56090,31,2606
260.059,17,4,352,2,60,260058,60,176,2,60,260058,60,176
370.503,6,31258,25451120,13688,340,27,343,855524,17570,1358,21,2736,24595596
4.01,17,8,792,4,39,1333,39,268,4,103,1334,103,524
1796.781,17,447,39580,403,35,4469,288,25676,44,288,40950,288,13904
33.01,17,4,352,2,60,33008,60,176,2,60,33009,60,176
1.631,6,50,19146,27,881,62,1360,13450,23,433,56,1360,5696
1795.127,17,449,39928,404,35,4454,288,25708,45,288,40019,288,14220
0.275,6,21,7281,12,334,24,663,1969,9,967,32,1471,5312
1742.598,6,95,7203,63,38,28106,205,4476,32,33,56197,98,2727
0.182,17,2,2384,2,1164,182,1164,2384,0,0,0,0,0
0.24,17,2,144,1,36,0,36,64,1,52,0,52,80
280.392,6,28,7352,12,158,25490,267,1277,16,603,18683,1400,6075
112.278,17,4,352,2,60,112277,60,176,2,60,112277,60,176
0.098,17,4,588,2,48,93,48,152,2,190,93,308,436
1775.553,17,140,11200,70,48,25732,48,5320,70,56,25732,56,5880
0.965,6,29,5933,14,123,74,267,1428,15,650,63,1420,4505
1792.002,6,357,22629,208,69,8657,69,12460,149,69,12108,69,10169
8.384,2,2,64,2,8,8384,8,64,0,0,0,0,0
3.478,17,5,835,3,39,1616,39,201,2,289,3216,289,634
1195.602,6,229,14749,127,69,9085,69,7840,102,69,11837,69,6909
1771.259,6,104,9500,66,65,27250,65,5577,38,59,47869,59,3923
1789.185,6,364,25392,212,100,8479,469,14896,152,69,11846,69,10496
7.454,6,27,7177,13,155,621,267,1306,14,530,571,3417,5871
1787.907,6,367,23236,212,69,8473,69,12896,155,69,11609,69,10340
1741.053,6,87,6322,58,31,30544,31,3915,29,31,62179,31,2407
1.916,17,3,276,3,64,958,64,276,0,0,0,0,0
1.664,6,30,10317,18,368,97,837,1829,12,1000,141,1452,8488
24.508,6,6,1257,4,327,8169,414,815,2,181,24323,270,442
11.786,6,20,4402,11,275,1178,275,998,9,758,1345,1420,3404
584.247,6,155,27063,101,304,5842,304,20168,54,83,11023,83,6895
3.886,6,11,460,6,0,777,0,248,5,0,700,0,212
300.719,6,37,8374,20,268,15827,727,1941,17,478,535,1928,6433
0.505,6,27,9069,13,257,42,669,1714,14,945,37,1438,7355
1773.436,6,180,15480,120,69,14902,69,8940,60,69,30054,69,6540
54.298,6,27,7177,13,155,4524,267,1306,14,530,4175,3417,5871
591.678,1,7,605,7,58,98613,88,605,0,0,0,0,0
240.062,6,265,199507,134,179,1804,179,7155,131,1449,1846,2876,192352
34.189,17,20,1760,10,48,3797,48,760,10,72,3797,72,1000
0.095,6,10,766,5,185,23,185,453,5,45,23,45,313
4.76,6,39,7285,20,218,250,314,3423,19,516,250,1179,3862
11.596,6,1844,1591173,1107,1380,10,1420,1557472,737,467,15,1883,33701
1.042,17,4,360,2,30,982,30,116,2,94,995,94,244
1785.969,17,142,11360,71,48,25513,48,5396,71,56,25513,56,5964
0.645,6,3,132,2,0,468,0,92,1,0,0,0,40
7.563,6,1647,1510329,1006,1421,7,1448,1472333,641,776,11,1448,37996
177.266,6,24,10168,13,549,70,1360,2749,11,1161,17706,2720,7419
1791.162,6,416,24920,208,69,8652,69,12460,208,34,8652,64,12460
0.188,1,5,420,5,56,47,56,420,0,0,0,0,0
1787.437,6,102,8228,68,64,26678,64,4896,34,58,54160,58,3332
1799.975,1,270,28620,270,78,6691,78,28620,0,0,0,0,0
150.322,1,3,168,3,28,75161,28,168,0,0,0,0,0
702.358,6,134,9180,57,46,12450,46,3754,77,46,9241,46,5426
1782.526,6,363,23007,211,69,8488,69,12787,152,69,11804,69,10220
3.009,17,2,176,2,60,3009,60,176,0,0,0,0,0
1743.214,6,94,7151,62,38,28577,205,4424,32,33,56220,98,2727
1795.721,1,57,4788,57,56,32066,56,4788,0,0,0,0,0
28.883,6,4,240,4,0,0,0,240,0,0,0,0,0
0.535,6,23,7307,13,318,43,600,1958,10,1205,58,1891,5349
4.895,6,12,2271,7,188,815,245,660,5,1407,1150,1407,1611
1793.825,17,29,9512,29,300,64065,300,9512,0,0,0,0,0
198.845,6,74,49241,46,1171,4418,1408,41051,28,960,2282,3847,8190
1790.136,1,164,9184,164,28,10982,28,9184,0,0,0,0,0
1784.135,17,73,3060,72,14,25128,14,3024,1,8,0,8,36
378.283,2,3,96,3,8,189141,8,96,0,0,0,0,0
1796.341,6,374,26068,217,98,8316,469,15303,157,69,11514,69,10765
1.315,6,54,21369,30,956,45,1460,15588,24,400,49,1460,5781
0.149,17,2,152,1,48,0,48,76,1,48,0,48,76
45.136,6,99,122409,44,289,1049,919,4023,55,2265,835,5608,118386
5.118,6,34,6169,19,206,284,314,2824,15,548,345,1179,3345
1203.17,2,12,384,12,8,109379,8,384,0,0,0,0,0
7.042,6,11,3652,5,171,1760,171,439,6,964,1407,1448,3213
3.996,17,5,340,5,40,999,40,340,0,0,0,0,0
0.307,6,9,1340,5,145,76,145,349,4,827,73,827,991
11.747,6,1852,1607964,1136,1362,10,1380,1573159,716,558,16,1923,34805
1780.718,6,197,16229,128,69,14021,69,9329,69,69,26186,69,6900
0.115,1,2,112,2,28,115,28,112,0,0,0,0,0
1.392,6,50,19728,27,922,53,1440,14032,23,433,54,1440,5696
657.138,6,104,9578,42,81,16024,301,3978,62,94,10772,1062,5600
1.788,17,20,5190,20,231,94,389,5190,0,0,0,0,0
1789.155,1,90,5040,90,28,20102,28,5040,0,0,0,0,0
1700.578,17,12,498,11,14,170057,14,462,1,8,0,8,36
0.013,17,2,475,1,40,0,40,68,1,379,0,379,407
187.493,6,14,784,6,0,37496,0,312,8,56,26783,56,472
1778.727,6,277,36462,115,162,15601,1360,19094,162,135,11047,4662,17368
42.238,17,24,2112,12,48,3839,48,912,12,72,3838,72,1200
5.582,6,10,472,5,0,1395,0,232,5,0,636,0,240
97.523,6,32,8952,15,158,6965,267,1397,17,687,6088,1781,7555
242.916,17,9,2992,9,304,30364,308,2992,0,0,0,0,0
1.319,6,48,19438,27,907,50,1360,13822,21,433,57,1360,5616
0.012,17,2,140,1,34,0,34,62,1,50,0,50,78
0.045,17,4,368,2,32,39,32,120,2,96,0,96,248
6.006,17,6,562,5,30,993,30,290,1,244,0,244,272
0.47,6,26,9017,13,261,39,683,1728,13,943,36,1448,7289
55.946,6,32,7765,11,155,8,267,1226,21,334,2796,1420,6539
38.532,6,13,3474,3,92,19266,92,244,10,386,4255,1408,3230
0.069,17,8,2446,8,277,9,316,2446,0,0,0,0,0
0.0,17,1,155,1,127,0,127,155,0,0,0,0,0
0.05,17,2,158,1,34,0,34,62,1,68,0,68,96
1772.472,6,180,15480,120,69,14894,69,8940,60,69,30041,69,6540
728.978,2,8,256,8,8,104139,8,256,0,0,0,0,0
61.689,6,36,15843,22,796,2937,1368,9117,14,748,4722,2519,6726
0.405,6,12,1653,6,288,74,288,548,6,426,46,434,1105
1799.904,6,335,26219,160,218,11310,528,10601,175,39,10340,76,15618
21.036,6,20,3130,12,183,1912,517,1561,8,381,3003,499,1569
18.095,17,4,352,2,60,18094,60,176,2,60,18094,60,176
1787.14,6,106,8456,68,65,26673,65,4930,38,59,48298,59,3526
3.185,6,23,5714,13,158,247,370,1315,10,998,331,1691,4399
10.452,6,6,328,4,0,3484,0,216,2,0,10297,0,112
1782.306,1,168,17808,168,78,10672,78,17808,0,0,0,0,0
1681.384,17,14,1036,7,30,280227,30,406,7,62,280228,62,630
121.726,1,20,1680,20,56,6406,56,1680,0,0,0,0,0
1772.199,6,181,15589,120,69,14892,69,8940,61,69,29532,69,6649
66.129,6,40,10111,16,144,242,267,1517,24,544,2874,1460,8594
5.014,17,4,558,2,36,5004,36,128,2,187,5005,187,430
280.46,6,31,7472,13,158,23371,267,1317,18,603,16494,2076,6155
1773.847,6,183,15738,121,69,14782,69,8980,62,69,29073,69,6758
240.223,6,54,18428,29,826,8579,1418,15569,25,193,10008,580,2859
1775.474,17,140,11200,70,48,25731,48,5320,70,56,25731,56,5880
67.321,17,5,3229,5,617,16830,1238,3229,0,0,0,0,0
0.13,17,6,912,3,60,11,60,264,3,188,8,188,648
1786.945,6,102,8296,68,65,26670,65,4930,34,59,54146,59,3366
1777.605,1,56,4704,56,56,32320,56,4704,0,0,0,0,0
1789.337,17,142,11360,71,48,25561,48,5396,71,56,25561,56,5964
0.233,17,23,15650,13,972,19,1350,13007,10,236,19,1350,2643
281.988,6,29,7392,13,158,23499,267,1317,16,603,18777,2036,6075
1794.583,17,274,56142,274,176,6573,422,56142,0,0,0,0,0
3.938,17,3,201,3,39,1969,39,201,0,0,0,0,0
345.221,6,34,7420,15,202,4008,502,1818,19,302,19174,1420,5602
3.209,17,4,1560,4,362,1069,362,1560,0,0,0,0,0
0.008,17,2,407,1,29,0,29,57,1,322,0,322,350
5.831,6,40,7325,21,218,291,314,3463,19,516,309,1179,3862
22.946,6,3512,3336770,2246,1406,10,1448,3266408,1266,899,18,1448,70362
20.407,6,14,1025,7,222,3398,222,506,7,231,3398,231,519
161.414,6,23,9193,12,703,76,1360,3324,11,1083,16124,3113,5869
1793.962,1,213,11928,213,28,8462,28,11928,0,0,0,0,0
10.89,6,24,8484,12,498,990,721,2479,12,919,900,1440,6005
95.12,6,38,9435,17,136,5945,267,1649,21,495,4711,3417,7786
1796.614,6,358,22669,209,69,8637,69,12569,149,69,12139,69,10100
1719.588,17,13,534,11,14,171940,14,462,2,8,1719408,8,72
3.208,6,20,3697,11,187,320,293,1381,9,488,316,1179,2316
1764.015,2,15,480,15,8,126001,8,480,0,0,0,0,0
1779.56,17,140,11200,70,48,25790,48,5320,70,56,25790,56,5880
20.89,6,26,4746,14,205,1606,517,1971,12,428,1897,499,2775
19.873,6,18,4370,9,263,2484,722,1519,9,793,2374,1408,2851
15.479,17,10,1512,7,88,2579,288,812,3,205,224,288,700
280.297,6,29,7392,13,158,23358,267,1317,16,603,18682,1400,6075
0.015,17,2,412,1,48,0,48,76,1,308,0,308,336
1.605,2,3,96,3,8,802,8,96,0,0,0,0,0
1.583,6,27,10121,16,275,105,558,1470,11,1025,141,1420,8651
592.068,17,6,2000,6,305,118413,308,2000,0,0,0,0,0
321.59,6,22,6605,4,98,107193,106,365,18,393,18916,1420,6240
0.332,17,20,13707,12,913,30,1350,11301,8,272,37,1350,2406
1771.876,6,182,15629,121,69,14765,69,8980,61,69,29530,69,6649
1793.232,1,84,4704,84,28,21605,28,4704,0,0,0,0,0
0.144,17,2,169,1,34,0,34,62,1,79,0,79,107
0.161,6,47,21015,26,1062,6,1420,15954,21,420,7,1420,5061
1776.251,6,104,8376,68,65,26511,65,4930,36,59,50747,59,3446
1781.345,6,388,27249,222,97,8060,469,15710,166,69,10795,69,11539
1763.893,17,44,14784,44,308,41020,308,14784,0,0,0,0,0
66.992,6,9,468,9,0,0,0,468,0,0,0,0,0
1770.438,6,99,9240,66,65,27237,65,5577,33,59,55323,59,3663
300.736,6,49,14080,26,893,12029,1360,8265,23,325,413,1360,5815
0.19,6,26,7256,13,155,15,267,1301,13,603,14,2800,5955
1754.904,1,61,5124,0,0,0,0,0,61,56,29248,56,5124
240.336,6,41,8983,20,523,12649,1408,5758,21,236,12016,619,3225
1799.848,1,58,4872,0,0,0,0,0,58,56,31576,56,4872
315.585,6,27,6601,9,220,8115,516,1245,18,308,18558,1452,5356
119.234,6,32,8952,14,158,9171,267,1357,18,624,7011,1400,7595
1762.842,1,74,4144,74,28,24148,28,4144,0,0,0,0,0
1.083,6,28,8160,15,222,64,540,1964,13,944,75,1591,6196
1785.45,6,412,36578,225,122,7970,1189,18472,187,126,9598,2077,18106
0.076,6,10,1514,5,503,18,503,771,5,475,19,475,743
1795.531,1,341,28644,341,56,5280,56,28644,0,0,0,0,0
5.962,17,34,16828,16,758,397,1350,12584,18,207,206,1350,4244
0.671,17,2,136,1,32,0,32,60,1,48,0,48,76
1778.945,17,140,11200,70,48,25781,48,5320,70,56,25781,56,5880
1786.81,6,102,8296,68,65,26668,65,4930,34,59,54140,59,3366
1797.982,1,120,6720,120,28,15109,28,6720,0,0,0,0,0
0.012,17,2,227,1,32,0,32,60,1,139,0,139,167
1796.185,17,448,39896,403,35,4468,288,25676,45,288,40016,288,14220
5.412,6,614,523319,368,1344,14,1368,504355,246,776,21,1473,18964
0.498,6,27,9043,13,250,41,639,1696,14,942,35,1368,7347
1774.1,6,180,15480,120,69,14908,69,8940,60,69,30064,69,6540
1772.118,6,182,15629,121,69,14767,69,8980,61,69,29530,69,6649
65.067,6,15,6197,6,138,13013,267,803,9,837,1149,1917,5394
1796.849,1,220,12320,220,28,8204,28,12320,0,0,0,0,0
71.971,17,4,240,2,32,71970,32,120,2,32,71970,32,120
101.024,6,30,7432,13,158,8418,267,1317,17,543,6309,1400,6115
0.091,17,2,198,1,39,0,39,67,1,103,0,103,131
0.691,17,22,13500,11,726,69,1350,8302,11,444,56,1350,5198
31.738,6,33,9225,13,189,2554,189,1026,20,526,1662,1360,8199
1.034,17,4,566,2,31,1029,31,118,2,196,1030,196,448
3.693,6,11,467,6,0,738,0,248,5,7,662,7,219
0.118,17,142,114961,61,111,1,1350,8539,81,1285,1,1350,106422
743.251,17,30,4567,15,40,53088,43,1026,15,208,53088,249,3541
72.366,1,4,224,4,28,24122,28,224,0,0,0,0,0
1790.053,1,76,6384,0,0,0,0,0,76,56,23867,56,6384
35.6,6,19,1482,9,65,4450,65,815,10,66,3504,118,667
0.004,17,2,376,1,39,0,39,67,1,281,0,281,309
1772.984,6,182,15698,120,69,14899,69,8940,62,69,29062,69,6758
280.697,6,29,7392,13,158,23391,267,1317,16,678,18707,3456,6075
1.234,6,24,8004,12,164,95,267,1288,12,1014,94,2804,6716
1774.151,6,180,15480,120,69,14908,69,8940,60,69,30069,69,6540
251.998,1,2,112,2,28,251998,28,112,0,0,0,0,0
0.682,6,134,98353,80,1305,8,1420,91972,54,526,12,3303,6381
131.984,6,29,13448,15,488,349,1360,3087,14,1223,10141,2568,10361
0.102,17,2,348,1,39,0,39,67,1,253,0,253,281
1700.457,17,12,498,11,14,170045,14,462,1,8,0,8,36
300.681,6,46,8907,23,266,13667,720,2078,23,327,586,1460,6829
4.0,17,3,201,3,39,2000,39,201,0,0,0,0,0
1789.21,17,142,11360,71,48,25560,48,5396,71,56,25560,56,5964
182.511,6,22,2609,12,324,16591,585,1281,10,396,20277,580,1328
7.111,6,22,4426,12,213,646,597,1689,10,441,767,1402,2737
1795.854,1,342,28728,342,56,5266,56,28728,0,0,0,0,0
838.798,1,10,560,10,28,93199,28,560,0,0,0,0,0
1786.52,6,102,8228,68,64,26664,64,4896,34,58,54134,58,3332
247.986,6,351,389396,70,465,3594,1408,7653,281,1359,885,1408,381743
1744.685,2,19,608,19,8,96926,8,608,0,0,0,0,0
1683.17,17,14,1036,7,30,280526,30,406,7,62,280526,62,630
1779.709,1,308,25872,308,56,5797,56,25872,0,0,0,0,0
0.494,17,3,451,2,39,215,39,134,1,289,0,289,317
1.015,17,2,279,1,36,0,36,64,1,187,0,187,215
21.954,6,28,5693,12,256,1995,722,1657,16,397,1421,2026,4036
300.265,6,40,10384,21,658,15004,1360,4822,19,399,16671,1360,5562
33.709,6,35,5514,17,154,2094,721,1974,18,371,1971,2026,3540
1776.361,6,104,8376,68,65,26512,65,4930,36,59,50750,59,3446
83.888,17,4,240,2,32,83887,32,120,2,32,83887,32,120
54.558,6,27,7177,13,155,4546,267,1306,14,530,4196,3417,5871
1.399,6,50,19598,27,913,53,1360,13902,23,433,55,1360,5696
20.124,6,20,5389,12,107,1829,159,1098,8,966,2874,1668,4291
60.398,6,9,676,9,26,7549,26,676,0,0,0,0,0
0.61,17,3,688,2,64,502,64,184,1,476,0,476,504
247.087,17,4,352,2,60,247086,60,176,2,60,247086,60,176
1774.636,1,84,4704,84,28,21381,28,4704,0,0,0,0,0
241.416,1,6,336,6,28,48283,28,336,0,0,0,0,0
0.072,17,2,241,1,36,0,36,64,1,149,0,149,177
1743.806,6,96,7286,64,38,27679,205,4559,32,33,56243,98,2727
158.96,17,3,531,3,149,79480,355,531,0,0,0,0,0
110.027,6,30,7432,13,158,9168,267,1317,17,543,6874,1400,6115
488.35,6,78,11904,38,91,13198,267,3272,40,195,12517,1460,8632
240.664,2,4,128,4,8,80221,8,128,0,0,0,0,0
0.637,6,22,7272,12,319,57,602,1908,10,1209,70,1906,5364
1739.405,6,87,6322,58,31,30515,31,3915,29,31,62121,31,2407
1121.014,17,10,740,5,30,280249,30,290,5,62,280250,62,450
7.937,6,38,7618,18,218,466,314,3343,20,495,403,1179,4275
86.452,17,6,390,3,37,43225,47,195,3,37,43225,47,195
0.023,1,4,416,0,0,0,0,0,4,76,7,76,416
13.734,6,27,4867,13,154,1126,722,1767,14,394,1042,1408,3100
0.384,6,12,1653,6,288,71,288,548,6,426,40,434,1105
1.166,6,25,8056,12,164,90,267,1288,13,869,82,1402,6768
0.464,6,12,1653,6,288,85,288,548,6,426,54,434,1105
1744.641,2,16,512,16,8,116309,8,512,0,0,0,0,0
1681.286,17,14,3843,7,30,280213,30,406,7,463,280212,463,3437
0.033,17,2,152,1,48,0,48,76,1,48,0,48,76
0.206,6,3,144,2,0,3,0,92,1,0,0,0,52
0.486,6,53,22959,29,1033,17,1380,17745,24,421,19,1923,5214
1795.064,17,449,39928,404,35,4454,288,25708,45,288,40021,288,14220
1772.336,6,180,15480,120,69,14893,69,8940,60,69,30037,69,6540
442.428,1,8,448,8,28,63204,28,448,0,0,0,0,0
240.106,6,40,4345,21,220,12005,579,2436,19,114,13338,457,1909
1786.683,6,104,8444,68,66,26666,66,4964,36,60,51044,60,3480
1.541,6,38,8254,19,321,85,1164,2718,19,433,76,1460,5536
0.532,6,28,9136,14,210,40,661,1789,14,942,38,1368,7347
36.963,17,11,836,11,48,3696,48,836,0,0,0,0,0
1787.351,6,104,8308,68,64,26676,64,4896,36,58,51062,58,3412
1.838,6,23,7478,10,268,204,517,1333,13,779,134,1418,6145
0.51,17,6,2084,6,319,102,355,2084,0,0,0,0,0
9.462,6,18,3286,11,199,946,293,1641,7,453,1102,1179,1645
3.436,17,5,340,5,40,859,40,340,0,0,0,0,0
1798.936,6,141,9505,78,59,23360,208,6055,63,31,29012,31,3450
82.945,17,4,240,2,32,82944,32,120,2,32,82944,32,120
191.943,6,34,9032,15,158,13710,267,1397,19,687,10662,1781,7635
5.001,17,4,288,2,36,5001,36,128,2,52,5001,52,160
12.257,6,29,5676,13,183,1021,314,2174,16,476,800,1179,3502
1744.862,17,29,6815,29,207,62316,207,6815,0,0,0,0,0
1798.751,17,763,46046,763,32,2360,37,46046,0,0,0,0,0
1789.956,1,67,5628,67,56,27120,56,5628,0,0,0,0,0
11.763,17,8,608,8,48,1680,48,608,0,0,0,0,0
352.318,1,22,2332,22,78,16777,78,2332,0,0,0,0,0
1798.39,6,359,22709,209,69,8646,69,12569,150,69,12069,69,10140
0.008,6,2,116,1,0,0,0,64,1,0,0,0,52
63.673,17,4,352,2,60,63671,60,176,2,60,63672,60,176
14.336,6,3,213,0,0,0,0,0,3,31,7168,31,213
0.49,6,47,18141,26,920,19,1380,13059,21,421,22,1923,5082
0.01,17,2,358,1,30,0,30,58,1,272,0,272,300
280.226,6,26,7272,12,158,25475,267,1277,14,678,21553,2045,5995
1762.491,6,109,8667,69,49,25918,205,5219,40,36,45185,98,3448
0.307,17,2,136,1,32,0,32,60,1,48,0,48,76
0.499,17,3,451,2,39,409,39,134,1,289,0,289,317
1788.491,1,342,28728,342,56,5244,56,28728,0,0,0,0,0
17.261,6,36,9321,14,290,1327,965,2311,22,340,821,1997,7010
6.518,6,42,7389,22,218,310,314,3503,20,513,329,1179,3886
5.527,6,23,10710,11,275,552,275,719,12,950,437,1380,9991
0.062,17,2,195,1,44,0,44,72,1,95,0,95,123
0.096,2,2,64,2,8,96,8,64,0,0,0,0,0
1.346,6,24,8004,12,164,104,267,1288,12,1014,104,2491,6716
1795.335,6,335,25963,163,259,11076,515,10649,172,38,10495,63,15314
0.02,6,11,1566,6,503,4,503,823,5,475,4,475,743
0.822,6,10,1687,7,100,137,100,384,3,1179,278,1179,1303
42.289,6,19,7304,10,267,4698,501,1205,9,819,263,1420,6099
1681.801,17,14,1036,7,30,280294,30,406,7,62,280295,62,630
1741.491,6,84,6104,56,31,31663,31,3780,28,31,64499,31,2324
1740.539,17,30,7050,30,207,60018,207,7050,0,0,0,0,0
1.046,17,4,580,2,40,1014,40,136,2,194,1015,194,444
197.19,17,3,225,3,47,98595,47,225,0,0,0,0,0
1755.956,6,104,6218,60,27,29761,27,3525,44,27,40835,27,2693
0.462,6,12,1653,6,288,91,288,548,6,426,56,434,1105
0.907,6,10,1687,7,100,151,100,384,3,1179,327,1179,1303
678.384,2,8,256,8,8,96912,8,256,0,0,0,0,0
11.257,6,27,11355,13,275,938,275,1078,14,1078,834,1414,10277
0.028,17,4,284,2,32,22,32,120,2,54,21,60,164
1.91,6,15,2391,9,125,238,245,740,6,1407,331,1407,1651
0.621,6,120,92955,76,1331,8,1432,86974,44,420,14,1432,5981
1781.779,6,104,8308,68,64,26593,64,4896,36,58,50905,58,3412
75.676,6,31,7613,12,155,29,267,1266,19,398,4203,3417,6347
1772.389,6,180,15480,120,69,14894,69,8940,60,69,30033,69,6540
1.504,17,3,1170,3,362,752,362,1170,0,0,0,0,0
1121.305,17,10,740,5,30,280321,30,290,5,62,280321,62,450
0.147,6,40,16818,23,997,6,1420,11917,17,467,8,1883,4901
0.782,17,22,15540,13,978,64,1350,13087,9,244,93,1350,2453
19.969,17,30,18219,16,707,1326,1350,11775,14,432,1530,1350,6444
60.359,6,40,7958,22,135,2874,174,1562,18,472,3543,1452,6396
1796.062,17,449,39928,404,35,4456,288,25708,45,288,40014,288,14220
280.247,6,29,7392,13,158,23353,267,1317,16,603,18682,2036,6075
1745.223,6,94,7151,62,38,28610,205,4424,32,33,56291,98,2727
1774.798,6,180,15480,120,69,14914,69,8940,60,69,30079,69,6540
0.462,6,22,7779,13,318,38,599,1969,9,1066,57,1906,5810
150.996,1,3,168,3,28,75498,28,168,0,0,0,0,0
4.044,17,5,295,5,31,1011,31,295,0,0,0,0,0
0.124,6,10,1379,5,145,31,145,349,5,826,25,826,1030
18.608,17,6,456,6,48,3721,48,456,0,0,0,0,0
240.34,6,48,8698,25,449,10014,1408,5816,23,186,10924,580,2882
723.641,6,77,6599,51,69,14472,69,3765,26,69,28913,69,2834
0.138,17,2,188,1,58,0,58,86,1,74,0,74,102
1.594,17,6,360,3,32,796,32,180,3,32,796,32,180
1.15,6,26,9564,13,164,81,267,1388,13,1070,81,2816,8176
21.535,6,12,3078,5,92,5383,92,348,7,2330,3494,2330,2730
4.254,6,5,341,1,0,0,0,40,4,31,1417,31,301
16.696,17,19,9409,8,314,2381,1350,2742,11,578,1666,1350,6667
0.014,6,16,6004,8,88,2,88,452,8,1305,1,1880,5552
1787.767,17,87,3648,86,14,21032,14,3612,1,8,0,8,36
101.67,6,223,180354,143,1293,715,1408,165294,80,680,1284,3847,15060
0.269,6,7,380,4,0,89,0,216,3,0,107,0,164
1792.563,6,244,46664,152,483,11871,483,36892,92,83,19698,83,9772
11.8,6,84,24885,42,542,287,1152,19048,42,461,281,1179,5837
1778.655,17,140,11200,70,48,25777,48,5320,70,56,25777,56,5880
0.446,17,8,2750,8,315,63,354,2750,0,0,0,0,0
106.832,2,2,64,2,8,106832,8,64,0,0,0,0,0
7.764,6,25,3779,13,149,647,293,1567,12,432,681,1179,2212
1777.51,6,208,24936,133,101,13465,965,12011,75,139,24016,3426,12925
172.524,6,81,58055,52,1207,3382,1368,49813,29,840,2204,2519,8242
1.664,6,11,975,6,304,332,304,624,5,83,395,83,351
0.691,17,2,152,1,48,0,48,76,1,48,0,48,76
0.538,6,12,3462,6,75,107,75,395,6,1373,107,1448,3067
61.429,6,23,11049,12,753,61,1360,3525,11,1414,6129,3940,7524
0.489,17,3,451,2,39,190,39,134,1,289,0,289,317
280.323,6,27,7312,12,158,25483,267,1277,15,678,20021,2045,6035
1786.868,6,104,8366,69,64,26277,64,4936,35,58,52552,58,3430
1792.055,6,459,27113,253,69,7111,69,14467,206,39,8740,69,12646
0.017,17,2,656,1,300,0,300,328,1,300,0,300,328
1763.293,17,46,15440,46,307,39184,308,15440,0,0,0,0,0
1.734,6,13,2311,8,188,247,245,700,5,1407,367,1407,1611
0.027,17,2,186,1,33,0,33,61,1,97,0,97,125
1.082,6,36,8484,20,401,56,888,2047,16,482,62,3488,6437
1761.587,6,117,7016,64,26,27960,26,3822,53,26,33875,26,3194
1682.822,17,16,1265,8,30,240396,37,471,8,71,240398,136,794
25.236,17,32,4704,16,48,1681,48,1216,16,190,1681,308,3488
0.127,6,4,3991,1,0,0,0,40,3,1277,0,1440,3951
124.418,6,9,522,2,106,124405,106,194,7,0,20734,0,328
4.007,17,8,1541,5,40,850,40,340,3,372,0,407,1201
7.496,6,41,8090,20,218,394,314,3423,21,477,361,1152,4667
1772.156,6,4345,3955872,1630,118,1087,333,96160,2715,1409,652,2836,3859712
149.254,6,18,3640,8,524,124,1309,1925,10,434,16563,999,1715
0.238,17,2,304,1,60,0,60,88,1,188,0,188,216
1799.553,6,243,46615,151,483,11996,483,36832,92,83,19775,102,9783
10.798,17,4,304,4,48,3599,48,304,0,0,0,0,0
1770.454,6,101,9344,66,65,27237,65,5577,35,59,52067,59,3767
1770.636,6,101,9410,66,66,27240,66,5610,35,60,52074,60,3800
1744.196,6,95,7203,63,38,28132,205,4476,32,33,56257,98,2727
0.051,17,4,368,2,32,0,32,120,2,96,0,96,248
0.063,6,2,149,1,0,0,0,40,1,69,0,69,109
6.839,6,37,7189,19,218,379,314,3383,18,513,377,1179,3806
7.797,6,28,6190,14,164,599,453,1558,14,555,527,1542,4632
6.392,6,40,7309,22,218,304,314,3503,18,513,358,1179,3806
0.027,6,9,1560,5,514,6,514,782,4,562,8,562,778
1798.026,17,450,39960,405,35,4450,288,25740,45,288,40020,288,14220
1789.667,17,142,11360,71,48,25566,48,5396,71,56,25566,56,5964
374.739,6,18,1242,14,180,28826,180,916,4,110,20068,110,326
1797.917,17,449,39928,404,35,4461,288,25708,45,288,40020,288,14220
2.815,17,4,624,4,128,938,128,624,0,0,0,0,0
222.711,17,4,240,2,32,222710,32,120,2,32,222709,32,120
1.697,17,2,144,1,36,0,36,64,1,52,0,52,80
2.637,17,2,152,1,48,0,48,76,1,48,0,48,76
41.647,17,14,1064,14,48,3203,48,1064,0,0,0,0,0
1.351,6,38,8258,19,321,75,1168,2722,19,433,64,1460,5536
70.912,6,47,10289,22,533,726,910,3083,25,344,2948,1360,7206
15.729,6,29,5000,15,154,1123,721,1869,14,399,1194,1368,3131
1781.766,6,366,25072,213,93,8404,469,14605,153,69,11722,69,10467
1718.637,1,8,448,8,28,245519,28,448,0,0,0,0,0
1771.439,6,102,9462,66,66,27252,66,5610,36,60,50609,60,3852
291.883,17,4,352,2,60,291881,60,176,2,60,291882,60,176
49.345,6,6249,6017251,4186,1361,11,1408,5905311,2063,776,23,1408,111940
250.12,6,60,20674,36,477,7146,1360,9644,24,670,10867,1595,11030
0.103,1,2,163,2,53,103,78,163,0,0,0,0,0
541.428,2,4,128,4,8,180476,8,128,0,0,0,0,0
0.555,17,2,136,1,32,0,32,60,1,48,0,48,76
40.263,6,48,13097,24,879,505,1360,7211,24,327,1742,2667,5886
280.454,6,29,7392,13,158,23371,267,1317,16,678,18694,2760,6075
0.769,2,2,64,2,8,769,8,64,0,0,0,0,0
0.014,17,2,438,1,33,0,33,61,1,349,0,349,377
4.202,6,59,20712,32,791,135,1360,14787,27,400,153,1360,5925
1.76,6,7,280,4,0,54,0,160,3,0,880,0,120
13.713,17,3,984,3,300,6856,300,984,0,0,0,0,0
464.511,6,70,8456,37,95,12903,501,3390,33,186,14208,1420,5066
1675.448,1,8,448,8,28,239349,28,448,0,0,0,0,0
1798.162,17,142,11360,71,48,25687,48,5396,71,56,25687,56,5964
0.216,17,2,384,1,36,0,36,64,1,292,0,292,320
0.005,6,2,92,1,0,0,0,40,1,0,0,0,52
133.282,6,6060,5032401,2879,729,46,1396,170284,3181,1484,41,9772,4862117
63.251,17,4,352,2,48,63238,48,152,2,72,63238,72,200
1764.951,1,58,4872,0,0,0,0,0,58,56,30964,56,4872
0.173,6,3,160,2,0,173,0,100,1,0,0,0,60
99.838,17,4,240,2,32,99837,32,120,2,32,99837,32,120
56.837,6,49,10455,23,533,704,910,3147,26,312,2268,1460,7308
1798.338,17,450,39960,405,35,4451,288,25740,45,288,40021,288,14220
10.921,6,18,5610,10,275,1213,275,958,8,1440,845,1440,4652
17.131,17,4,352,2,48,17114,48,152,2,72,17111,72,200
17.36,17,4,352,2,48,17351,48,152,2,72,17351,72,200
4.0,17,8,578,4,34,1333,34,248,4,54,1328,68,330
37.384,17,22,1936,11,48,3732,48,836,11,72,3732,72,1100
5.996,6,39,7269,19,218,333,314,3383,20,513,300,1179,3886
2.495,17,4,1564,4,363,831,363,1564,0,0,0,0,0
280.441,6,28,7352,13,158,23370,267,1317,15,678,20028,2760,6035
283.801,17,4,352,2,60,283800,60,176,2,60,283800,60,176
69.105,6,27,7177,13,155,5758,267,1306,14,530,5315,3417,5871
560.38,6,41,7629,19,142,15094,516,1905,22,254,26680,1452,5724
91.853,6,64,41324,40,1156,2355,1448,33322,24,749,2674,1448,8002
0.01,17,2,390,1,30,0,30,58,1,304,0,304,332
1636.705,1,7,392,7,28,272784,28,392,0,0,0,0,0
0.079,17,2,157,1,31,0,31,59,1,70,0,70,98
3.014,17,8,1714,4,45,1001,45,292,4,327,1001,339,1422
51.455,1,49,5096,0,0,0,0,0,49,76,1071,76,5096
0.442,17,2,152,1,48,0,48,76,1,48,0,48,76
0.306,17,2,152,1,48,0,48,76,1,48,0,48,76
1465.414,6,151,13078,97,70,15264,138,7330,54,69,27649,69,5748
0.533,17,2,784,2,364,533,364,784,0,0,0,0,0
1412.788,1,46,3864,46,56,31395,56,3864,0,0,0,0,0
229.645,17,5,670,5,106,57411,346,670,0,0,0,0,0
1771.949,6,99,9306,66,66,27260,66,5610,33,60,55370,60,3696
1773.085,6,180,15480,120,69,14899,69,8940,60,69,30044,69,6540
1.537,6,44,17656,26,852,61,1360,12160,18,476,77,2715,5496
1776.632,17,140,11200,70,48,25748,48,5320,70,56,25748,56,5880
102.01,6,11,719,11,31,10201,31,719,0,0,0,0,0
1795.975,17,448,39896,403,35,4467,288,25676,45,288,40018,288,14220
1786.46,6,104,8444,68,66,26663,66,4964,36,60,51039,60,3480
0.158,1,10,280,10,0,0,0,280,0,0,0,0,0
367.336,6,27,1767,18,177,21608,177,1181,9,110,8776,110,586
240.116,6,11,1269,6,187,48023,187,507,5,247,60004,462,762
1691.056,17,17,3486,17,177,105691,284,3486,0,0,0,0,0
223.746,6,31,8912,14,158,17211,267,1357,17,763,13976,2076,7555
131.162,6,30,13159,16,489,334,1460,3121,14,1051,10079,1460,10038
1792.397,6,371,23465,213,69,8454,69,13005,158,69,11416,69,10460
253.079,6,30,7432,13,158,21089,267,1317,17,543,15816,1400,6115
5.109,6,40,7309,20,218,268,314,3423,20,440,256,1152,3886
1692.049,17,14,2716,14,166,130157,166,2716,0,0,0,0,0
1744.095,17,284,59696,284,182,6162,422,59696,0,0,0,0,0
0.531,6,14,1745,7,288,61,288,600,7,426,60,434,1145
0.276,17,2,304,1,60,0,60,88,1,188,0,188,216
0.756,17,2,412,1,33,0,33,61,1,323,0,323,351
0.245,6,12,3705,6,171,48,171,491,6,964,48,1448,3214
9.9,6,19,2550,13,210,824,210,1152,6,545,1910,904,1398
4.374,6,81,51957,50,1139,89,1360,37358,31,953,141,1990,14599
1743.563,6,95,7203,63,38,28121,205,4476,32,33,56236,98,2727
1786.352,6,373,25959,215,98,8347,469,15223,158,69,11377,69,10736
1781.883,1,58,4872,58,56,31261,56,4872,0,0,0,0,0
0.313,17,2,304,1,60,0,60,88,1,188,0,188,216
33.589,17,17,4743,8,273,4797,1350,2415,9,230,4194,1350,2328
1.667,6,12,1163,6,222,331,222,688,6,231,331,231,475
0.016,17,4,284,2,32,10,32,120,2,54,8,60,164
1.33,17,3,1176,3,364,665,364,1176,0,0,0,0,0
0.207,6,9,1002,5,213,51,213,417,4,421,58,421,585
81.938,6,33,7954,11,162,8193,267,1423,22,331,3895,1460,6531
0.427,6,11,1418,5,145,106,145,349,6,825,72,825,1069
7.168,6,1059,971057,689,1363,10,1432,951966,370,427,19,1432,19091
0.029,6,10,2046,6,739,5,1322,1723,4,159,9,159,323
147.331,6,51,13429,27,719,5666,1230,8603,24,186,6405,1296,4826
85.917,6,120,91466,75,1285,1161,1448,81013,45,675,1947,1448,10453
367.105,6,18,1242,14,180,28238,180,916,4,110,20063,110,326
0.524,17,4,288,2,36,492,36,128,2,52,492,52,160
1786.778,6,105,8475,68,65,26668,65,4930,37,59,49628,59,3545
1769.675,1,58,4872,58,56,31046,56,4872,0,0,0,0,0
3.211,6,53,34790,33,962,100,1360,11976,20,2200,161,5440,22814
0.487,6,23,6000,12,108,44,147,919,11,927,45,1608,5081
5.75,6,2,111,2,31,5750,31,111,0,0,0,0,0
13.0,6,1886,1765855,1245,1366,10,1432,1735924,641,475,20,1871,29931
1772.668,1,58,4872,58,56,31099,56,4872,0,0,0,0,0
169.479,6,37,8238,13,175,194,267,1579,24,316,7368,1460,6659
1700.64,17,13,534,11,14,170046,14,462,2,8,1700465,8,72
0.949,6,11,1727,7,100,158,100,384,4,589,234,1152,1343
4.0,17,2,134,2,39,4000,39,134,0,0,0,0,0
0.079,17,2,322,1,33,0,33,61,1,233,0,233,261
1.217,6,49,19195,27,887,46,1360,13539,22,433,49,1360,5656
0.996,17,2,464,2,204,996,204,464,0,0,0,0,0
7.362,6,1512,1245195,813,1431,8,1448,1195843,699,776,10,1448,49352
0.114,17,2,348,1,39,0,39,67,1,253,0,253,281
1671.849,1,7,742,7,78,278641,78,742,0,0,0,0,0
440.062,17,16,1538,16,68,29337,355,1538,0,0,0,0,0
75.307,6,21,860,10,0,5450,0,404,11,0,7526,0,456
11.154,6,97,28298,50,538,227,1152,21920,47,408,236,1152,6378
1794.124,1,58,4872,58,56,31475,56,4872,0,0,0,0,0
1770.85,6,99,9174,66,64,27243,64,5544,33,58,55335,58,3630
1770.569,1,49,4116,49,56,36886,56,4116,0,0,0,0,0
0.505,6,22,7345,13,334,42,663,2021,9,1209,59,1946,5324
1.659,6,19,5908,10,281,184,544,1248,9,716,197,1420,4660
0.049,6,9,1339,5,145,12,145,349,4,826,14,826,990
0.068,6,12,965,6,182,13,182,490,6,77,11,134,475
0.005,17,2,367,1,39,0,39,67,1,272,0,272,300
1772.522,6,180,15480,120,69,14895,69,8940,60,69,30039,69,6540
9.235,6,17,6735,9,275,1154,275,643,8,1440,1126,1440,6092
213.129,6,38,6681,16,230,353,314,2715,22,513,10136,1179,3966
0.033,17,4,608,2,60,16,60,176,2,188,14,188,432
1797.774,6,141,10691,78,83,23347,208,7055,63,31,28991,31,3636
40.568,6,105,28868,62,162,665,477,8285,43,555,964,1709,20583
1.617,6,41,9968,21,440,80,1360,4392,20,433,73,1360,5576
1772.361,6,180,15480,120,69,14893,69,8940,60,69,30039,69,6540
0.037,17,2,247,1,36,0,36,64,1,155,0,155,183
223.099,6,36,11598,20,516,11742,1360,4458,16,648,14861,2720,7140
1777.866,17,73,3060,72,14,25040,14,3024,1,8,0,8,36
0.074,1,2,112,2,28,74,28,112,0,0,0,0,0
1795.963,1,58,4872,58,56,31508,56,4872,0,0,0,0,0
280.638,6,30,7432,13,158,23386,267,1317,17,543,17536,1400,6115
1.675,6,14,2351,8,188,239,245,700,6,703,283,1152,1651
24.389,6,9,527,5,43,6097,43,311,4,0,8123,0,216
50.002,17,13,610,12,15,4545,58,526,1,56,0,56,84
20.403,6,25,6569,15,117,1457,159,1401,10,773,2265,1675,5168
0.154,6,11,1739,6,126,30,126,386,5,1149,28,1149,1353
1785.856,6,371,25810,215,99,8345,469,15154,156,69,11521,69,10656
309.635,6,74,13120,35,266,9106,1189,5138,39,291,5754,1460,7982
241.217,6,125,119354,57,562,4307,1402,7474,68,1969,3600,5474,111880
0.857,6,2,87,1,0,0,0,40,1,7,0,7,47
1743.963,6,97,7307,62,38,28589,205,4424,35,33,51285,98,2883
54.986,6,43,8878,22,410,414,882,2178,21,389,2742,2720,6700
9.212,6,19,2788,8,310,1314,666,1878,11,231,920,231,910
280.373,6,29,7392,13,158,23364,267,1317,16,678,18689,2085,6075
202.721,6,46,12596,25,733,8439,1360,6909,21,371,10127,1360,5687
181.917,17,9,684,9,48,22739,48,684,0,0,0,0,0
1800.0,6,213,16466,79,69,22692,314,7786,134,48,13533,78,8680
1781.764,6,371,25810,215,99,8325,469,15154,156,69,11495,69,10656
286.713,6,33,3365,16,324,19113,585,1525,17,192,17918,580,1840
1782.283,17,83,3480,82,14,22003,14,3444,1,8,0,8,36
3.907,17,5,295,5,31,976,31,295,0,0,0,0,0
1789.948,6,365,24963,212,94,8483,469,14496,153,69,11775,69,10467
1787.242,6,356,22520,208,69,8634,69,12460,148,69,12156,69,10060
1790.275,6,355,22480,207,69,8690,69,12420,148,69,12178,69,10060
1799.069,1,58,4872,58,56,31562,56,4872,0,0,0,0,0
1799.842,1,57,4788,57,56,32140,56,4788,0,0,0,0,0
0.811,17,3,1170,3,362,405,362,1170,0,0,0,0,0
5.684,6,38,7229,20,218,299,314,3423,18,513,318,1179,3806
0.062,17,2,176,1,48,0,48,76,1,72,0,72,100
1771.842,6,99,9306,66,66,27259,66,5610,33,60,55367,60,3696
1787.951,6,356,22520,208,69,8637,69,12460,148,69,12162,69,10060
0.205,6,10,1378,5,145,51,145,349,5,825,30,825,1029
0.533,6,7,295,4,0,177,0,164,3,7,160,7,131
19.786,6,69,26300,36,1060,565,1460,19565,33,270,612,2567,6735
1772.875,6,180,15480,120,69,14898,69,8940,60,69,30045,69,6540
1751.459,6,95,7203,63,38,28249,205,4476,32,33,56490,98,2727
0.223,17,8,2758,8,316,31,355,2758,0,0,0,0,0
1774.978,17,140,11200,70,48,25724,48,5320,70,56,25724,56,5880
109.954,6,30,13362,16,560,92,928,4036,14,875,8445,1696,9326
0.77,6,11,1727,7,100,128,100,384,4,589,175,1152,1343
1498.268,1,7,392,7,28,249711,28,392,0,0,0,0,0
1.347,6,12,1106,6,304,269,304,612,6,83,251,83,494
101.963,17,4,240,2,32,101962,32,120,2,32,101962,32,120
2.752,6,27,10845,16,703,183,1408,5766,11,899,269,2816,5079
6.814,6,515,430836,314,1305,21,1368,415720,201,776,33,1473,15116
1.651,6,25,8707,15,275,117,559,1431,10,981,164,1420,7276
10.966,6,86,26509,42,562,267,1152,20251,44,449,248,1179,6258
1.661,6,14,2351,8,188,237,245,700,6,703,281,1152,1651
1798.33,1,345,28980,345,56,5227,56,28980,0,0,0,0,0
0.517,6,128,87733,59,131,8,232,2889,69,1302,7,1430,84844
108.544,6,42,26862,24,729,198,1360,3935,18,1849,6374,8160,22927
1794.2,17,180,11520,180,36,10023,36,11520,0,0,0,0,0
5.1,17,4,288,2,36,5007,36,128,2,52,5068,52,160
293.384,1,4,224,4,28,97794,28,224,0,0,0,0,0
0.388,6,13,1693,7,288,59,288,588,6,426,43,434,1105
0.039,17,4,368,2,32,20,32,120,2,96,0,96,248
1792.294,17,87,3648,86,14,21085,14,3612,1,8,0,8,36
0.555,6,22,8150,13,518,46,912,2239,9,1087,65,2031,5911
1787.206,17,87,3648,86,14,21025,14,3612,1,8,0,8,36
2.076,17,3,174,3,30,1038,30,174,0,0,0,0,0
240.297,6,55,20071,30,858,8285,1418,17026,25,217,10012,580,3045
0.62,6,14,1745,7,288,73,288,600,7,426,72,434,1145
0.024,17,2,334,1,39,0,39,67,1,239,0,239,267
33.577,17,4,240,2,32,33576,32,120,2,32,33576,32,120
1732.217,6,70,5131,44,33,40284,33,3080,26,31,69280,31,2051
1.964,6,26,8809,17,286,122,590,1542,9,1150,225,2130,7267
1798.641,17,448,39896,403,35,4474,288,25676,45,288,40019,288,14220
1772.116,6,180,15480,120,69,14891,69,8940,60,69,30031,69,6540
240.221,6,57,20144,31,818,8007,1418,17178,26,200,9608,580,2966
1.381,6,10,1687,7,100,230,100,384,3,1179,565,1179,1303
12.531,6,13,2133,8,324,1790,585,1073,5,396,3080,580,1060
1.334,6,47,19049,27,882,51,1360,13473,20,476,60,2715,5576
619.392,6,68,8290,38,98,16735,722,3755,30,157,21351,2329,4535
242.482,17,4,352,2,60,242481,60,176,2,60,242481,60,176
1750.815,17,13,534,11,14,175060,14,462,2,8,1750632,8,72
0.111,17,2,136,1,32,0,32,60,1,48,0,48,76
7.46,17,4,352,2,60,7458,60,176,2,60,7458,60,176
2.826,6,2,80,1,0,0,0,40,1,0,0,0,40
0.006,17,2,443,1,37,0,37,65,1,350,0,350,378
54.474,6,27,7177,13,155,4539,267,1306,14,530,4189,3417,5871
1680.984,1,15,840,15,28,120070,28,840,0,0,0,0,0
1771.997,1,8,448,8,28,253142,28,448,0,0,0,0,0
10.232,6,47,8830,25,227,426,314,4182,22,470,475,1179,4648
1746.092,6,95,7203,63,38,28162,205,4476,32,33,56312,98,2727
125.817,6,17,6337,9,275,15727,275,639,8,895,17885,2760,5698
0.004,6,2,104,1,0,0,0,40,1,0,0,0,64
1798.12,6,367,25112,213,94,8481,469,14536,154,69,11751,69,10576
1782.337,6,102,8296,68,65,26602,65,4930,34,59,54007,59,3366
14.965,6,2798,2517716,1659,1428,8,1448,2446936,1139,776,12,1448,70780
721.961,2,10,320,10,8,80217,8,320,0,0,0,0,0
4.582,6,741,629182,445,1374,10,1420,613121,296,467,15,1883,16061
1680.553,17,12,498,11,14,168055,14,462,1,8,0,8,36
0.132,17,2,778,2,361,132,361,778,0,0,0,0,0
280.192,6,29,7392,13,158,23349,267,1317,16,603,18678,2800,6075
1779.269,17,140,11200,70,48,25786,48,5320,70,56,25786,56,5880
7.153,6,8,448,4,0,2327,0,240,4,0,2327,0,208
0.531,6,22,6082,11,298,52,521,1775,11,745,51,1448,4307
1792.737,6,360,22818,209,69,8618,69,12638,151,69,11951,69,10180
0.149,17,2,154,1,33,0,33,61,1,65,0,65,93
140.667,6,23,11278,12,433,84,990,1823,11,1286,14051,3928,9455
0.216,6,12,3705,6,171,42,171,491,6,964,42,1448,3214
90.263,6,18,5839,10,784,10029,1360,3538,8,247,12860,272,2301
300.251,6,33,11985,18,593,17661,1408,4527,15,833,17178,1578,7458
1.702,6,25,8761,15,284,121,586,1458,10,985,170,1420,7303
1744.729,17,21,6847,21,298,87236,893,6847,0,0,0,0,0
1740.462,17,30,31680,30,1028,60015,1028,31680,0,0,0,0,0
1771.972,6,180,15480,120,69,14890,69,8940,60,69,30032,69,6540
280.07,6,27,7312,12,158,25460,267,1277,15,678,20000,2800,6035
6.771,6,53,9629,27,219,260,314,4821,26,470,260,1179,4808
1686.964,6,119,19302,72,92,23760,722,7414,47,400,19601,2535,11888
1798.269,1,345,28980,345,56,5227,56,28980,0,0,0,0,0
0.776,17,2,136,1,32,0,32,60,1,48,0,48,76
9.228,6,85,27034,44,563,214,1152,20912,41,447,224,1179,6122
1729.22,6,61,4452,40,33,44338,33,2740,21,31,86451,31,1712
81.661,6,742,378898,423,838,193,1152,361347,319,398,255,1152,17551
1740.592,17,30,7050,30,207,60020,207,7050,0,0,0,0,0
3.347,6,8,436,4,0,1115,0,216,4,0,1056,0,220
1768.785,1,58,4872,0,0,0,0,0,58,56,31031,56,4872
183.37,6,60,39458,39,1138,4825,1408,31625,21,841,3070,2439,7833
280.555,6,30,7432,13,158,23379,267,1317,17,543,17531,1400,6115
29.443,17,20,12070,10,663,3271,1350,6913,10,487,42,1350,5157
1.416,6,52,21265,29,898,50,1360,15569,23,433,55,1360,5696
1.32,6,51,21215,28,957,48,1440,15519,23,433,52,1440,5696
0.453,6,20,7165,13,318,37,599,1957,7,1209,74,1906,5208
67.427,6,167,173169,113,430,602,647,7258,54,3197,1253,16896,165911
1772.201,6,180,15480,120,69,14892,69,8940,60,69,30035,69,6540
160.972,17,4,352,2,60,160971,60,176,2,60,160970,60,176
1740.433,17,28,29512,28,1026,64460,1026,29512,0,0,0,0,0
1799.423,17,62,20832,62,308,29498,308,20832,0,0,0,0,0
1752.89,6,130,8587,74,55,24012,208,5386,56,31,31863,31,3201
300.643,6,38,8566,20,315,15823,882,2093,18,441,499,1360,6473
300.284,6,35,18329,21,981,15014,1448,12881,14,785,1873,1448,5448
9.703,6,9,527,5,43,2425,43,311,4,0,3227,0,216
298.628,1,4,224,4,28,99542,28,224,0,0,0,0,0
0.205,17,2,194,1,61,0,61,89,1,77,0,77,105
0.287,17,2,241,1,36,0,36,64,1,149,0,149,177
240.182,6,54,17384,29,766,8577,1408,14552,25,190,10007,580,2832
1799.426,6,356,22520,208,69,8692,69,12460,148,69,12239,69,10060
5.239,6,35,6225,20,206,275,314,2864,15,551,356,1179,3361
2.571,6,14,2351,8,188,367,245,700,6,703,463,1152,1651
6.525,6,10,1102,6,483,1305,483,803,4,83,2172,83,299
1682.676,17,14,1036,7,30,280438,30,406,7,62,280440,62,630
8.426,6,76,24613,39,561,221,1152,18976,37,461,226,1179,5637
1787.496,6,102,8296,68,65,26679,65,4930,34,59,54162,59,3366
1771.217,6,99,9174,66,64,27249,64,5544,33,58,55347,58,3630
11.282,6,18,4266,10,275,1253,275,958,8,992,927,1440,3308
34.138,17,3,228,3,48,17069,48,228,0,0,0,0,0
1787.907,6,358,22669,209,69,8594,69,12500,149,69,12080,69,10169
1789.184,1,212,11872,212,28,8479,28,11872,0,0,0,0,0
1770.456,6,99,9240,66,65,27237,65,5577,33,59,55323,59,3663
1.713,6,12,1304,6,256,341,256,756,6,304,341,304,548
1740.292,6,100,7256,64,31,27623,31,4356,36,31,49721,31,2900
0.726,6,4,490,2,0,726,0,80,2,165,0,261,410
13.714,6,28,4918,13,154,1125,722,1766,15,338,967,1448,3152
36.277,6,13,780,4,0,2336,0,240,9,0,4533,0,540
1775.346,17,140,11200,70,48,25729,48,5320,70,56,25729,56,5880
0.572,6,22,7376,14,273,44,663,2104,8,1612,75,3314,5272
10.614,17,4,824,2,48,10596,48,152,2,308,10596,308,672
31.145,17,4,352,2,48,31136,48,152,2,72,31136,72,200
64.533,6,40,25787,19,840,40,1460,5847,21,1193,3219,1460,19940
181.163,6,4707,4106999,2825,1366,64,1368,3995177,1882,899,96,1473,111822
380.684,2,6,192,6,8,76136,8,192,0,0,0,0,0
65.864,6,42,21883,24,1062,2863,1408,11925,18,901,3864,2825,9958
7.956,6,21,6603,7,140,1326,267,849,14,576,608,1420,5754
240.221,6,54,17976,29,765,8579,1418,15301,25,170,10008,580,2675
194.135,1,3,348,3,88,97067,88,348,0,0,0,0,0
0.766,6,24,6239,13,268,62,679,1865,11,786,74,1460,4374
1738.301,17,30,10080,30,308,59941,308,10080,0,0,0,0,0
368.29,6,18,1242,14,180,28330,180,916,4,110,20061,110,326
1799.74,6,363,24414,212,88,8529,469,14027,151,69,11996,69,10387
1457.668,6,72,5236,35,36,42869,36,1964,37,449,40488,458,3272
4.853,6,43,8329,21,227,242,314,4022,22,427,218,1152,4307
12.448,6,92,27297,47,536,270,1152,20674,45,438,276,1179,6623
75.576,6,31,7613,12,155,28,267,1266,19,398,4198,3417,6347
1664.531,1,8,448,8,28,237790,28,448,0,0,0,0,0
126.296,1,4,224,4,28,42098,28,224,0,0,0,0,0
447.667,17,10,3360,10,308,49740,308,3360,0,0,0,0,0
1796.696,6,282,35864,114,140,15898,1460,16983,168,141,10757,1642,18881
1.44,6,47,18725,27,859,55,1360,13149,20,476,66,2715,5576
10.086,6,23,5271,12,351,916,1382,2242,11,430,1006,1420,3029
1.533,6,24,9050,13,422,127,1205,2374,11,1219,132,2491,6676
13.139,6,1559,1302721,873,1399,14,1448,1257149,686,776,18,1448,45572
300.564,6,44,8904,22,286,14312,766,2116,22,346,607,2128,6788
7.638,17,6,528,3,48,3791,48,228,3,72,3740,72,300
5.538,6,41,8517,20,218,291,314,3423,21,607,263,1179,5094
8.038,6,71,21742,36,540,229,1152,16574,35,470,227,1179,5168
0.24,6,19,6262,10,268,26,517,1322,9,744,17,1418,4940
0.335,17,2,360,1,128,0,128,156,1,176,0,176,204
3.916,17,4,268,4,39,1305,39,268,0,0,0,0,0
831.323,1,8,448,8,28,118760,28,448,0,0,0,0,0
12.484,17,4,240,2,32,12483,32,120,2,32,12483,32,120
3.074,17,4,368,4,64,1024,64,368,0,0,0,0,0
42.684,17,24,2112,12,48,3879,48,912,12,72,3879,72,1200
8.305,6,1695,1563795,1046,1415,7,1448,1525383,649,776,12,1448,38412
0.858,6,10,1687,7,100,143,100,384,3,1179,296,1179,1303
15.491,17,12,5166,6,490,3083,1350,3110,6,314,3081,1350,2056
280.467,6,29,7392,13,158,23372,267,1317,16,603,18696,2036,6075
0.632,6,10,924,5,283,116,283,551,5,105,116,105,373
13.729,17,8,704,4,48,4571,48,304,4,72,4572,72,400
0.255,6,21,5000,10,137,28,267,1092,11,577,24,1400,3908
61.307,6,37,15868,22,793,2919,1448,9089,15,665,4361,1448,6779
176.471,6,22,8876,11,499,94,1193,1971,11,921,17629,1460,6905
1.949,17,2,178,1,29,0,29,57,1,93,0,93,121
65.448,6,25,7097,12,155,5949,267,1266,13,589,5453,3426,5831
234.163,1,4,224,4,28,78054,28,224,0,0,0,0,0
0.929,6,10,1687,7,100,154,100,384,3,1179,334,1179,1303
6.797,6,64,20526,34,559,205,1152,15899,30,489,225,1179,4627
85.183,6,10374,9887335,6733,1389,12,1440,9693339,3641,776,23,1440,193996
1795.809,17,80,3354,79,14,23023,14,3318,1,8,0,8,36
1789.076,1,58,4872,0,0,0,0,0,58,56,31387,56,4872
300.72,6,39,9955,21,593,15036,1360,4433,18,435,509,2667,5522
9.18,6,85,27855,43,587,218,1152,21693,42,447,217,1179,6162
1778.905,6,384,31005,172,94,10402,1360,16951,212,50,8430,162,14054
0.022,17,2,247,1,42,0,42,70,1,149,0,149,177
841.391,17,8,592,4,30,280448,30,232,4,62,280463,62,360
1787.449,6,102,8228,68,64,26678,64,4896,34,58,54162,58,3332
17.945,6,12,1304,3,69,8971,69,189,9,107,2243,341,1115
3.778,6,11,467,6,0,755,0,248,5,7,691,7,219
280.454,6,28,7352,13,158,23371,267,1317,15,775,20030,3465,6035
10.083,6,85,25170,44,550,234,1152,19389,41,459,246,1179,5781
1775.265,6,180,15480,120,69,14918,69,8940,60,69,30081,69,6540
133.777,6,25,1020,11,0,13377,0,444,14,0,10289,0,576
1788.168,17,83,3480,82,14,22076,14,3444,1,8,0,8,36
51.876,17,16,18211,16,1110,3458,1451,18211,0,0,0,0,0
300.545,6,18,1227,5,177,75093,177,445,13,110,25031,110,782
10.249,6,26,11484,10,275,1138,275,954,16,760,518,1440,10530
1772.727,6,180,15480,120,69,14896,69,8940,60,69,30041,69,6540
6.096,6,32,6089,17,206,381,314,2744,15,548,399,1179,3345
0.253,6,9,1002,5,213,63,213,417,4,421,66,421,585
79.87,17,4,240,2,32,79869,32,120,2,32,79869,32,120
8.678,6,17,1375,8,222,1232,222,768,9,231,1080,231,607
240.312,6,45,9087,23,524,10922,1418,5921,22,223,11442,617,3166
11.222,6,26,9953,13,275,935,275,1078,13,1042,686,1440,8875
1755.649,6,204,13977,102,67,17382,208,8998,102,31,17380,31,4979
659.861,2,6,192,6,8,131972,8,192,0,0,0,0,0
0.056,17,2,198,1,37,0,37,65,1,105,0,105,133
1799.591,17,447,39296,403,35,4476,288,25392,44,288,40953,288,13904
4.992,17,4,558,2,36,4987,36,128,2,187,4986,187,430
378.197,2,4,128,4,8,126065,8,128,0,0,0,0,0
0.03,17,2,554,1,30,0,30,58,1,468,0,468,496
1799.069,6,130,8180,74,44,24644,208,4700,56,31,32704,31,3480
204.349,6,33,7095,18,171,12020,517,1790,15,645,13968,2416,5305
6.248,6,24,4542,13,213,520,597,1741,11,552,603,1767,2801
0.006,17,2,376,1,39,0,39,67,1,281,0,281,309
1.166,6,11,976,5,283,249,283,551,6,105,199,105,425
1764.752,2,14,448,14,8,135750,8,448,0,0,0,0,0
679.15,6,84,11306,42,154,16564,722,6498,42,187,16560,1440,4808
1777.575,17,73,3060,72,14,25036,14,3024,1,8,0,8,36
0.023,17,2,368,1,37,0,37,65,1,275,0,275,303
5.028,17,4,288,2,36,4997,36,128,2,52,4996,52,160
1.398,6,50,19000,29,865,49,1360,13339,21,437,60,2720,5661
27.425,17,12,3420,12,257,2493,390,3420,0,0,0,0,0
153.898,17,4,240,2,32,153897,32,120,2,32,153897,32,120
1786.111,6,110,8664,70,64,25885,64,4976,40,58,45794,58,3688
1772.965,6,180,15480,120,69,14898,69,8940,60,69,30048,69,6540
0.103,6,3,144,2,0,94,0,104,1,0,0,0,40
1749.594,6,95,7203,63,38,28219,205,4476,32,33,56427,98,2727
1780.148,1,27,3180,27,89,68467,113,3180,0,0,0,0,0
1794.13,6,121,7634,70,44,25999,208,4509,51,31,35879,31,3125
316.947,6,117,36548,60,541,5371,1360,25193,57,302,5657,2720,11355
225.368,17,4,352,2,60,225366,60,176,2,60,225367,60,176
4.002,6,13,551,6,0,800,0,248,7,7,513,7,303
240.207,6,56,18436,31,806,8006,1402,15373,25,219,10008,580,3063
1.383,6,40,9928,21,440,69,1360,4392,19,476,66,2720,5536
107.248,6,59,18080,26,311,4284,1185,3943,33,556,3314,1440,14137
1.378,6,25,8056,12,164,106,267,1288,13,869,98,1368,6768
183.302,6,31,8912,15,158,13093,267,1397,16,763,12215,2800,7515
61.65,17,4,240,2,32,61649,32,120,2,32,61649,32,120
4.126,6,23,2508,11,222,411,222,1558,12,231,372,231,950
0.126,17,8,2758,8,316,18,355,2758,0,0,0,0,0
617.745,6,77,14336,32,159,19927,971,4031,45,257,14035,3089,10305
1.701,17,3,1480,1,300,0,300,328,2,548,90,548,1152
0.111,17,2,672,2,308,111,308,672,0,0,0,0,0
1792.539,17,177,11328,177,36,10184,36,11328,0,0,0,0,0
1795.404,17,448,39896,403,35,4466,288,25676,45,288,40018,288,14220
19.117,17,27,14079,14,746,1468,1350,10846,13,220,1590,1350,3233
0.816,6,4,191,2,0,36,0,80,2,31,400,31,111
0.914,6,10,1687,7,100,152,100,384,3,1179,324,1179,1303
21.56,6,26,4112,13,179,1796,517,1772,13,411,1792,499,2340
30.239,6,4333,3948985,2616,1421,11,1448,3844101,1717,776,17,1448,104884
33.713,6,31,5294,15,154,2408,722,1858,16,371,2235,2026,3436
1786.849,6,104,8376,68,65,26669,65,4930,36,59,51048,59,3446
629.938,2,5,160,5,8,157484,8,160,0,0,0,0,0
20.633,6,28,7373,15,200,1473,411,1812,13,695,1718,1402,5561
196.3,17,2,122,2,33,196300,33,122,0,0,0,0,0
2.436,17,26,10289,11,485,243,1350,5649,15,281,125,1350,4640
1798.9,17,444,39768,399,36,4519,288,25548,45,288,40021,288,14220
38.461,17,44,6468,22,48,1829,48,1672,22,190,1828,308,4796
1770.957,6,101,9344,66,65,27245,65,5577,35,59,52084,59,3767
0.209,1,2,112,2,28,209,28,112,0,0,0,0,0
1795.704,17,448,39896,403,35,4466,288,25676,45,288,40030,288,14220
1608.524,1,8,448,8,28,229789,28,448,0,0,0,0,0
1.441,6,10,1197,5,279,317,279,547,5,191,317,272,650
5.172,6,42,8305,21,227,258,314,4022,21,491,245,1179,4283
33.577,17,18,6141,8,414,4792,1350,3537,10,232,3727,1350,2604
0.008,6,2,80,1,0,0,0,40,1,0,0,0,40
1795.814,17,448,39896,403,35,4467,288,25676,45,288,40012,288,14220
15.157,17,21,13005,12,855,1374,1350,10601,9,239,1890,1350,2404
7.387,6,6,324,2,0,7387,0,100,4,0,2403,0,224
1772.081,6,180,15480,120,69,14891,69,8940,60,69,30033,69,6540
1786.912,17,310,66839,310,187,5782,422,66839,0,0,0,0,0
82.171,6,13,1474,5,302,20542,302,860,8,83,11730,83,614
1.321,6,25,8056,12,164,102,267,1288,13,869,93,1448,6768
0.004,17,8,1670,8,180,0,219,1670,0,0,0,0,0
5.359,6,5,264,3,0,2679,0,160,2,0,1011,0,104
11.869,6,17,2449,11,211,1186,211,1050,6,545,2373,904,1399
1764.906,2,15,480,15,8,126064,8,480,0,0,0,0,0
4.263,6,40,7309,20,218,224,314,3423,20,513,211,1179,3886
1790.855,6,356,22520,208,69,8651,69,12460,148,69,12182,69,10060
11.746,1,8,832,0,0,0,0,0,8,76,1678,76,832
125.674,6,14,3143,7,92,20945,92,452,7,464,20863,1408,2691
0.022,17,2,279,1,36,0,36,64,1,187,0,187,215
0.108,17,2,572,1,39,0,39,67,1,477,0,477,505
5.485,6,27,7010,14,282,421,613,2699,13,725,441,1767,4311
1791.805,17,87,3648,86,14,21080,14,3612,1,8,0,8,36
1.308,6,10,1687,7,100,218,100,384,3,1179,524,1179,1303
1.472,6,3,168,1,0,0,0,52,2,0,1472,0,116
8.535,6,17,6735,9,275,1066,275,643,8,1440,974,1440,6092
0.81,6,28,5893,14,123,62,267,1428,14,650,56,1414,4465
0.439,6,26,7751,16,339,29,949,3017,10,721,47,1420,4734
1789.282,17,83,3480,82,14,22089,14,3444,1,8,0,8,36
0.502,17,2,384,1,39,0,39,67,1,289,0,289,317
371.926,6,27,1767,18,177,21878,177,1181,9,110,8665,110,586
3.824,17,8,1176,4,48,1271,48,304,4,190,1271,308,872
300.661,6,46,8907,23,266,13666,720,2078,23,327,586,1460,6829
104.101,6,67,48621,45,1199,2365,1408,40742,22,961,2937,3847,7879
11.847,6,1858,1614383,1139,1363,10,1380,1581381,719,421,16,1923,33002
0.31,6,3,144,2,0,1,0,92,1,0,0,0,52
0.067,17,2,170,1,49,0,49,77,1,65,0,65,93
1756.931,6,110,6608,62,27,28801,27,3668,48,27,37374,27,2940
1781.761,6,366,24603,211,87,8484,469,14056,155,69,11569,69,10547
1789.948,6,370,25701,214,99,8403,469,15114,156,69,11548,69,10587
0.325,6,22,7342,12,335,28,668,1974,10,1210,35,1906,5368
55.368,6,74,16853,37,472,405,787,3601,37,435,1534,1360,13252
240.181,6,53,18035,28,806,8895,1402,15187,25,192,10007,580,2848
0.116,6,12,3462,6,75,23,75,395,6,1373,23,1448,3067
1.91,17,22,7258,10,321,208,1350,3494,12,285,170,1350,3764
372.228,6,18,1242,14,180,28632,180,916,4,110,20070,110,326
0.139,17,2,411,1,33,0,33,61,1,322,0,322,350
20.287,17,16,5077,7,381,3375,1350,2868,9,217,2531,1350,2209
68.072,6,47,9485,17,339,203,882,2092,30,268,2342,1440,7393
1798.03,6,356,22520,208,69,8686,69,12460,148,69,12231,69,10060
242.228,6,53,10307,24,179,10531,564,3097,29,435,8650,1418,7210
0.405,6,6,324,4,0,135,0,216,2,0,232,0,108
1781.521,6,354,22440,207,69,8648,69,12420,147,69,12202,69,10020
1764.579,2,15,480,15,8,126041,8,480,0,0,0,0,0
11.475,6,28,11413,14,275,882,275,1118,14,1080,846,1420,10295
1.668,6,13,2311,8,188,238,245,700,5,1407,354,1407,1611
0.432,6,6,324,4,0,144,0,216,2,0,254,0,108
1.339,6,40,9928,21,440,66,1360,4392,19,476,63,2720,5536
1773.281,6,182,15698,120,69,14901,69,8940,62,69,29064,69,6758
12.762,6,2419,2293995,1573,1381,7,1408,2245339,846,931,14,2816,48656
1.598,6,52,19598,29,903,57,1460,13857,23,400,62,1460,5741
10.136,6,86,26829,45,555,230,1152,20707,41,447,246,1179,6122
1789.165,17,144,11520,72,48,25199,48,5472,72,56,25199,56,6048
1682.807,17,14,1036,7,30,280458,30,406,7,62,280462,62,630
38.057,17,22,1672,22,48,1812,48,1672,0,0,0,0,0
1734.821,6,91,7202,58,65,30435,65,4140,33,58,54210,59,3062
8.174,6,68,20558,36,554,233,1152,15851,32,427,255,1152,4707
96.053,6,43,10399,14,144,7388,267,2017,29,360,3430,1420,8382
1461.112,6,93,7566,61,66,24351,66,4486,32,60,47129,60,3080
1777.384,17,84,3522,83,14,21675,14,3486,1,8,0,8,36
2.62,6,13,2311,8,188,374,245,700,5,1407,575,1407,1611
9.188,6,8,440,3,0,4594,0,164,5,0,2248,0,276
1.294,6,49,19966,28,879,47,1360,14350,21,433,55,1360,5616
0.903,6,23,6433,13,315,74,913,2099,10,982,98,1699,4334
0.319,17,8,2742,8,314,45,353,2742,0,0,0,0,0
1799.033,6,368,26031,213,92,8486,469,14440,155,80,11678,453,11591
5.749,6,40,7309,21,218,287,314,3463,19,513,304,1179,3846
1682.762,17,14,1036,7,30,280452,30,406,7,62,280452,62,630
7.847,6,1797,1581753,1035,1438,7,1448,1532653,762,776,10,1448,49100
1797.034,17,142,11360,71,48,25671,48,5396,71,56,25671,56,5964
0.011,17,2,390,1,30,0,30,58,1,304,0,304,332
1750.998,17,12,498,11,14,175099,14,462,1,8,0,8,36
240.188,6,54,17976,29,786,8577,1418,14879,25,223,10007,580,3097
4.009,17,8,616,4,33,1333,33,244,4,65,1333,65,372
0.035,17,2,136,1,32,0,32,60,1,48,0,48,76
1601.317,6,260,43576,139,304,11603,304,30692,121,83,13333,83,12884
0.257,6,22,4442,11,165,25,456,1394,11,493,24,888,3048
252.336,2,2,64,2,8,252336,8,64,0,0,0,0,0
1783.812,6,358,22738,208,69,8617,69,12460,150,69,11971,69,10278
4.184,17,5,290,5,30,1046,30,290,0,0,0,0,0
1.004,17,2,685,1,308,0,308,336,1,321,0,321,349
0.38,6,27,8920,13,227,31,547,1592,14,941,26,1408,7328
65.034,6,12,976,4,226,123,226,442,8,110,9264,110,534
5.776,6,19,3445,10,211,641,211,986,9,665,721,904,2459
25.129,17,4,352,2,60,25127,60,176,2,60,25127,60,176
0.027,17,7,2445,7,321,4,355,2445,0,0,0,0,0
683.026,6,56,8731,35,103,20089,500,2960,21,273,34146,1420,5771
16.615,17,17,7043,8,533,2364,1350,4494,9,255,2066,1350,2549
4.296,6,718,600506,423,1384,10,1420,584485,295,420,14,1420,16021
1.351,6,50,19207,28,949,50,1460,13506,22,400,56,1460,5701
0.058,6,10,1514,5,503,14,503,771,5,475,14,475,743
0.609,6,20,7229,13,334,50,663,2021,7,1209,94,1946,5208
1744.445,6,95,7203,63,38,28136,205,4476,32,33,56257,98,2727
15.72,17,26,15531,15,832,1116,1350,12906,11,210,1566,1350,2625
192.0,6,4,574,4,103,64000,138,574,0,0,0,0,0
1774.124,6,128,7817,69,27,26089,27,4161,59,27,30587,27,3656
2.329,6,56,20625,29,965,83,1440,14724,27,400,82,1440,5901
1635.913,1,7,392,7,28,272652,28,392,0,0,0,0,0
661.789,2,9,288,9,8,82723,8,288,0,0,0,0,0
252.259,17,4,272,2,32,252252,32,120,2,48,252252,48,152
0.013,17,2,570,1,30,0,30,58,1,484,0,484,512
1306.643,6,51,5068,31,124,43548,1448,3606,20,31,68760,31,1462
376.825,17,12,4136,12,316,34256,376,4136,0,0,0,0,0
287.19,6,44,5594,18,162,5334,517,2093,26,133,11487,880,3501
241.627,6,62,8909,28,171,8948,585,3585,34,219,7320,705,5324
0.291,6,27,9047,13,252,24,647,1692,14,945,22,1408,7355
3.857,17,2,152,2,48,3857,48,152,0,0,0,0,0
0.403,17,4,580,2,40,385,40,136,2,194,384,194,444
0.529,6,25,6080,13,108,44,147,959,12,772,44,1608,5121
184.002,17,6,1952,6,297,36800,308,1952,0,0,0,0,0
0.08,17,4,420,2,33,1,33,122,2,121,31,145,298
11.833,6,24,8413,13,275,986,275,1078,11,1147,941,2840,7335
1.391,6,24,8004,12,164,108,267,1288,12,1014,106,2491,6716
109.883,17,4,240,2,32,109882,32,120,2,32,109882,32,120
7.373,6,1758,1630946,1113,1387,6,1408,1592730,645,776,11,1408,38216
116.441,6,37,8701,12,155,663,267,1266,25,306,4851,1420,7435
1.031,6,213,190773,107,335,9,335,7643,106,1741,9,2736,183130
1799.43,1,16,896,16,28,119962,28,896,0,0,0,0,0
401.522,6,18,1242,14,180,30886,180,916,4,110,20068,110,326
1770.973,6,103,9448,66,65,27245,65,5577,37,59,49191,59,3871
299.819,6,63,19094,30,888,10332,1460,8460,33,442,9363,1460,10634
1783.808,6,370,25770,214,99,8374,469,15114,156,69,11508,69,10656
337.399,6,103,14432,49,159,6037,1189,5153,54,284,6362,2920,9279
23.18,6,23,7617,13,261,1931,467,1469,10,802,2534,1408,6148
1742.647,1,49,4116,49,56,36305,56,4116,0,0,0,0,0
265.765,6,31,8912,14,158,20443,267,1357,17,687,16602,1781,7555
1.998,6,14,2351,8,188,285,245,700,6,703,349,1152,1651
87.254,6,23,11278,12,433,71,990,1823,11,1286,8712,3928,9455
176.482,17,2,368,2,156,176482,156,368,0,0,0,0,0
755.822,2,6,192,6,8,151164,8,192,0,0,0,0,0
0.008,17,2,350,1,39,0,39,67,1,255,0,255,283
1799.764,17,764,46132,764,32,2358,37,46132,0,0,0,0,0
541.448,2,7,224,7,8,90241,8,224,0,0,0,0,0
114.72,17,4,352,2,60,114719,60,176,2,60,114719,60,176
28.358,6,46,13845,22,315,1350,721,3409,24,676,1188,1440,10436
1797.934,6,357,22629,208,69,8685,69,12460,149,69,12148,69,10169
1740.404,17,30,7050,30,207,60013,207,7050,0,0,0,0,0
1.723,6,13,2311,8,188,246,245,700,5,1407,363,1407,1611
11.634,6,1817,1591918,1102,1389,10,1420,1559097,715,467,16,1883,32821
1788.52,17,87,3648,86,14,21041,14,3612,1,8,0,8,36
0.015,17,2,245,1,32,0,32,60,1,157,0,157,185
0.838,6,17,5164,9,150,104,174,664,8,835,103,1452,4500
1.721,6,26,8108,13,164,127,267,1340,13,869,126,1368,6768
129.711,17,4,352,2,60,129710,60,176,2,60,129710,60,176
13.284,17,4,824,2,48,13274,48,152,2,308,13270,308,672
0.005,17,2,442,1,35,0,35,63,1,351,0,351,379
1795.651,17,83,3480,82,14,22168,14,3444,1,8,0,8,36
2.346,17,2,677,1,300,0,300,328,1,321,0,321,349
1720.48,17,13,534,11,14,172048,14,462,2,8,172024,8,72
1741.275,6,87,6322,58,31,30548,31,3915,29,31,62187,31,2407
16.252,1,2,112,2,28,16252,28,112,0,0,0,0,0
7.107,6,1486,1382391,949,1380,7,1408,1349803,537,931,12,2801,32588
1.403,6,38,8252,19,320,77,1162,2716,19,476,67,2715,5536
0.426,6,13,1693,7,288,67,288,588,6,426,45,434,1105
300.286,6,23,8334,14,401,23098,1018,2341,9,919,12613,2899,5993
0.188,17,2,172,1,50,0,50,78,1,66,0,66,94
0.2,6,20,6553,9,181,19,267,1088,11,836,19,2045,5465
35.856,17,2,672,2,308,35856,308,672,0,0,0,0,0
10.749,6,20,4442,11,275,1074,275,998,9,768,747,1440,3444
0.205,6,28,7336,13,155,17,267,1301,15,543,12,1400,6035
1798.848,6,356,22520,208,69,8690,69,12460,148,69,12236,69,10060
7.948,6,683,579970,419,1316,18,1368,561578,264,776,29,2736,18392
0.318,17,2,154,1,41,0,41,69,1,57,0,57,85
235.512,17,4,352,2,60,235511,60,176,2,60,235511,60,176
377.272,6,21,1419,15,177,26948,177,989,6,110,12264,110,430
249.841,1,4,224,4,28,83280,28,224,0,0,0,0,0
32.675,6,2830,2626901,1782,1392,18,1448,2564581,1048,776,30,1448,62320
1787.036,6,104,8376,68,65,26672,65,4930,36,59,51054,59,3446
1.331,6,47,19496,27,914,51,1360,13920,20,476,60,2715,5576
1786.207,6,151,19497,90,302,20069,302,13752,61,83,29770,83,5745
1775.406,6,180,15480,120,69,14919,69,8940,60,69,30082,69,6540
617.287,1,7,420,7,32,102881,32,420,0,0,0,0,0
230.834,6,176,143016,116,1281,2007,1368,130381,60,679,1945,2519,12635
13.85,6,113,33570,57,555,247,1152,26166,56,430,247,1179,7404
129.073,6,867,393337,441,824,293,1152,371165,426,427,303,1179,22172
0.008,6,2,172,1,0,0,0,40,1,92,0,92,132
243.644,6,57,19938,29,840,8701,1408,16650,28,182,9023,580,3288
1799.754,1,198,11088,198,28,9135,28,11088,0,0,0,0,0
367.029,17,26,2064,15,48,26216,48,1140,11,56,26208,56,924
0.263,6,11,1170,6,135,51,135,379,5,587,63,587,791
1788.405,1,62,5208,62,56,29318,56,5208,0,0,0,0,0
0.486,6,32,7856,18,456,28,1408,5508,14,230,36,580,2348
209.024,6,85,56169,50,1216,4265,1368,47614,35,840,1815,2519,8555
0.177,6,2,592,1,512,0,512,552,1,0,0,0,40
139.087,17,4,240,2,32,139086,32,120,2,32,139086,32,120
1786.97,6,102,8296,68,65,26671,65,4930,34,59,54146,59,3366
1.678,1,10,280,10,0,0,0,280,0,0,0,0,0
1795.21,17,447,39864,402,35,4476,288,25644,45,288,40019,288,14220
4.378,6,5,280,2,0,4378,0,100,3,0,1513,0,180
1794.803,1,127,7112,127,28,14244,28,7112,0,0,0,0,0
0.432,6,51,21179,28,991,16,1380,16017,23,421,17,1923,5162
1787.383,6,104,8376,68,65,26677,65,4930,36,59,51063,59,3446
1681.615,17,16,1265,8,30,240222,37,471,8,71,240224,136,794
1793.016,17,144,11520,72,48,25253,48,5472,72,56,25253,56,6048
2.646,6,6,328,4,0,882,0,216,2,0,2635,0,112
1786.327,6,102,8228,68,64,26661,64,4896,34,58,54128,58,3332
0.004,17,2,554,1,30,0,30,58,1,468,0,468,496
346.779,6,36,3096,21,69,17338,69,1530,15,69,24554,69,1566
4.055,17,5,588,4,64,1289,64,368,1,192,0,192,220
1.008,6,10,1687,7,100,168,100,384,3,1179,371,1179,1303
1787.195,6,102,8228,68,64,26674,64,4896,34,58,54155,58,3332
1793.631,17,87,3648,86,14,21101,14,3612,1,8,0,8,36
1740.379,17,30,20190,30,645,60013,645,20190,0,0,0,0,0
1796.691,17,447,39296,404,35,4458,288,25708,43,288,41920,288,13588
0.496,17,8,2750,8,315,70,354,2750,0,0,0,0,0
10.299,6,84,24885,43,560,245,1152,19088,41,415,250,1152,5797
15.227,17,5,380,5,48,3806,48,380,0,0,0,0,0
1744.596,2,30,960,30,8,60158,8,960,0,0,0,0,0
339.467,17,5,1672,5,306,84866,308,1672,0,0,0,0,0
26.531,1,4,224,4,28,8843,28,224,0,0,0,0,0
56.723,6,35,7885,13,155,4726,267,1306,22,316,2700,1420,6579
1770.969,6,99,9240,66,65,27245,65,5577,33,59,55338,59,3663
6.998,17,3,366,3,94,3499,94,366,0,0,0,0,0
3.792,17,26,19516,12,483,344,1350,6141,14,927,131,1350,13375
1782.085,17,73,3060,72,14,25099,14,3024,1,8,0,8,36
1.127,6,32,6300,16,138,75,267,1755,16,650,68,1452,4545
0.528,17,14,6675,7,582,88,1350,4270,7,315,78,1350,2405
1795.324,17,81,3390,79,14,23014,14,3318,2,8,1795146,8,72
619.151,6,67,8168,38,96,16729,722,3723,29,162,22106,1408,4445
0.027,17,2,367,1,39,0,39,67,1,272,0,272,300
1787.164,6,108,8595,69,65,26281,65,4970,39,59,47022,59,3625
2.252,6,4,303,2,0,2252,0,104,2,83,2071,83,199
1.339,6,48,19566,27,917,51,1360,13950,21,433,58,1360,5616
300.435,6,59,44380,37,1297,8345,1448,38260,22,828,1644,1448,6120
2.443,17,375,420328,71,108,34,1350,9682,304,1322,7,1350,410646
1770.182,1,38,3192,38,56,47842,56,3192,0,0,0,0,0
9.495,6,9,527,5,43,2373,43,311,4,0,3130,0,216
2.149,6,10,1102,6,483,429,483,803,4,83,712,83,299
280.205,6,29,7392,13,158,23350,267,1317,16,603,18679,2800,6075
220.183,17,4,304,2,48,220172,48,152,2,48,220173,48,152
240.217,6,56,20359,30,839,8283,1418,17514,26,185,9608,580,2845
1744.916,6,95,7203,63,38,28143,205,4476,32,33,56273,98,2727
223.076,17,4,352,2,60,223075,60,176,2,60,223075,60,176
33.675,17,10,760,10,48,3741,48,760,0,0,0,0,0
3.191,17,5,290,5,30,797,30,290,0,0,0,0,0
1799.651,1,284,30104,284,78,6359,78,30104,0,0,0,0,0
279.328,17,4,352,2,60,279326,60,176,2,60,279326,60,176
1799.312,6,366,24672,213,88,8487,469,14067,153,69,11834,69,10605
1792.002,6,363,22938,210,69,8574,69,12678,153,69,11789,69,10260
1797.416,17,449,39928,404,35,4460,288,25708,45,288,40023,288,14220
0.135,17,2,685,1,308,0,308,336,1,321,0,321,349
11.608,6,21,6825,12,275,1055,275,1038,9,1353,825,1440,5787
31.864,6,9,540,2,0,1083,0,120,7,0,5277,0,420
280.217,6,27,7312,12,158,25474,267,1277,15,603,20014,1400,6035
1.919,17,3,264,3,60,959,60,264,0,0,0,0,0
53.22,6,43,8956,21,412,773,889,2168,22,368,2527,3488,6788
20.511,6,16,3900,4,92,6837,92,296,12,297,1846,1408,3604
316.955,6,99,34253,51,575,6339,1360,23350,48,358,6741,3289,10903
0.959,6,10,1687,7,100,159,100,384,3,1179,345,1179,1303
1.254,6,47,19574,27,920,48,1360,13998,20,433,57,1360,5576
0.044,17,2,322,1,33,0,33,61,1,233,0,233,261
12.141,17,10,690,5,33,3033,33,305,5,49,3033,49,385
3.96,17,2,148,2,46,3960,46,148,0,0,0,0,0
1779.796,17,140,11200,70,48,25793,48,5320,70,56,25793,56,5880
40.736,6,48,13420,24,926,545,1360,7534,24,307,1763,1360,5886
299.592,6,6,364,4,31,99864,31,222,2,31,299578,31,142
0.015,1,2,112,2,28,15,28,112,0,0,0,0,0
1785.683,6,184,32684,122,302,14757,302,24472,62,83,29273,83,8212
1779.333,6,102,8228,68,64,26557,64,4896,34,58,53916,58,3332
324.911,6,21,1694,14,64,24993,64,1008,7,58,54136,58,686
0.032,6,12,3702,6,170,3,170,490,6,964,6,1448,3212
899.594,6,12,728,8,31,128513,31,444,4,31,299756,31,284
87.647,17,4,240,2,32,87646,32,120,2,32,87646,32,120
0.627,6,372,479398,220,183,2,230,11997,152,3063,3,9814,467401
1.724,6,29,9050,17,371,107,845,1797,12,846,144,1380,7253
1773.477,6,181,15589,120,69,14903,69,8940,61,69,29552,69,6649
303.31,6,28,5303,17,154,18956,516,1764,11,343,21869,1452,3539
375.259,17,14,4734,14,310,28866,329,4734,0,0,0,0,0
48.399,6,41,8827,19,410,763,882,2070,22,366,2298,2720,6757
1685.513,17,12,498,11,14,168551,14,462,1,8,0,8,36
20.612,6,7,466,0,0,0,0,0,7,31,3435,31,466
700.804,17,535,37988,456,40,1540,41,31306,79,56,677,57,6682
1682.224,17,14,1036,7,30,280367,30,406,7,62,280364,62,630
3.587,17,25,10298,11,332,358,1350,3969,14,424,204,1350,6329
1720.721,17,12,498,11,14,172072,14,462,1,8,0,8,36
1.937,17,4,464,3,64,957,64,276,1,160,0,160,188
1798.954,17,449,39928,404,35,4463,288,25708,45,288,40022,288,14220
20.602,17,22,3365,18,40,1184,41,1235,4,504,3,505,2130
0.077,17,4,288,2,36,45,36,128,2,52,36,52,160
1786.057,6,81,4302,41,26,44650,26,2184,40,26,45795,26,2118
75.381,6,16,660,7,0,3987,0,284,9,0,9421,0,376
0.005,6,2,214,1,134,0,134,174,1,0,0,0,40
352.503,17,12,2472,6,48,70498,48,456,6,308,70498,308,2016
115.213,17,6,528,3,48,57602,48,228,3,72,57602,72,300
1799.456,6,356,22520,208,69,8693,69,12460,148,69,12241,69,10060
0.32,6,32,17042,16,129,21,129,969,16,1269,21,1448,16073
373.631,6,25,1651,17,177,23351,177,1117,8,110,9248,110,534
1793.608,17,66,2766,65,14,28025,14,2730,1,8,0,8,36
11.883,6,1874,1642531,1145,1381,10,1420,1609138,729,467,16,1883,33393
1791.629,1,336,28224,336,56,5348,56,28224,0,0,0,0,0
5.024,17,4,732,2,37,5017,37,130,2,273,5018,273,602
1782.378,6,102,8296,68,65,26602,65,4930,34,59,54008,59,3366
0.233,6,10,1042,5,213,58,213,417,5,421,44,421,625
11.262,6,27,11373,13,275,938,275,1078,14,1080,848,1420,10295
69.56,6,64,38911,38,1152,1880,1448,30804,26,843,2459,2359,8107
2.748,6,31,13721,17,763,171,1460,6056,14,1013,201,1460,7665
263.695,1,4,224,4,28,87898,28,224,0,0,0,0,0
0.469,6,25,6055,13,108,38,147,959,12,768,42,1581,5096
1794.436,17,87,3648,86,14,21111,14,3612,1,8,0,8,36
9.059,6,81,24765,40,560,232,1152,18968,41,461,219,1179,5797
0.274,17,4,560,2,64,272,64,184,2,160,133,160,376
1787.286,6,104,8366,69,64,26283,64,4936,35,58,52564,58,3430
240.671,6,45,6260,21,196,12032,585,3064,24,161,10461,580,3196
1742.854,6,93,7068,62,38,28571,205,4424,31,33,58082,98,2644
1680.544,1,15,870,15,30,120038,30,870,0,0,0,0,0
299.518,6,6,364,4,31,99839,31,222,2,31,299505,31,142
0.029,17,2,212,1,46,0,46,74,1,110,0,110,138
58.532,17,4,272,2,40,58531,47,136,2,40,58531,47,136
0.004,17,2,409,1,52,0,52,80,1,301,0,301,329
1772.861,6,180,15480,120,69,14897,69,8940,60,69,30043,69,6540
33.514,6,27,4886,13,180,2792,722,1756,14,399,2562,1408,3130
0.385,6,10,968,5,256,94,256,460,5,304,94,304,508
0.832,6,20,5959,11,274,83,523,1267,9,721,93,1452,4692
0.901,17,4,854,2,39,890,39,134,2,332,889,332,720
0.022,17,2,158,1,34,0,34,62,1,68,0,68,96
1772.962,6,180,15480,120,69,14898,69,8940,60,69,30047,69,6540
1785.375,6,109,9183,70,72,25875,292,5336,39,65,46981,247,3847
1799.921,17,83,3480,82,14,22221,14,3444,1,8,0,8,36
281.277,6,30,7432,13,158,23439,267,1317,17,543,17555,1400,6115
0.094,1,2,112,2,28,94,28,112,0,0,0,0,0
108.138,17,4,352,2,60,108137,60,176,2,60,108137,60,176
538.55,1,6,336,6,28,107710,28,336,0,0,0,0,0
1377.617,6,140,12017,92,69,15138,69,6923,48,69,29310,69,5094
1756.054,6,105,6270,60,27,29762,27,3525,45,27,39909,27,2745
1773.02,6,180,15480,120,69,14899,69,8940,60,69,30045,69,6540
1757.489,6,124,9964,68,26,26230,26,4024,56,130,31953,427,5940
33.751,6,32,5147,15,154,2410,722,1860,17,299,2097,1440,3287
123.79,17,4,352,2,60,123788,60,176,2,60,123789,60,176
0.014,17,4,368,2,32,14,32,120,2,96,13,96,248
0.931,2,3,96,3,8,465,8,96,0,0,0,0,0
1717.149,1,8,448,8,28,245307,28,448,0,0,0,0,0
38.759,1,44,4576,0,0,0,0,0,44,76,901,76,4576
3.867,17,4,244,4,33,1289,33,244,0,0,0,0,0
40.131,17,3,228,3,48,20065,48,228,0,0,0,0,0
1203.211,2,10,320,10,8,133690,8,320,0,0,0,0,0
0.162,6,10,1669,6,551,32,947,1346,4,159,54,159,323
1.705,6,50,21276,29,904,60,1360,15660,21,433,75,1360,5616
1685.771,17,12,498,11,14,168577,14,462,1,8,0,8,36
1.049,6,32,10520,17,517,65,1460,3311,15,659,61,1460,7209
41.001,17,4,244,2,33,41000,33,122,2,33,41000,33,122
840.816,17,10,821,5,31,210200,37,297,5,76,210201,136,524
1790.98,6,367,23236,212,69,8488,69,12827,155,69,11629,69,10409
11.456,6,29,11457,14,275,881,275,1118,15,1080,768,1420,10339
143.247,17,6,2016,6,308,28649,308,2016,0,0,0,0,0
1797.841,6,373,26028,217,98,8323,469,15303,156,69,11598,69,10725
5.606,17,4,304,4,48,1868,48,304,0,0,0,0,0
741.92,6,53,6577,26,302,21077,302,4078,27,83,28535,83,2499
20.297,6,22,5470,12,107,1845,159,1074,10,773,2253,1418,4396
1776.393,17,73,3060,72,14,25019,14,3024,1,8,0,8,36
882.045,2,7,224,7,8,147007,8,224,0,0,0,0,0
0.799,6,111,87464,53,131,15,232,2649,58,1556,12,4140,84815
1791.736,1,204,11424,204,28,8826,28,11424,0,0,0,0,0
1797.328,17,449,39928,404,35,4459,288,25708,45,288,40017,288,14220
63.406,6,64,41806,40,1174,1625,1448,33806,24,749,2677,1448,8000
1772.355,6,180,15480,120,69,14893,69,8940,60,69,30035,69,6540
162.562,6,186,153636,121,1343,1354,1448,139278,65,609,2531,1448,14358
12.543,6,36,6344,18,206,737,314,2784,18,472,723,1179,3560
0.55,6,21,7220,13,319,45,602,1960,8,967,72,1946,5260
0.093,6,11,1228,6,145,18,145,389,5,635,18,635,839
1794.483,17,83,3480,82,14,22154,14,3444,1,8,0,8,36
1773.012,6,180,15480,120,69,14899,69,8940,60,69,30045,69,6540
201.993,6,12,2531,2,245,1719,245,329,10,299,22416,299,2202
0.161,6,26,7256,13,155,13,267,1301,13,603,12,2036,5955
50.027,17,60,13877,26,323,1998,1350,9127,34,111,1514,1350,4750
0.376,6,10,1992,5,288,85,288,508,5,424,52,434,1484
1789.003,6,218,25921,137,97,13154,469,12117,81,137,22358,1420,13804
27.401,6,6,328,4,0,9133,0,216,2,0,27167,0,112
3.55,6,2,88,2,0,0,0,88,0,0,0,0,0
1738.07,1,56,4704,56,56,31601,56,4704,0,0,0,0,0
240.288,6,43,8999,21,524,12013,1418,5816,22,225,11441,618,3183
1739.015,6,133,8322,74,46,23822,208,5063,59,31,29975,31,3259
1773.125,6,180,15480,120,69,14900,69,8940,60,69,30045,69,6540
1682.879,17,16,1265,8,30,240402,37,471,8,71,240405,136,794
18.803,6,29,12051,11,456,1862,1360,2776,18,776,1095,2134,9275
5.207,6,12,2475,7,56,867,56,440,5,883,1251,1408,2035
1215.888,6,276,46967,125,311,9805,1360,28126,151,127,8104,3289,18841
0.4,6,12,1304,6,256,76,256,756,6,304,75,304,548
1795.413,17,448,39612,404,35,4455,288,25708,44,288,40948,288,13904
180.955,17,4,352,2,60,180953,60,176,2,60,180954,60,176
179.5,1,4,542,4,107,59833,125,542,0,0,0,0,0
0.437,17,8,2750,8,315,62,354,2750,0,0,0,0,0
0.42,6,28,9001,13,227,35,547,1592,15,827,27,1448,7409
1.992,6,22,7900,12,164,164,267,1288,10,1521,157,5227,6612
3.949,17,10,785,5,31,979,31,295,5,70,976,70,490
1752.139,6,97,7338,64,38,27811,205,4528,33,33,54744,98,2810
1791.046,17,144,11520,72,48,25225,48,5472,72,56,25225,56,6048
2.646,6,13,5587,4,106,882,106,274,9,706,315,1420,5313
0.99,6,27,5927,13,156,82,267,1462,14,780,69,1460,4465
65.142,6,27,11079,13,410,64,922,1794,14,871,5000,1360,9285
76.366,6,9439,9047557,6299,1359,12,1408,8879613,3140,931,24,2801,167944
0.469,6,20,5856,12,265,42,517,1694,8,934,66,1891,4162
1742.211,1,56,4704,0,0,0,0,0,56,56,31676,56,4704
296.902,17,4,352,2,60,296901,60,176,2,60,296900,60,176
0.95,17,4,368,2,64,949,64,184,2,64,949,64,184
2.609,17,4,1568,4,364,869,364,1568,0,0,0,0,0
1779.1,6,137,44315,71,548,25415,1360,21577,66,502,27368,1360,22738
0.127,6,9,1050,5,261,31,261,465,4,421,39,421,585
0.028,6,16,6016,9,88,3,88,504,7,1740,4,1880,5512
367.26,6,18,1239,14,177,28250,177,913,4,110,20056,110,326
1779.415,17,142,11360,71,48,25420,48,5396,71,56,25420,56,5964
7.108,6,25,8255,14,315,546,1091,2303,11,1072,691,2519,5952
1.23,6,22,7900,11,164,106,267,1236,11,1216,106,3819,6664
66.821,6,28,7217,13,155,5568,267,1306,15,482,4772,2840,5911
0.032,17,2,198,1,39,0,39,67,1,103,0,103,131
1.42,6,40,8389,21,320,71,1162,2808,19,437,68,2715,5581
1.003,17,2,925,1,548,0,548,576,1,321,0,321,349
0.015,6,2,149,1,69,0,69,109,1,0,0,0,40
0.043,17,2,188,1,37,0,37,65,1,95,0,95,123
0.523,17,2,672,2,308,523,308,672,0,0,0,0,0
1.051,17,8,672,4,34,347,34,248,4,78,347,84,424
72.599,6,26,9492,13,552,87,1318,2257,13,957,6034,4080,7235
1752.539,17,69,2892,68,14,26157,14,2856,1,8,0,8,36
1142.99,2,12,384,12,8,103908,8,384,0,0,0,0,0
0.516,17,3,543,2,39,455,39,134,1,381,0,381,409
5.005,17,4,288,2,36,5004,36,128,2,52,5005,52,160
1797.477,17,447,39580,403,35,4471,288,25676,44,288,40950,288,13904
1681.719,17,16,1265,8,30,240241,37,471,8,71,240241,136,794
104.914,17,7,2352,7,308,17485,308,2352,0,0,0,0,0
1.748,17,6,870,3,40,858,40,204,3,194,850,194,666
1.231,6,41,11964,22,612,58,1360,6428,19,476,58,2715,5536
1558.929,2,14,448,14,8,119917,8,448,0,0,0,0,0
0.499,17,3,451,2,39,306,39,134,1,289,0,289,317
1.296,6,41,10025,22,502,61,1460,4444,19,400,62,1460,5581
49.05,6,13,5592,4,112,16350,112,280,9,822,6068,1420,5312
1.303,6,39,7977,19,268,72,848,2401,20,433,59,1360,5576
0.516,6,21,5000,10,137,57,267,1092,11,692,41,1467,3908
1.342,6,41,8429,21,320,67,1162,2808,20,400,61,1460,5621
0.414,6,12,1653,6,288,77,288,548,6,426,46,434,1105
1.334,6,37,8212,19,320,74,1162,2716,18,476,67,2720,5496
6.272,6,40,7325,21,218,313,314,3463,19,516,334,1179,3862
1.384,17,13,4742,13,336,115,361,4742,0,0,0,0,0
42.17,17,24,1824,24,48,1833,48,1824,0,0,0,0,0
33.722,17,6,525,3,32,16855,37,181,3,86,16853,136,344
17.101,17,15,7697,8,676,2439,1350,5634,7,266,2845,1350,2063
1774.89,6,181,15589,120,69,14915,69,8940,61,69,29579,69,6649
156.524,6,73,51227,47,1196,3402,1408,43142,26,960,2464,3847,8085
280.477,6,31,7472,13,158,23373,267,1317,18,603,16495,2760,6155
106.781,6,49,11630,20,305,1634,469,4469,29,272,3812,1460,7161
0.432,6,20,7229,13,334,36,663,2021,7,1209,66,1946,5208
69.523,6,29,7326,13,155,5793,267,1306,16,447,4634,1997,6020
1797.878,17,448,39896,403,35,4472,288,25676,45,288,40019,288,14220
1791.065,6,356,22520,208,69,8652,69,12460,148,69,12184,69,10060
3.27,17,2,690,2,317,3270,317,690,0,0,0,0,0
68.226,17,4,352,2,60,68225,60,176,2,60,68225,60,176
1759.58,6,104,6218,60,27,29823,27,3525,44,27,40912,27,2693
0.104,17,2,384,1,32,0,32,60,1,296,0,296,324
0.205,6,6,240,3,0,4,0,120,3,0,0,0,120
0.719,17,8,2750,8,315,102,354,2750,0,0,0,0,0
0.017,17,2,350,1,37,0,37,65,1,257,0,257,285
0.002,6,2,104,2,0,0,0,104,0,0,0,0,0
1786.363,6,102,8364,68,66,26662,66,4964,34,60,54129,60,3400
22.615,17,31,7403,14,284,1737,1350,4374,17,150,1411,1350,3029
1683.231,1,8,848,8,78,240461,78,848,0,0,0,0,0
380.196,6,36,2504,20,31,20010,31,1276,16,31,25326,31,1228
1.527,6,48,18293,28,882,56,1360,12672,20,437,69,2715,5621
1.456,6,60,18135,29,707,52,1360,8977,31,416,48,1360,9158
1.666,6,7,295,4,0,555,0,164,3,7,356,7,131
10.437,17,9,1480,6,102,2087,288,780,3,205,202,288,700
1770.867,6,99,9240,66,65,27244,65,5577,33,59,55336,59,3663
0.025,17,2,246,1,67,0,67,95,1,123,0,123,151
1792.012,6,441,28998,215,99,8373,469,15154,226,35,7964,69,13844
248.63,6,58,14491,25,345,10359,1056,4487,33,487,7769,1223,10004
1795.988,6,356,22520,208,69,8676,69,12460,148,69,12217,69,10060
1096.971,17,216,16416,216,48,5102,48,16416,0,0,0,0,0
280.212,6,26,7272,12,158,25473,267,1277,14,775,21549,3445,5995
1797.684,17,449,39928,404,35,4460,288,25708,45,288,40017,288,14220
365.969,6,18,1239,14,177,28151,177,913,4,110,24417,110,326
11.792,6,1886,1632706,1154,1363,10,1380,1598975,732,387,16,1923,33731
0.051,17,2,158,1,34,0,34,62,1,68,0,68,96
7.215,6,5,220,1,0,0,0,44,4,0,2375,0,176
8.267,6,18,6871,9,275,1033,275,643,9,1171,847,1440,6228
1768.348,1,58,4872,58,56,31023,56,4872,0,0,0,0,0
0.082,6,18,4140,10,101,9,101,629,8,514,11,1000,3511
944.388,6,52,3777,31,31,31479,31,2065,21,31,47195,31,1712
278.506,6,34,7747,16,247,18564,517,1830,18,712,16379,1418,5917
1740.352,6,140,16923,83,76,21223,877,7411,57,148,31077,1448,9512
37.717,17,22,1936,11,48,3770,48,836,11,72,3770,72,1100
1772.843,6,134,8204,72,26,24969,26,4348,62,26,29062,26,3856
1772.371,6,180,15480,120,69,14893,69,8940,60,69,30036,69,6540
0.667,17,2,152,1,48,0,48,76,1,48,0,48,76
0.006,6,3,189,1,0,0,0,40,2,69,1,69,149
60.51,6,50,11463,24,271,2630,469,4767,26,332,2419,1452,6696
1.479,6,50,19090,27,877,56,1360,13394,23,433,58,1360,5696
1799.731,17,754,45496,754,32,2390,37,45496,0,0,0,0,0
1680.032,17,13,534,11,14,167984,14,462,2,8,1679716,8,72
2.903,17,4,624,4,128,967,128,624,0,0,0,0,0
595.056,2,4,128,4,8,198352,8,128,0,0,0,0,0
1784.811,6,102,8172,68,63,26638,64,4868,34,57,54082,58,3304
7.469,17,6,528,3,48,3707,48,228,3,72,3663,72,300
1789.217,6,358,22669,209,69,8602,69,12500,149,69,12089,69,10169
1787.628,6,102,8228,68,64,26681,64,4896,34,58,54168,58,3332
0.114,17,2,138,1,33,0,33,61,1,49,0,49,77
1792.809,1,58,4872,0,0,0,0,0,58,56,31452,56,4872
78.665,17,4,240,2,32,78664,32,120,2,32,78664,32,120
1773.575,6,180,15480,120,69,14903,69,8940,60,69,30052,69,6540
0.637,6,10,924,5,283,115,283,551,5,105,115,105,373
1799.956,17,468,44000,410,37,4400,288,26656,58,271,31575,308,17344
0.527,17,2,476,1,39,0,39,67,1,381,0,381,409
9.133,17,8,664,4,47,3042,47,300,4,63,3042,63,364
0.21,6,33,22604,15,180,15,250,1342,18,1269,11,1440,21262
1744.084,6,99,7411,63,38,28130,205,4476,36,33,49825,98,2935
1790.374,17,87,3648,86,14,21063,14,3612,1,8,0,8,36
1756.753,6,204,19910,100,78,17744,721,9279,104,174,16945,1440,10631
63.536,6,43,8924,20,401,731,889,2096,23,368,2881,3488,6828
0.012,17,2,167,1,31,0,31,59,1,80,0,80,108
1783.81,6,415,24880,207,69,8659,69,12420,208,34,8617,64,12460
1790.041,1,278,15568,278,28,6462,28,15568,0,0,0,0,0
321.261,17,11,3688,11,307,32126,308,3688,0,0,0,0,0
4.162,6,42,11091,16,586,277,1440,4814,26,325,159,1440,6277
0.3,17,2,685,1,308,0,308,336,1,321,0,321,349
10.402,6,2897,2750068,1876,1388,5,1408,2692312,1021,931,10,2816,57756
0.045,17,4,352,2,37,0,37,130,2,83,8,89,222
0.599,6,10,861,5,222,146,222,426,5,231,146,231,435
4.726,6,39,7285,19,218,262,314,3383,20,516,235,1179,3902
79.267,6,30,3710,16,183,5284,517,1841,14,381,6097,499,1869
1772.512,6,258,35606,98,153,18271,1440,15619,160,159,11146,1702,19987
113.451,17,4,240,2,32,113449,32,120,2,32,113450,32,120
31.839,6,7,308,1,0,0,0,44,6,0,6306,0,264
616.006,6,105,16465,47,138,13391,1305,5240,58,216,10804,2720,11225
1797.807,6,254,25252,103,67,17624,659,9558,151,125,11984,1460,15694
5.719,6,4,191,2,31,5719,31,111,2,0,1,0,80
300.869,2,3,96,3,8,150434,8,96,0,0,0,0,0
255.207,6,23,8047,8,138,36458,267,883,15,655,18226,1460,7164
1110.27,6,515,90866,335,304,3324,304,67660,180,83,6201,83,23206
381.595,6,71,11700,33,322,11924,1366,5916,38,211,10313,1384,5784
0.588,6,15,1785,8,288,77,288,640,7,426,69,434,1145
1684.487,2,17,544,17,8,105280,8,544,0,0,0,0,0
64.031,6,32,7926,12,155,5821,267,1884,20,475,3368,1420,6042
1786.457,6,303,31324,152,149,11830,208,24168,151,31,11908,31,7156
10.763,6,20,4390,11,275,1076,275,998,9,755,754,1414,3392
6.477,17,4,3100,4,747,2159,1451,3100,0,0,0,0,0
78.657,17,4,1344,4,308,26219,308,1344,0,0,0,0,0
0.921,6,10,1687,7,100,153,100,384,3,1179,325,1179,1303
220.636,6,13,2224,7,221,36772,517,1270,6,323,44126,499,954
1781.822,6,356,22520,208,69,8607,69,12460,148,69,12120,69,10060
315.833,6,74,19011,41,303,7895,1360,10170,33,441,9717,4649,8841
0.104,17,2,251,1,36,0,36,64,1,159,0,159,187
1.373,17,6,552,3,32,686,32,180,3,96,679,96,372
280.022,6,29,7392,14,158,21540,267,1357,15,678,19998,3436,6035
376.035,6,18,1242,14,180,28925,180,916,4,110,20060,110,326
2.543,6,14,2351,8,188,363,245,700,6,703,455,1152,1651
13.84,6,27,4865,13,154,1131,721,1766,14,394,1048,1368,3099
0.069,1,2,112,2,28,69,28,112,0,0,0,0,0
1799.28,6,360,22887,209,69,8650,69,12569,151,69,11993,69,10318
1.319,6,48,18924,26,938,52,1460,13268,22,433,54,1460,5656
0.279,6,10,1188,5,145,69,145,349,5,635,49,635,839
15.622,6,6,264,1,0,0,0,44,5,0,3860,0,220
1740.752,17,30,7050,30,207,60025,207,7050,0,0,0,0,0
299.613,6,6,364,4,31,99871,31,222,2,31,299560,31,142
182.751,17,4,352,2,60,182750,60,176,2,60,182750,60,176
1751.661,6,95,7203,63,38,28252,205,4476,32,33,56492,98,2727
145.759,17,4,352,2,60,145758,60,176,2,60,145758,60,176
1786.323,6,390,31725,218,91,8231,1189,15042,172,136,10446,1420,16683
1790.045,17,87,3648,86,14,21059,14,3612,1,8,0,8,36
300.598,6,37,8526,20,315,15820,916,2094,17,478,527,2128,6432
280.882,6,454,211953,230,840,174,1152,195746,224,381,1258,1179,16207
7.168,6,45,8329,23,227,325,314,4102,22,477,328,1179,4227
1799.138,6,370,25839,215,99,8407,469,15154,155,69,11679,69,10685
0.08,17,2,640,2,292,80,298,640,0,0,0,0,0
0.88,6,28,6140,14,138,67,267,1675,14,650,61,1420,4465
1750.078,17,12,498,11,14,175007,14,462,1,8,0,8,36
0.31,17,8,2750,8,315,44,354,2750,0,0,0,0,0
11.843,6,25,8453,13,275,986,275,1078,12,983,857,1420,7375
1530.028,1,18,1008,18,28,90001,28,1008,0,0,0,0,0
3.913,17,5,290,5,30,978,30,290,0,0,0,0,0
1773.341,6,180,15480,120,69,14902,69,8940,60,69,30053,69,6540
902.425,2,9,288,9,8,112803,8,288,0,0,0,0,0
1797.056,6,381,26555,219,97,8243,469,15590,162,69,11161,69,10965
1749.545,6,95,7203,63,38,28218,205,4476,32,33,56425,98,2727
1795.801,17,449,39928,404,35,4456,288,25708,45,288,40015,288,14220
1786.953,17,370,48025,174,180,10324,1350,36268,196,31,9163,60,11757
1.625,6,30,10317,18,368,95,837,1829,12,1000,139,1452,8488
1789.361,1,256,14336,256,28,7017,28,14336,0,0,0,0,0
4.852,6,39,7269,20,218,255,314,3423,19,513,255,1179,3846
3.641,17,10,785,5,31,907,31,295,5,70,907,70,490
6.648,2,4,176,4,20,2216,24,176,0,0,0,0,0
13.874,6,20,3003,12,211,1204,211,1500,8,545,1981,904,1503
1786.998,6,105,8550,69,66,26279,66,5070,36,60,51043,60,3480
1.217,6,41,11378,22,547,57,1360,5842,19,476,57,2715,5536
1796.144,6,370,23425,213,69,8472,69,13005,157,69,11512,69,10420
196.605,17,4,352,2,60,196603,60,176,2,60,196604,60,176
397.92,6,20,1737,15,187,28422,187,975,5,247,60061,462,762
1797.702,6,423,25397,211,69,8560,69,12580,212,34,8519,64,12817
1.158,6,55,17074,34,320,35,1360,9081,21,793,50,4649,7993
1779.711,17,142,11360,71,48,25424,48,5396,71,56,25424,56,5964
360.894,2,5,160,5,8,90223,8,160,0,0,0,0,0
1.17,6,2,100,1,0,0,0,40,1,0,0,0,60
1781.76,6,365,25432,213,100,8404,469,14936,152,69,11799,69,10496
7.276,6,18,6000,10,275,808,275,954,8,944,747,1414,5046
181.122,6,24,9050,12,649,77,1360,3109,12,908,16449,1747,5941
1791.927,6,355,22480,207,69,8698,69,12420,148,69,12189,69,10060
1797.219,17,448,39896,403,35,4470,288,25676,45,288,40015,288,14220
1791.471,17,180,14040,180,50,10008,50,14040,0,0,0,0,0
317.08,6,47,12255,22,267,15099,1305,3316,25,417,13206,4649,8939
300.32,6,46,29489,22,190,14300,444,1913,24,1385,10445,2804,27576
3.335,6,24,6125,14,232,256,501,1725,10,999,369,1731,4400
1788.394,6,215,30192,130,302,13863,302,21590,85,83,21290,83,8602
1222.745,1,18,1008,18,28,71926,28,1008,0,0,0,0,0
20.326,6,25,5668,14,92,1563,159,1209,11,773,2027,1368,4459
27.478,17,32,4704,16,48,1831,48,1216,16,190,1831,308,3488
20.646,6,28,7223,13,156,1720,267,1312,15,482,1474,1997,5911
7.531,6,20,6866,8,154,1075,267,792,12,620,681,1933,6074
158.061,6,22,9334,11,596,71,1446,2262,11,945,15791,1460,7072
68.44,17,4,352,2,48,68430,48,152,2,72,68431,72,200
852.001,17,8,592,4,30,283995,30,232,4,62,283993,62,360
76.111,17,8,704,4,48,25367,48,304,4,72,25367,72,400
1789.721,17,86,3612,86,14,21055,14,3612,0,0,0,0,0
1786.246,6,104,8444,68,66,26660,66,4964,36,60,51033,60,3480
15.288,6,21,6825,12,275,1389,275,1038,9,1353,1285,1440,5787
0.37,6,41,8493,21,351,18,1420,2600,20,424,19,1420,5893
1795.893,17,448,39896,403,35,4467,288,25676,45,288,40018,288,14220
1793.257,1,112,6272,112,28,16155,28,6272,0,0,0,0,0
1792.477,17,87,3648,86,14,21087,14,3612,1,8,0,8,36
63.25,6,38,5470,21,154,3162,722,2182,17,300,979,1408,3288
22.114,6,13,2133,8,324,3159,585,1073,5,396,5521,580,1060
162.6,6,22,8752,11,314,92,634,1415,11,983,16243,1360,7337
1022.701,2,11,352,11,8,102270,8,352,0,0,0,0,0
1.397,6,27,5811,14,125,107,267,1315,13,567,111,1420,4496
601.61,2,8,256,8,8,85944,8,256,0,0,0,0,0
7.156,6,48,8529,24,227,311,314,4142,24,427,300,1152,4387
0.132,1,2,112,2,28,132,28,112,0,0,0,0,0
0.013,17,2,136,1,32,0,32,60,1,48,0,48,76
0.159,6,10,1569,5,627,39,627,895,5,406,39,406,674
0.025,17,4,398,2,46,17,46,148,2,97,15,103,250
65.745,17,4,352,2,60,65744,60,176,2,60,65744,60,176
0.11,17,2,204,1,34,0,34,62,1,114,0,114,142
29.347,6,16,660,9,0,3668,0,364,7,0,3950,0,296
0.108,6,11,1703,6,314,21,500,948,5,487,26,487,755
1783.107,17,83,3480,82,14,22013,14,3444,1,8,0,8,36
59.704,6,36,9385,19,528,515,882,2952,17,521,3721,3488,6433
1.095,6,11,988,5,283,230,283,563,6,105,183,105,425
0.403,6,10,968,5,256,95,256,460,5,304,95,304,508
14.11,17,4,352,2,48,14100,48,152,2,72,14099,72,200
1.499,6,39,9936,21,440,74,1360,4440,18,529,76,4075,5496
3.705,6,23,7449,11,262,366,517,1380,12,778,332,1418,6069
306.251,1,10,560,10,28,34027,28,560,0,0,0,0,0
1696.259,1,7,392,7,28,282709,28,392,0,0,0,0,0
3.708,6,25,8078,11,326,366,517,1897,14,777,281,1418,6181
1772.693,6,180,15480,120,69,14896,69,8940,60,69,30037,69,6540
21.084,6,28,7038,10,133,2342,267,941,18,447,1229,1452,6097
1754.746,1,40,4894,40,94,44993,173,4894,0,0,0,0,0
0.238,17,2,384,1,39,0,39,67,1,289,0,289,317
1037.425,6,125,9670,62,90,17006,208,6530,63,31,16729,31,3140
1783.554,17,83,3480,82,14,22019,14,3444,1,8,0,8,36
67.94,6,27,2896,14,189,5225,517,1578,13,323,5661,499,1318
4.385,6,2,88,2,0,0,0,88,0,0,0,0,0
240.715,6,54,17570,29,739,8594,1418,14829,25,179,10026,580,2741
1793.87,6,353,22400,206,69,8750,69,12380,147,69,12286,69,10020
1777.473,6,82,4386,40,26,45575,26,2130,42,24,43352,24,2256
11.845,6,25,8453,13,275,987,275,1078,12,983,869,1420,7375
1775.632,6,265,19806,133,69,13451,69,9736,132,38,13554,69,10070
0.937,6,10,1687,7,100,156,100,384,3,1179,338,1179,1303
1682.124,1,7,742,7,78,280354,78,742,0,0,0,0,0
25.706,6,48,12806,22,161,1224,721,2335,26,628,1019,1440,10471
0.281,17,4,954,2,44,257,44,144,2,377,256,391,810
1789.467,6,112,8674,71,63,25508,63,4982,41,57,44736,57,3692
1776.708,17,142,11360,71,48,25380,48,5396,71,56,25380,56,5964
1.208,17,4,360,2,30,1162,30,116,2,94,660,94,244
10.603,17,4,352,2,48,10575,48,152,2,72,10588,72,200
1795.036,1,343,28812,343,56,5248,56,28812,0,0,0,0,0
290.667,6,37,4321,18,324,17097,585,1641,19,242,16147,580,2680
2.884,17,4,518,3,39,737,39,201,1,289,0,289,317
27.34,6,37,8576,17,192,1708,722,2221,20,616,1384,1380,6355
1764.3,2,15,480,15,8,126021,8,480,0,0,0,0,0
106.599,6,127,98311,81,1266,1332,1368,87793,46,738,2363,2519,10518
1794.159,17,80,3354,79,14,23002,14,3318,1,8,0,8,36
240.444,6,41,7490,18,203,14143,517,2191,23,455,10928,1418,5299
1752.403,17,34,11501,34,310,53103,342,11501,0,0,0,0,0
0.116,17,4,588,2,48,93,48,152,2,190,97,308,436
5.401,6,38,7245,19,218,300,314,3383,19,516,285,1179,3862
0.231,17,2,1922,2,933,231,933,1922,0,0,0,0,0
3.992,17,4,240,4,32,1330,32,240,0,0,0,0,0
11.886,17,16,2352,8,48,1696,48,608,8,190,1696,308,1744
18.821,6,14,4631,9,290,2352,517,1057,5,3306,4635,3306,3574
0.432,6,6,324,4,0,144,0,216,2,0,244,0,108
1.592,6,42,10065,23,440,72,1360,4484,19,400,77,1360,5581
23.753,17,48,10366,22,283,1129,1350,6860,26,106,948,1350,3506
1.244,6,47,18743,27,861,47,1360,13167,20,476,56,2715,5576
1775.782,6,27,4077,18,241,104457,241,2889,9,92,221950,92,1188
1788.14,6,356,22520,208,69,8638,69,12460,148,69,12164,69,10060
153.643,6,836,385070,434,821,354,1152,364199,402,435,382,1179,20871
0.14,6,2,92,1,0,0,0,40,1,0,0,0,52
199.885,6,149,98267,81,1251,2498,1368,88062,68,606,2982,1571,10205
1788.917,17,87,3648,86,14,21046,14,3612,1,8,0,8,36
597.649,6,62,7543,31,95,19915,722,3059,31,151,19915,1408,4484
1666.175,1,8,448,8,28,238025,28,448,0,0,0,0,0
32.569,6,46,9342,23,188,1480,721,2814,23,621,1471,1420,6528
125.374,6,15,3419,8,92,17910,92,528,7,504,20864,2026,2891
1768.365,1,58,4872,58,56,31023,56,4872,0,0,0,0,0
61.09,6,27,7183,13,156,5090,267,1312,14,530,4698,3417,5871
333.119,17,6,360,3,32,166559,32,180,3,32,166559,32,180
23.917,6,3304,3096034,2092,1400,11,1448,3028346,1212,776,19,1448,67688
1772.047,6,99,9306,66,66,27262,66,5610,33,60,55373,60,3696
300.582,6,18,1275,9,177,37550,177,701,9,110,37550,110,574
0.869,6,10,1687,7,100,144,100,384,3,1179,310,1179,1303
39.948,6,26,6335,15,117,2853,159,1389,11,727,3993,1418,4946
1799.386,17,771,46482,771,32,2336,37,46482,0,0,0,0,0
0.587,6,20,7238,13,335,48,668,2026,7,1210,92,1946,5212
0.019,17,2,410,1,36,0,36,64,1,318,0,318,346
77.558,17,4,352,2,60,77557,60,176,2,60,77557,60,176
19.812,6,27,4750,14,275,1524,275,1130,13,768,1249,1440,3620
119.88,6,30,8872,15,158,8562,267,1397,15,858,8561,3436,7475
2.002,17,2,176,2,60,2002,60,176,0,0,0,0,0
1770.084,6,99,9240,66,65,27232,65,5577,33,59,55311,59,3663
47.636,6,6,328,4,0,15878,0,216,2,0,47621,0,112
1.349,6,46,18855,27,871,51,1360,13319,19,476,64,2715,5536
11.821,6,1860,1632581,1155,1358,10,1420,1599910,705,475,16,1883,32671
11.964,6,1900,1620819,1145,1363,10,1380,1586152,755,387,15,1923,34667
526.266,6,23908,23288133,8605,334,61,336,490449,15303,1438,34,5752,22797684
1779.899,1,342,28728,342,56,5219,56,28728,0,0,0,0,0
1680.104,1,12,696,12,30,152736,30,696,0,0,0,0,0
0.062,17,2,180,1,30,0,30,58,1,94,0,94,122
1784.895,17,263,52598,263,171,6812,422,52598,0,0,0,0,0
0.404,17,3,451,2,39,399,39,134,1,289,0,289,317
55.057,6,19,780,10,0,6115,0,404,9,0,6880,0,376
300.571,6,18,1227,5,177,75099,177,445,13,110,25033,110,782
0.775,6,16,3032,8,285,110,517,1267,8,447,109,1148,1765
300.633,6,43,9240,21,390,15031,1216,2482,22,345,463,1360,6758
0.064,6,9,1344,5,145,16,145,349,4,831,15,831,995
300.159,6,41,10207,21,607,14999,1360,4543,20,373,15789,2667,5664
8.531,6,25,11439,7,138,1421,267,843,18,759,500,1420,10596
11.835,6,23,6165,10,272,1074,516,1220,13,442,979,1452,4945
574.188,6,48,8216,23,127,17267,516,2195,25,228,23920,1452,6021
0.681,6,6,324,3,0,340,0,164,3,0,230,0,160
1786.451,6,104,8308,68,64,26663,64,4896,36,58,51037,58,3412
0.009,1,2,112,2,28,9,28,112,0,0,0,0,0
3.312,6,27,8253,12,330,297,517,1978,15,685,233,1418,6275
1785.557,6,102,8296,68,65,26650,65,4930,34,59,54104,59,3366
280.246,6,26,7272,13,158,23353,267,1317,13,905,23351,4845,5955
1772.696,6,180,15480,120,69,14896,69,8940,60,69,30037,69,6540
1.913,17,2,136,1,32,0,32,60,1,48,0,48,76
0.182,6,45,22540,27,1101,7,1414,17618,18,522,10,1889,4922
5.46,6,26,7962,13,257,445,517,1727,13,925,447,2736,6235
1798.739,17,142,11360,71,48,25695,48,5396,71,56,25695,56,5964
337.795,6,254,211049,162,1354,2098,1448,193997,92,583,1791,1448,17052
16.073,6,14,5715,5,101,4015,112,411,9,822,2007,1452,5304
16.352,17,19,6478,9,432,2040,1350,4144,10,205,1813,1350,2334
11.763,6,90,26802,46,567,261,1152,20560,44,447,267,1179,6242
2.385,17,9,4047,4,479,795,1350,2028,5,375,392,1350,2019
299.2,1,4,224,4,28,99733,28,224,0,0,0,0,0
0.164,6,10,1671,6,552,32,948,1348,4,159,52,159,323
280.481,6,28,7352,13,158,23373,267,1317,15,775,20030,4836,6035
1754.158,1,63,5292,0,0,0,0,0,63,56,28292,56,5292
503.848,2,4,128,4,8,167949,8,128,0,0,0,0,0
0.126,17,6,444,6,46,25,46,444,0,0,0,0,0
125.013,6,38,8095,14,155,9616,267,1346,24,304,5434,1420,6749
251.909,6,34,2241,17,60,15744,208,1406,17,31,15728,31,835
264.01,6,38,3569,18,324,15530,585,1641,20,396,13884,580,1928
204.789,6,22,5680,7,187,745,293,1035,15,367,14610,1179,4645
1338.196,6,147,10158,52,46,25653,46,4196,95,46,14235,46,5962
0.725,17,4,368,2,32,384,32,120,2,96,375,96,248
10.008,6,1509,1368167,967,1363,10,1420,1342160,542,427,18,1420,26007
45.017,6,42,8737,20,410,684,882,2086,22,359,2137,1460,6651
240.305,6,43,9122,21,524,12014,1418,5816,22,239,11442,638,3306
1740.363,6,87,6322,58,31,30532,31,3915,29,31,62155,31,2407
52.289,6,25,7097,12,155,4753,267,1266,13,589,4356,3426,5831
752.155,1,4,224,4,28,250718,28,224,0,0,0,0,0
16.608,17,25,6740,9,286,2075,1350,2832,16,216,1105,1350,3908
32.003,6,27,8594,7,157,5308,189,635,20,476,1676,1360,7959
0.203,17,8,2758,8,316,29,355,2758,0,0,0,0,0
240.094,6,37,7141,18,194,14122,517,2112,19,504,13338,1402,5029
3.318,17,3,234,2,39,3279,39,134,1,72,0,72,100
1773.165,6,180,15480,120,69,14900,69,8940,60,69,30048,69,6540
0.722,17,4,368,2,64,717,64,184,2,64,720,64,184
1795.103,17,80,3354,79,14,23014,14,3318,1,8,0,8,36
190.354,1,8,224,8,0,0,0,224,0,0,0,0,0
0.0,17,3,993,3,303,0,332,993,0,0,0,0,0
6.702,17,64,47247,25,356,279,1350,9624,39,936,156,1350,37623
51.745,17,6,480,3,48,25867,48,228,3,56,25867,56,252
1773.37,6,180,15480,120,69,14902,69,8940,60,69,30049,69,6540
0.251,6,9,1345,5,145,62,145,349,4,832,30,832,996
0.04,17,4,352,2,37,34,37,130,2,83,30,89,222
117.077,6,22,9188,11,418,64,952,1727,11,1001,11694,1440,7461
268.244,17,19,1706,19,61,14902,346,1706,0,0,0,0,0
0.822,17,2,784,2,364,822,364,784,0,0,0,0,0
1.447,6,47,19532,27,917,55,1460,13956,20,476,66,2615,5576
1798.072,17,450,39960,405,35,4450,288,25740,45,288,40027,288,14220
22.704,17,46,18353,21,431,1133,1350,9652,25,320,944,1350,8701
1770.678,6,99,9306,66,66,27241,66,5610,33,60,55330,60,3696
1746.213,6,90,6540,60,31,29596,31,4050,30,31,60201,31,2490
5.441,6,39,7285,20,218,286,314,3423,19,516,287,1179,3862
300.793,2,3,96,3,8,150396,8,96,0,0,0,0,0
136.606,17,6,360,3,32,68302,32,180,3,32,68302,32,180
280.199,6,27,7312,13,158,23349,267,1317,14,775,21552,4836,5995
2.463,2,2,64,2,8,2463,8,64,0,0,0,0,0
1763.63,2,15,480,15,8,125973,8,480,0,0,0,0,0
305.158,6,39,13970,21,647,15257,1438,6293,18,743,14394,1438,7677
1797.569,6,370,23425,213,69,8479,69,13005,157,69,11522,69,10420
16.114,1,18,1872,0,0,0,0,0,18,76,947,76,1872
62.128,6,75,51640,46,1205,1380,1368,43396,29,747,2210,1368,8244
1.653,6,25,8763,15,285,118,587,1459,10,985,164,1420,7304
1772.372,6,180,15480,120,69,14893,69,8940,60,69,30034,69,6540
33.755,6,30,5240,15,180,2411,721,1858,15,433,2395,2026,3382
2.889,17,4,248,4,34,963,34,248,0,0,0,0,0
1781.113,6,152,28782,92,333,19572,1303,18380,60,173,30126,1420,10402
13.281,6,13,2133,8,324,1897,585,1073,5,396,3315,580,1060
7.192,6,1485,1339535,918,1380,7,1408,1305387,567,776,12,1408,34148
1785.346,6,235,21530,88,94,20519,375,10341,147,70,12227,1062,11189
281.941,6,34,7661,14,158,21687,267,1357,20,500,14829,1400,6304
4.821,6,33,6129,18,206,283,314,2784,15,548,324,1179,3345
1.682,6,12,1163,6,222,334,222,688,6,231,334,231,475
1780.964,6,354,22440,207,69,8645,69,12420,147,69,12198,69,10020
1771.129,6,99,9306,66,66,27248,66,5610,33,60,55345,60,3696
41.223,6,29,7257,13,155,3435,267,1306,16,441,2747,1420,5951
1796.81,6,381,26955,219,103,8242,469,15990,162,69,11158,69,10965
1787.907,6,363,25421,210,100,8554,469,14816,153,69,11762,69,10605
61.387,6,34,10870,19,344,3410,1292,3065,15,701,4366,1440,7805
50.34,6,50,10160,24,311,398,619,1987,26,395,2006,1360,8173
63.605,6,42,10413,22,328,3021,1408,3488,20,453,3339,3047,6925
23.028,6,39,8318,21,243,1151,626,1844,18,441,530,1360,6474
0.005,17,2,338,1,33,0,33,61,1,249,0,249,277
1787.715,6,102,11543,50,172,36482,517,3468,52,765,35051,2450,8075
1741.324,17,30,20190,30,645,60045,645,20190,0,0,0,0,0
1.814,6,27,8851,16,286,120,591,1503,11,863,160,1380,7348
1787.477,6,108,10045,70,99,25905,1258,6268,38,62,48307,192,3777
168.905,6,32,8519,19,234,9381,1146,2906,13,617,14071,1368,5613
0.98,6,10,1687,7,100,163,100,384,3,1179,356,1179,1303
15.502,6,39,7273,20,218,815,314,3423,19,513,790,1179,3850
1746.588,6,95,7203,63,38,28170,205,4476,32,33,56334,98,2727
1778.88,1,342,28728,342,56,5216,56,28728,0,0,0,0,0
117.866,17,4,352,2,60,117865,60,176,2,60,117865,60,176
0.001,6,2,119,1,0,0,0,40,1,27,0,27,79
8.431,6,1918,1747395,1198,1379,6,1408,1705291,720,931,11,2801,42104
6.727,6,407,318268,191,209,35,256,12289,216,1383,31,2816,305979
240.182,6,43,7470,20,147,12640,617,2224,23,447,10917,2555,5246
1.352,6,162,133903,103,1361,13,1432,125381,59,559,22,1871,8522
287.943,6,33,7621,15,143,20567,267,1466,18,603,16935,2076,6155
0.265,17,2,152,1,48,0,48,76,1,48,0,48,76
0.855,6,10,1687,7,100,142,100,384,3,1179,305,1179,1303
64.73,6,22,2069,12,177,5884,177,1211,10,110,7130,110,858
1797.305,6,379,26544,217,97,8320,469,15441,162,69,11163,69,11103
1779.49,6,200,12963,99,57,18156,208,7962,101,31,17793,31,5001
7.187,6,5,240,1,0,0,0,48,4,0,2392,0,192
32.12,6,280,282588,90,103,360,300,5093,190,1438,169,2804,277495
280.199,6,27,7312,13,158,23349,267,1317,14,775,21550,4836,5995
17.32,6,2848,2717613,1874,1373,9,1408,2662301,974,931,17,2816,55312
287.749,6,33,7893,15,158,20553,267,1397,18,524,16910,1400,6496
1791.9,17,179,13962,179,50,10066,50,13962,0,0,0,0,0
1747.045,6,95,7203,63,38,28178,205,4476,32,33,56345,98,2727
1745.644,6,95,7203,63,38,28155,205,4476,32,33,56304,98,2727
75.115,6,20,820,9,0,6818,0,364,11,0,7507,0,456
196.86,6,9,515,5,43,49215,43,299,4,0,65619,0,216
121.726,17,4,352,2,60,121725,60,176,2,60,121725,60,176
1745.099,6,95,7203,63,38,28146,205,4476,32,33,56287,98,2727
0.111,1,2,112,2,28,111,28,112,0,0,0,0,0
1772.203,6,180,15480,120,69,14892,69,8940,60,69,30035,69,6540
100.743,6,64,26137,34,1065,377,1360,19553,30,282,3468,2667,6584
1777.247,1,70,5880,70,56,25757,56,5880,0,0,0,0,0
1798.158,6,368,25759,214,99,8442,469,15045,154,69,11752,69,10714
67.121,6,27,7177,13,155,5593,267,1306,14,530,5162,3417,5871
1794.176,17,144,11520,72,48,25270,48,5472,72,56,25269,56,6048
5.613,6,39,7285,20,218,295,314,3423,19,516,298,1179,3862
1.393,6,51,19768,29,918,49,1460,14067,22,400,57,1460,5701
63.845,6,21,852,11,0,6383,0,444,10,0,7093,0,408
5.006,17,4,514,2,36,5001,36,128,2,165,5001,187,386
15.744,6,22,6792,9,160,1968,267,1168,13,637,1308,1420,5624
0.11,17,2,146,1,37,0,37,65,1,53,0,53,81
0.021,6,4,212,2,0,19,0,112,2,0,4,0,100
0.418,6,7,288,4,0,139,0,164,3,0,100,0,124
1.401,6,46,18627,26,921,56,1460,13051,20,476,64,2615,5576
0.497,6,12,1653,6,288,94,288,548,6,426,55,434,1105
73.267,17,9,1724,5,48,18312,48,380,4,308,24416,308,1344
131.798,6,9,396,3,0,65899,0,124,6,7,26311,7,272
0.069,6,12,3462,6,75,13,75,395,6,1373,13,1448,3067
1781.854,1,243,13608,243,28,7363,28,13608,0,0,0,0,0
0.023,17,2,167,1,39,0,39,67,1,72,0,72,100
1708.589,1,8,448,8,28,244084,28,448,0,0,0,0,0
33.485,17,724,443185,392,941,85,1350,379875,332,162,100,1350,63310
181.974,17,4,240,2,32,181973,32,120,2,32,181973,32,120
1795.79,17,449,39928,404,35,4456,288,25708,45,288,40018,288,14220
0.902,6,114,86712,50,131,18,232,2529,64,1383,14,2860,84183
247.242,6,29,7392,13,158,20603,267,1317,16,603,16480,1400,6075
0.09,6,9,1343,5,145,22,145,349,4,830,24,830,994
1686.068,17,12,498,11,14,168606,14,462,1,8,0,8,36
280.194,6,29,7392,13,158,23349,267,1317,16,603,18679,2036,6075
1795.363,1,164,9184,164,28,11014,28,9184,0,0,0,0,0
6.013,17,12,3369,6,33,1200,33,366,6,472,1200,507,3003
2.47,6,21,6351,10,262,269,517,1316,11,744,242,1418,5035
0.481,6,20,7238,13,335,40,668,2026,7,1210,74,1946,5212
1794.46,17,96,22814,96,209,18889,422,22814,0,0,0,0,0
473.808,1,5,665,5,105,118452,173,665,0,0,0,0,0
4.059,17,35,6681,16,192,268,1350,3524,19,138,223,1350,3157
1744.717,2,28,896,28,8,64619,8,896,0,0,0,0,0
0.478,6,12,1653,6,288,91,288,548,6,426,56,434,1105
0.449,6,54,22381,31,993,14,1380,17174,23,426,18,3303,5207
1797.771,1,345,28980,345,56,5226,56,28980,0,0,0,0,0
84.858,6,22,4567,10,341,9428,722,1541,12,299,7695,1408,3026
10.942,6,90,26509,45,557,248,1152,20211,45,449,242,1179,6298
4.225,17,5,290,5,30,1056,30,290,0,0,0,0,0
0.143,6,43,19609,25,1049,5,1420,14668,18,467,8,1883,4941
1773.337,6,184,15778,122,69,14655,69,9158,62,69,29070,69,6620
295.113,17,4,352,2,60,295111,60,176,2,60,295112,60,176
1797.983,6,369,27495,212,113,8521,1189,15760,157,81,11525,485,11735
103.481,6,42,25909,19,840,39,1460,5847,23,1195,4697,1460,20062
8.967,6,84,26317,43,559,213,1152,20195,41,407,217,1152,6122
6.175,6,40,7325,21,218,308,314,3463,19,516,328,1179,3862
36.578,17,22,1936,11,48,3649,48,836,11,72,3656,72,1100
1764.842,17,168,14034,156,30,11386,37,9090,12,384,154848,463,4944
1793.929,1,210,11760,210,28,8583,28,11760,0,0,0,0,0
34.316,17,40,5880,20,48,1805,48,1520,20,190,1805,308,4360
0.545,17,7,2390,7,313,90,354,2390,0,0,0,0,0
1796.416,1,117,12402,117,78,15486,78,12402,0,0,0,0,0
32.836,6,62,23383,33,454,1026,1360,5621,29,974,1034,3921,17762
1795.543,17,447,39864,402,35,4477,288,25644,45,288,40023,288,14220
0.782,6,28,10490,15,566,55,1360,4040,13,657,51,1360,6450
1772.261,6,181,15589,120,69,14892,69,8940,61,69,29532,69,6649
1792.585,6,357,22629,208,69,8659,69,12460,149,69,12111,69,10169
1783.334,17,339,66744,339,168,5276,422,66744,0,0,0,0,0
1744.617,2,30,960,30,8,60159,8,960,0,0,0,0,0
1775.474,1,58,4872,0,0,0,0,0,58,56,31148,56,4872
11.749,6,1915,1622758,1144,1363,10,1380,1587676,771,421,15,1923,35082
7.124,6,1508,1387177,929,1414,7,1448,1352405,579,776,12,1448,34772
1.5,6,38,8262,19,322,83,1172,2726,19,476,72,2715,5536
0.108,17,4,588,2,48,100,48,152,2,190,99,308,436
3.488,6,2,88,2,0,0,0,88,0,0,0,0,0
196.238,17,4,1344,4,308,65412,308,1344,0,0,0,0,0
0.147,17,2,158,1,34,0,34,62,1,68,0,68,96
0.142,6,3,182,2,31,142,31,111,1,31,0,31,71
1798.489,1,345,28980,345,56,5228,56,28980,0,0,0,0,0
65.088,6,8,332,4,0,21696,0,164,4,0,21391,0,168
1.722,6,13,2311,8,188,246,245,700,5,1407,365,1407,1611
240.477,6,56,24037,26,539,9618,1402,6214,30,956,8292,2804,17823
52.443,6,14,3991,8,307,7491,722,1345,6,1165,10441,1408,2646
2.088,6,23,5715,13,158,173,370,1315,10,999,230,1691,4400
421.156,2,6,192,6,8,84231,8,192,0,0,0,0,0
23.293,17,21,7401,10,432,2584,1350,4602,11,226,2326,1350,2799
9.997,17,5,290,4,23,3332,58,206,1,56,0,56,84
1797.305,17,449,39928,404,35,4459,288,25708,45,288,40021,288,14220
4.046,6,14,1858,8,131,577,131,563,6,967,809,967,1295
1.953,6,12,945,6,222,388,222,466,6,231,388,231,479
1799.999,6,223,19153,83,75,21951,339,8528,140,69,12949,1062,10625
19.656,6,22,4374,12,296,1786,722,1517,10,581,1899,1448,2857
1793.744,17,87,3648,86,14,21102,14,3612,1,8,0,8,36
1.305,6,53,22484,31,968,43,1360,16783,22,400,53,1360,5701
0.053,17,2,2382,2,1163,53,1163,2382,0,0,0,0,0
0.021,17,2,412,1,33,0,33,61,1,323,0,323,351
0.225,17,7,2390,7,313,37,354,2390,0,0,0,0,0
3.697,17,4,240,4,32,1232,32,240,0,0,0,0,0
39.717,6,43,8782,20,360,696,766,1985,23,366,1798,2720,6797
31.881,6,4537,4358211,3022,1365,10,1408,4274767,1515,776,20,1408,83444
0.531,17,3,451,2,39,382,39,134,1,289,0,289,317
1.895,17,4,334,2,39,1847,39,134,2,72,1842,72,200
98.001,6,18,1104,7,42,11333,46,449,11,43,9800,46,655
35.463,6,12,700,4,0,11821,0,220,8,0,4511,0,480
437.073,6,44,6647,21,127,19055,516,2122,23,189,19862,2642,4525
1789.998,6,356,22520,208,69,8647,69,12460,148,69,12176,69,10060
0.27,17,2,168,1,48,0,48,76,1,64,0,64,92
3.003,17,4,932,4,205,1001,205,932,0,0,0,0,0
2.82,6,2,88,2,0,0,0,88,0,0,0,0,0
121.54,6,30,7432,13,158,10128,267,1317,17,543,7594,1400,6115
1757.696,6,188,11496,94,47,18899,208,6775,94,31,18897,31,4721
121.388,17,7,532,7,48,20231,48,532,0,0,0,0,0
246.051,6,15,1121,13,31,20504,31,955,2,31,60190,31,166
812.685,17,160,12160,160,48,5111,48,12160,0,0,0,0,0
0.256,17,2,154,1,41,0,41,69,1,57,0,57,85
0.45,6,20,7238,12,335,40,668,1974,8,1210,63,1906,5264
4.856,6,27,10173,16,284,323,584,1496,11,1029,468,1420,8677
0.519,6,29,9282,14,216,39,688,1819,15,832,34,1368,7463
300.645,6,44,8842,23,315,13665,882,2249,21,441,506,1460,6593
0.0,17,2,704,2,324,0,422,704,0,0,0,0,0
0.026,17,2,263,1,36,0,36,64,1,171,0,171,199
1745.562,6,90,6540,60,31,29585,31,4050,30,31,60179,31,2490
240.646,2,3,96,3,8,120323,8,96,0,0,0,0,0
61.729,6,54,36294,36,1113,1763,1408,28609,18,963,3617,3847,7685
0.048,17,4,288,2,33,0,33,122,2,55,0,61,166
0.038,17,2,247,1,36,0,36,64,1,155,0,155,183
1796.01,1,78,4368,78,28,23324,28,4368,0,0,0,0,0
0.859,6,24,6420,14,299,66,842,2063,10,988,94,1791,4357
0.18,17,2,517,1,34,0,34,62,1,427,0,427,455
1795.775,17,447,39864,402,35,4478,288,25644,45,288,40016,288,14220
1741.346,6,91,6604,59,31,30023,31,3998,32,31,56172,31,2606
8.844,6,9,527,5,43,2211,43,311,4,0,2944,0,216
16.072,17,28,12614,15,655,1144,1350,10245,13,154,1335,1350,2369
3.339,17,5,295,5,31,834,31,295,0,0,0,0,0
318.462,17,18,3708,9,48,39806,48,684,9,308,39806,308,3024
1784.77,6,270,32215,110,133,16372,1460,15508,160,128,11224,1642,16707
1755.813,6,105,8572,67,50,26603,205,5159,38,39,47445,131,3413
0.07,17,2,210,1,53,0,53,81,1,101,0,101,129
1741.113,6,94,7151,62,38,28542,205,4424,32,33,56150,98,2727
0.592,6,10,1383,5,145,148,145,349,5,830,100,830,1034
0.734,6,115,87277,55,131,13,232,2729,60,1493,11,2760,84548
1.23,6,25,8056,12,164,94,267,1288,13,869,87,1440,6768
1746.271,6,95,7203,63,38,28165,205,4476,32,33,56321,98,2727
29.86,17,40,20895,17,501,1865,1350,8998,23,489,1355,1350,11897
11.249,6,930,841199,597,1337,18,1368,818599,333,776,33,2736,22600
0.72,17,2,198,1,63,0,63,91,1,79,0,79,107
1.175,1,2,291,2,117,1175,142,291,0,0,0,0,0
33.661,6,34,5473,16,180,2230,721,1935,18,288,1968,2026,3538
0.346,6,20,7151,11,318,33,600,1854,9,964,42,1471,5297
127.994,1,4,224,4,28,42664,28,224,0,0,0,0,0
0.931,6,36,8192,19,241,51,619,1758,17,478,47,2128,6434
1769.17,6,99,9174,66,64,27218,64,5544,33,58,55282,58,3630
1777.289,1,68,5712,68,56,26526,56,5712,0,0,0,0,0
216.341,6,36,8458,21,288,10817,1249,3154,15,427,15445,1420,5304
0.139,6,3,128,2,0,139,0,84,1,0,0,0,44
4.3,17,5,290,5,30,1075,30,290,0,0,0,0,0
71.257,17,3,228,3,48,35628,48,228,0,0,0,0,0
300.586,6,19,1279,6,177,60082,177,497,13,110,25034,110,782
601.631,2,4,128,4,8,200543,8,128,0,0,0,0,0
0.549,17,2,384,1,39,0,39,67,1,289,0,289,317
95.899,6,159,131843,107,1281,904,1408,119629,52,730,1876,3847,12214
10.246,6,82,24485,42,550,249,1152,18744,40,459,256,1179,5741
62.369,6,24,9894,12,477,63,1360,2435,12,1161,5657,2574,7459
1791.627,17,144,11520,72,48,25233,48,5472,72,56,25233,56,6048
1792.367,17,142,11360,71,48,25604,48,5396,71,56,25604,56,5964
236.275,6,186,29958,101,304,2362,304,21188,85,83,2794,83,8770
158.712,6,28,6562,11,220,5499,516,1325,17,325,9914,1452,5237
300.231,6,37,26437,19,405,16679,1066,2629,18,1524,3655,4224,23808
167.698,6,68,47113,44,1188,3899,1408,39133,24,960,2678,3847,7980
1.449,6,46,18947,26,946,57,1460,13371,20,476,66,2615,5576
6.622,17,28,8288,11,280,662,1350,3394,17,259,410,1350,4894
1779.765,6,207,23990,132,89,13585,981,11187,75,137,24044,1460,12803
45.845,2,2,64,2,8,45845,8,64,0,0,0,0,0
1.533,6,12,3462,6,75,306,75,395,6,1373,306,1448,3067
0.916,17,4,502,2,31,906,31,118,2,164,906,164,384
1741.255,6,89,6469,59,31,30021,31,3998,30,31,60042,31,2471
1782.486,17,83,3480,82,14,22006,14,3444,1,8,0,8,36
95.168,6,7,292,4,0,31722,0,164,3,0,47536,0,128
2.179,6,42,27471,21,246,108,246,1592,21,1457,91,2447,25879
0.014,17,2,411,1,33,0,33,61,1,322,0,322,350
2.031,6,15,3636,7,150,338,174,584,8,681,271,1452,3052
18.058,17,18,9086,8,615,2574,1350,5151,10,365,2002,1350,3935
1798.392,1,254,14224,254,28,7108,28,14224,0,0,0,0,0
0.064,6,15,5165,7,290,10,517,941,8,950,7,1418,4224
8.312,6,79,24946,41,569,207,1152,19285,38,413,217,1152,5661
1740.285,1,15,840,15,28,124306,28,840,0,0,0,0,0
134.765,17,260,50184,19,49,3936,288,1480,241,174,560,308,48704
3.611,6,14,3143,8,49,515,92,511,6,579,42,1408,2632
0.027,17,2,554,1,30,0,30,58,1,468,0,468,496
1748.184,6,97,7369,64,38,27748,205,4559,33,33,54620,98,2810
7.237,6,1416,1364419,942,1375,7,1408,1335107,474,776,14,1408,29312
1.628,6,11,1727,7,100,271,100,384,4,589,463,1152,1343
91.533,17,4,304,4,48,30511,48,304,0,0,0,0,0
1787.509,6,102,8296,68,65,26679,65,4930,34,59,54163,59,3366
127.929,17,27,4561,27,140,4920,352,4561,0,0,0,0,0
35.655,6,32,5147,16,154,2377,722,1912,16,342,2343,1448,3235
1.284,6,51,21953,29,944,45,1360,16297,22,476,53,2715,5656
1794.601,6,366,25886,209,99,8627,469,14845,157,69,11502,69,11041
1.432,6,10,1687,7,100,238,100,384,3,1179,595,1179,1303
0.168,6,25,7216,13,155,14,267,1301,12,775,14,2800,5915
6.401,6,34,6169,18,206,376,314,2784,16,548,409,1179,3385
11.323,17,8,704,4,48,3770,48,304,4,72,3770,72,400
117.681,6,21,8247,11,514,93,1237,2016,10,969,13053,1791,6231
7.866,17,6,528,3,48,3927,48,228,3,72,3927,72,300
1780.132,17,142,11360,71,48,25430,48,5396,71,56,25430,56,5964
1219.95,1,16,896,16,28,81330,28,896,0,0,0,0,0
240.267,6,45,9188,24,522,10446,1408,5962,21,236,12013,618,3226
1785.856,6,366,23127,211,69,8504,69,12787,155,69,11596,69,10340
519.407,17,32,7596,16,33,34626,37,984,16,385,34625,463,6612
5.24,6,41,7349,21,218,262,314,3463,20,440,262,1152,3886
8.225,6,79,24717,40,561,210,1152,19016,39,413,209,1152,5701
1776.192,17,73,3060,72,14,25016,14,3024,1,8,0,8,36
62.57,6,8,376,2,0,62570,0,88,6,0,6313,0,288
1772.055,6,99,9306,66,66,27262,66,5610,33,60,55373,60,3696
1083.41,2,17,544,17,8,67713,8,544,0,0,0,0,0
55.299,17,4,352,2,60,55298,60,176,2,60,55298,60,176
1755.228,1,137,7672,137,28,12906,28,7672,0,0,0,0,0
5.016,17,4,558,2,36,5011,36,128,2,187,5012,187,430
90.77,6,101,57160,54,817,75,1360,19366,47,920,1970,2384,37794
1750.014,6,96,7286,63,38,28226,205,4476,33,33,54679,98,2810
1792.206,6,118,7660,69,49,26355,208,4646,49,31,37331,31,3014
0.139,17,2,180,1,30,0,30,58,1,94,0,94,122
280.013,6,31,7472,14,158,21539,267,1357,17,543,17500,1400,6115
10.933,6,18,5610,10,275,1214,275,958,8,1440,854,1440,4652
0.226,17,2,152,1,48,0,48,76,1,48,0,48,76
1781.762,6,365,25432,213,100,8404,469,14936,152,69,11799,69,10496
7.221,2,2,64,2,8,7221,8,64,0,0,0,0,0
17.385,6,1033,850765,616,1301,27,1368,823073,417,776,41,2736,27692
1.2,6,38,9127,20,399,63,1360,3631,18,476,61,2715,5496
1785.873,6,367,23305,211,69,8504,69,12787,156,69,11521,69,10518
36.559,6,26,5382,12,243,3323,773,2434,14,397,2773,1179,2948
301.358,6,108,71161,62,1346,4940,1440,64457,46,346,202,1440,6704
0.433,6,50,21387,28,944,16,1380,16265,22,421,18,1923,5122
40.47,17,24,2112,12,48,3675,48,912,12,72,3677,72,1200
1799.848,17,444,93842,444,183,4062,352,93842,0,0,0,0,0
1761.363,6,116,9308,74,66,24128,66,5468,42,60,42957,60,3840
1714.988,1,72,4032,72,28,24154,28,4032,0,0,0,0,0
1.834,6,49,19471,27,907,70,1460,13815,22,433,73,1460,5656
70.37,6,5,6955,5,1339,17592,1339,6955,0,0,0,0,0
10.186,6,18,4144,11,258,1018,597,1600,7,543,1667,1440,2544
71.14,6,12,984,11,43,7114,43,924,1,0,0,0,60
16.754,17,27,10862,13,519,1393,1350,7121,14,239,1286,1350,3741
3.51,17,5,290,5,30,877,30,290,0,0,0,0,0
1780.029,17,140,11200,70,48,25797,48,5320,70,56,25797,56,5880
1773.101,6,181,15589,120,69,14900,69,8940,61,69,29544,69,6649
1785.024,6,356,22520,208,69,8623,69,12460,148,69,12142,69,10060
27.079,6,3906,3703654,2501,1401,10,1448,3625930,1405,776,19,1448,77724
251.788,2,3,96,3,8,125894,8,96,0,0,0,0,0
1745.33,6,146,9143,78,48,22666,208,5555,68,31,26046,31,3588
0.084,17,2,167,1,39,0,39,67,1,72,0,72,100
276.758,17,21,7614,21,334,13837,548,7614,0,0,0,0,0
1798.005,17,448,39896,403,35,4472,288,25676,45,288,40022,288,14220
1.641,6,38,8252,19,320,91,1162,2716,19,433,80,1360,5536
1.284,6,48,19059,26,948,51,1460,13403,22,433,52,1460,5656
1771.195,6,99,9306,66,66,27249,66,5610,33,60,55347,60,3696
3.395,17,5,568,4,60,1121,60,352,1,188,0,188,216
0.153,17,2,144,1,36,0,36,64,1,52,0,52,80
376.412,1,8,848,8,78,53773,78,848,0,0,0,0,0
120.599,6,12,8679,3,100,318,100,224,9,1155,15043,1179,8455
2.071,6,14,2351,8,188,295,245,700,6,703,362,1152,1651
0.012,6,10,1794,6,613,2,1070,1471,4,159,3,159,323
36.172,6,27,4810,16,176,2411,517,2087,11,428,3615,499,2723
7.744,6,64,20542,34,559,234,1152,15915,30,489,258,1179,4627
5.014,17,4,558,2,36,5010,36,128,2,187,5009,187,430
123.43,6,63,10986,28,231,4571,1189,3440,35,341,3624,1917,7546
62.53,6,3,132,2,0,62530,0,88,1,0,0,0,44
1793.986,1,58,4872,58,56,31473,56,4872,0,0,0,0,0
0.131,17,2,334,1,32,0,32,60,1,246,0,246,274
0.063,6,11,913,6,182,12,182,490,5,77,13,134,423
963.579,17,43,21168,15,308,68827,308,5040,28,548,26984,548,16128
1.439,6,26,9026,13,263,119,691,1736,13,943,99,1438,7290
60.421,6,9,771,5,177,15105,177,445,4,110,20062,110,326
107.159,6,13,1720,4,330,8890,330,876,9,83,13393,83,844
1795.323,1,263,14728,263,28,6852,28,14728,0,0,0,0,0
541.423,2,7,224,7,8,90237,8,224,0,0,0,0,0
1786.515,6,102,8364,68,66,26664,66,4964,34,60,54132,60,3400
0.34,17,2,778,2,361,340,361,778,0,0,0,0,0
0.345,17,3,1170,3,362,172,362,1170,0,0,0,0,0
1.551,17,2,778,2,361,1551,361,778,0,0,0,0,0
372.131,6,18,1242,14,180,28625,180,916,4,110,20061,110,326
157.879,17,4,352,2,60,157878,60,176,2,60,157878,60,176
0.459,6,51,22633,28,1085,17,1380,17459,23,421,19,1923,5174
1797.117,6,400,35298,220,116,8206,1189,17536,180,130,10039,2920,17762
15.154,6,1998,1872068,1310,1373,11,1380,1834506,688,421,21,1923,37562
7.268,6,14,4051,8,49,1038,92,523,6,1070,1375,1448,3528
300.288,6,40,29206,21,190,15014,444,1861,19,1756,13446,5197,27345
0.253,17,475,541875,86,87,2,1350,9923,389,1339,0,1350,531952
10.183,6,82,24837,43,561,242,1152,19136,39,413,261,1152,5701
1783.258,17,83,3480,82,14,22015,14,3444,1,8,0,8,36
240.209,6,57,20607,31,840,8006,1418,17594,26,206,9607,580,3013
0.092,17,4,420,2,33,1,33,122,2,121,2,145,298
829.608,1,27,2268,27,56,31908,56,2268,0,0,0,0,0
0.514,17,2,144,1,36,0,36,64,1,52,0,52,80
0.222,17,2,2382,2,1163,222,1163,2382,0,0,0,0,0
0.013,17,2,435,1,44,0,44,72,1,335,0,335,363
0.584,17,4,350,2,34,576,34,124,2,85,576,91,226
12.763,17,4,352,2,48,12737,48,152,2,72,12748,72,200
37.071,17,44,6468,22,48,1763,48,1672,22,190,1764,308,4796
280.213,6,28,7352,13,158,23351,267,1317,15,678,20011,2800,6035
0.242,6,48,22999,27,1121,9,1420,17926,21,467,11,1883,5073
280.243,6,28,7352,13,158,23353,267,1317,15,678,20013,2800,6035
1747.821,6,94,7151,62,38,28652,205,4424,32,33,56375,98,2727
1785.784,6,106,8320,68,63,26653,63,4862,38,57,48262,57,3458
0.553,6,27,9167,13,282,46,769,1814,14,943,38,1368,7353
2.452,17,27,8996,11,311,245,1350,3738,16,300,122,1350,5258
165.652,17,12,912,12,48,15059,48,912,0,0,0,0,0
0.309,6,27,9065,14,252,23,646,1746,13,947,25,1402,7319
4.307,17,4,352,2,48,4285,48,152,2,72,4288,72,200
0.512,6,21,7281,13,334,42,663,2021,8,1209,68,1946,5260
5.435,6,41,7349,21,218,271,314,3463,20,513,272,1179,3886
1797.854,17,144,11520,72,48,25321,48,5472,72,56,25321,56,6048
1.02,6,31,13226,16,525,68,1440,3310,15,930,59,1440,9916
0.106,17,2,2750,2,1347,106,1347,2750,0,0,0,0,0
584.761,17,36,2880,18,48,34397,48,1368,18,56,34397,56,1512
1773.509,6,112,6712,62,27,29072,27,3668,50,27,36192,27,3044
1690.835,2,17,544,17,8,105677,8,544,0,0,0,0,0
280.267,6,29,7392,13,158,23355,267,1317,16,603,18683,2236,6075
18.849,6,26,6797,12,181,1713,267,1212,14,627,1448,1400,5585
1715.928,17,243,51850,243,185,7090,422,51850,0,0,0,0,0
300.744,6,39,8497,21,277,15037,762,1992,18,444,501,2128,6505
245.695,6,8,320,8,0,0,0,320,0,0,0,0,0
877.133,1,14,784,14,28,67471,28,784,0,0,0,0,0
0.209,17,2,198,1,39,0,39,67,1,103,0,103,131
0.698,6,149,100223,80,1303,8,1420,93160,69,427,10,1420,7063
31.396,17,4,1344,4,308,10465,308,1344,0,0,0,0,0
1623.025,6,335,21197,192,69,8497,69,11751,143,69,11429,69,9446
0.523,17,3,543,2,39,433,39,134,1,381,0,381,409
1610.33,1,14,784,14,28,123871,28,784,0,0,0,0,0
10.216,6,37,8325,19,345,567,721,1852,18,441,504,1360,6473
0.056,17,2,206,1,44,0,44,72,1,106,0,106,134
280.201,6,30,7432,13,158,23350,267,1317,17,543,17510,1300,6115
7.935,6,609,501964,362,1315,21,1368,484456,247,931,31,2736,17508
22.673,6,16,3269,6,92,4534,92,400,10,579,2499,1408,2869
19.155,6,6,328,4,0,6385,0,216,2,0,18931,0,112
280.205,6,29,7392,13,158,23350,267,1317,16,603,18677,2036,6075
81.356,6,50,20465,28,1128,338,1360,14738,22,402,3863,2667,5727
1.365,6,11,1727,7,100,227,100,384,4,589,368,1152,1343
0.502,6,28,9197,13,277,41,747,1792,15,943,32,1368,7405
1788.16,6,4262,4241548,1445,131,1238,339,81040,2817,1463,634,2804,4160508
3.016,17,8,608,4,37,1002,37,260,4,59,1002,65,348
0.475,17,18,7438,9,501,59,1350,4764,9,269,52,1350,2674
1718.843,17,15,5163,15,316,122774,1102,5163,0,0,0,0,0
112.464,6,23,8936,11,392,105,866,1649,12,970,10211,1440,7287
20.136,6,20,3788,11,269,2013,517,1668,9,411,2515,499,2120
5.339,6,40,7325,21,218,266,314,3463,19,516,282,1179,3862
1798.548,17,87,3648,86,14,21159,14,3612,1,8,0,8,36
1.574,6,48,18527,27,842,60,1360,12911,21,476,68,2720,5616
1782.746,17,142,11360,71,48,25467,48,5396,71,56,25466,56,5964
0.192,6,45,21595,26,1036,7,1420,16614,19,467,10,1883,4981
0.086,6,2,92,1,0,0,0,52,1,0,0,0,40
1.272,6,25,8056,12,164,98,267,1288,13,869,90,1402,6768
1.272,6,25,8080,12,164,98,267,1312,13,869,90,1408,6768
1799.082,17,448,39896,403,35,4475,288,25676,45,288,40021,288,14220
0.018,17,4,368,2,32,0,32,120,2,96,1,96,248
1779.023,1,178,18868,178,78,10050,78,18868,0,0,0,0,0
0.337,17,2,152,1,48,0,48,76,1,48,0,48,76
175.579,6,22,9920,11,433,71,990,1771,11,1099,17544,1440,8149
1790.502,6,358,22669,209,69,8608,69,12569,149,69,12097,69,10100
68.274,6,47,12177,23,371,3098,1392,3543,24,434,2963,2816,8634
2.022,6,14,4304,5,288,486,288,520,9,682,230,853,3784
0.122,17,3,234,2,39,100,39,134,1,72,0,72,100
0.17,17,2,219,1,50,0,50,78,1,113,0,113,141
1.794,6,12,2271,7,188,299,245,660,5,1407,382,1407,1611
1781.14,17,136,10880,68,48,26583,48,5168,68,56,26583,56,5712
182.715,6,70,49718,46,1192,4060,1408,41736,24,960,2681,3847,7982
1.368,6,53,21867,28,995,50,1440,16091,25,433,49,1440,5776
36.491,6,24,3996,14,179,2807,517,1824,10,411,4053,499,2172
340.433,17,5,1672,5,306,85108,308,1672,0,0,0,0,0
371.121,6,27,1767,18,177,21830,177,1181,9,110,8616,110,586
1798.964,17,848,284928,848,308,2123,308,284928,0,0,0,0,0
300.985,2,3,96,3,8,150492,8,96,0,0,0,0,0
3.801,17,2,690,2,317,3801,317,690,0,0,0,0,0
0.776,6,11,1727,7,100,129,100,384,4,589,172,1152,1343
31.29,6,8,348,2,0,9,0,84,6,0,6256,0,264
8.126,6,14,2185,8,324,1160,585,1073,6,396,1621,580,1112
38.208,6,46,27590,24,530,15,1034,2908,22,1384,1819,7040,24682
14.437,17,4,352,2,60,14435,60,176,2,60,14436,60,176
3.002,17,4,932,4,205,1000,205,932,0,0,0,0,0
1775.18,6,180,15480,120,69,14917,69,8940,60,69,30084,69,6540
1.139,17,4,560,2,64,1000,64,184,2,160,1021,160,376
0.306,17,2,154,1,33,0,33,61,1,65,0,65,93
1784.814,1,70,5880,70,56,25866,56,5880,0,0,0,0,0
20.363,17,24,7032,12,40,1836,41,824,12,489,1665,505,6208
242.674,6,61,40593,40,1135,6222,1408,32759,21,841,3075,2816,7834
13.815,6,68,20702,36,538,394,1152,15995,32,489,426,1179,4707
1.296,6,38,9848,21,440,64,1360,4392,17,433,69,1360,5456
902.44,2,8,256,8,8,128920,8,256,0,0,0,0,0
0.024,17,2,507,1,37,0,37,65,1,414,0,414,442
240.504,6,55,11201,28,175,8906,751,3125,27,510,9248,2380,8076
1781.405,17,140,11200,70,48,25817,48,5320,70,56,25817,56,5880
77.556,6,37,8393,16,208,5170,314,2518,21,457,3864,1179,5875
372.102,6,18,1242,14,180,28623,180,916,4,110,20065,110,326
1772.884,6,180,15480,120,69,14898,69,8940,60,69,30047,69,6540
1742.706,6,95,7203,63,38,28108,205,4476,32,33,56207,98,2727
10.639,6,16,3911,9,275,1329,275,643,7,992,957,1440,3268
11.002,6,18,5610,10,275,1222,275,958,8,1440,855,1440,4652
8.183,6,76,24245,39,550,215,1152,18624,37,459,220,1179,5621
240.2,6,58,18149,30,753,8282,1418,15130,28,194,8895,580,3019
1772.794,6,180,15480,120,69,14897,69,8940,60,69,30046,69,6540
0.028,17,2,182,1,39,0,39,67,1,87,0,87,115
917.774,17,70,5584,37,48,25493,48,2812,33,56,25509,56,2772
199.568,17,4,352,2,60,199567,60,176,2,60,199567,60,176
1794.664,6,365,23087,211,69,8546,69,12787,154,69,11729,69,10300
1776.162,6,77,4054,38,26,48002,26,2002,39,24,46739,24,2052
2.055,17,3,201,3,39,1027,39,201,0,0,0,0,0
287.743,6,38,4360,18,237,16925,584,1716,20,228,15143,580,2644
61.369,6,36,15979,22,810,2922,1402,9253,14,748,4700,2451,6726
1785.296,6,356,22520,208,69,8624,69,12460,148,69,12144,69,10060
23.271,6,33,8097,15,188,1662,722,1924,18,681,1356,1380,6173
0.014,17,2,180,1,30,0,30,58,1,94,0,94,122
5.947,17,3,1008,3,308,2973,308,1008,0,0,0,0,0
10.884,6,20,4402,11,275,1088,275,998,9,758,764,1420,3404
9.04,17,16,1408,8,37,1287,37,520,8,83,1290,89,888
0.938,6,11,1727,7,100,156,100,384,4,589,227,1152,1343
0.038,17,2,317,1,43,0,43,71,1,218,0,218,246
0.899,6,10,1687,7,100,149,100,384,3,1179,317,1179,1303
3.022,6,2,88,2,0,0,0,88,0,0,0,0,0
240.219,6,56,21266,30,885,8283,1418,18401,26,188,9608,580,2865
1798.242,6,377,26257,218,98,8286,469,15412,159,69,11379,69,10845
0.053,6,4,220,2,0,53,0,104,2,0,4,0,116
47.529,6,28,7352,12,158,4320,267,1277,16,603,3164,1400,6075
12.126,6,6,328,4,0,4042,0,216,2,0,12071,0,112
1787.9,6,356,22520,208,69,8637,69,12460,148,69,12162,69,10060
240.193,6,58,20007,29,849,8577,1418,16805,29,210,8577,580,3202
123.352,6,11,640,3,0,61587,0,164,8,0,17596,0,476
0.027,17,2,575,1,40,0,40,68,1,479,0,479,507
164.118,17,4,240,2,32,164117,32,120,2,32,164116,32,120
1.326,6,52,23712,30,989,45,1360,18056,22,433,54,1360,5656
0.909,17,4,1006,2,40,897,40,136,2,407,899,407,870
1784.158,6,361,22858,210,69,8536,69,12678,151,69,11894,69,10180
0.044,17,2,417,1,34,0,34,62,1,327,0,327,355
36.74,17,4,240,2,32,36739,32,120,2,32,36739,32,120
61.319,6,37,15981,22,805,2919,1408,9203,15,665,4360,1408,6778
1782.388,17,83,3480,82,14,22004,14,3444,1,8,0,8,36
60.833,6,11,2993,6,92,12166,92,400,5,1164,15099,1448,2593
0.021,17,2,162,1,34,0,34,62,1,72,0,72,100
0.021,6,2,133,1,0,0,0,40,1,53,0,53,93
146.178,17,4,1344,4,308,48726,308,1344,0,0,0,0,0
39.685,17,5,380,5,48,9921,48,380,0,0,0,0,0
1786.845,6,102,8364,68,66,26669,66,4964,34,60,54143,60,3400
1799.104,17,448,39896,403,35,4475,288,25676,45,288,40022,288,14220
1.667,6,16,5398,8,170,237,170,638,8,867,229,1448,4760
1783.936,6,355,22411,207,69,8659,69,12351,148,69,12120,69,10060
0.142,6,9,1002,5,213,35,213,417,4,421,41,421,585
0.934,6,10,1687,7,100,155,100,384,3,1179,339,1179,1303
7.304,6,1718,1591522,1086,1387,6,1408,1553994,632,931,11,2801,37528
1740.502,17,28,29512,28,1026,64463,1026,29512,0,0,0,0,0
1791.199,6,363,22938,210,69,8570,69,12678,153,69,11784,69,10260
0.395,6,14,1733,7,288,62,288,588,7,284,36,434,1145
1788.592,1,50,2800,50,28,36501,28,2800,0,0,0,0,0
31.911,6,9,396,2,0,3462,0,88,7,0,5305,0,308
1744.671,2,28,896,28,8,64617,8,896,0,0,0,0,0
13.367,6,2042,1872228,1309,1373,10,1380,1829432,733,751,18,3303,42796
1.535,6,48,18944,27,872,59,1360,13328,21,433,66,1360,5616
280.254,6,27,7312,12,158,25477,267,1277,15,678,20014,2045,6035
487.495,1,12,672,12,28,44317,28,672,0,0,0,0,0
0.21,17,2,322,1,33,0,33,61,1,233,0,233,261
0.234,6,46,22545,27,1097,9,1420,17564,19,467,12,1883,4981
104.355,6,24,8146,12,417,56,950,1765,12,736,9474,1360,6381
0.106,17,2,334,1,32,0,32,60,1,246,0,246,274
378.026,2,4,128,4,8,126008,8,128,0,0,0,0,0
66.358,6,152,128782,58,430,1164,648,4375,94,1313,710,1408,124407
192.83,17,6,528,3,60,96414,60,264,3,60,96414,60,264
300.596,6,37,8619,20,335,15820,994,2185,17,478,527,2128,6434
43.409,2,3,96,3,8,21704,8,96,0,0,0,0,0
120.321,2,2,64,2,8,120321,8,64,0,0,0,0,0
23.243,6,35,8176,17,188,1452,721,2003,18,605,1355,2840,6173
280.281,6,29,7392,13,158,23356,267,1317,16,603,18682,1400,6075
1793.114,1,235,24910,235,78,7662,78,24910,0,0,0,0,0
1096.214,1,8,1124,8,112,156602,351,1124,0,0,0,0,0
59.784,6,204,136374,104,257,580,631,7070,100,1320,603,2760,129304
0.076,6,10,766,5,185,15,185,453,5,45,15,45,313
1738.588,6,89,6512,58,31,30501,31,3939,31,31,57952,31,2573
0.034,6,14,4044,8,88,4,88,452,6,1670,6,1880,3592
125.39,2,2,64,2,8,125390,8,64,0,0,0,0,0
0.085,6,2,84,1,0,0,0,44,1,0,0,0,40
0.911,6,11,1727,7,100,151,100,384,4,589,215,1152,1343
1771.293,6,99,9240,66,65,27250,65,5577,33,59,55349,59,3663
0.236,6,3,187,1,0,0,0,40,2,31,26,31,147
280.096,6,29,7392,14,158,21545,267,1357,15,678,20000,3436,6035
102.823,17,66,28616,30,517,3544,1350,16368,36,312,2936,1350,12248
1779.406,17,140,11200,70,48,25788,48,5320,70,56,25788,56,5880
0.058,6,9,1339,5,145,14,145,349,4,826,14,826,990
5.699,6,51,23349,20,1005,299,1440,12899,31,573,184,1440,10450
1799.983,6,211,14618,78,46,22986,46,6124,133,46,13635,46,8494
166.862,6,73,49153,45,1207,3792,1448,40973,28,746,2283,1448,8180
1712.552,1,8,448,8,28,244650,28,448,0,0,0,0,0
0.045,6,2,104,1,0,0,0,40,1,0,0,0,64
0.092,17,4,420,2,33,0,33,122,2,121,43,145,298
1781.807,6,367,23305,213,69,8404,69,12798,154,69,11645,69,10507
1795.323,17,448,39896,403,35,4465,288,25676,45,288,40016,288,14220
1787.685,1,58,4872,58,56,31362,56,4872,0,0,0,0,0
300.599,6,40,8658,21,315,15029,882,2145,19,441,492,1440,6513
11.611,6,1836,1604374,1113,1386,10,1420,1571233,723,467,16,1883,33141
5.01,17,4,558,2,36,5005,36,128,2,187,3583,187,430
1.956,17,4,580,2,40,1924,40,136,2,194,1793,194,444
86.287,6,54,22893,24,389,3751,1067,2685,30,790,2958,1360,20208
0.013,6,2,133,1,0,0,0,40,1,53,0,53,93
140.303,6,169,78759,100,789,1417,1360,62493,69,481,2061,4658,16266
0.066,17,2,152,1,48,0,48,76,1,48,0,48,76
1783.878,6,413,24986,201,69,8919,69,12180,212,34,8454,48,12806
597.092,1,6,336,6,28,119418,28,336,0,0,0,0,0
280.211,17,6,1496,3,32,140103,37,181,3,410,140103,463,1315
31.316,6,8,348,2,0,21,0,84,6,0,6260,0,264
0.052,17,2,904,1,300,0,300,328,1,548,0,548,576
1.196,6,33,11570,17,270,70,561,2101,16,979,68,1631,9469
111.817,6,61,31824,37,943,3106,1418,24598,24,597,4860,1418,7226
1796.964,6,354,22440,206,69,8765,69,12380,148,69,12223,69,10060
280.488,6,27,7312,12,158,25498,267,1277,15,678,20030,2045,6035
1792.662,17,144,11520,72,48,25248,48,5472,72,56,25248,56,6048
286.592,6,3,450,3,110,143296,110,450,0,0,0,0,0
1680.868,1,15,840,15,28,120062,28,840,0,0,0,0,0
1796.366,17,42,14192,42,309,43813,382,14192,0,0,0,0,0
125.924,17,4,240,2,32,125922,32,120,2,32,125923,32,120
10.351,6,72,20670,38,531,279,1152,15883,34,489,305,1179,4787
100.389,6,34,7871,13,155,8365,267,1306,21,357,5019,3417,6565
49.272,17,4,352,2,60,49271,60,176,2,60,49271,60,176
1638.246,2,11,352,11,8,163824,8,352,0,0,0,0,0
1.019,6,31,12413,16,525,67,1440,3298,15,850,60,1440,9115
342.848,1,7,392,7,28,57141,28,392,0,0,0,0,0
1799.014,6,255,27609,146,111,12406,722,14944,109,72,16654,1448,12665
3.008,17,3,211,2,37,3003,37,130,1,53,0,53,81
1794.101,17,80,3354,79,14,23001,14,3318,1,8,0,8,36
0.789,6,11,1095,7,182,131,182,724,4,77,215,134,371
300.29,6,33,8822,14,409,23099,1050,2386,19,388,3803,1491,6436
0.389,6,27,9076,13,252,32,647,1692,14,831,28,1448,7384
1.028,17,25,12317,13,515,82,1350,7071,12,409,90,1350,5246
0.36,17,2,152,1,48,0,48,76,1,48,0,48,76
10.842,6,18,5610,10,275,1204,275,958,8,1440,835,1440,4652
0.06,6,10,766,5,185,13,185,453,5,45,13,45,313
0.605,6,20,7238,13,335,50,668,2026,7,1613,93,3314,5212
0.195,17,316,339724,74,114,2,1350,10529,242,1332,0,1350,329195
300.828,6,41,13612,23,892,13674,1360,8090,18,435,507,2720,5522
0.252,17,3,234,2,39,66,39,134,1,72,0,72,100
1782.832,6,102,8296,68,65,26609,65,4930,34,59,54022,59,3366
1740.658,17,30,6930,30,203,60022,203,6930,0,0,0,0,0
1754.525,6,94,7151,62,38,28762,205,4424,32,33,56587,98,2727
542.899,17,7,2548,7,336,90483,548,2548,0,0,0,0,0
145.92,17,4,352,2,60,145918,60,176,2,60,145919,60,176
1751.756,6,213,22340,120,89,14720,722,10969,93,82,19036,1408,11371
1.407,6,47,19328,27,902,54,1460,13752,20,476,64,2615,5576
74.772,17,27,2281,25,30,3115,37,1457,2,384,6874,463,824
1775.806,17,136,10880,68,48,26503,48,5168,68,56,26502,56,5712
0.983,6,10,1687,7,100,163,100,384,3,1179,350,1179,1303
6.304,1,4,224,4,28,2101,28,224,0,0,0,0,0
27.951,6,22,3892,13,179,2329,517,1772,9,411,3492,499,2120
180.472,2,3,96,3,8,90236,8,96,0,0,0,0,0
0.079,17,2,221,1,35,0,35,63,1,130,0,130,158
0.45,6,6,324,4,0,150,0,216,2,0,243,0,108
1.488,6,41,9968,21,440,74,1360,4392,20,433,67,1360,5576
300.333,6,96,86048,36,145,8580,230,2472,60,1411,5090,2896,83576
134.178,6,23,10989,12,380,77,832,1665,11,1267,13404,3928,9324
280.055,6,26,7272,13,158,23337,267,1317,13,775,23337,3445,5955
25.201,17,8,608,8,48,3600,48,608,0,0,0,0,0
39.939,17,3,228,3,48,19969,48,228,0,0,0,0,0
0.515,6,11,1008,6,256,96,256,500,5,304,115,304,508
335.858,6,9,546,6,31,67171,31,333,3,31,167903,31,213
2.97,17,2,1430,2,687,2970,687,1430,0,0,0,0,0
1.159,17,4,306,2,40,1133,41,137,2,56,1131,57,169
0.19,17,2,383,1,39,0,39,67,1,288,0,288,316
299.539,6,6,364,4,31,99846,31,222,2,31,299513,31,142
227.615,17,8,2688,8,308,32516,308,2688,0,0,0,0,0
28.79,6,26,7243,14,429,2214,646,2061,12,650,1435,1846,5182
1786.126,6,102,8364,68,66,26658,66,4964,34,60,54122,60,3400
1679.869,1,15,840,15,28,119990,28,840,0,0,0,0,0
1.282,6,46,19517,26,919,51,1360,13941,20,476,58,2720,5576
8.899,6,81,24477,40,550,228,1152,18680,41,461,215,1179,5797
95.974,6,892,446192,490,843,196,1152,425321,402,435,238,1179,20871
280.26,17,4,296,2,30,280246,30,116,2,62,280244,62,180
1741.791,1,77,6468,0,0,0,0,0,77,56,22918,56,6468
1740.605,17,29,30624,29,1028,62164,1028,30624,0,0,0,0,0
7.647,6,15,1362,8,275,1092,275,878,7,96,956,96,484
3.348,6,13,2311,8,188,478,245,700,5,1407,769,1407,1611
1798.848,17,346,26296,346,48,5214,48,26296,0,0,0,0,0
38.739,6,1710,1531123,1083,1333,35,1368,1490981,627,792,61,2736,40142
1773.528,6,182,15629,121,69,14779,69,8980,61,69,29552,69,6649
280.301,6,30,7432,13,158,23358,267,1317,17,543,17511,1400,6115
1791.951,6,133,11324,69,26,26351,26,4078,64,154,28442,427,7246
1479.639,6,305,21008,130,46,11429,46,8442,175,46,8503,46,12566
0.646,17,2,685,1,308,0,308,336,1,321,0,321,349
1778.411,6,240,23533,120,141,14943,208,17710,120,31,14942,31,5823
148.554,17,5,380,5,48,37138,48,380,0,0,0,0,0
1734.732,17,144,24390,144,141,12130,373,24390,0,0,0,0,0
0.249,17,2,152,1,48,0,48,76,1,48,0,48,76
2.312,6,30,7559,17,305,144,1086,2825,13,601,186,1420,4734
127.395,6,18,11870,4,92,392,92,320,14,901,9785,2026,11550
1745.37,6,95,7203,63,38,28151,205,4476,32,33,56291,98,2727
1786.354,6,158,20624,92,304,19630,304,14512,66,83,27482,83,6112
1772.04,6,180,15480,120,69,14891,69,8940,60,69,30032,69,6540
168.39,17,21,4893,21,205,8419,205,4893,0,0,0,0,0
11.876,6,1891,1630319,1151,1363,10,1380,1594554,740,511,16,1923,35765
354.644,6,126,103703,88,1189,4076,1408,96186,38,922,23,2899,7517
0.847,6,19,5908,11,281,84,544,1288,8,859,108,2642,4620
0.263,6,46,21690,27,1040,10,1420,16709,19,467,14,1883,4981
1740.484,17,30,31680,30,1028,60016,1028,31680,0,0,0,0,0
0.266,6,7,352,0,0,0,0,0,7,0,0,0,352
300.794,2,6,192,6,8,60158,8,192,0,0,0,0,0
0.411,1,2,112,2,28,411,28,112,0,0,0,0,0
280.401,6,30,7432,13,158,23366,267,1317,17,603,17523,2760,6115
0.181,17,2,2382,2,1163,181,1163,2382,0,0,0,0,0
1.42,17,6,540,3,30,688,30,174,3,94,687,94,366
0.546,17,2,784,2,364,546,364,784,0,0,0,0,0
1772.47,6,180,15480,120,69,14894,69,8940,60,69,30040,69,6540
31.133,6,29,4910,14,170,2394,722,1748,15,297,2210,1408,3162
15.371,1,8,832,0,0,0,0,0,8,76,2195,76,832
280.417,6,29,7392,13,158,23368,267,1317,16,603,18691,2036,6075
1783.359,6,104,8435,68,65,26617,65,4930,36,59,50951,59,3505
1683.069,17,16,1265,8,30,240432,37,471,8,71,240431,136,794
19.954,17,38,9444,17,267,1245,1350,5020,21,182,996,1350,4424
166.328,6,24,10657,13,741,57,1360,3517,11,1337,16620,4428,7140
0.804,6,120,87721,53,131,15,232,2649,67,1350,11,1420,85072
3.19,6,5,232,2,0,3190,0,88,3,0,1522,0,144
1474.561,6,293,18482,171,69,8673,69,10221,122,69,12186,69,8261
69.336,17,5,352,3,36,34500,36,192,2,52,68955,52,160
350.49,6,114,83456,43,603,8345,944,5519,71,1301,5006,1440,77937
176.674,2,2,64,2,8,176674,8,64,0,0,0,0,0
0.023,17,2,167,1,31,0,31,59,1,80,0,80,108
150.203,6,27,12921,15,519,58,884,2733,12,1212,13642,2568,10188
1675.067,1,7,742,7,78,279177,78,742,0,0,0,0,0
29.417,17,20,12049,10,663,3268,1350,6913,10,485,40,1350,5136
32.542,6,13,2133,8,324,4648,585,1073,5,396,8053,580,1060
6.407,6,1618,1461806,994,1391,6,1408,1424694,624,931,10,2816,37112
1787.17,6,102,8228,68,64,26674,64,4896,34,58,54152,58,3332
13.521,6,2287,2211069,1523,1376,8,1408,2166677,764,776,17,1408,44392
153.914,6,27,11123,13,410,56,922,1838,14,871,11830,1360,9285
1783.858,6,368,25621,214,99,8374,469,15045,154,69,11659,69,10576
73.967,6,38,9914,14,149,5689,267,1463,24,393,3214,1926,8451
365.035,6,17,1190,13,180,30419,180,864,4,110,20082,110,326
8.828,6,34,8357,18,391,519,860,1963,16,522,572,2720,6394
280.239,6,27,7312,13,158,23353,267,1317,14,775,21551,3445,5995
40.071,17,43,6368,22,48,1907,48,1672,21,195,2002,308,4696
97.144,6,59,38547,38,1149,2625,1408,30713,21,841,3070,2816,7834
1795.112,6,368,23096,213,69,8467,69,12660,155,63,11656,69,10436
1792.731,17,180,11520,180,36,10015,36,11520,0,0,0,0,0
1.717,17,2,204,1,34,0,34,62,1,114,0,114,142
5.576,6,35,6300,18,206,328,314,2784,17,472,332,1179,3516
0.102,6,13,1749,8,253,14,500,930,5,551,25,551,819
377.515,2,3,96,3,8,188757,8,96,0,0,0,0,0
1794.287,6,357,22629,208,69,8668,69,12460,149,69,12123,69,10169
121.237,6,491,233736,260,831,468,1103,222540,231,488,525,1179,11196
8.663,6,1336,1195945,848,1361,10,1420,1172086,488,427,17,1420,23859
1796.726,6,270,32334,110,134,16482,1460,15627,160,128,11299,1642,16707
0.452,6,12,1653,6,288,84,288,548,6,426,50,434,1105
73.19,6,44,9881,18,300,4305,1189,2833,26,352,2921,1420,7048
1785.875,17,140,11200,70,48,25881,48,5320,70,56,25882,56,5880
1.357,6,51,19558,29,903,48,1440,13857,22,400,55,1440,5701
108.189,6,33,7991,10,141,12021,267,1255,23,305,4915,1452,6736
1.476,17,33,20174,17,699,90,1350,12363,16,460,96,1350,7811
0.369,6,27,9069,13,261,30,683,1728,14,943,27,1408,7341
1579.68,1,8,448,8,28,225668,28,448,0,0,0,0,0
1798.102,17,449,39928,404,35,4461,288,25708,45,288,40021,288,14220
0.081,17,4,420,2,33,0,33,122,2,121,70,145,298
0.179,6,9,1339,5,145,44,145,349,4,826,46,826,990
1751.696,17,189,46893,189,220,9317,422,46893,0,0,0,0,0
12.636,6,1866,1677751,1181,1367,10,1380,1645113,685,421,18,1923,32638
1786.936,6,105,8475,68,65,26670,65,4930,37,59,49633,59,3545
0.386,17,8,2758,8,316,55,355,2758,0,0,0,0,0
1688.883,1,136,7616,136,28,12510,28,7616,0,0,0,0,0
0.033,17,2,148,1,30,0,30,58,1,62,0,62,90
0.062,17,2,212,1,46,0,46,74,1,110,0,110,138
1.037,17,2,244,2,94,1037,94,244,0,0,0,0,0
1.049,17,4,952,2,39,527,39,134,2,381,522,381,818
140.979,6,38,18958,19,708,99,1460,4334,19,1154,7824,1460,14624
28.806,6,27,7715,13,207,2400,469,1775,14,537,2215,2840,5940
0.1,6,9,1340,5,145,25,145,349,4,827,28,827,991
0.28,6,27,6202,13,181,23,537,1578,14,555,20,1542,4624
248.247,17,4,604,4,123,82749,348,604,0,0,0,0,0
2.407,6,13,2311,8,188,343,245,700,5,1407,540,1407,1611
0.266,17,4,284,2,32,259,32,120,2,54,259,60,164
0.003,6,2,1540,1,1448,0,1448,1500,1,0,0,0,40
107.076,17,5,210,5,14,26769,14,210,0,0,0,0,0
280.745,6,30,7432,13,158,23395,267,1317,17,543,17539,1380,6115
10.909,6,1520,1388210,962,1362,11,1368,1349830,558,776,19,1473,38380
180.949,6,22,9176,11,499,76,1193,1971,11,964,18078,1360,7205
0.074,17,2,558,1,32,0,32,60,1,470,0,470,498
1.37,6,11,1727,7,100,228,100,384,4,589,367,1152,1343
22.277,17,6,528,3,48,11134,48,228,3,72,11133,72,300
1787.267,6,106,8515,69,65,26283,65,4970,37,59,49643,59,3545
1790.816,1,218,12208,218,28,8252,28,12208,0,0,0,0,0
4.372,17,4,352,2,60,4371,60,176,2,60,4371,60,176
1776.429,17,73,3060,72,14,25020,14,3024,1,8,0,8,36
91.008,6,4,1024,3,416,45504,416,972,1,0,0,0,52
0.056,17,4,284,2,32,53,32,120,2,54,52,60,164
5.458,6,38,7229,19,218,303,314,3383,19,513,288,1179,3846
400.337,17,16,1408,8,48,57189,48,608,8,72,57189,72,800
83.709,6,140,106279,87,1261,973,1368,95394,53,738,1605,2519,10885
240.336,6,44,8447,22,449,11444,1408,5648,22,205,11444,580,2799
14.348,6,2172,2013193,1352,1409,10,1448,1965865,820,776,17,1448,47328
0.682,6,118,88270,54,131,12,232,2689,64,1407,10,2760,85581
0.02,17,5,1064,3,60,7,60,264,2,372,13,372,800
1790.557,17,142,11360,71,48,25579,48,5396,71,56,25579,56,5964
1796.931,17,448,39896,403,35,4469,288,25676,45,288,40020,288,14220
8.695,6,17,1153,9,222,1085,222,586,8,231,1240,231,567
41.51,17,6,1236,3,48,20750,48,228,3,308,20750,308,1008
0.122,17,2,588,1,39,0,39,67,1,493,0,493,521
0.17,17,2,586,1,46,0,46,74,1,484,0,484,512
240.2,6,57,20819,31,862,8006,1418,18000,26,182,9607,580,2819
2.091,6,20,3833,11,234,209,564,1504,9,463,235,1343,2329
371.497,6,23,1535,16,177,24766,177,1053,7,110,10382,110,482
13.642,6,28,4919,13,154,1118,722,1766,15,338,961,1440,3153
10.081,6,9,527,5,43,2520,43,311,4,0,3349,0,216
1.999,17,2,214,1,39,0,39,67,1,119,0,119,147
300.552,6,39,8618,20,315,15818,882,2105,19,441,468,1360,6513
0.405,6,41,30823,17,191,25,287,1466,24,1405,12,2876,29357
68.22,6,30,8809,16,434,4548,659,2190,14,534,5132,1440,6619
301.349,6,50,20420,26,1045,12046,1360,14649,24,369,13094,1360,5771
13.732,17,8,608,8,48,1961,48,608,0,0,0,0,0
450.878,6,51,9403,29,115,16102,501,2550,22,397,21463,1420,6853
0.23,6,9,1002,5,213,57,213,417,4,421,59,421,585
627.82,6,137,23828,52,257,12310,1460,10869,85,153,7293,1460,12959
0.405,2,2,64,2,8,405,8,64,0,0,0,0,0
372.955,1,4,240,4,32,124318,32,240,0,0,0,0,0
0.88,6,31,9275,17,451,55,1440,3421,14,660,52,1440,5854
17.707,6,1324,1345030,457,648,38,649,33354,867,1471,20,4344,1311676
6.407,6,12,783,7,275,1037,275,567,5,0,1548,0,216
4.835,6,39,9530,20,450,254,766,2657,19,435,258,2128,6873
134.266,1,2,728,2,336,134266,336,728,0,0,0,0,0
369.75,6,27,1767,18,177,21750,177,1181,9,110,8617,110,586
1438.172,6,119,12539,65,76,20794,722,5831,54,86,27131,1448,6708
280.395,6,25,7232,12,158,25490,267,1277,13,775,23363,3465,5955
0.051,17,2,154,1,33,0,33,61,1,65,0,65,93
1779.616,6,381,23856,217,69,8238,69,12820,164,58,10917,69,11036
15.341,6,8,440,5,0,3835,0,268,3,0,7664,0,172
3.414,6,2,88,2,0,0,0,88,0,0,0,0,0
1707.683,1,8,448,8,28,243954,28,448,0,0,0,0,0
3.041,6,4,192,1,0,0,0,48,3,0,1516,0,144
1786.408,6,102,8364,68,66,26662,66,4964,34,60,54131,60,3400
1746.614,6,95,7203,63,38,28171,205,4476,32,33,56334,98,2727
59.366,6,41,10090,20,706,483,1360,4386,21,373,2960,2667,5704
29.285,6,49,13326,23,188,1331,721,2810,26,676,1130,1440,10516
0.158,6,10,1380,6,145,31,145,389,4,827,45,827,991
1745.572,6,90,6540,60,31,29585,31,4050,30,31,60180,31,2490
6.086,6,44,7469,23,218,276,314,3543,21,440,291,1152,3926
11.774,6,89,27401,45,543,267,1152,20818,44,438,267,1179,6583
360.26,6,46,10606,29,302,12866,1360,5124,17,435,538,2667,5482
0.834,6,10,1687,7,100,139,100,384,3,1179,291,1179,1303
216.579,17,6,528,3,60,108289,60,264,3,60,108289,60,264
1681.85,1,15,840,15,28,120132,28,840,0,0,0,0,0
281.626,6,32,7650,13,158,23468,267,1317,19,464,15616,1400,6333
1799.998,6,215,17206,79,76,23075,375,8357,136,50,13333,143,8849
1.678,6,25,8755,15,283,119,583,1455,10,985,167,1420,7300
1786.518,6,104,8376,68,65,26664,65,4930,36,59,51040,59,3446
285.379,17,4,352,2,60,285378,60,176,2,60,285378,60,176
1781.156,6,354,22440,207,69,8646,69,12420,147,69,12199,69,10020
0.036,17,4,284,2,32,15,32,120,2,54,24,60,164
1790.659,6,285,36142,117,139,15435,1360,16964,168,148,10721,2720,19178
7.784,6,16,1402,9,275,973,275,918,7,96,989,96,484
281.052,6,29,7392,13,158,23421,267,1317,16,603,18726,2800,6075
311.21,6,75,44272,39,392,8189,970,3785,36,1206,1091,1368,40487
2.234,17,4,580,2,40,2087,40,136,2,194,2085,194,444
1789.007,17,385,67575,193,231,9317,1350,50170,192,62,9364,1350,17405
1779.21,17,73,3060,72,14,25059,14,3024,1,8,0,8,36
1786.488,6,104,8308,68,64,26664,64,4896,36,58,51039,58,3412
1784.745,6,114,9270,70,66,25865,66,5110,44,60,41502,60,4160
1782.214,6,382,23560,208,69,8609,69,12460,174,48,10301,69,11100
0.023,17,4,420,2,33,4,33,122,2,121,3,145,298
1.978,17,3,183,3,33,989,33,183,0,0,0,0,0
3.131,17,5,418,3,30,1538,30,174,2,94,1758,94,244
199.776,17,4,352,2,60,199775,60,176,2,60,199775,60,176
1786.457,6,102,8364,68,66,26663,66,4964,34,60,54132,60,3400
240.254,6,54,17922,29,807,8580,1418,15251,25,170,10010,580,2671
1681.34,17,14,3843,7,30,280221,30,406,7,463,280221,463,3437
1772.089,6,99,9306,66,66,27262,66,5610,33,60,55374,60,3696
0.531,6,10,1669,6,551,106,947,1346,4,159,177,159,323
1744.618,2,15,480,15,8,124615,8,480,0,0,0,0,0
1789.693,17,142,11360,71,48,25566,48,5396,71,56,25566,56,5964
280.232,6,30,7432,14,158,21556,267,1357,16,603,18677,2036,6075
0.511,6,52,21276,29,1061,18,1380,16069,23,387,19,1923,5207
240.311,6,54,18077,30,759,8286,1408,15237,24,198,10448,580,2840
1782.57,17,83,3480,82,14,22007,14,3444,1,8,0,8,36
1708.879,17,20,7021,20,323,89941,1438,7021,0,0,0,0,0
1747.447,6,99,7411,63,38,28184,205,4476,36,33,49915,98,2935
1713.898,1,8,448,8,28,244842,28,448,0,0,0,0,0
0.034,17,2,140,1,34,0,34,62,1,50,0,50,78
1681.517,17,14,1036,7,30,280250,30,406,7,62,280249,62,630
1.023,17,4,934,2,40,1007,40,136,2,371,1010,379,798
1776.605,1,244,13664,244,28,7311,28,13664,0,0,0,0,0
1.696,17,32,26778,12,231,154,1350,3108,20,1155,84,1350,23670
2.075,6,14,3451,5,288,474,288,520,9,639,236,853,2931
0.634,6,13,1095,7,256,104,256,544,6,303,125,303,551
361.463,6,46,11311,29,356,12909,1360,5829,17,435,539,2667,5482
1.61,6,61,27239,32,1047,51,1460,21207,29,433,49,1460,6032
300.255,6,26,8523,14,403,23096,1066,2374,12,788,3075,1491,6149
0.013,17,2,467,1,33,0,33,61,1,378,0,378,406
288.683,6,52,8283,25,116,12026,517,2267,27,417,11101,1418,6016
15.235,17,21,9365,9,434,1900,1350,4160,12,405,1382,1350,5205
114.725,6,31,8912,14,158,8825,267,1357,17,624,7160,1400,7555
1.846,17,3,183,3,33,923,33,183,0,0,0,0,0
1756.996,6,179,17105,94,60,18892,721,7314,85,168,20913,1414,9791
1763.933,17,16,4241,8,30,251988,37,471,8,443,251988,463,3770
60.915,1,12,1248,0,0,0,0,0,12,76,5537,76,1248
188.699,17,24,8730,24,335,8204,358,8730,0,0,0,0,0
29.675,6,24,1926,12,275,2697,275,1042,12,96,2540,96,884
18.883,6,6,328,4,0,6294,0,216,2,0,18861,0,112
1.155,6,3,160,2,0,1155,0,100,1,0,0,0,60
110.416,17,4,240,2,32,110414,32,120,2,32,110415,32,120
29.022,6,17,2373,8,324,4146,585,1073,9,396,3626,580,1300
1795.993,6,367,25650,214,99,8431,469,15045,153,69,11815,69,10605
240.3,6,41,8291,21,449,12014,1408,5596,20,205,12647,580,2695
0.058,17,2,588,1,39,0,39,67,1,493,0,493,521
1120.955,17,10,2745,5,30,280235,30,290,5,463,280236,463,2455
378.047,2,4,128,4,8,126015,8,128,0,0,0,0,0
112.584,6,13624,13145545,9156,1358,12,1408,12908509,4468,931,25,2801,237036
1787.045,6,115,9190,73,66,24820,66,5230,42,60,43580,60,3960
179.646,6,1622,823114,908,841,198,1152,786662,714,394,251,1179,36452
61.926,6,7,292,4,0,20642,0,164,3,0,30818,0,128
141.186,17,4,240,2,32,141185,32,120,2,32,141185,32,120
1771.702,6,99,9240,66,65,27256,65,5577,33,59,55362,59,3663
3.296,6,8,460,4,0,1098,0,220,4,0,940,0,240
5.837,6,4,167,1,0,0,0,40,3,7,2918,7,127
0.037,1,2,208,0,0,0,0,0,2,76,37,76,208
1798.305,6,381,24679,218,74,8287,469,13881,163,69,11100,69,10798
1788.685,17,87,3648,86,14,21043,14,3612,1,8,0,8,36
61.316,6,35,16025,22,819,2919,1408,9351,13,855,5087,3847,6674
1.662,6,48,19401,29,897,59,1360,13820,19,480,80,4075,5581
1794.296,6,244,36185,151,302,11961,302,26274,93,83,19503,83,9911
550.659,6,68,8598,29,111,16071,722,3191,39,112,14486,1448,5407
368.618,6,19,1303,14,177,28355,177,925,5,110,15161,110,378
11.953,6,1766,1628366,1150,1365,10,1432,1599402,616,428,19,1871,28964
284.165,6,63,40475,39,1170,7478,1440,32472,24,749,2671,1440,8003
266.89,17,4,352,2,60,266889,60,176,2,60,266889,60,176
53.097,6,39,12992,22,687,2528,1402,10777,17,189,3318,580,2215
374.713,6,18,1242,14,180,28824,180,916,4,110,20076,110,326
0.483,17,3,451,2,39,326,39,134,1,289,0,289,317
1.644,6,13,2311,8,188,234,245,700,5,1407,348,1407,1611
292.735,17,3,251,3,55,146367,67,251,0,0,0,0,0
2.531,6,10,2957,6,92,506,92,412,4,2329,388,2329,2545
74.83,6,15,620,7,0,4028,0,284,8,0,10689,0,336
137.346,17,4,1344,4,308,45782,308,1344,0,0,0,0,0
17.379,6,7,420,0,0,0,0,0,7,0,0,0,420
1781.761,6,361,22858,210,69,8525,69,12678,151,69,11878,69,10180
13.49,6,22,5962,11,275,1349,275,998,11,902,1224,1440,4964
1766.781,17,109,8716,55,48,32716,48,4180,54,56,33335,56,4536
240.212,6,53,17535,28,778,8896,1408,14700,25,190,10008,580,2835
1783.811,6,366,25541,213,99,8414,469,15005,153,69,11735,69,10536
1.363,17,6,552,3,32,565,32,180,3,96,521,96,372
0.326,6,22,7342,13,335,27,668,2026,9,1210,39,1906,5316
0.793,6,10,924,5,283,154,283,551,5,105,154,105,373
1785.548,6,104,8376,68,65,26649,65,4930,36,59,51013,59,3446
15.189,17,12,5347,6,490,3024,1350,3110,6,344,3023,1350,2237
0.006,6,2,84,1,0,0,0,44,1,0,0,0,40
300.699,6,42,8917,18,308,17680,889,1987,24,331,13068,3488,6930
1776.532,17,134,10720,67,48,26917,48,5092,67,56,26917,56,5628
0.047,17,4,859,2,37,0,37,130,2,336,3,348,729
1684.054,2,24,768,24,8,73219,8,768,0,0,0,0,0
9.361,17,8,544,4,32,3118,32,240,4,48,3118,48,304
283.03,6,32,7779,14,176,21771,267,1624,18,543,16646,1400,6155
0.074,17,2,136,1,32,0,32,60,1,48,0,48,76
1056.789,6,175,21590,86,123,12432,469,8986,89,108,12006,1452,12604
0.857,6,30,10709,16,511,57,1360,3240,14,766,53,2720,7469
0.042,17,4,420,2,33,0,33,122,2,121,36,145,298
1787.708,17,142,11360,71,48,25537,48,5396,71,56,25538,56,5964
1794.41,17,338,73073,338,188,5324,422,73073,0,0,0,0,0
255.344,17,4,352,2,60,255343,60,176,2,60,255343,60,176
10.057,17,4,328,2,46,10024,46,148,2,62,10023,62,180
11.206,6,27,11433,13,275,933,275,1078,14,1087,803,1440,10355
0.186,6,24,6046,13,181,15,537,1578,11,555,17,1542,4468
1787.668,17,142,11360,71,48,25537,48,5396,71,56,25537,56,5964
8.17,6,71,20326,38,520,220,1152,15579,33,489,247,1179,4747
0.148,17,2,198,1,39,0,39,67,1,103,0,103,131
1770.818,6,109,10056,70,65,25664,65,5939,39,59,46597,59,4117
96.854,6,30,7432,13,158,8071,267,1317,17,543,6049,1400,6115
1.31,6,30,6427,15,164,93,267,1922,15,780,82,1460,4505
1786.572,6,102,8364,68,66,26665,66,4964,34,60,54135,60,3400
9.394,6,8,427,4,0,3131,0,204,4,7,3050,7,223
0.081,17,4,414,2,40,0,40,136,2,111,71,117,278
93.569,6,42,13311,22,720,4455,1440,6203,20,548,4828,1440,7108
13.286,6,23,6002,12,275,1207,275,1038,11,902,1204,1440,4964
11.894,6,2294,2159410,1447,1413,8,1448,2110702,847,776,13,1448,48708
481.256,2,4,128,4,8,160418,8,128,0,0,0,0,0
1.889,6,3,120,1,0,0,0,40,2,0,1850,0,80
56.86,17,58,22008,27,334,2185,1350,9783,31,366,1894,1350,12225
0.067,6,10,1495,5,507,16,507,727,5,556,16,556,768
1799.396,17,448,39896,403,35,4476,288,25676,45,288,40018,288,14220
0.008,17,2,391,1,44,0,44,72,1,291,0,291,319
1795.373,17,80,3354,79,14,23017,14,3318,1,8,0,8,36
0.53,6,116,87428,51,131,10,232,2569,65,1370,7,2860,84859
0.013,17,2,158,1,34,0,34,62,1,68,0,68,96
0.416,6,32,8515,17,240,26,537,2371,15,668,29,2194,6144
0.015,17,2,394,1,37,0,37,65,1,301,0,301,329
16.266,6,9,2365,6,315,3040,505,871,3,458,4898,1222,1494
1786.499,6,106,8524,68,66,26664,66,4964,38,60,48281,60,3560
2.113,6,59,27753,32,1080,68,1460,21849,27,433,72,1460,5904
0.273,6,18,3004,9,266,34,517,1542,9,493,27,828,1462
0.33,6,2,80,2,0,0,0,80,0,0,0,0,0
1785.225,17,87,3648,86,14,21002,14,3612,1,8,0,8,36
126.639,17,10,880,5,48,31657,48,380,5,72,31657,72,500
16.003,6,23,10200,13,433,1333,990,1851,10,1322,1761,2568,8349
84.663,6,29,17521,16,708,40,1360,4214,13,1596,7043,4080,13307
0.403,6,7,295,4,0,134,0,164,3,7,99,7,131
2.275,6,35,8200,17,159,142,267,2115,18,893,124,1460,6085
1.981,6,56,23026,30,936,68,1360,17150,26,433,70,1360,5876
1772.845,6,180,15480,120,69,14897,69,8940,60,69,30046,69,6540
0.486,6,16,2713,8,324,69,585,1073,8,304,68,580,1640
1787.598,6,428,34080,221,92,8125,1189,15024,207,94,8677,1420,19056
4.076,17,28,16850,14,671,311,1350,9798,14,475,311,1350,7052
377.238,6,25,1654,17,180,23577,180,1120,8,110,9254,110,534
135.176,6,24,11318,12,433,89,990,1823,12,1125,12274,2720,9495
0.683,6,20,7168,12,319,61,602,1908,8,1209,96,1906,5260
317.042,6,62,18665,35,367,9324,1360,9926,27,546,12188,1360,8739
9.012,6,3,180,3,0,0,0,180,0,0,0,0,0
37.12,17,2,152,2,48,37120,48,152,0,0,0,0,0
12.017,6,1883,1654632,1169,1359,10,1420,1621625,714,427,16,1420,33007
1793.448,1,58,4872,58,56,31464,56,4872,0,0,0,0,0
280.546,6,29,7392,13,158,23378,267,1317,16,603,18696,2036,6075
1.505,17,2,144,1,36,0,36,64,1,52,0,52,80
37.676,1,42,4368,0,0,0,0,0,42,76,918,76,4368
0.885,17,20,9082,9,587,110,1350,5537,11,294,51,1350,3545
299.839,6,47,10545,23,607,13627,1360,4659,24,307,13027,1360,5886
0.829,17,2,176,2,60,829,60,176,0,0,0,0,0
1.622,17,6,552,3,32,710,32,180,3,96,0,96,372
338.127,6,53,10188,20,108,17795,267,2660,33,258,10566,2840,7528
4.367,17,2,668,2,306,4367,306,668,0,0,0,0,0
120.791,17,4,1344,4,308,40263,308,1344,0,0,0,0,0
1790.905,1,274,15344,274,28,6560,28,15344,0,0,0,0,0
22.758,17,4,352,2,60,22756,60,176,2,60,22757,60,176
1787.05,6,104,8376,68,65,26672,65,4930,36,59,51055,59,3446
1786.64,17,87,3648,86,14,21019,14,3612,1,8,0,8,36
0.388,6,13,1693,7,288,59,288,588,6,426,42,434,1105
17.051,17,5,380,5,48,4262,48,380,0,0,0,0,0
20.273,6,24,5825,14,107,1559,159,1190,10,821,2250,1658,4635
72.67,2,3,96,3,8,36335,8,96,0,0,0,0,0
225.763,17,4,240,2,32,225762,32,120,2,32,225762,32,120
237.704,6,228,183125,146,1293,1639,1368,167951,82,605,1694,1368,15174
1772.179,6,180,15480,120,69,14892,69,8940,60,69,30030,69,6540
1794.572,6,209,17054,132,69,13699,69,9558,77,69,23607,69,7496
479.475,6,58,7224,28,103,13963,721,2807,30,135,16525,1448,4417
122.553,6,71,55080,50,1206,2501,1368,47252,21,841,3093,2519,7828
0.227,6,10,1512,5,503,56,503,771,5,473,56,473,741
10.202,17,3,3249,3,1055,5101,1055,3249,0,0,0,0,0
1776.773,17,140,11200,70,48,25750,48,5320,70,56,25750,56,5880
11.081,6,1911,1713547,1128,1432,9,1448,1664423,783,776,13,1448,49124
0.028,17,2,152,1,48,0,48,76,1,48,0,48,76
1023.619,17,333,22866,333,40,3083,41,22866,0,0,0,0,0
240.169,6,65,22097,35,776,7063,1408,17382,30,285,8281,739,4715
1.181,6,10,1687,7,100,196,100,384,3,1179,463,1179,1303
280.462,6,29,7392,13,158,23371,267,1317,16,603,18694,2076,6075
1772.51,6,205,22439,131,75,13634,267,10097,74,133,24278,1997,12342
1771.304,6,101,9344,66,65,27250,65,5577,35,59,52093,59,3767
157.35,6,25,8348,13,429,66,952,1887,12,746,14291,4080,6461
0.176,6,4,3245,3,1028,0,1360,3205,1,0,0,0,40
280.409,6,30,7432,13,158,23367,267,1317,17,603,17522,2760,6115
1764.068,2,20,640,20,8,92845,8,640,0,0,0,0,0
0.194,6,9,1343,5,145,48,145,349,4,830,27,830,994
24.985,6,3962,3724517,2574,1369,9,1408,3647677,1388,931,17,2816,76840
1591.139,1,8,448,8,28,227305,28,448,0,0,0,0,0
15.567,17,5,380,5,48,3891,48,380,0,0,0,0,0
30.334,6,44,8883,21,401,871,889,2148,23,483,1372,4848,6735
240.434,6,54,17870,29,784,8586,1418,14860,25,212,10017,580,3010
3.506,6,26,7872,11,248,346,517,1599,15,685,247,1418,6273
0.027,17,2,362,1,39,0,39,67,1,267,0,267,295
10.772,6,20,4442,11,275,1077,275,998,9,768,746,1440,3444
1785.858,6,377,26657,217,103,8267,469,15841,160,69,11231,69,10816
240.175,6,53,18033,28,798,8895,1408,15030,25,211,10007,580,3003
67.641,1,2,728,2,336,67641,336,728,0,0,0,0,0
39.111,17,44,6468,22,48,1861,48,1672,22,190,1861,308,4796
0.08,17,2,602,1,46,0,46,74,1,500,0,500,528
0.02,17,2,554,1,30,0,30,58,1,468,0,468,496
1777.883,6,120,13933,76,82,23705,519,6008,44,162,41344,1420,7925
1.008,17,5,804,3,32,501,32,180,2,284,6,294,624
1791.799,6,369,26061,215,105,8372,469,15485,154,69,11709,69,10576
374.439,6,25,1899,16,65,24962,65,1095,9,55,46794,59,804
209.231,17,4,352,2,60,209230,60,176,2,60,209229,60,176
3.634,6,12,1036,6,283,690,283,603,6,105,690,105,433
0.013,1,2,112,2,28,13,28,112,0,0,0,0,0
6.911,6,65,20582,34,559,209,1152,15915,31,427,221,1152,4667
1459.199,6,21,2869,13,241,121599,241,1966,8,83,208431,92,903
240.889,6,60,14405,29,609,8602,1368,9521,31,293,8027,1335,4884
184.659,17,16,1408,8,48,26378,48,608,8,72,26378,72,800
149.802,6,32,8952,14,158,11523,267,1357,18,624,8807,1400,7595
1797.783,1,345,28980,345,56,5226,56,28980,0,0,0,0,0
1799.204,17,83,3480,82,14,22212,14,3444,1,8,0,8,36
1786.721,6,364,25392,212,100,8467,469,14896,152,69,11832,69,10496
1744.83,6,96,7286,63,38,28142,205,4476,33,33,54518,98,2810
11.929,6,457,433251,178,246,67,517,13944,279,1466,42,4344,419307
379.732,6,18,1242,14,180,29210,180,916,4,110,20057,110,326
16.571,17,452,441669,110,182,151,1350,23208,342,1195,48,1350,418461
95.128,17,8,704,4,48,31706,48,304,4,72,31706,72,400
1783.435,17,83,3480,82,14,22017,14,3444,1,8,0,8,36
280.4,6,30,7432,14,158,21569,267,1357,16,678,18690,3456,6075
0.802,6,10,1687,7,100,133,100,384,3,1179,276,1179,1303
0.049,17,4,420,2,33,0,33,122,2,121,2,145,298
61.014,6,14,11284,3,92,274,92,256,11,1306,6054,1448,11028
0.045,17,2,290,1,40,0,40,68,1,194,0,194,222
0.214,17,2,157,1,31,0,31,59,1,70,0,70,98
0.481,6,47,19806,27,975,18,1380,14764,20,468,23,3303,5042
0.021,6,10,1794,6,613,3,1070,1471,4,159,6,159,323
252.48,6,8,482,2,106,252480,106,194,6,0,6294,0,288
1780.891,6,309,26843,181,75,9893,267,12410,128,134,14022,2840,14433
929.547,17,11,3888,11,325,92954,548,3888,0,0,0,0,0
0.112,17,7,2438,7,320,18,354,2438,0,0,0,0,0
1744.689,2,29,928,29,8,62310,8,928,0,0,0,0,0
1797.216,17,140,11200,70,48,26046,48,5320,70,56,26046,56,5880
0.934,17,2,157,1,31,0,31,59,1,70,0,70,98
118.541,6,45,8836,21,345,700,720,1967,24,327,5148,1360,6869
0.064,17,3,234,2,39,10,39,134,1,72,0,72,100
4.196,6,17,2475,9,125,524,245,740,8,703,562,1152,1735
337.581,6,35,7102,22,140,16075,501,2010,13,415,22502,1420,5092
9.215,6,11,3186,3,92,4607,92,244,8,503,1287,1448,2942
252.456,6,25,7419,9,142,461,174,790,16,460,16824,1452,6629
0.344,17,12,4389,12,337,31,360,4389,0,0,0,0,0
64.782,6,28,7217,13,155,5398,267,1306,15,482,4626,1997,5911
1796.699,17,449,39928,404,35,4458,288,25708,45,288,40016,288,14220
0.124,6,9,1002,5,213,31,213,417,4,421,33,421,585
271.562,17,6,528,3,60,135780,60,264,3,60,135780,60,264
0.794,17,24,14954,11,454,79,1350,5304,13,714,53,1350,9650
13.623,6,2301,1956495,1279,1431,10,1448,1887615,1022,776,13,1448,68880
1797.657,2,15,480,15,8,128404,8,480,0,0,0,0,0
240.75,6,60,24758,26,548,9629,1418,6297,34,878,7295,1418,18461
300.876,6,53,17982,28,989,11143,1360,12087,25,325,411,1360,5895
0.011,17,2,367,1,33,0,33,61,1,278,0,278,306
1776.805,6,187,17417,123,83,14563,965,10025,64,75,28199,485,7392
0.387,17,2,384,1,36,0,36,64,1,292,0,292,320
115.662,6,32,13492,16,864,2059,1360,5880,16,773,7699,1360,7612
1791.707,1,66,5544,0,0,0,0,0,66,56,27564,56,5544
75.812,6,32,7653,12,155,6892,267,1266,20,371,3989,1460,6387
1746.066,6,105,7602,66,31,26862,31,4503,39,31,45948,31,3099
1771.053,1,67,5628,67,56,26834,56,5628,0,0,0,0,0
1790.583,17,140,11200,70,48,25950,48,5320,70,56,25950,56,5880
1791.923,1,342,28728,342,56,5254,56,28728,0,0,0,0,0
280.343,6,30,7432,13,158,23361,267,1317,17,543,17513,1400,6115
1656.961,1,8,448,8,28,236708,28,448,0,0,0,0,0
2.78,6,34,21066,20,763,146,1360,6191,14,2860,203,6592,14875
15.133,17,4,824,2,48,15116,48,152,2,308,15113,308,672
1781.758,6,395,24176,214,69,8365,69,12700,181,45,9898,69,11476
5.808,6,38,7245,20,218,305,314,3423,18,516,325,1179,3822
0.406,6,13,1693,6,288,74,288,548,7,426,37,434,1145
4.778,17,5,320,5,36,1194,36,320,0,0,0,0,0
1744.315,6,95,7203,63,38,28134,205,4476,32,33,56254,98,2727
7.107,6,151,197998,84,133,85,201,3927,67,3037,105,35350,194071
68.506,6,79,59224,53,1209,1317,1368,51137,26,840,2493,2519,8087
61.716,6,68,42329,39,1186,1624,1448,34066,29,749,2196,1448,8263
1776.128,1,58,4872,58,56,31160,56,4872,0,0,0,0,0
43.485,6,5935,5658621,3918,1366,11,1408,5549073,2017,931,21,2801,109548
6.332,6,54,29204,26,659,253,1418,11938,28,877,233,1418,17266
4.136,6,45,29684,29,854,147,1360,10615,16,1841,266,3934,19069
1504.004,2,15,480,15,8,107428,8,480,0,0,0,0,0
5.959,6,33,6470,18,206,350,314,2784,15,513,388,1179,3686
26.73,6,51,13288,24,186,1162,722,2641,27,683,1013,2760,10647
1.24,17,32,22715,17,809,77,1350,14229,15,537,78,1350,8486
1793.921,17,65,2730,65,14,28030,14,2730,0,0,0,0,0
840.67,17,8,2196,4,30,280219,30,232,4,463,280219,463,1964
7.086,6,1141,1003991,665,1427,10,1448,972683,476,776,14,1448,31308
3.632,17,5,290,5,30,908,30,290,0,0,0,0,0
1794.825,6,356,22520,208,69,8670,69,12460,148,69,12209,69,10060
0.057,17,2,198,1,39,0,39,67,1,103,0,103,131
22.857,17,4,352,2,48,22632,48,152,2,72,22837,72,200
0.005,6,2,129,1,0,0,0,40,1,37,0,37,89
1771.824,6,99,9240,66,65,27258,65,5577,33,59,55366,59,3663
1.154,6,24,8004,12,164,89,267,1288,12,1014,88,2804,6716
2.308,6,22,5961,12,108,209,147,919,10,927,221,1608,5042
273.723,17,4,240,2,32,273722,32,120,2,32,273722,32,120
0.018,17,2,144,1,36,0,36,64,1,52,0,52,80
1740.548,17,29,19517,29,645,62162,645,19517,0,0,0,0,0
1229.448,6,65,11824,43,116,29272,721,5351,22,620,949,1440,6473
1.092,6,25,8056,12,164,84,267,1288,13,869,77,1402,6768
1742.859,6,97,7307,63,38,28110,205,4476,34,33,52804,98,2831
7.872,6,12,5538,4,106,2624,106,274,8,822,1091,1452,5264
12.294,6,1967,1698174,1186,1377,10,1420,1662713,781,467,15,1883,35461
30.337,17,5,380,5,48,7584,48,380,0,0,0,0,0
0.123,17,2,376,1,41,0,41,69,1,279,0,279,307
0.26,17,2,167,1,39,0,39,67,1,72,0,72,100
1.403,6,39,8294,19,321,77,1164,2718,20,433,62,1360,5576
1785.146,6,109,8700,70,65,25871,65,5075,39,59,46972,59,3625
252.085,2,2,64,2,8,252085,8,64,0,0,0,0,0
6.073,17,3,228,3,48,3036,48,228,0,0,0,0,0
5.48,6,40,7309,20,218,288,314,3423,20,513,274,1179,3886
3.4,17,10,1907,5,44,848,44,360,5,281,848,291,1547
1016.757,6,100,11649,59,80,17530,722,5419,41,131,25409,2026,6230
4.028,6,39,7269,20,218,212,314,3423,19,440,210,1152,3846
240.205,6,53,17656,28,783,8896,1418,14785,25,195,10008,580,2871
1787.561,6,107,8496,68,65,26680,65,4930,39,59,47037,59,3566
9.418,6,16,3618,4,92,3139,92,296,12,269,839,1408,3322
88.571,17,4,352,2,60,88570,60,176,2,60,88570,60,176
0.215,6,28,7336,13,155,17,267,1301,15,543,13,1400,6035
0.146,6,8,2239,4,69,47,69,229,4,925,4,1781,2010
1783.906,6,102,8228,68,64,26625,64,4896,34,58,54054,58,3332
8.207,1,9,756,9,56,1025,56,756,0,0,0,0,0
17.032,6,432,327318,214,1039,79,1460,28005,218,1424,77,1607,299313
7.847,17,12,1764,6,48,1565,48,456,6,190,1566,308,1308
125.947,2,2,64,2,8,125947,8,64,0,0,0,0,0
0.014,17,2,354,1,46,0,46,74,1,252,0,252,280
125.283,17,16,17416,16,1060,8352,1449,17416,0,0,0,0,0
2.864,6,33,16943,18,784,168,1460,6256,15,1259,194,2920,10687
6.419,6,39,7658,20,218,337,314,3423,19,495,339,1179,4235
601.599,2,6,192,6,8,120319,8,192,0,0,0,0,0
1558.365,1,7,392,7,28,259727,28,392,0,0,0,0,0
2.962,17,390,411742,85,160,35,1350,15984,305,1269,9,1350,395758
240.23,6,54,17271,29,754,8579,1408,14342,25,202,10009,580,2929
34.658,17,22,1672,22,48,1650,48,1672,0,0,0,0,0
0.699,6,14,1745,7,288,87,288,600,7,426,86,434,1145
120.34,2,2,64,2,8,120340,8,64,0,0,0,0,0
0.089,6,4,191,2,0,89,0,80,2,31,0,31,111
1798.325,6,366,24134,213,81,8482,469,13667,153,69,11828,69,10467
2.286,17,4,518,3,39,884,39,201,1,289,0,289,317
1.27,6,50,18971,29,863,45,1360,13310,21,400,54,1360,5661
0.005,17,3,704,2,60,0,60,176,1,500,0,500,528
0.076,6,7,759,3,69,37,69,189,4,205,4,341,570
0.0,17,2,196,1,62,0,62,90,1,78,0,78,106
182.94,6,21,3562,6,92,176,92,412,15,197,13054,1408,3150
26.81,6,15,1279,7,275,4468,275,563,8,96,3466,96,716
8.084,17,6,528,3,48,4035,48,228,3,72,4035,72,300
4.01,17,3,201,3,39,2005,39,201,0,0,0,0,0
180.473,2,3,96,3,8,90236,8,96,0,0,0,0,0
1771.041,6,101,9344,66,65,27246,65,5577,35,59,52087,59,3767
5.02,17,4,558,2,36,5007,36,128,2,187,5006,187,430
227.058,17,4,352,2,60,227057,60,176,2,60,227057,60,176
42.799,6,45,8851,22,371,455,766,2085,23,388,1939,2128,6766
0.913,6,7,295,4,0,304,0,164,3,7,120,7,131
0.442,6,49,20799,27,1040,17,1380,15677,22,421,19,2760,5122
4.004,17,2,656,2,300,4004,300,656,0,0,0,0,0
286.789,6,27,1859,13,332,23898,332,1052,14,83,22060,83,807
1793.151,6,259,18985,158,69,11421,69,10736,101,69,17931,69,8249
15.266,17,23,6965,10,305,1692,1350,3330,13,251,1269,1350,3635
1797.408,17,508,170648,508,307,3545,308,170648,0,0,0,0,0
257.156,6,76,15690,37,449,7143,1418,10055,39,224,6767,1379,5635
1.294,6,48,17481,27,891,49,1440,11820,21,400,55,1440,5661
0.059,17,2,144,1,36,0,36,64,1,52,0,52,80
1793.107,1,67,5628,67,56,27168,56,5628,0,0,0,0,0
0.416,17,2,237,1,72,0,72,100,1,109,0,109,137
286.556,6,34,3737,16,324,19103,585,1525,18,254,16855,580,2212
1775.682,17,140,11200,70,48,25734,48,5320,70,56,25734,56,5880
1799.999,6,211,16214,79,67,23076,290,7706,132,48,13739,78,8508
0.422,17,8,2750,8,315,60,354,2750,0,0,0,0,0
0.199,17,12,10841,6,771,39,1350,4794,6,979,31,1350,6047
2.44,17,4,610,3,39,968,39,201,1,381,0,381,409
1746.999,1,57,4788,57,56,31196,56,4788,0,0,0,0,0
0.254,17,2,476,1,39,0,39,67,1,381,0,381,409
1772.151,6,182,15698,120,69,14892,69,8940,62,69,29048,69,6758
1771.544,6,99,9306,66,66,27254,66,5610,33,60,55358,60,3696
0.797,6,10,1687,7,100,132,100,384,3,1179,268,1179,1303
0.045,17,8,2758,8,316,6,355,2758,0,0,0,0,0
1765.028,2,15,480,15,8,126073,8,480,0,0,0,0,0
5.94,6,40,7325,21,218,297,314,3463,19,516,315,1179,3862
3.592,17,5,295,5,31,898,31,295,0,0,0,0,0
1740.582,17,30,31680,30,1028,60020,1028,31680,0,0,0,0,0
0.418,6,48,19398,26,1015,16,1380,14276,22,383,17,1380,5122
280.472,6,30,7432,13,158,23372,267,1317,17,603,17525,2760,6115
1.233,6,41,9968,21,440,61,1360,4392,20,433,56,1360,5576
121.512,6,65,46610,44,1177,2825,1408,38784,21,960,3078,3847,7826
0.199,17,5,1752,5,322,49,353,1752,0,0,0,0,0
7.35,17,6,528,3,48,3664,48,228,3,72,3663,72,300
1781.686,6,109,8944,68,66,26592,66,4964,41,60,44539,60,3980
1.669,6,25,8765,15,285,119,588,1460,10,985,166,1420,7305
0.028,17,4,284,2,32,0,32,120,2,54,6,60,164
147.377,6,25,9968,12,549,64,1440,2709,13,961,12270,1440,7259
0.24,6,50,23152,28,1056,8,1420,18039,22,467,11,1883,5113
1798.487,1,58,4872,58,56,31552,56,4872,0,0,0,0,0
0.571,17,2,167,1,39,0,39,67,1,72,0,72,100
1.583,6,16,3672,9,150,197,174,664,7,681,216,1452,3008
63.589,6,9,372,5,0,15897,0,204,4,0,20363,0,168
0.485,17,3,451,2,39,71,39,134,1,289,0,289,317
0.13,6,40,16897,23,1005,5,1420,11996,17,467,7,1883,4901
0.928,17,4,624,2,64,927,64,184,2,192,803,192,440
0.335,6,11,975,6,304,67,304,624,5,83,78,83,351
1.315,6,47,19006,27,879,50,1360,13430,20,476,60,2720,5576
1796.456,17,766,46192,766,32,2348,37,46192,0,0,0,0,0
0.084,6,14,4044,8,88,11,88,452,6,1670,16,1880,3592
1773.714,6,180,15480,120,69,14905,69,8940,60,69,30056,69,6540
1740.546,17,29,6815,29,207,62162,207,6815,0,0,0,0,0
0.793,6,20,5959,11,274,79,523,1267,9,721,89,1452,4692
331.886,17,16,5360,16,307,22125,308,5360,0,0,0,0,0
0.082,6,13,4387,7,92,13,92,464,6,1201,16,2121,3923
0.092,17,2,268,1,54,0,54,82,1,158,0,158,186
39.787,17,10,585,10,30,4420,31,585,0,0,0,0,0
1793.061,1,224,12544,224,28,8040,28,12544,0,0,0,0,0
280.035,6,29,7392,13,158,23336,267,1317,16,603,18667,1400,6075
0.342,6,26,8868,13,227,28,547,1592,13,941,28,1408,7276
1799.087,6,251,47713,155,483,11682,483,37555,96,83,18936,83,10158
8.75,6,14,2242,8,210,1249,210,844,6,545,1748,904,1398
0.899,6,10,1687,7,100,149,100,384,3,1179,325,1179,1303
2.142,6,12,3940,7,88,357,88,388,5,3340,535,3340,3552
14.142,6,25,7037,14,275,1087,275,1118,11,1092,912,2840,5919
2.054,17,6,936,3,64,1010,64,276,3,192,944,192,660
0.508,6,19,7099,11,318,49,600,1854,8,1205,70,1851,5245
206.956,6,30,8872,14,158,15919,267,1357,16,763,13794,2036,7515
5.039,17,4,288,2,36,5005,36,128,2,52,5005,52,160
213.751,6,26,4999,11,220,6618,516,1325,15,255,15261,1452,3674
300.647,6,37,8526,20,315,15823,882,2093,17,478,531,2720,6433
40.078,17,22,1672,22,48,1908,48,1672,0,0,0,0,0
5.807,6,44,8369,23,227,263,314,4102,21,489,277,1179,4267
1740.221,1,8,448,8,28,248603,28,448,0,0,0,0,0
0.399,6,10,968,5,256,94,256,460,5,304,94,304,508
1796.623,17,180,14040,180,50,10037,50,14040,0,0,0,0,0
62.881,6,75,51438,46,1198,1397,1408,43183,29,748,2237,1408,8255
1682.677,17,14,1036,7,30,280439,30,406,7,62,280439,62,630
1797.495,1,345,28980,345,56,5225,56,28980,0,0,0,0,0
37.64,17,4,352,2,60,37639,60,176,2,60,37639,60,176
152.568,6,25,10089,12,531,59,1360,2637,13,988,12702,1360,7452
1763.666,2,14,448,14,8,135666,8,448,0,0,0,0,0
6.765,17,16,9717,8,706,966,1350,5874,8,452,958,1350,3843
34.32,6,17,4900,8,321,202,517,1067,9,673,4280,1408,3833
1770.534,6,99,9306,66,66,27238,66,5610,33,60,55326,60,3696
5.021,17,4,558,2,36,5010,36,128,2,187,5011,187,430
0.187,6,3,175,2,31,10,31,135,1,0,0,0,40
0.056,17,3,244,2,32,29,32,120,1,96,0,96,124
0.814,6,160,120084,95,1334,8,1420,113263,65,420,12,1420,6821
0.51,6,2,92,1,0,0,0,40,1,0,0,0,52
1773.25,6,180,15480,120,69,14901,69,8940,60,69,30048,69,6540
1758.476,6,115,8980,70,44,25485,205,5203,45,34,39956,98,3777
1.285,6,50,19860,28,870,47,1360,14204,22,433,52,1360,5656
0.164,17,2,176,1,48,0,48,76,1,72,0,72,100
1772.618,6,180,15480,120,69,14895,69,8940,60,69,30040,69,6540
115.156,17,8,333,7,13,19192,14,289,1,16,0,16,44
106.317,6,24,10049,12,531,59,1360,2637,12,1153,9652,2574,7412
1771.197,6,99,9240,66,65,27249,65,5577,33,59,55347,59,3663
0.275,6,19,5855,11,281,26,517,1704,8,931,38,1912,4151
0.422,6,51,22762,29,1028,15,1380,17640,22,421,18,1923,5122
1017.17,6,87,9426,47,73,22112,721,4086,40,105,23255,1448,5340
0.496,6,21,7290,13,335,41,668,2026,8,968,61,1946,5264
15.202,6,1701,1582584,1071,1423,14,1432,1550076,630,428,23,1871,32508
1.765,17,20,5190,20,231,92,389,5190,0,0,0,0,0
0.051,6,11,912,6,181,10,181,489,5,77,2,134,423
0.004,6,3,2880,1,0,0,0,40,2,1368,0,1368,2840
2.888,17,3,468,3,128,1444,128,468,0,0,0,0,0
47.44,6,37,9686,15,166,78,267,1784,22,583,2258,1420,7902
367.061,6,23,1538,16,180,24470,180,1056,7,110,10400,110,482
1711.37,1,8,448,8,28,244481,28,448,0,0,0,0,0
0.109,1,2,163,2,53,109,78,163,0,0,0,0,0
35.766,17,10,760,10,48,3974,48,760,0,0,0,0,0
4.588,17,26,7253,10,230,509,1350,2582,16,263,218,1350,4671
134.447,17,10,880,5,48,33609,48,380,5,72,33609,72,500
1749.796,17,13,534,11,14,174960,14,462,2,8,1749544,8,72
1783.811,6,355,23625,202,81,8874,469,13158,153,69,11735,69,10467
3.768,17,4,4619,4,1126,1256,1451,4619,0,0,0,0,0
462.577,1,10,560,10,28,51397,28,560,0,0,0,0,0
32.21,6,372,328080,152,131,213,316,9402,220,1422,147,2836,318678
156.989,6,32,8952,14,158,12076,267,1357,18,624,9229,1400,7595
280.199,6,28,7352,13,158,23349,267,1317,15,678,20011,2800,6035
1781.76,6,370,28474,215,117,8325,1189,15987,155,93,11569,485,12487
1779.736,1,342,28728,342,56,5219,56,28728,0,0,0,0,0
973.79,6,194,12314,112,69,8772,69,6757,82,69,12022,69,5557
1774.897,6,147,9214,80,48,22467,208,5635,67,31,26886,31,3579
9.517,6,21,4494,10,275,999,275,962,11,768,903,1440,3532
122.637,6,29,7392,13,158,10219,267,1317,16,603,8171,1400,6075
0.421,6,26,9017,13,261,35,683,1728,13,943,30,1438,7289
0.153,6,43,17817,24,988,6,1420,12836,19,420,8,1420,4981
1772.536,6,180,15480,120,69,14895,69,8940,60,69,30035,69,6540
1787.432,6,375,26177,217,98,8275,469,15303,158,69,11384,69,10874
0.019,6,10,1514,5,503,4,503,771,5,475,4,475,743
1194.608,6,239,15149,138,69,8719,69,8349,101,69,11946,69,6800
1751.669,6,101,7963,66,45,26948,205,4914,35,35,51507,98,3049
1739.49,1,15,870,15,30,124249,30,870,0,0,0,0,0
1.013,17,2,685,1,308,0,308,336,1,321,0,321,349
1.862,6,28,8839,17,277,116,565,1517,11,859,166,1380,7322
0.406,6,20,7151,12,318,36,600,1906,8,1205,57,1891,5245
19.178,17,4,352,2,48,19168,48,152,2,72,19166,72,200
34.645,6,34,5536,16,144,2309,722,1986,18,324,2027,1402,3550
4.199,6,37,7189,19,218,233,314,3383,18,513,232,1179,3806
11.671,6,1841,1605672,1112,1388,10,1420,1572291,729,467,16,1883,33381
26.41,6,949,811923,563,1359,46,1368,783631,386,931,68,2841,28292
280.2,6,32,7512,15,158,20014,267,1397,17,543,17510,1300,6115
4.263,6,38,7229,19,218,236,314,3383,19,440,222,1152,3846
1.319,6,6,328,4,0,439,0,216,2,0,1308,0,112
1771.876,6,180,15480,120,69,14889,69,8940,60,69,30031,69,6540
2.139,6,35,6651,19,143,118,267,2055,16,564,121,1420,4596
1784.764,1,58,4872,58,56,31311,56,4872,0,0,0,0,0
1787.902,6,355,22480,207,69,8679,69,12420,148,69,12162,69,10060
1047.464,6,127,20311,84,145,12620,869,11348,43,190,15100,3423,8963
1680.687,1,15,840,15,28,120049,28,840,0,0,0,0,0
61.752,6,61,14154,32,337,1983,581,4131,29,465,2195,1986,10023
33.023,6,4500,4278052,2885,1403,11,1448,4189360,1615,776,20,1448,88692
317.039,6,56,12661,28,141,11742,615,3556,28,419,11736,4649,9105
128.671,6,16,2289,9,324,16083,585,1125,7,396,21443,580,1164
240.434,6,44,8469,22,449,11448,1418,5648,22,208,11448,580,2821
149.011,6,25,11118,12,433,77,990,1823,13,973,12405,1440,9295
3.023,17,7,1264,4,39,1001,39,268,3,304,0,304,996
284.825,17,4,352,2,60,284824,60,176,2,60,284824,60,176
4.012,17,4,296,4,46,1337,46,296,0,0,0,0,0
1743.095,6,95,7203,63,38,28114,205,4476,32,33,56218,98,2727
3.746,17,2,152,2,48,3746,48,152,0,0,0,0,0
1788.981,1,304,32224,304,78,5904,78,32224,0,0,0,0,0
354.151,6,17,1190,13,180,29512,180,864,4,110,20085,110,326
1680.92,17,13,534,11,14,168073,14,462,2,8,1680725,8,72
251.991,2,3,96,3,8,125995,8,96,0,0,0,0,0
0.899,17,2,178,1,29,0,29,57,1,93,0,93,121
5.259,17,3,208,2,36,5003,36,128,1,52,0,52,80
1795.334,6,356,22520,208,69,8673,69,12460,148,69,12211,69,10060
2.343,17,2,152,1,48,0,48,76,1,48,0,48,76
10.882,6,18,5610,10,275,1209,275,958,8,1440,839,1440,4652
0.31,17,2,196,1,62,0,62,90,1,78,0,78,106
0.016,17,4,350,2,34,0,34,124,2,85,0,91,226
67.595,6,29,7326,13,155,5632,267,1306,16,447,4505,1997,6020
1794.156,17,144,11520,72,48,25269,48,5472,72,56,25269,56,6048
1.38,6,50,19240,27,888,53,1360,13544,23,433,54,1360,5696
1792.932,17,180,11520,180,36,10016,36,11520,0,0,0,0,0
1769.59,6,130,7960,70,27,25646,27,4240,60,27,29983,27,3720
10.77,6,20,4442,11,275,1077,275,998,9,768,780,1440,3444
1744.741,6,95,7203,63,38,28140,205,4476,32,33,56273,98,2727
1755.137,6,108,8108,68,38,26196,205,4829,40,32,44994,98,3279
131.971,17,6,525,3,32,65977,37,181,3,86,65977,136,344
99.801,17,4,240,2,32,99800,32,120,2,32,99800,32,120
1739.864,6,87,6322,58,31,30523,31,3915,29,31,62137,31,2407
1082.832,2,11,352,11,8,108283,8,352,0,0,0,0,0
1763.748,2,15,480,15,8,125982,8,480,0,0,0,0,0
1741.895,17,245,48836,245,171,7138,358,48836,0,0,0,0,0
0.578,6,13,1693,7,288,92,288,588,6,426,62,434,1105
2.284,6,27,8827,16,282,152,578,1490,11,984,210,1452,7337
82.592,6,43,8670,20,329,505,671,1903,23,364,3748,1360,6767
275.623,17,4,352,2,60,275621,60,176,2,60,275622,60,176
882.259,2,8,256,8,8,126037,8,256,0,0,0,0,0
1785.865,6,357,22905,204,69,8797,69,12300,153,69,11749,69,10605
240.617,6,43,8698,20,578,12663,1418,5677,23,227,10936,580,3021
0.423,17,2,136,1,32,0,32,60,1,48,0,48,76
11.629,6,1847,1600732,1118,1376,10,1420,1567351,729,467,15,2840,33381
19.113,6,1611,1426093,979,1376,19,1448,1388565,632,776,30,1448,37528
39.956,17,24,2112,12,48,3630,48,912,12,72,3624,72,1200
1772.249,6,180,15480,120,69,14892,69,8940,60,69,30035,69,6540
280.421,6,31,7472,13,158,23368,267,1317,18,603,16493,2760,6155
216.87,6,122,99574,79,553,2780,1344,5992,43,2403,2860,8376,93582
0.004,17,3,821,1,137,0,137,165,2,300,3,300,656
1794.296,17,180,11520,180,36,10024,36,11520,0,0,0,0,0
15.611,6,28,4956,12,179,1419,722,1696,16,342,1026,1408,3260
3.859,6,2,1175,1,0,0,0,40,1,1095,0,1095,1135
3.21,17,2,322,1,33,0,33,61,1,233,0,233,261
375.993,6,18,1242,14,180,28922,180,916,4,110,20058,110,326
1788.215,6,104,6706,64,46,28384,208,4145,40,31,45842,31,2561
1708.497,17,19,5937,19,284,94916,1451,5937,0,0,0,0,0
0.29,6,27,8963,13,237,24,590,1635,14,941,21,1408,7328
2.308,6,24,6547,14,158,168,370,1355,10,957,254,1691,5192
1799.487,17,142,11360,71,48,25706,48,5396,71,56,25706,56,5964
1799.517,1,232,24592,232,78,7790,78,24592,0,0,0,0,0
1783.618,17,83,3480,82,14,22019,14,3444,1,8,0,8,36
0.074,17,2,572,1,39,0,39,67,1,477,0,477,505
1794.015,17,106,8480,53,48,34500,48,4028,53,56,34500,56,4452
638.457,17,15,1140,15,48,45604,48,1140,0,0,0,0,0
118.928,6,225,185498,142,1346,843,1448,170301,83,604,1447,1448,15197
1.215,6,25,8056,12,164,93,267,1288,13,869,86,1440,6768
0.435,6,3,199,1,31,0,31,83,2,0,435,0,116
280.444,6,30,7432,13,158,23370,267,1317,17,543,17522,1400,6115
1783.886,6,354,22440,207,69,8659,69,12420,147,69,12218,69,10020
7.051,6,4,239,2,31,5600,31,135,2,0,7051,0,104
0.702,6,32,6033,15,120,50,267,1448,17,650,39,1420,4585
25.31,6,27,7972,8,154,3615,267,792,19,458,1398,1420,7180
0.454,17,2,152,1,48,0,48,76,1,48,0,48,76
0.096,6,10,1514,5,503,24,503,771,5,475,23,475,743
1771.344,6,111,10206,68,66,26437,66,5846,43,60,42172,60,4360
682.626,6,123213,103051994,58483,717,11,1396,3314570,64730,1491,10,11168,99737424
0.017,17,2,656,1,300,0,300,328,1,300,0,300,328
1.109,6,24,8004,12,164,85,267,1288,12,1014,85,2411,6716
1779.795,6,130,7944,70,26,25793,26,4204,60,26,30165,26,3740
0.159,6,12,3462,6,75,31,75,395,6,1373,31,1448,3067
1794.124,17,144,11520,72,48,25269,48,5472,72,56,25269,56,6048
187.864,6,90,76583,38,56,5076,74,2089,52,1560,3683,4841,74494
1.534,6,47,19378,27,905,59,1360,13802,20,476,70,2715,5576
300.716,6,46,9070,23,315,13668,882,2273,23,345,532,1440,6797
0.004,6,3,189,1,0,0,0,40,2,69,0,69,149
2.675,17,2,204,1,34,0,34,62,1,114,0,114,142
0.89,6,20,5948,11,281,89,544,1288,9,716,100,1420,4660
1705.439,1,8,448,8,28,243634,28,448,0,0,0,0,0
223.508,17,4,352,2,60,223507,60,176,2,60,223507,60,176
374.703,6,18,1242,14,180,28823,180,916,4,110,20074,110,326
7.851,6,631,571031,410,1325,18,1368,554335,221,776,34,1473,16696
17.93,6,2639,2393120,1589,1418,11,1448,2326276,1050,776,16,1448,66844
1793.611,17,180,11520,180,36,10020,36,11520,0,0,0,0,0
9.06,6,16,1113,8,222,1292,222,546,8,231,1293,231,567
7.05,6,1169,1025397,696,1395,10,1408,996125,473,931,14,2816,29272
1772.084,6,180,15480,120,69,14891,69,8940,60,69,30032,69,6540
0.016,17,2,223,1,36,0,36,64,1,131,0,131,159
1681.308,17,16,4153,8,30,240185,37,471,8,432,240184,463,3682
1775.88,6,180,15480,120,69,14923,69,8940,60,69,30092,69,6540
1792.88,17,178,11392,178,36,10129,36,11392,0,0,0,0,0
2.307,17,4,518,3,39,891,39,201,1,289,0,289,317
1749.712,6,231,24944,118,111,14954,721,14067,113,176,15620,2828,10877
0.003,1,2,112,2,28,3,28,112,0,0,0,0,0
0.443,6,13,1693,6,288,84,288,548,7,426,41,434,1145
1794.414,17,144,11520,72,48,25273,48,5472,72,56,25273,56,6048
1056.006,6,14,1211,14,46,81231,62,1211,0,0,0,0,0
1578.613,1,50,2800,50,28,32216,28,2800,0,0,0,0,0
1782.181,17,83,3480,82,14,22002,14,3444,1,8,0,8,36
240.349,6,54,17797,28,784,8901,1402,14807,26,203,9613,580,2990
19.025,6,24,5124,12,137,1729,267,1172,12,577,1440,1400,3952
1784.814,6,422,25373,209,69,8580,69,12569,213,34,8418,48,12804
11.82,6,1873,1633300,1142,1376,10,1420,1599839,731,467,16,1883,33461
1.55,6,29,10365,17,367,96,833,1785,12,1012,133,1420,8580
246.31,6,85,21995,38,520,6656,1418,13438,47,339,5351,1418,8557
12.546,6,6,467,6,31,2509,31,467,0,0,0,0,0
371.648,6,27,1767,18,177,21861,177,1181,9,110,8606,110,586
0.384,6,27,9091,13,266,32,705,1750,14,943,28,1438,7341
312.51,6,10,562,4,106,104170,106,274,6,0,6321,0,288
2.509,6,38,8167,20,140,132,267,2071,18,671,143,1420,6096
247.689,6,384,409015,135,449,1848,1408,12371,249,1668,998,4224,396644
31.749,6,7,308,1,0,0,0,44,6,0,6299,0,264
120.279,2,3,96,3,8,60139,8,96,0,0,0,0,0
90.183,6,43,8642,22,359,773,762,2049,21,574,4501,4848,6593
10.154,6,86,27070,44,590,236,1152,21265,42,457,241,1179,5805
3.925,17,31,13941,14,662,301,1350,9663,17,223,205,1350,4278
1680.483,1,15,840,15,28,120034,28,840,0,0,0,0,0
1.562,6,58,18046,28,707,57,1360,8937,30,438,53,1360,9109
1786.013,6,106,8456,68,65,26656,65,4930,38,59,48267,59,3526
1793.196,6,290,22708,175,99,10305,469,13554,115,69,15729,69,9154
504.027,2,3,96,3,8,252013,8,96,0,0,0,0,0
3.948,17,2,656,2,300,3948,300,656,0,0,0,0,0
0.081,17,2,672,2,308,81,308,672,0,0,0,0,0
100.488,6,24,6248,9,272,100,516,1180,15,372,7170,1452,5068
1793.346,6,366,25610,213,99,8459,469,15005,153,69,11796,69,10605
9.203,6,1955,1819320,1219,1413,7,1448,1776384,736,776,12,1448,42936
1709.917,1,8,448,8,28,244273,28,448,0,0,0,0,0
1.501,6,32,6084,17,111,93,267,1579,15,650,96,1452,4505
1783.49,6,105,8475,68,65,26619,65,4930,37,59,49538,59,3545
176.419,6,23,9823,12,410,56,922,1742,11,1089,17628,2720,8081
0.046,17,4,368,2,32,39,32,120,2,96,0,96,248
300.632,6,43,8744,22,266,14315,721,2027,21,366,475,2720,6717
106.081,17,4,240,2,32,106080,32,120,2,32,106080,32,120
102.445,6,16,1300,5,177,25570,177,622,11,110,10228,110,678
1792.306,1,58,4872,58,56,31443,56,4872,0,0,0,0,0
0.02,1,2,112,2,28,20,28,112,0,0,0,0,0
1.636,6,31,6267,17,138,102,267,1795,14,558,114,1452,4472
374.744,6,18,1242,14,180,28826,180,916,4,110,20070,110,326
9.074,6,44,15538,23,968,412,1360,9667,21,386,443,2667,5871
1.166,6,195,144705,110,1366,10,1432,137005,85,389,12,1432,7700
1786.059,6,102,8364,68,66,26657,66,4964,34,60,54120,60,3400
1772.18,6,180,15480,120,69,14892,69,8940,60,69,30032,69,6540
280.379,6,29,7392,13,158,23364,267,1317,16,603,18686,1400,6075
1.377,6,26,8710,15,195,98,389,1763,11,909,103,1448,6947
5.027,17,3,208,2,36,5004,36,128,1,52,0,52,80
280.451,6,27,7312,13,158,23370,267,1317,14,678,21569,2760,5995
126.784,17,4,352,2,60,126782,60,176,2,60,126783,60,176
3.294,6,71,16811,36,510,94,1429,6123,35,386,96,1460,10688
1795.245,17,447,39864,402,35,4476,288,25644,45,288,40018,288,14220
0.277,6,25,6032,12,164,25,453,1442,13,651,22,1402,4590
5.014,17,4,288,2,36,4978,36,128,2,52,4983,52,160
1790.864,6,354,22440,206,69,8735,69,12380,148,69,12182,69,10060
262.796,17,4,304,4,48,87598,48,304,0,0,0,0,0
0.046,6,10,1173,6,160,9,160,480,4,477,13,477,693
1681.718,1,8,848,8,78,240245,78,848,0,0,0,0,0
421.097,2,6,192,6,8,84219,8,192,0,0,0,0,0
58.792,6,30,7432,13,158,4899,267,1317,17,603,3671,2076,6115
61.121,6,12,3767,7,406,10186,721,1173,5,2330,15225,2330,2594
0.088,17,2,140,1,34,0,34,62,1,50,0,50,78
1797.276,17,87,3648,86,14,21144,14,3612,1,8,0,8,36
1715.48,6,78,3588,39,0,45143,0,2028,39,0,45144,0,1560
0.437,6,21,7203,12,318,38,600,1906,9,964,52,1471,5297
120.129,6,138,106411,87,1300,1396,1408,94250,51,730,2398,3847,12161
8.087,6,1288,1116232,776,1388,10,1420,1091531,512,467,15,1883,24701
1772.305,6,180,15480,120,69,14893,69,8940,60,69,30035,69,6540
1778.535,6,102,8328,68,65,26545,66,4946,34,59,53891,60,3382
300.82,6,52,13733,27,824,11570,1460,7776,25,290,636,1460,5957
1.87,6,17,4147,10,273,207,517,1083,7,1342,303,1418,3064
0.0,17,2,144,1,36,0,36,64,1,52,0,52,80
125.852,2,2,64,2,8,125852,8,64,0,0,0,0,0
1785.861,6,356,22920,208,75,8627,469,12860,148,69,12148,69,10060
4.168,6,34,6185,18,206,245,314,2784,16,551,261,1179,3401
290.115,17,4,240,2,32,290114,32,120,2,32,290113,32,120
39.043,6,22,6928,9,156,4880,267,838,13,618,3251,1460,6090
0.072,1,2,112,2,28,72,28,112,0,0,0,0,0
1773.291,6,180,15480,120,69,14901,69,8940,60,69,30050,69,6540
1.435,6,19,3781,10,234,159,564,1452,9,463,155,1343,2329
1.061,6,31,12148,17,525,66,1360,3374,14,820,67,1380,8774
149.56,6,293,250536,191,1315,787,1368,233639,102,641,1478,2519,16897
787.064,17,10,821,5,31,196762,37,297,5,76,196762,136,524
0.43,6,54,23582,31,947,14,1380,16497,23,558,17,1923,7085
1569.477,6,162,14001,105,70,15090,138,7926,57,69,28024,69,6075
131.162,6,84,60554,53,1236,2522,1368,52204,31,841,2065,2736,8350
80.016,17,18,19312,18,1044,4706,1060,19312,0,0,0,0,0
1788.623,6,4097,4152537,1257,123,1424,354,76245,2840,1420,630,4254,4076292
240.417,6,55,17675,30,765,8290,1402,14576,25,223,10017,580,3099
1701.902,17,12,498,11,14,170190,14,462,1,8,0,8,36
1772.455,6,180,15480,120,69,14894,69,8940,60,69,30036,69,6540
342.309,17,12,4032,12,308,31119,308,4032,0,0,0,0,0
38.637,6,9,608,0,0,0,0,0,9,31,4829,31,608
1773.635,6,180,15480,120,69,14904,69,8940,60,69,30058,69,6540
0.015,17,2,471,1,39,0,39,67,1,376,0,376,404
1.34,6,48,20151,27,958,51,1460,14535,21,433,57,1460,5616
8.399,6,16,5713,5,106,2097,106,314,11,823,838,1460,5399
1798.568,17,449,39928,404,35,4462,288,25708,45,288,40018,288,14220
19.365,6,14,1025,7,222,3225,222,506,7,231,3225,231,519
0.624,6,56,21835,28,1041,23,1380,15834,28,404,21,1923,6001
1.31,6,48,19186,27,889,50,1360,13570,21,433,56,1360,5616
1.661,6,11,819,6,186,332,186,506,5,45,414,45,313
1745.897,6,95,7203,63,38,28159,205,4476,32,33,56307,98,2727
1682.953,2,18,576,18,8,98997,8,576,0,0,0,0,0
0.099,17,2,362,1,46,0,46,74,1,260,0,260,288
1773.75,6,180,15480,120,69,14905,69,8940,60,69,30055,69,6540
0.872,17,2,390,1,46,0,46,74,1,288,0,288,316
1.146,6,27,9624,13,164,81,267,1396,14,936,74,1408,8228
1788.595,1,58,4872,58,56,31378,56,4872,0,0,0,0,0
62.589,6,27,7177,13,155,5215,267,1306,14,530,4813,3417,5871
0.377,6,6,324,4,0,125,0,216,2,0,188,0,108
1.623,6,15,6111,4,189,538,267,547,11,639,161,1420,5564
240.174,6,53,17712,28,785,8895,1402,14820,25,198,10007,580,2892
252.769,2,2,64,2,8,252769,8,64,0,0,0,0,0
1.632,6,30,7561,17,306,102,1088,2827,13,601,121,1420,4734
0.987,6,27,8453,14,270,62,561,1957,13,994,67,1791,6496
1776.514,17,312,71002,312,199,5712,422,71002,0,0,0,0,0
5.289,17,4,288,2,36,5006,36,128,2,52,4952,52,160
2.171,6,51,18825,28,916,80,1460,13084,23,400,87,1460,5741
100.696,6,25,10208,12,549,56,1360,2709,13,995,8381,1360,7499
1786.211,6,217,17280,81,76,22325,375,8431,136,50,13230,143,8849
0.021,17,2,570,1,30,0,30,58,1,484,0,484,512
1.103,6,12,3705,6,171,220,171,491,6,964,218,1448,3214
147.621,6,21,9714,12,410,55,922,1742,9,1520,18436,4416,7972
0.014,17,2,382,1,36,0,36,64,1,290,0,290,318
0.069,17,8,1670,8,180,9,219,1670,0,0,0,0,0
0.316,6,27,9065,13,257,26,669,1714,14,945,23,1402,7351
115.165,6,123,89777,76,1254,1535,1408,79211,47,811,2200,3847,10566
97.725,6,25,10113,12,531,66,1360,2661,13,988,8131,1360,7452
0.974,6,27,8420,15,222,58,540,1964,12,1192,72,3151,6456
1.453,6,22,7900,12,164,109,267,1288,10,1521,138,5227,6612
2.578,6,54,19998,29,926,92,1460,14177,25,400,93,1460,5821
85.91,17,4,352,2,60,85908,60,176,2,60,85909,60,176
0.246,17,8,1670,8,180,35,219,1670,0,0,0,0,0
1731.202,17,16,5331,16,305,115413,1238,5331,0,0,0,0,0
1681.038,1,15,840,15,28,120074,28,840,0,0,0,0,0
1740.465,17,28,29568,28,1028,64461,1028,29568,0,0,0,0,0
0.546,6,12,1653,6,288,102,288,548,6,426,67,434,1105
1740.875,1,14,812,14,30,133913,30,812,0,0,0,0,0
299.945,6,40,9995,21,593,14988,1460,4433,19,399,16653,1460,5562
3.12,6,35,16522,17,685,195,1348,2961,18,970,120,1408,13561
1323.531,2,14,448,14,8,101810,8,448,0,0,0,0,0
0.835,6,123,89613,68,131,12,232,3249,55,1683,15,4080,86364
0.165,17,2,1920,2,932,165,932,1920,0,0,0,0,0
5.915,17,4,352,2,60,5913,60,176,2,60,5913,60,176
27.666,17,28,7173,11,309,2766,1350,3710,17,175,1695,1350,3463
481.28,2,3,96,3,8,240640,8,96,0,0,0,0,0
39.816,2,2,64,2,8,39816,8,64,0,0,0,0,0
34.067,17,20,1760,10,48,3784,48,760,10,72,3783,72,1000
107.116,6,41,20195,20,670,103,1360,4879,21,1112,5349,1360,15316
297.67,6,36,8086,13,158,24805,267,1317,23,365,13529,1400,6769
280.528,6,31,7472,13,158,23377,267,1317,18,543,16494,1380,6155
0.784,17,4,820,2,36,773,36,128,2,318,775,318,692
1791.562,1,58,4872,0,0,0,0,0,58,56,31430,56,4872
1775.976,1,58,4872,0,0,0,0,0,58,56,31157,56,4872
1786.774,17,87,3648,86,14,21020,14,3612,1,8,0,8,36
637.903,17,108,22197,76,40,8505,41,5205,32,503,20511,505,16992
4.742,6,38,7245,19,218,263,314,3383,19,516,249,1179,3862
0.017,17,2,180,1,30,0,30,58,1,94,0,94,122
300.609,6,37,8607,19,335,16700,994,2133,18,441,498,1460,6474
1788.195,1,56,4704,56,56,32512,56,4704,0,0,0,0,0
0.099,6,12,2069,7,324,16,585,1009,5,396,21,580,1060
0.061,6,2,1211,1,0,0,0,40,1,1131,0,1131,1171
31.419,6,8,376,2,0,31419,0,88,6,0,6281,0,288
1788.973,17,83,3480,82,14,22086,14,3444,1,8,0,8,36
1.897,6,22,4395,11,288,180,288,1360,11,639,173,853,3035
0.1,17,6,462,6,49,20,49,462,0,0,0,0,0
5.0,17,4,288,2,36,4996,36,128,2,52,4999,52,160
1783.25,17,73,3060,72,14,25116,14,3024,1,8,0,8,36
1139.934,17,164,12464,164,48,6993,48,12464,0,0,0,0,0
1794.324,6,361,24334,211,88,8544,469,13987,150,69,12041,69,10347
1790.98,1,342,28728,342,56,5252,56,28728,0,0,0,0,0
1.81,1,9,756,9,56,226,56,756,0,0,0,0,0
1779.036,17,258,54236,258,182,6922,422,54236,0,0,0,0,0
0.027,17,3,634,2,32,19,32,120,1,486,0,486,514
262.485,6,94,11070,43,131,6249,630,4401,51,164,5249,619,6669
0.015,17,2,166,1,39,0,39,67,1,71,0,71,99
0.013,6,14,4334,7,111,2,111,483,7,869,2,1448,3851
1758.053,6,100,7866,66,45,27046,205,4902,34,35,53264,98,2964
105.37,6,42,9653,18,279,2784,1189,2961,24,477,4574,2920,6692
280.344,6,30,7432,13,158,23362,267,1317,17,543,17512,1400,6115
63.178,6,14,9716,3,92,1501,92,256,11,1268,6300,1408,9460
0.96,6,29,8303,15,225,57,561,1985,14,820,59,1440,6318
15.52,17,18,11900,10,940,1716,1350,9682,8,249,2207,1350,2218
0.061,6,11,819,6,186,12,186,506,5,45,13,45,313
0.491,6,48,22402,24,171,21,313,1978,24,1197,20,1408,20424
1796.166,6,416,24920,208,69,8677,69,12460,208,34,8677,64,12460
504.179,2,4,128,4,8,168059,8,128,0,0,0,0,0
300.809,6,46,10323,23,433,13673,910,3166,23,345,434,2720,7157
310.939,6,73,15531,32,574,10029,1418,9744,41,166,7773,580,5787
0.654,6,20,7168,13,319,54,602,1960,7,1209,96,1946,5208
104.414,6,72,47571,44,1196,2428,1448,39385,28,746,2281,1448,8186
0.039,6,18,4140,10,101,4,101,629,8,514,5,1000,3511
1643.637,1,8,448,8,28,234805,28,448,0,0,0,0,0
1.955,6,28,7330,15,657,139,1418,5392,13,249,161,580,1938
0.456,6,6,324,4,0,152,0,216,2,0,250,0,108
0.741,17,4,288,2,36,709,36,128,2,52,706,52,160
1791.674,17,144,11520,72,48,25234,48,5472,72,56,25234,56,6048
1770.943,6,102,9711,68,69,26431,233,5914,34,59,53661,82,3797
5.119,6,38,7229,19,218,284,314,3383,19,513,270,1179,3846
1673.308,1,7,392,7,28,278884,28,392,0,0,0,0,0
1799.83,1,59,4956,0,0,0,0,0,59,56,31031,56,4956
1773.4,6,180,15480,120,69,14902,69,8940,60,69,30049,69,6540
33.538,6,32,5193,17,154,2096,722,2011,15,399,1412,2026,3182
161.788,6,9,515,5,43,40447,43,299,4,0,53928,0,216
15.862,17,18,5033,8,318,2256,1350,2771,10,198,1754,1350,2262
1740.54,17,30,31680,30,1028,60018,1028,31680,0,0,0,0,0
2.078,1,2,112,2,28,2078,28,112,0,0,0,0,0
1786.447,6,102,8364,68,66,26663,66,4964,34,60,54132,60,3400
281.695,6,29,7733,14,158,21668,267,1357,15,641,20114,2045,6376
325.145,6,28,5272,13,169,13686,516,1538,15,260,23217,1452,3734
3.189,17,31,16451,17,485,199,1350,8732,14,523,239,1350,7719
240.205,6,54,16661,29,723,8578,1402,13816,25,192,10008,580,2845
1770.394,6,99,9240,66,65,27236,65,5577,33,59,55322,59,3663
20.849,1,7,392,7,28,3474,28,392,0,0,0,0,0
15.111,6,16,1327,8,222,2157,222,768,8,231,2157,231,559
0.65,17,4,284,2,32,327,32,120,2,54,324,60,164
661.791,2,7,224,7,8,110298,8,224,0,0,0,0,0
63.872,6,16,8805,16,498,4258,1402,8805,0,0,0,0,0
0.174,6,30,16938,15,129,12,129,917,15,1269,12,1448,16021
2.955,17,3,468,3,128,1477,128,468,0,0,0,0,0
1681.074,17,12,498,11,14,168107,14,462,1,8,0,8,36
195.564,1,3,312,3,76,97782,76,312,0,0,0,0,0
1.4,6,10,1687,7,100,233,100,384,3,1179,568,1179,1303
336.39,1,6,636,6,78,67278,78,636,0,0,0,0,0
1.486,17,2,214,1,39,0,39,67,1,119,0,119,147
1774.334,17,140,11200,70,48,25714,48,5320,70,56,25714,56,5880
1.34,6,41,8443,21,321,67,1164,2822,20,400,60,1360,5621
0.311,6,18,6547,9,290,38,517,1069,9,1000,37,1507,5478
42.155,17,32,5412,16,48,2809,48,1216,16,234,2809,308,4196
0.061,6,2,251,1,159,0,159,211,1,0,0,0,40
8.097,1,9,756,9,56,1012,56,756,0,0,0,0,0
1.656,6,31,6419,12,239,150,585,2071,19,335,87,830,4348
1.779,6,25,8703,15,275,127,557,1429,10,981,177,1420,7274
69.234,6,42,15260,23,971,409,1360,9698,19,435,3835,2667,5562
0.28,6,12,4310,7,127,45,127,499,5,1771,49,3378,3811
240.29,6,43,8821,21,197,12013,751,2481,22,518,11440,2736,6340
10.683,6,1571,1312226,867,1418,12,1448,1264734,704,776,14,1448,47492
0.226,6,26,7256,13,155,18,267,1301,13,603,18,2800,5955
0.093,17,2,382,1,32,0,32,60,1,294,0,294,322
10.765,6,20,4442,11,275,1076,275,998,9,768,786,1440,3444
0.927,17,18,7041,8,445,132,1350,3789,10,297,57,1350,3252
97.838,6,29,15888,13,533,82,1287,2165,16,1188,6510,1460,13723
1779.75,1,342,28728,342,56,5219,56,28728,0,0,0,0,0
244.011,17,3,1236,3,384,122005,394,1236,0,0,0,0,0
7.538,6,18,10349,5,124,1884,126,468,13,1038,616,1360,9881
3.077,17,4,352,2,37,1,37,130,2,83,0,89,222
0.087,6,10,767,5,186,20,186,454,5,45,19,45,313
0.279,17,2,268,1,54,0,54,82,1,158,0,158,186
1775.277,6,180,15480,120,69,14918,69,8940,60,69,30087,69,6540
1795.093,17,448,39896,403,35,4465,288,25676,45,288,40018,288,14220
1763.508,17,286,58933,286,178,6187,422,58933,0,0,0,0,0
1792.002,6,356,22520,208,69,8656,69,12460,148,69,12190,69,10060
7.146,6,5,240,1,0,0,0,48,4,0,2378,0,192
1740.448,17,29,30624,29,1028,62158,1028,30624,0,0,0,0,0
52.778,17,4,3633,4,880,17592,1444,3633,0,0,0,0,0
1799.986,17,83010,3320032,41551,8,43,8,1495836,41459,16,43,16,1824196
0.068,6,2,116,1,0,0,0,52,1,0,0,0,64
1.592,6,9,527,5,43,398,43,311,4,0,511,0,216
1797.521,17,444,39200,400,35,4505,288,25296,44,288,40950,288,13904
301.029,6,51,20443,29,969,10751,1360,14761,22,399,423,1360,5682
157.702,6,36,8132,13,140,13140,267,1513,23,316,7167,1420,6619
1792.624,6,244,35804,152,302,11871,302,26032,92,83,19699,83,9772
0.582,17,2,144,1,36,0,36,64,1,52,0,52,80
0.326,17,2,172,1,50,0,50,78,1,66,0,66,94
14.001,6,20,5882,10,275,1555,275,958,10,902,1385,1440,4924
5.137,6,16,2439,10,188,570,245,788,6,703,359,1152,1651
288.515,17,4,352,2,60,288514,60,176,2,60,288514,60,176
22.361,6,11,612,6,0,4472,0,328,5,0,5582,0,284
280.256,6,31,7472,13,158,23354,267,1317,18,543,16482,1400,6155
1797.464,6,373,26028,216,98,8360,469,15263,157,69,11520,69,10765
0.224,6,19,7962,11,290,22,517,1149,8,1277,25,2736,6813
15.486,17,18,11445,10,896,1714,1350,9244,8,247,2201,1350,2201
1739.205,6,87,6322,58,31,30512,31,3915,29,31,62113,31,2407
296.954,17,4,352,2,60,296953,60,176,2,60,296952,60,176
0.101,6,9,1346,5,145,25,145,349,4,833,28,833,997
0.102,6,9,1340,5,145,25,145,349,4,827,25,827,991
1771.249,17,299,62132,299,179,5943,422,62132,0,0,0,0,0
240.159,6,39,8650,19,165,13341,517,1990,20,623,12638,1418,6660
1768.318,17,331,54300,331,136,5358,363,54300,0,0,0,0,0
8.112,6,77,24365,39,552,213,1152,18704,38,459,212,1179,5661
207.342,17,456,21888,228,20,913,20,10944,228,20,913,20,10944
0.891,6,11,1727,7,100,148,100,384,4,589,215,1152,1343
1794.917,6,375,24301,216,74,8348,469,13663,159,69,11358,69,10638
0.466,17,3,216,2,31,436,31,118,1,70,0,70,98
1.213,6,52,19152,29,871,43,1360,13411,23,437,47,2715,5741
1740.904,6,87,6322,58,31,30542,31,3915,29,31,62173,31,2407
280.225,6,28,7352,13,158,23352,267,1317,15,678,20012,2045,6035
5.887,17,30,12412,14,614,450,1350,9001,16,185,389,1350,3411
0.023,17,2,912,1,308,0,308,336,1,548,0,548,576
33.779,6,32,5157,16,154,2237,721,1922,16,399,2238,1368,3235
0.54,6,12,1653,6,288,105,288,548,6,426,72,434,1105
1.377,6,51,18982,28,929,51,1460,13241,23,400,54,1460,5741
1785.418,6,357,22698,207,69,8666,69,12420,150,69,11979,69,10278
0.243,6,21,7281,12,334,21,663,1969,9,967,29,1471,5312
1797.541,1,645,54180,645,56,2791,56,54180,0,0,0,0,0
1794.274,6,362,22898,210,69,8585,69,12678,152,69,11882,69,10220
9.542,17,4,352,2,48,9526,48,152,2,72,9524,72,200
3.236,6,557,453220,323,1376,10,1420,439627,234,467,13,1883,13593
1783.623,6,123,16752,78,220,23163,1272,11707,45,83,40534,241,5045
1741.614,17,30,7050,30,207,60055,207,7050,0,0,0,0,0
86.725,17,4,352,2,60,86724,60,176,2,60,86724,60,176
3.019,17,4,268,4,39,1006,39,268,0,0,0,0,0
1740.253,1,13,728,13,28,145021,28,728,0,0,0,0,0
39.212,17,22,1936,11,48,3918,48,836,11,72,3915,72,1100
4.429,6,2,88,2,0,0,0,88,0,0,0,0,0
1785.862,6,369,25730,214,99,8384,469,15114,155,69,11596,69,10616
2.0,17,3,276,3,64,1000,64,276,0,0,0,0,0
1795.599,1,274,15344,274,28,6577,28,15344,0,0,0,0,0
0.114,6,9,1343,5,145,28,145,349,4,830,33,830,994
0.047,6,16,5005,9,128,5,128,616,7,1004,7,1393,4389
6.095,6,6,364,0,0,0,0,0,6,31,1219,31,364
2.88,17,3,186,3,34,1440,34,186,0,0,0,0,0
4.572,6,40,7309,21,218,228,314,3463,19,513,239,1179,3846
0.022,6,11,1564,6,503,4,503,823,5,473,5,473,741
4.64,17,4,3296,4,796,1546,1451,3296,0,0,0,0,0
1770.885,6,99,9306,66,66,27244,66,5610,33,60,55336,60,3696
10.214,6,26,5449,12,245,928,383,2448,14,487,765,1179,3001
0.036,17,3,672,2,60,12,60,176,1,468,0,468,496
0.29,6,25,6014,12,164,26,453,1442,13,555,21,1448,4572
503.933,2,3,96,3,8,251966,8,96,0,0,0,0,0
0.177,17,2,2754,2,1349,177,1349,2754,0,0,0,0,0
0.984,6,31,12855,16,830,65,1440,5664,15,731,57,1485,7191
372.129,6,18,1242,14,180,28625,180,916,4,110,20063,110,326
1744.572,2,29,928,29,8,62306,8,928,0,0,0,0,0
347.094,6,54,3646,22,46,16528,46,1538,32,46,11191,46,2108
11.891,6,1750,1629319,1151,1365,10,1432,1601068,599,427,19,1432,28251
1799.051,17,449,39928,404,35,4464,288,25708,45,288,40021,288,14220
1791.163,17,35,11989,35,314,52681,317,11989,0,0,0,0,0
8.449,6,10,628,4,106,2814,106,274,6,90,1688,90,354
1746.214,6,96,7286,63,38,28164,205,4476,33,33,54562,98,2810
4.659,6,704,634272,454,1360,10,1432,616678,250,689,18,3303,17594
1.351,6,49,20236,29,954,48,1460,14615,20,480,61,4075,5621
1787.979,1,168,9408,168,28,10706,28,9408,0,0,0,0,0
0.298,6,20,7229,11,334,29,663,1917,9,967,36,1906,5312
52.668,6,10,648,10,31,5852,31,648,0,0,0,0,0
0.441,6,8,423,4,0,147,0,204,4,7,68,7,219
280.298,6,29,7392,13,158,23358,267,1317,16,603,18679,1400,6075
1.424,6,25,8056,12,164,106,267,1288,13,869,101,1448,6768
1.014,6,15,4096,8,88,144,88,452,7,1670,168,1880,3644
1675.141,6,201,15146,75,65,22634,293,7063,126,48,13401,78,8083
1.668,6,27,10121,16,275,111,558,1470,11,1025,149,1420,8651
1.447,6,52,18928,26,926,57,1440,13112,26,433,50,1440,5816
1790.198,1,292,30952,292,78,6151,78,30952,0,0,0,0,0
36.556,17,40,5880,20,48,1923,48,1520,20,190,1923,308,4360
1700.619,17,13,534,11,14,170044,14,462,2,8,1700442,8,72
11.825,6,25,8453,13,275,985,275,1078,12,983,866,1420,7375
1796.013,17,448,39896,403,35,4467,288,25676,45,288,40018,288,14220
1786.053,1,58,4872,0,0,0,0,0,58,56,31334,56,4872
62.363,6,10,628,4,106,20783,106,274,6,90,12470,90,354
0.238,17,2,167,1,39,0,39,67,1,72,0,72,100
1744.822,6,95,7203,63,38,28142,205,4476,32,33,56276,98,2727
89.023,17,2,740,2,342,89023,342,740,0,0,0,0,0
842.229,2,11,352,11,8,84222,8,352,0,0,0,0,0
11.735,17,4,352,2,48,11712,48,152,2,72,11720,72,200
1745.836,6,97,7307,63,38,28158,205,4476,34,33,52893,98,2831
1.426,6,37,8214,19,321,79,1164,2718,18,476,72,2615,5496
20.275,6,18,2368,10,189,2252,517,1298,8,323,2895,499,1070
0.958,6,24,6500,13,323,79,954,2140,11,783,95,1420,4360
2.37,6,20,3833,11,234,237,564,1504,9,463,272,1343,2329
1741.465,6,87,6322,58,31,30552,31,3915,29,31,62187,31,2407
240.121,6,38,4749,18,181,14124,517,2035,20,208,12637,851,2714
2.573,6,21,6352,10,262,281,517,1316,11,744,253,1418,5036
1773.524,6,183,15738,121,69,14779,69,8980,62,69,29068,69,6758
504.528,2,4,128,4,8,168176,8,128,0,0,0,0,0
147.042,17,4,352,2,60,147040,60,176,2,60,147041,60,176
1.397,6,36,8174,19,321,77,1164,2718,17,476,74,2715,5456
1.313,6,50,19678,27,919,50,1460,13982,23,433,50,1460,5696
1794.429,1,216,22896,216,78,8346,78,22896,0,0,0,0,0
1770.514,6,99,9306,66,66,27238,66,5610,33,60,55325,60,3696
1798.152,17,448,39896,403,35,4473,288,25676,45,288,40015,288,14220
1.1,6,23,7952,12,164,84,267,1288,11,1216,93,3819,6664
1680.5,17,12,498,11,14,168050,14,462,1,8,0,8,36
35.344,6,49,11829,26,136,1413,159,2657,23,662,1606,1658,9172
299.788,1,4,326,4,53,99929,78,326,0,0,0,0,0
49.042,6,27,7177,13,155,4086,267,1306,14,530,3771,3417,5871
0.878,17,24,9898,11,387,84,1350,4568,13,382,70,1350,5330
1.449,6,52,20308,27,958,55,1440,14532,25,433,52,1440,5776
240.283,6,45,8957,23,523,10921,1408,5913,22,210,11441,618,3044
195.769,17,6,1236,3,48,97755,48,228,3,308,97845,308,1008
2.211,6,14,2351,8,188,315,245,700,6,703,389,1152,1651
1794.181,6,409,33632,233,127,7733,485,19044,176,98,10251,453,14588
0.159,6,3,132,2,0,0,0,92,1,0,0,0,40
1775.053,6,180,15480,120,69,14916,69,8940,60,69,30082,69,6540
23.384,17,4,240,2,32,23382,32,120,2,32,23383,32,120
0.262,17,2,476,1,39,0,39,67,1,381,0,381,409
15.397,17,10,880,5,48,3846,48,380,5,72,3838,72,500
1791.353,6,357,22629,208,69,8653,69,12460,149,69,12103,69,10169
317.142,6,47,11841,28,141,11746,615,3556,19,834,17611,3289,8285
0.561,17,2,384,1,39,0,39,67,1,289,0,289,317
1796.102,1,278,15568,278,28,6484,28,15568,0,0,0,0,0
1782.509,6,354,22440,207,69,8652,69,12420,147,69,12208,69,10020
366.273,6,27,1767,18,177,21545,177,1181,9,110,8550,110,586
0.979,6,26,9155,14,212,75,495,1443,12,1031,72,2720,7712
1775.533,6,181,15589,120,69,14920,69,8940,61,69,29589,69,6649
1786.698,17,142,11360,71,48,25523,48,5396,71,56,25523,56,5964
1787.214,6,208,24168,132,89,13642,981,11118,76,138,23827,2920,13050
1116.457,17,162,31012,81,48,13955,48,6156,81,278,13955,308,24856
1045.971,1,46,2576,46,28,23243,28,2576,0,0,0,0,0
1710.403,1,8,448,8,28,244343,28,448,0,0,0,0,0
130.073,6,8,807,2,92,2862,92,204,6,70,25977,92,603
1740.491,17,29,30403,29,1020,62160,1028,30403,0,0,0,0,0
24.989,6,35,8342,17,165,1561,721,2169,18,778,1457,2840,6173
0.068,17,2,650,1,308,0,308,336,1,286,0,286,314
2.05,17,6,460,3,40,1008,41,206,3,56,1011,57,254
14.045,6,1463,1321099,883,1414,15,1448,1285335,580,776,23,1448,35764
32.059,6,9,396,2,0,3483,0,88,7,0,5328,0,308
1743.885,1,58,4872,58,56,30594,56,4872,0,0,0,0,0
299.29,1,4,224,4,28,99763,28,224,0,0,0,0,0
280.214,6,29,7392,13,158,23351,267,1317,16,603,18677,2236,6075
4.182,6,38,7229,19,218,232,314,3383,19,440,218,1152,3846
1682.583,17,16,1265,8,30,240364,37,471,8,71,240361,136,794
1.324,6,48,19654,27,923,50,1460,14038,21,433,57,1460,5616
31.616,6,7,308,1,0,0,0,44,6,0,6304,0,264
2.965,6,12,507,7,0,494,0,288,5,7,685,7,219
8.909,6,4,240,4,0,0,0,240,0,0,0,0,0
9.822,6,15,5329,7,171,1635,171,567,8,867,1400,1448,4762
118.591,6,25,11093,12,380,83,832,1689,13,985,9869,1360,9404
240.244,6,48,6470,22,213,11439,585,3087,26,183,9609,580,3383
3.016,17,4,374,2,46,3004,46,148,2,85,3004,85,226
0.008,6,6,362,3,31,4,31,175,3,31,0,31,187
1799.349,17,462,41044,405,35,4453,288,25784,57,239,31565,288,15260
0.938,17,2,144,1,36,0,36,64,1,52,0,52,80
1799.716,17,449,39928,404,35,4465,288,25708,45,288,40020,288,14220
12.392,17,3,208,2,36,5006,36,128,1,52,0,52,80
1773.214,6,180,15480,120,69,14900,69,8940,60,69,30045,69,6540
240.673,2,3,96,3,8,120336,8,96,0,0,0,0,0
0.372,17,2,144,1,36,0,36,64,1,52,0,52,80
0.23,6,9,1002,5,213,57,213,417,4,421,66,421,585
11.768,6,1867,1625120,1127,1387,10,1420,1591299,740,467,15,1883,33821
2.029,6,26,6125,14,108,156,147,999,12,773,156,1608,5126
75.176,17,53,13596,53,228,1445,389,13596,0,0,0,0,0
22.936,6,14,1851,6,100,969,100,344,8,1179,3238,1179,1507
1774.877,6,180,15480,120,69,14914,69,8940,60,69,30077,69,6540
58.063,17,6,528,3,48,29027,48,228,3,72,29027,72,300
0.124,17,2,467,1,33,0,33,61,1,378,0,378,406
127.384,17,4,352,2,60,127383,60,176,2,60,127383,60,176
1679.604,1,15,840,15,28,119971,28,840,0,0,0,0,0
1744.293,6,95,7203,63,38,28133,205,4476,32,33,56254,98,2727
6.848,6,30,8848,13,155,570,267,1306,17,527,427,3417,7542
3.16,6,10,427,5,0,739,0,208,5,7,740,7,219
0.137,17,4,820,2,36,126,36,128,2,318,11,318,692
5.003,17,4,558,2,36,4997,36,128,2,187,4993,187,430
0.069,6,9,1340,5,145,17,145,349,4,827,20,827,991
85.916,6,36,8455,17,410,548,882,1942,19,441,4763,1360,6513
0.056,17,2,144,1,36,0,36,64,1,52,0,52,80
14.125,6,955,853917,620,1306,22,1368,831833,335,776,41,2736,22084
9.322,6,83,24877,42,561,227,1152,19096,41,413,226,1152,5781
2.376,6,28,8030,16,215,158,652,1965,12,926,195,1538,6065
3.331,6,6,344,2,0,3140,0,112,4,0,1046,0,232
5.828,6,39,7285,21,218,291,314,3463,18,516,326,1179,3822
4.06,17,4,244,4,33,1353,33,244,0,0,0,0,0
1741.282,6,87,6322,58,31,30548,31,3915,29,31,62187,31,2407
0.019,17,4,284,2,32,13,32,120,2,54,13,60,164
1799.767,17,448,39896,403,35,4477,288,25676,45,288,40017,288,14220
2.78,6,27,8245,12,330,248,517,1978,15,684,195,1418,6267
176.707,6,24,8050,12,377,68,798,1669,12,841,16050,2720,6381
5.035,17,4,288,2,36,5003,36,128,2,52,4997,52,160
1.384,6,48,19343,27,901,53,1360,13727,21,476,59,2715,5616
1.009,17,2,116,2,30,1009,30,116,0,0,0,0,0
3.378,17,69,57212,28,371,125,1350,11189,41,1094,66,1350,46023
16.093,17,12,5259,6,489,3212,1350,3107,6,330,3212,1350,2152
3.022,17,2,656,2,300,3022,300,656,0,0,0,0,0
16.607,6,30,7089,14,111,1277,267,1345,16,637,1088,1917,5744
0.448,6,6,324,4,0,149,0,216,2,0,269,0,108
1.09,6,68,48218,34,165,33,253,2591,34,1414,32,2896,45627
1.242,6,2,80,1,0,0,0,40,1,0,0,0,40
94.267,6,25,6318,9,272,102,516,1180,16,345,6278,1452,5138
0.101,17,2,558,1,32,0,32,60,1,470,0,470,498
4.01,6,5,232,2,0,4010,0,88,3,0,1521,0,144
1740.513,17,30,7050,30,207,60017,207,7050,0,0,0,0,0
1755.806,6,4007,3739897,2157,148,814,911,127114,1850,1975,949,11264,3612783
3.308,17,5,290,5,30,827,30,290,0,0,0,0,0
0.017,17,2,322,1,33,0,33,61,1,233,0,233,261
164.922,6,25,9854,12,532,56,1440,2642,13,954,13732,1440,7212
1.049,6,24,6416,13,299,87,838,2019,11,988,103,1699,4397
0.511,17,2,152,1,48,0,48,76,1,48,0,48,76
9.113,17,8,1672,4,37,3033,37,260,4,325,3033,325,1412
165.403,6,1533,774393,853,844,194,1152,739642,680,397,243,1179,34751
281.092,6,30,7570,13,158,23424,267,1317,17,556,17542,2800,6253
4.48,6,2,88,2,0,0,0,88,0,0,0,0,0
0.002,6,3,1507,1,0,0,0,40,2,1363,1,1363,1467
1640.848,1,8,448,8,28,234406,28,448,0,0,0,0,0
0.016,17,3,418,2,36,2,36,128,1,262,0,262,290
1796.218,17,142,11360,71,48,25660,48,5396,71,56,25660,56,5964
9.174,6,1465,1272395,885,1387,10,1420,1244938,580,420,15,1420,27457
14.347,6,71,21859,37,525,398,1152,16731,34,470,417,1179,5128
64.778,6,18,1813,8,177,130,177,955,10,110,7177,110,858
240.329,6,45,8499,24,449,10448,1402,5752,21,205,12016,580,2747
0.416,6,27,9042,13,247,34,624,1672,14,947,29,1448,7370
1795.332,17,80,3354,79,14,23017,14,3318,1,8,0,8,36
0.012,17,2,412,1,40,0,40,68,1,316,0,316,344
21.44,17,12,1056,6,48,4285,48,456,6,72,4285,72,600
4.082,6,39,7269,19,218,226,314,3383,20,440,201,1152,3886
1798.802,6,365,23087,211,69,8565,69,12787,154,69,11756,69,10300
15.176,6,5,752,3,46,7588,46,166,2,506,14956,506,586
0.847,6,20,5966,12,287,77,562,1346,8,859,108,2642,4620
244.077,6,38,6044,23,304,11094,304,4564,15,83,17415,83,1480
1750.731,6,95,7203,63,38,28237,205,4476,32,33,56467,98,2727
57.534,17,8,704,4,48,19175,48,304,4,72,19175,72,400
1794.371,1,256,14336,256,28,7036,28,14336,0,0,0,0,0
0.058,17,2,904,2,424,58,548,904,0,0,0,0,0
280.248,6,27,7312,13,158,23354,267,1317,14,775,21553,4836,5995
1122.212,17,139,8896,139,36,8131,36,8896,0,0,0,0,0
0.494,17,3,451,2,39,151,39,134,1,289,0,289,317
33.724,6,23,4015,11,148,1880,293,1333,12,366,3044,1179,2682
6.987,6,658,594610,423,1336,16,1368,576846,235,776,28,1473,17764
1798.109,6,376,26286,219,98,8248,469,15452,157,69,11525,69,10834
0.079,6,9,1340,5,145,19,145,349,4,827,16,827,991
1744.691,2,30,960,30,8,60161,8,960,0,0,0,0,0
0.986,17,4,240,2,32,984,32,120,2,32,985,32,120
0.346,17,2,304,1,60,0,60,88,1,188,0,188,216
240.725,6,42,9021,21,610,12035,1402,5980,21,242,12035,589,3041
0.051,17,2,410,1,46,0,46,74,1,308,0,308,336
210.171,17,2,150,2,47,210171,47,150,0,0,0,0,0
1748.08,1,80,6720,0,0,0,0,0,80,56,22127,56,6720
126.448,2,2,64,2,8,126448,8,64,0,0,0,0,0
1719.531,17,12,498,11,14,171953,14,462,1,8,0,8,36
654.328,6,63,7564,36,88,18690,722,3380,27,185,25160,2329,4184
281.19,6,24,7054,11,181,28119,267,1168,13,670,23429,2076,5886
2.059,6,9,527,5,43,514,43,311,4,0,650,0,216
1776.861,17,73,3060,72,14,25026,14,3024,1,8,0,8,36
211.783,17,4,240,2,32,211782,32,120,2,32,211782,32,120
105.266,6,24,11120,13,526,49,1360,2658,11,1602,10514,4432,8462
1702.638,6,227,29528,119,304,14429,304,19740,108,83,15912,83,9788
229.824,6,16,1144,9,34,28712,38,638,7,35,38282,40,506
20.02,17,22,8267,10,437,2221,1350,4655,12,273,1817,1350,3612
0.044,17,4,284,2,32,40,32,120,2,54,38,60,164
1786.66,6,104,8444,68,66,26666,66,4964,36,60,51044,60,3480
1772.649,6,180,15480,120,69,14896,69,8940,60,69,30036,69,6540
7.989,6,27,11674,9,138,998,267,923,18,771,463,1997,10751
13.204,6,72,22215,35,551,388,1152,16850,37,431,359,1179,5365
1.031,6,10,1687,7,100,171,100,384,3,1179,380,1179,1303
1744.296,6,96,7255,62,38,28595,205,4424,34,33,52846,98,2831
0.033,6,10,1866,6,649,6,1142,1543,4,159,10,159,323
44.722,17,11,836,11,48,4472,48,836,0,0,0,0,0
1772.239,6,180,15480,120,69,14892,69,8940,60,69,30030,69,6540
299.513,6,6,364,4,31,99837,31,222,2,31,299504,31,142
15.631,6,32,5158,16,154,1042,722,1923,16,299,1030,1440,3235
170.154,17,4,352,2,60,170153,60,176,2,60,170153,60,176
11.875,6,20,3051,9,517,1484,517,1005,11,1418,1069,1418,2046
1443.892,2,15,480,15,8,103135,8,480,0,0,0,0,0
1783.838,6,356,22520,208,69,8617,69,12460,148,69,12134,69,10060
10.971,6,20,4442,11,275,1097,275,998,9,768,773,1440,3444
133.576,6,23,10009,12,531,53,1360,2637,11,1384,13345,3934,7372
4.217,6,20,2722,10,271,468,517,1602,10,197,460,409,1120
1756.063,6,103,6136,59,26,30276,26,3458,44,26,40837,26,2678
1.949,17,6,552,3,64,973,64,276,3,64,974,64,276
1743.457,6,95,7203,63,38,28120,205,4476,32,33,56233,98,2727
240.368,6,56,11007,29,220,8584,517,3069,27,435,9244,1498,7938
11.595,6,25,8473,13,275,966,275,1078,12,986,762,1440,7395
1796.791,1,345,28980,345,56,5223,56,28980,0,0,0,0,0
1483.373,17,39,14011,39,331,39036,382,14011,0,0,0,0,0
0.346,6,24,5980,12,164,31,453,1442,12,651,29,1448,4538
1775.742,17,142,11360,71,48,25367,48,5396,71,56,25367,56,5964
1779.274,17,140,11200,70,48,25786,48,5320,70,56,25786,56,5880
0.022,17,4,398,2,46,13,46,148,2,97,14,103,250
1775.654,6,269,32677,112,133,15995,1360,15690,157,137,11381,4662,16987
8.203,6,77,24637,39,561,215,1152,18976,38,413,214,1152,5661
1756.544,1,8,848,8,78,250934,78,848,0,0,0,0,0
62.639,6,27,7177,13,155,5219,267,1306,14,530,4817,3417,5871
0.5,17,3,451,2,39,141,39,134,1,289,0,289,317
1666.178,1,8,848,8,78,238025,78,848,0,0,0,0,0
0.007,17,3,543,2,39,0,39,134,1,381,0,381,409
0.1,17,2,2752,2,1348,100,1348,2752,0,0,0,0,0
135.815,6,3858,3369493,2318,1365,58,1368,3275499,1540,899,88,2736,93994
1788.594,1,225,12600,225,28,7984,28,12600,0,0,0,0,0
0.56,6,27,9167,13,282,46,769,1814,14,943,40,1368,7353
1775.36,1,60,5040,60,56,30090,56,5040,0,0,0,0,0
1764.518,1,63,5292,0,0,0,0,0,63,56,28459,56,5292
0.596,6,14,1745,7,288,70,288,600,7,426,67,434,1145
1.358,6,52,22491,29,975,48,1440,16795,23,433,53,1440,5696
2.798,6,14,2351,8,188,399,245,700,6,1407,507,1407,1651
53.761,17,6,528,3,48,26876,48,228,3,72,26875,72,300
1769.277,6,104,8136,67,45,26807,205,4985,37,35,49137,98,3151
0.037,6,13,4282,7,111,6,111,483,6,1159,7,1863,3799
1788.151,17,73,3060,72,14,25185,14,3024,1,8,0,8,36
46.255,17,8,704,4,48,15415,48,304,4,72,15415,72,400
1786.953,6,104,8308,68,64,26670,64,4896,36,58,51052,58,3412
12.687,6,29,8058,13,241,1057,721,1730,16,568,831,4260,6328
1787.539,1,90,5040,90,28,20084,28,5040,0,0,0,0,0
124.456,6,52,7388,25,166,2852,189,1651,27,258,4780,1360,5737
0.262,17,8,2750,8,315,37,354,2750,0,0,0,0,0
1797.482,6,364,23047,211,69,8559,69,12787,153,69,11825,69,10260
96.718,6,25,6391,9,272,157,517,1181,16,351,6441,1452,5210
1772.059,6,180,15480,120,69,14891,69,8940,60,69,30033,69,6540
701.962,6,46,3569,24,66,25818,66,1752,22,49,33418,60,1817
280.538,6,30,7432,13,158,23378,267,1317,17,603,17526,2760,6115
1798.905,17,449,39928,404,35,4463,288,25708,45,288,40019,288,14220
1520.067,17,150,22350,150,121,10201,121,22350,0,0,0,0,0
102.085,6,21,8417,11,468,92,1067,1878,10,1021,11323,1591,6539
0.25,17,2,154,1,33,0,33,61,1,65,0,65,93
1.432,6,49,19675,27,921,55,1440,14019,22,433,59,1440,5656
1.477,6,48,19090,28,946,54,1460,13469,20,437,67,2615,5621
280.898,6,29,7392,13,158,23408,267,1317,16,678,18721,2760,6075
300.771,6,49,13210,25,884,12532,1460,7293,24,290,663,1460,5917
1798.951,17,447,39580,403,35,4475,288,25676,44,288,40949,288,13904
300.378,6,49,27708,29,415,10727,1066,3225,20,1562,1596,5632,24483
0.136,17,4,624,2,64,120,64,184,2,192,117,192,440
92.758,6,10,648,5,92,23189,92,360,5,0,11213,0,288
1785.73,6,356,22520,208,69,8626,69,12460,148,69,12147,69,10060
0.424,6,26,9017,13,261,35,683,1728,13,943,33,1438,7289
1784.561,1,58,4872,58,56,31308,56,4872,0,0,0,0,0
1782.663,6,374,23861,214,69,8369,69,12976,160,69,11211,69,10885
134.555,17,10,880,5,48,33636,48,380,5,72,33636,72,500
1764.366,2,14,448,14,8,135720,8,448,0,0,0,0,0
1783.236,6,106,8456,68,65,26615,65,4930,38,59,48191,59,3526
1.352,6,30,6427,15,164,96,267,1922,15,780,85,1460,4505
0.549,6,50,22391,28,1073,20,1380,17257,22,421,24,1923,5134
174.272,17,4,240,2,32,174270,32,120,2,32,174271,32,120
0.068,6,11,913,6,182,13,182,490,5,77,8,134,423
186.936,17,4,352,2,60,186935,60,176,2,60,186934,60,176
220.322,6,29,7392,13,158,18360,267,1317,16,603,14686,2036,6075
0.37,6,48,20484,26,1020,14,1380,15362,22,421,15,1923,5122
0.843,6,10,1687,7,100,140,100,384,3,1179,300,1179,1303
20.683,17,40,10392,19,294,1147,1350,6133,21,174,1032,1350,4259
593.218,1,6,336,6,28,118643,28,336,0,0,0,0,0
240.572,6,430,383231,156,460,1552,1418,11815,274,1368,881,3198,371416
5.459,2,2,64,2,8,5459,8,64,0,0,0,0,0
2.771,6,26,8147,12,330,248,517,1966,14,777,209,1418,6181
0.152,6,7,423,4,43,39,43,259,3,0,20,0,164
52.327,6,19,5304,10,263,5814,722,1571,9,815,6510,1448,3733
0.075,6,9,1106,5,405,18,405,609,4,333,21,333,497
0.09,17,3,180,3,32,45,32,180,0,0,0,0,0
595.855,1,6,489,6,53,119171,78,489,0,0,0,0,0
63.098,6,14,5625,4,106,21029,106,274,10,706,7009,1460,5351
28.469,6,29,3400,16,145,1897,145,950,13,634,2183,634,2450
503.97,2,3,96,3,8,251985,8,96,0,0,0,0,0
0.017,1,2,722,2,333,17,333,722,0,0,0,0,0
695.332,6,103,15154,40,114,17829,659,4496,63,188,11212,1638,10658
240.32,6,44,8447,23,449,10923,1402,5700,21,205,12015,580,2747
0.021,17,2,570,1,30,0,30,58,1,484,0,484,512
225.446,17,4,558,2,36,225393,36,128,2,187,225432,187,430
0.474,6,22,7345,14,334,36,663,2085,8,967,62,1946,5260
300.866,6,43,13746,25,891,12536,1360,8179,18,402,507,2667,5567
0.0,17,1,383,1,355,0,355,383,0,0,0,0,0
1.081,6,30,12084,17,529,67,1360,3370,13,1022,74,3921,8714
240.221,6,63,21089,30,854,8283,1418,17812,33,194,7506,580,3277
1796.436,17,448,39896,403,35,4468,288,25676,45,288,40024,288,14220
0.227,6,108,207153,79,183,2,230,4665,29,7443,5,21120,202488
1796.932,17,448,39896,403,35,4469,288,25676,45,288,40020,288,14220
300.714,6,41,8664,22,266,14319,720,2026,19,419,540,4848,6638
9.281,1,9,756,0,0,0,0,0,9,56,1160,56,756
1018.087,1,70,3920,70,28,14754,28,3920,0,0,0,0,0
0.948,6,29,8524,15,222,57,540,1988,14,852,59,1360,6536
1793.135,1,140,7840,140,28,12900,28,7840,0,0,0,0,0
0.26,17,2,172,1,50,0,50,78,1,66,0,66,94
38.435,17,44,6468,22,48,1829,48,1672,22,190,1829,308,4796
1793.507,17,175,11200,175,36,10307,36,11200,0,0,0,0,0
3.807,17,4,292,2,37,3775,37,130,2,53,3775,53,162
12.026,17,10,810,5,45,3004,45,365,5,61,2991,61,445
33.767,6,32,5144,16,154,2251,722,1910,16,342,2237,1448,3234
343.917,6,63,43144,41,1183,8597,1408,35267,22,960,2926,3847,7877
1.265,6,25,8056,12,164,98,267,1288,13,869,89,1408,6768
244.364,6,51,9893,22,250,11636,654,3442,29,379,8726,1418,6451
0.056,6,2,80,1,0,0,0,40,1,0,0,0,40
255.291,6,44,13731,27,387,9818,1360,6573,17,587,15945,1360,7158
241.939,6,50,10308,24,523,10518,1408,6002,26,226,9677,618,4306
0.481,6,10,968,5,256,116,256,460,5,304,115,304,508
1745.743,6,95,7203,63,38,28157,205,4476,32,33,56300,98,2727
0.017,17,2,336,1,32,0,32,60,1,248,0,248,276
126.344,6,21,8544,11,556,102,1329,2140,10,998,14015,1791,6404
0.022,6,3,132,1,0,0,0,40,2,0,15,0,92
3.141,17,4,660,2,33,1010,33,122,2,241,0,249,538
1740.003,17,26,1482,26,29,69600,29,1482,0,0,0,0,0
1799.338,17,449,39928,404,35,4464,288,25708,45,288,40017,288,14220
1732.719,1,203,11368,203,28,8577,28,11368,0,0,0,0,0
1681.352,17,16,4257,8,30,240183,37,471,8,445,240192,463,3786
10.086,6,15,3586,9,142,1260,142,506,6,945,1973,1380,3080
165.298,6,17,700,6,0,2450,0,244,11,0,16528,0,456
1787.893,6,373,25959,215,98,8354,469,15223,158,69,11387,69,10736
1764.781,2,12,384,12,8,160434,8,384,0,0,0,0,0
1786.702,6,154,25004,92,483,19633,483,19282,62,83,29289,83,5722
270.89,17,4,352,2,60,270889,60,176,2,60,270889,60,176
289.924,1,9,1115,9,95,36240,165,1115,0,0,0,0,0
504.127,2,4,128,4,8,168042,8,128,0,0,0,0,0
0.016,17,4,680,2,33,0,33,122,2,251,1,323,558
1681.464,17,18,1413,9,30,210178,37,529,9,70,210180,136,884
3.42,6,13,2311,8,188,488,245,700,5,1407,791,1407,1611
0.563,6,24,7321,12,257,51,748,1663,12,837,45,1418,5658
27.168,17,16,1408,8,48,3879,48,608,8,72,3879,72,800
130.367,6,10,427,5,0,32591,0,208,5,7,32489,7,219
1779.579,6,356,22520,208,69,8597,69,12391,148,69,11981,69,10129
0.246,6,24,4571,12,165,22,456,1446,12,415,21,888,3125
2.886,17,4,232,4,30,962,30,232,0,0,0,0,0
1772.329,6,103,9596,68,65,26452,65,5758,35,59,52120,59,3838
1.023,6,37,8391,19,281,56,780,1918,18,441,52,1460,6473
0.126,17,2,152,1,48,0,48,76,1,48,0,48,76
0.345,6,27,8920,13,227,28,547,1592,14,941,23,1438,7328
0.064,17,2,465,1,48,0,48,76,1,361,0,361,389
280.26,6,27,7312,13,158,23355,267,1317,14,775,21555,2800,5995
3.899,17,4,352,2,48,3891,48,152,2,72,3889,72,200
0.019,17,2,204,1,51,0,51,79,1,97,0,97,125
0.056,17,2,327,1,49,0,49,77,1,222,0,222,250
1763.319,2,15,480,15,8,125951,8,480,0,0,0,0,0
0.1,17,4,284,2,32,89,32,120,2,54,88,60,164
1792.384,17,140,11200,70,48,25976,48,5320,70,56,25976,56,5880
300.619,6,38,8316,20,241,15822,619,1842,18,441,498,1360,6474
1779.353,17,140,11200,70,48,25787,48,5320,70,56,25787,56,5880
280.461,6,31,7472,14,158,21573,267,1357,17,603,17525,2076,6115
1783.212,17,83,3480,82,14,22014,14,3444,1,8,0,8,36
240.959,17,4,1352,4,310,80319,318,1352,0,0,0,0,0
280.251,6,30,7432,13,158,23354,267,1317,17,543,17513,1300,6115
56.856,6,18,5071,11,290,5685,517,1173,7,881,9475,1473,3898
1787.107,6,103,8464,68,66,26673,66,4964,35,60,52559,60,3500
0.889,6,3,127,1,0,0,0,40,2,7,0,7,87
1799.902,17,5924,284352,2962,20,607,20,142176,2962,20,607,20,142176
0.343,17,8,2766,8,317,49,356,2766,0,0,0,0,0
0.02,17,4,352,2,37,0,37,130,2,83,11,89,222
0.015,17,2,455,1,36,0,36,64,1,363,0,363,391
0.012,17,3,394,2,32,2,32,120,1,246,0,246,274
1773.182,6,180,15480,120,69,14900,69,8940,60,69,30051,69,6540
0.58,17,2,184,1,32,0,32,60,1,96,0,96,124
3.561,6,20,2545,11,304,356,304,1808,9,83,423,83,737
928.404,6,47,3393,31,31,30946,31,2065,16,31,61880,31,1328
0.009,17,2,245,1,32,0,32,60,1,157,0,157,185
378.93,2,4,128,4,8,126310,8,128,0,0,0,0,0
0.314,17,2,362,1,46,0,46,74,1,260,0,260,288
0.106,6,10,1327,5,299,22,299,567,5,246,22,459,760
1.425,6,24,8004,12,164,111,267,1288,12,1014,110,2491,6716
1.317,6,50,19703,27,919,50,1360,14007,23,476,51,2720,5696
1773.35,6,182,15629,120,69,14902,69,8940,62,69,29065,69,6689
1771.85,6,106,9880,68,66,26445,66,5792,38,60,47885,60,4088
60.5,6,5,328,4,112,20166,112,280,1,0,0,0,48
0.067,6,4,208,0,0,0,0,0,4,0,0,0,208
8.663,6,66,20142,33,562,270,1152,15395,33,489,261,1179,4747
107.9,6,1019,517405,568,848,190,1152,494233,451,427,239,1179,23172
1701.972,1,8,448,8,28,243138,28,448,0,0,0,0,0
93.68,6,25,6318,9,272,93,516,1180,16,345,6239,1452,5138
0.109,6,3,144,0,0,0,0,0,3,0,0,0,144
300.577,6,17,1175,6,177,60079,177,497,11,110,30039,110,678
1797.696,17,450,39960,405,35,4449,288,25740,45,288,40023,288,14220
27.121,17,3,228,3,48,13560,48,228,0,0,0,0,0
0.126,6,44,31072,22,218,6,299,2075,22,1392,4,2650,28997
315.912,6,118,21962,55,257,5850,1360,10863,63,208,5093,3289,11099
4.548,6,40,10272,16,502,303,1440,4228,24,361,175,1440,6044
5.402,6,16,6585,4,275,1742,275,439,12,566,475,1440,6146
0.888,6,52,13869,24,551,38,1429,4840,28,438,32,1460,9029
8.189,6,41,8504,18,175,481,721,2127,23,544,349,1440,6377
50.505,6,45,8839,22,338,720,668,2011,23,368,2290,3488,6828
1776.646,17,140,11200,70,48,25748,48,5320,70,56,25748,56,5880
6.956,6,37,9931,20,254,359,625,3138,17,871,422,2720,6793
10.805,6,2,87,1,0,0,0,40,1,7,0,7,47
1.058,1,10,840,10,56,117,56,840,0,0,0,0,0
36.379,17,4,1356,4,311,12126,320,1356,0,0,0,0,0
2.836,6,2,80,1,0,0,0,40,1,0,0,0,40
0.53,6,20,7229,13,334,44,663,2021,7,1209,83,1946,5208
4.111,17,10,900,5,30,1016,30,290,5,94,1019,94,610
44.553,17,6,525,3,32,22271,37,181,3,86,22099,136,344
1.418,6,50,19851,28,869,52,1360,14195,22,433,58,1360,5656
0.415,1,10,280,10,0,0,0,280,0,0,0,0,0
1777.464,1,211,11816,211,28,8464,28,11816,0,0,0,0,0
0.299,17,2,144,1,36,0,36,64,1,52,0,52,80
0.549,17,3,451,2,39,13,39,134,1,289,0,289,317
8.881,6,82,24901,41,546,222,1152,19120,41,459,215,1179,5781
1786.718,6,106,8524,68,66,26667,66,4964,38,60,48287,60,3560
16.482,17,28,22464,14,821,1264,1350,11890,14,727,1261,1350,10574
1784.628,6,102,8296,68,65,26636,65,4930,34,59,54076,59,3366
1.884,6,15,3632,8,150,269,174,624,7,681,238,1452,3008
96.857,6,11,599,3,0,48428,0,152,8,7,13807,7,447
1794.424,17,144,11520,72,48,25273,48,5472,72,56,25273,56,6048
1796.892,17,448,39896,403,35,4469,288,25676,45,288,40022,288,14220
5.019,17,4,720,2,41,5010,41,138,2,263,5009,279,582
332.884,1,3,180,3,32,166442,32,180,0,0,0,0,0
1.232,17,4,567,2,31,1219,31,118,2,196,1217,229,449
240.332,6,53,18036,27,804,9243,1418,15095,26,197,9612,580,2941
0.016,17,2,251,1,31,0,31,59,1,164,0,164,192
3.723,17,5,514,4,32,1235,32,240,1,246,0,246,274
1.226,6,14,5975,4,186,406,267,541,10,718,135,1420,5434
0.057,6,6,386,2,31,0,31,135,4,31,2,31,251
0.016,17,2,459,1,40,0,40,68,1,363,0,363,391
19.738,17,4,1344,4,308,6579,308,1344,0,0,0,0,0
0.017,17,2,510,1,37,0,37,65,1,417,0,417,445
11.656,6,1851,1604976,1124,1372,10,1420,1571675,727,467,16,1883,33301
18.348,6,12,1514,4,226,6116,226,430,8,110,2590,110,1084
23.16,17,3,228,3,48,11580,48,228,0,0,0,0,0
14.303,6,43,8349,20,227,752,314,3982,23,429,638,1152,4367
7.494,6,68,20206,34,561,227,1152,15403,34,491,219,1179,4803
1681.169,17,14,3815,7,30,280194,30,406,7,459,280194,463,3409
1.459,6,47,18985,26,945,58,1460,13369,21,476,63,2615,5616
3.228,17,4,624,4,128,1076,128,624,0,0,0,0,0
6.54,6,15,5681,5,106,1631,106,322,10,823,725,1452,5359
5.052,6,35,6209,19,206,280,314,2824,16,548,319,1179,3385
0.006,17,2,362,1,32,0,32,60,1,274,0,274,302
118.486,17,4,240,2,32,118484,32,120,2,32,118484,32,120
9.436,6,94,30273,46,594,209,1152,23855,48,449,195,1179,6418
1.128,6,12,1163,6,222,222,222,688,6,231,222,231,475
27.419,2,2,64,2,8,27419,8,64,0,0,0,0,0
11.334,6,13,2133,8,324,1619,585,1073,5,396,2790,580,1060
0.106,17,4,368,2,32,105,32,120,2,96,20,96,248
1787.911,6,367,23236,212,69,8473,69,12896,155,69,11609,69,10340
0.026,17,2,132,1,30,0,30,58,1,46,0,46,74
0.087,17,2,362,1,46,0,46,74,1,260,0,260,288
24.399,17,11,836,11,48,2439,48,836,0,0,0,0,0
116.67,6,48,7480,30,304,4023,304,5520,18,83,6856,83,1960
0.024,6,12,977,7,182,4,182,554,5,77,5,134,423
1756.029,6,107,6344,60,26,29762,26,3510,47,26,38173,26,2834
1742.351,6,97,7307,63,38,28102,205,4476,34,33,52786,98,2831
3.34,17,3,1059,3,325,1670,329,1059,0,0,0,0,0
1.638,6,53,19220,29,873,58,1360,13439,24,400,62,1360,5781
4.768,6,16,3263,8,49,681,92,511,8,388,650,1408,2752
1740.505,17,30,31680,30,1028,60017,1028,31680,0,0,0,0,0
60.412,6,39,7887,23,135,2746,174,1602,16,512,3518,1452,6285
36.905,17,22,1672,22,48,1757,48,1672,0,0,0,0,0
579.04,17,115,8740,115,48,5079,48,8740,0,0,0,0,0
64.85,6,18,1813,8,177,149,177,955,10,110,7187,110,858
315.856,6,81,14331,35,166,9289,1091,4184,46,243,6900,4649,10147
96.157,6,16,2478,6,483,19231,483,1286,10,83,10683,83,1192
279.561,6,31,11476,15,731,6752,1351,3571,16,725,18626,1631,7905
2.045,17,4,360,2,30,2018,30,116,2,94,2017,94,244
286.438,6,30,8137,13,158,23869,267,1317,17,681,17900,2085,6820
1796.506,17,452,40136,405,35,4446,288,25780,47,277,38286,288,14356
1796.414,17,449,39928,404,35,4457,288,25708,45,288,40020,288,14220
180.023,17,8,488,8,33,25717,33,488,0,0,0,0,0
1.223,6,50,19543,29,904,43,1360,13882,21,437,53,2715,5661
1677.908,17,17,5811,17,313,104869,954,5811,0,0,0,0,0
0.687,17,4,360,2,30,679,30,116,2,94,675,94,244
1.553,6,10,931,5,304,388,304,572,5,83,359,83,359
315.625,17,12,4032,12,308,28693,308,4032,0,0,0,0,0
1.385,6,14,4945,7,125,227,125,497,7,1019,230,1448,4448
5.458,6,40,7309,20,218,287,314,3423,20,513,273,1179,3886
99.331,17,4,240,2,32,99330,32,120,2,32,99329,32,120
0.079,6,27,13460,14,138,6,138,874,13,1190,1,1448,12586
385.095,6,18,1242,14,180,29622,180,916,4,110,20078,110,326
21.445,17,12,2472,6,48,4287,48,456,6,308,4286,308,2016
0.228,6,12,2133,6,503,45,503,1326,6,475,45,475,807
252.198,2,3,96,3,8,126099,8,96,0,0,0,0,0
0.022,17,2,218,1,65,0,65,93,1,97,0,97,125
30.059,6,29,7257,14,155,2312,267,1346,15,482,2146,2840,5911
0.023,17,2,184,1,32,0,32,60,1,96,0,96,124
0.868,6,25,9058,14,275,66,743,1706,11,1150,70,2570,7352
1.591,6,41,11964,22,612,75,1360,6428,19,476,76,2715,5536
161.295,6,160,114676,93,1271,1753,1368,102778,67,738,1121,2519,11898
0.004,17,2,558,1,32,0,32,60,1,470,0,470,498
47.039,6,23,3779,7,558,47,1098,2046,16,89,3134,437,1733
2.179,6,20,3833,11,234,217,564,1504,9,463,248,1343,2329
1769.832,6,99,9306,66,66,27228,66,5610,33,60,55302,60,3696
7.456,6,14,1557,8,145,1065,145,473,6,832,921,832,1084
2.663,17,4,624,4,128,887,128,624,0,0,0,0,0
1791.86,6,738,49923,369,31,4869,31,25047,369,31,4869,31,24876
0.717,17,4,1344,4,308,239,308,1344,0,0,0,0,0
1796.642,17,447,39296,404,35,4458,288,25708,43,288,40979,288,13588
0.576,6,20,7168,13,319,48,602,1960,7,1209,89,1946,5208
7.62,6,4,520,0,0,0,0,0,4,90,2540,90,520
73.646,6,39,8585,19,401,526,889,2032,20,478,3869,2128,6553
1785.942,17,136,10880,68,48,26655,48,5168,68,56,26655,56,5712
10.585,6,16,1406,9,275,1323,275,922,7,96,1034,96,484
3.975,6,671,556855,394,1376,10,1420,541542,277,467,14,1883,15313
1744.598,2,27,864,27,8,67099,8,864,0,0,0,0,0
82.022,6,722,338431,378,836,217,1152,318825,344,417,238,1179,19606
8.854,17,4,1824,2,308,8854,308,672,2,548,80,548,1152
1772.98,6,181,15589,120,69,14898,69,8940,61,69,29544,69,6649
485.697,6,130,16244,64,148,7709,1189,5837,66,228,7469,1420,10407
280.437,6,28,7352,12,158,25494,267,1277,16,678,18691,2085,6075
1798.237,1,345,28980,345,56,5227,56,28980,0,0,0,0,0
1.39,6,45,19336,27,909,53,1360,13840,18,529,71,4075,5496
1788.233,1,262,14672,262,28,6851,28,14672,0,0,0,0,0
41.826,17,24,2112,12,48,3801,48,912,12,72,3801,72,1200
0.106,17,2,702,2,323,106,329,702,0,0,0,0,0
44.938,17,4,352,2,60,44937,60,176,2,60,44937,60,176
42.133,6,42,8681,19,401,1564,889,2008,23,521,1909,2720,6673
8.987,6,33,8281,18,391,528,860,1927,15,574,626,4848,6354
37.902,6,5044,4850673,3361,1366,11,1408,4758493,1683,776,22,1408,92180
0.127,6,16,6172,8,103,18,103,527,8,1044,18,1448,5645
93.246,6,69,48094,45,1180,2119,1408,40112,24,960,2678,3847,7982
0.222,6,9,1002,5,213,55,213,417,4,421,60,421,585
1791.315,1,270,15120,270,28,6659,28,15120,0,0,0,0,0
0.875,6,10,1687,7,100,145,100,384,3,1179,312,1179,1303
0.027,17,2,192,1,37,0,37,65,1,99,0,99,127
1758.662,17,47,1974,47,14,38231,14,1974,0,0,0,0,0
0.186,6,27,7296,13,155,15,267,1301,14,603,13,2036,5995
198.469,17,9,3024,9,308,24808,308,3024,0,0,0,0,0
149.558,6,1235,608222,672,837,222,1152,579515,563,412,265,1179,28707
1796.008,6,380,26515,219,97,8238,469,15590,161,69,11224,69,10925
3.46,17,10,2459,5,40,862,40,340,5,395,862,407,2119
0.01,17,2,527,1,35,0,35,63,1,436,0,436,464
2.452,6,28,8910,16,289,163,600,1512,12,987,205,1420,7398
240.183,6,57,18846,31,750,8005,1402,15872,26,201,9607,580,2974
0.201,6,46,20495,26,1029,8,1420,15474,20,467,10,1883,5021
1786.844,6,366,23196,211,69,8508,69,12787,155,69,11602,69,10409
62.61,6,8,360,4,0,20870,0,168,4,0,2375,0,192
90.18,17,4,308,2,33,90131,33,122,2,65,90141,65,186
1757.09,6,170,10236,86,43,20671,208,5915,84,31,21166,31,4321
0.036,6,10,1512,5,503,9,503,771,5,473,9,473,741
176.268,6,31,14313,15,1006,73,1460,6681,16,775,11739,1460,7632
0.704,6,14,3952,8,124,100,124,572,6,1530,140,1612,3380
33.83,6,30,5043,15,154,2416,721,1859,15,400,2401,1368,3184
1785.489,6,358,22738,208,69,8625,69,12529,150,69,11982,69,10209
58.649,1,4,224,4,28,19549,28,224,0,0,0,0,0
1.34,6,50,19387,27,898,51,1360,13691,23,433,52,1360,5696
0.914,2,2,80,2,16,914,16,80,0,0,0,0,0
0.697,17,22,12149,12,557,63,1350,7020,10,484,73,1350,5129
315.972,6,108,21834,56,259,5744,1360,11175,52,244,6192,4649,10659
1012.437,6,90,15771,50,133,20661,549,5172,40,530,24668,2414,10599
2.922,6,20,3833,11,234,292,564,1504,9,463,340,1343,2329
1763.546,1,75,6300,0,0,0,0,0,75,56,23831,56,6300
0.083,6,2,143,1,63,0,63,103,1,0,0,0,40
1799.747,6,273,33431,110,141,16510,1360,16160,163,132,11108,2720,17271
1788.964,17,87,3648,86,14,21046,14,3612,1,8,0,8,36
280.202,6,25,7094,11,181,28020,267,1168,14,595,21552,1400,5926
0.486,17,3,451,2,39,174,39,134,1,289,0,289,317
55.205,6,7,368,4,0,18387,0,216,3,0,27585,0,152
54.229,6,46,8977,23,378,667,787,2210,23,389,2234,2128,6767
181.85,1,16,896,16,28,12123,28,896,0,0,0,0,0
1787.905,6,356,22920,208,75,8637,469,12860,148,69,12162,69,10060
7.014,6,42,7389,22,218,334,314,3503,20,513,353,1179,3886
11.023,6,20,4442,11,275,1102,275,998,9,768,798,1440,3444
1754.178,6,204,14185,102,69,17368,208,9175,102,31,17365,31,5010
240.533,6,46,12725,22,587,11453,1402,5849,24,624,10457,2427,6876
0.049,6,10,766,6,185,9,185,505,4,45,15,45,261
1799.42,1,15,840,15,28,128530,28,840,0,0,0,0,0
240.485,6,59,24545,27,534,9248,1418,6225,32,876,7757,1418,18320
1789.871,17,362,60567,178,219,10112,1350,44143,184,61,9779,1350,16424
68.732,6,5,231,3,0,34365,0,120,2,31,2002,31,111
62.078,6,27,7177,13,155,5173,267,1306,14,530,4774,3417,5871
1789.73,17,140,11200,70,48,25937,48,5320,70,56,25937,56,5880
617.953,6,145,37338,68,438,9223,1360,23849,77,199,8129,3289,13489
1796.96,17,438,38440,395,34,4560,288,24852,43,288,41927,288,13588
0.022,17,2,358,1,30,0,30,58,1,272,0,272,300
0.096,17,2,212,1,46,0,46,74,1,110,0,110,138
0.293,17,2,157,1,31,0,31,59,1,70,0,70,98
1783.173,6,202,14026,73,46,24765,46,5876,129,46,13930,46,8150
7.959,6,18,6767,9,275,994,275,643,9,1150,699,1414,6124
52.188,6,2612,2448428,1737,1332,29,1368,2394128,875,776,59,2736,54300
0.065,6,2,100,1,0,0,0,60,1,0,0,0,40
0.17,17,2,2756,2,1350,170,1350,2756,0,0,0,0,0
296.879,1,4,224,4,28,98959,28,224,0,0,0,0,0
240.649,6,64,19112,35,794,7077,1418,15362,29,203,8594,594,3750
1792.962,6,356,22520,208,69,8661,69,12460,148,69,12195,69,10060
31.51,6,9,392,8,0,4501,0,348,1,0,0,0,44
2.655,17,4,1564,4,363,885,363,1564,0,0,0,0,0
135.152,6,36,10869,16,204,3714,513,1869,20,455,7108,1452,9000
1771.274,6,99,9306,66,66,27250,66,5610,33,60,55349,60,3696
1702.797,1,8,448,8,28,243256,28,448,0,0,0,0,0
0.16,6,46,21620,27,1035,6,1414,16639,19,467,8,1889,4981
316.941,6,114,36218,58,512,5560,1360,24903,56,302,5760,1929,11315
105.099,6,33,14450,16,488,320,1440,3127,17,966,6560,1440,11323
0.878,17,4,927,2,33,866,33,122,2,374,867,404,805
0.638,6,28,9001,13,227,53,547,1592,15,827,44,1408,7409
0.254,6,3,206,1,0,0,0,40,2,31,0,31,166
371.099,6,25,1639,16,177,24739,177,1053,9,110,8801,110,586
276.707,17,19,21670,19,1112,15372,1451,21670,0,0,0,0,0
45.272,17,12,912,12,48,4115,48,912,0,0,0,0,0
1.255,6,50,21255,29,902,44,1360,15639,21,433,53,1360,5616
1785.034,6,100,7702,66,40,27462,205,4730,34,35,54080,108,2972
66.855,6,42,25867,19,840,38,1460,5847,23,1193,3033,1460,20020
0.388,17,2,152,1,48,0,48,76,1,48,0,48,76
1787.798,6,102,8228,68,64,26683,64,4896,34,58,54173,58,3332
0.012,6,10,1634,5,131,3,131,399,5,967,3,967,1235
1781.563,6,322,27740,184,75,9735,267,12493,138,129,13003,1933,15247
30.442,6,24,4782,14,227,2341,517,2111,10,428,3381,499,2671
315.782,6,87,19651,47,295,6864,1360,10254,40,338,8008,3289,9397
1.333,6,37,8214,19,321,74,1164,2718,18,476,68,2720,5496
362.064,6,19,1306,14,180,27851,180,928,5,110,15258,110,378
1764.908,2,15,480,15,8,126064,8,480,0,0,0,0,0
5.576,6,42,7389,23,201,253,314,3543,19,513,295,1179,3846
280.029,6,29,7392,13,158,23335,267,1317,16,603,18666,2036,6075
19.301,6,3348,3161844,2175,1375,8,1408,3096184,1173,931,16,2816,65660
2.518,17,28,12762,13,662,209,1350,8978,15,224,117,1350,3784
1.182,6,24,8004,12,164,91,267,1288,12,1014,91,2816,6716
1.424,6,49,19224,27,889,54,1360,13568,22,433,58,1360,5656
1680.001,1,15,840,15,28,120000,28,840,0,0,0,0,0
77.232,6,58,21070,31,1062,314,1360,11993,27,469,2962,2667,9077
0.244,17,2,154,1,33,0,33,61,1,65,0,65,93
1787.048,6,108,8604,68,66,26672,66,4964,40,60,45818,60,3640
616.078,6,106,16580,42,122,15026,658,4580,64,196,9776,1929,12000
1778.099,17,140,11200,70,48,25769,48,5320,70,56,25769,56,5880
15.671,17,17,6610,8,483,2219,1350,4094,9,251,1949,1350,2516
0.276,17,3,451,2,39,177,39,134,1,289,0,289,317
181.892,6,22,9220,11,429,66,952,1759,11,1001,18175,1440,7461
1.466,6,23,6100,12,273,132,517,1724,11,759,145,1408,4376
4.0,17,4,240,4,32,1333,32,240,0,0,0,0,0
0.09,17,4,1375,4,315,30,354,1375,0,0,0,0,0
1740.338,6,87,6322,58,31,30532,31,3915,29,31,62153,31,2407
1763.717,2,14,448,14,8,135670,8,448,0,0,0,0,0
215.747,17,4,352,2,60,215746,60,176,2,60,215746,60,176
9.939,6,82,25050,43,568,236,1152,19349,39,459,254,1179,5701
0.041,6,6,716,3,302,12,302,458,3,102,12,102,258
0.908,6,10,1687,7,100,151,100,384,3,1179,324,1179,1303
0.013,17,2,548,2,246,13,246,548,0,0,0,0,0
10.689,6,18,4266,10,275,1187,275,958,8,992,806,1440,3308
1776.945,6,147,11201,83,81,21670,208,7618,64,31,27549,31,3583
5.824,6,509,459299,325,1350,17,1368,445055,184,776,30,2736,14244
702.682,1,4,224,4,28,234227,28,224,0,0,0,0,0
301.082,6,24,9287,13,382,25086,1193,2082,11,1125,30086,2279,7205
1.698,6,25,8761,15,284,121,586,1458,10,985,168,1420,7303
3.454,6,31,8912,14,158,265,267,1357,17,687,211,2036,7555
1772.851,6,180,15480,120,69,14897,69,8940,60,69,30042,69,6540
107.633,6,23,6177,9,272,105,516,1180,14,403,8271,1452,4997
1741.266,17,30,20190,30,645,60043,645,20190,0,0,0,0,0
8.624,17,4,352,2,60,8623,60,176,2,60,8622,60,176
16.32,6,14,5639,4,112,5436,112,280,10,823,1812,2840,5359
8.26,6,1668,1530911,1053,1376,7,1408,1494267,615,931,13,2816,36644
3.605,17,31,17386,17,833,223,1350,14651,14,167,274,1350,2735
0.158,6,6,716,3,302,41,302,458,3,102,41,102,258
298.018,6,6,364,4,31,99339,31,222,2,31,298006,31,142
280.234,6,30,7432,13,158,23352,267,1317,17,543,17513,1300,6115
0.276,6,80,62713,35,245,8,299,3349,45,1325,4,1440,59364
1797.836,17,87,3648,86,14,21151,14,3612,1,8,0,8,36
70.199,6,30,7432,13,158,5849,267,1317,17,543,4385,1400,6115
0.879,6,10,1687,7,100,146,100,384,3,1179,306,1179,1303
300.26,6,33,11958,18,588,17662,1438,4500,15,833,17178,1488,7458
1.346,17,15,7180,7,604,223,1350,4430,8,315,187,1350,2750
646.867,1,10,560,10,28,71874,28,560,0,0,0,0,0
1745.595,6,94,7151,62,38,28616,205,4424,32,33,56301,98,2727
29.798,6,27,2367,14,329,2291,595,1427,13,212,2482,212,940
1700.62,17,13,534,11,14,170044,14,462,2,8,1700447,8,72
1793.142,17,180,11520,180,36,10017,36,11520,0,0,0,0,0
0.437,6,5,284,1,0,0,0,52,4,0,145,0,232
1793.819,17,140,11200,70,48,25997,48,5320,70,56,25997,56,5880
1.71,6,36,11977,19,633,95,1360,4619,17,606,95,1360,7358
37.505,6,25,7097,12,155,3409,267,1266,13,589,3124,3426,5831
126.78,2,2,64,2,8,126780,8,64,0,0,0,0,0
1791.61,6,374,23585,213,69,8450,69,13005,161,65,11197,69,10580
50.483,6,45,10209,22,533,746,910,3083,23,364,2288,2128,7126
5.917,6,40,7309,21,218,295,314,3463,19,513,313,1179,3846
894.525,17,273,30767,130,134,6934,1350,21128,143,39,6299,1350,9639
63.409,6,8,376,2,0,63409,0,88,6,0,6305,0,288
1.72,6,48,20113,28,891,63,1360,14525,20,476,79,2715,5588
0.321,17,2,290,1,40,0,40,68,1,194,0,194,222
280.193,6,29,7392,13,158,23349,267,1317,16,603,18677,2236,6075
1.132,17,2,257,1,48,0,48,76,1,153,0,153,181
300.876,6,52,10618,26,433,12035,910,3310,26,312,623,1460,7308
36.671,17,44,6468,22,48,1742,48,1672,22,190,1745,308,4796
1790.578,17,44,14784,44,308,41641,308,14784,0,0,0,0,0
60.385,6,22,4140,11,150,6038,174,744,11,368,4763,1452,3396
17.236,17,33,15629,16,699,1147,1350,11644,17,206,1075,1350,3985
287.746,17,4,352,2,60,287745,60,176,2,60,287745,60,176
300.683,6,40,8617,21,283,15034,787,2041,19,414,471,2720,6576
0.031,17,4,284,2,32,0,32,120,2,54,4,60,164
3.862,6,284,266228,181,233,21,256,12182,103,2486,37,8448,254046
0.012,17,2,367,1,39,0,39,67,1,272,0,272,300
0.053,17,4,664,2,36,29,36,128,2,240,29,262,536
1.807,6,9,527,5,43,451,43,311,4,0,600,0,216
1564.176,2,15,480,15,8,111726,8,480,0,0,0,0,0
0.31,17,2,180,1,30,0,30,58,1,94,0,94,122
0.17,17,2,154,1,33,0,33,61,1,65,0,65,93
280.261,6,29,7392,13,158,23355,267,1317,16,603,18679,1400,6075
280.424,6,30,7432,13,158,23368,267,1317,17,543,17525,1400,6115
1794.439,1,288,16128,288,28,6252,28,16128,0,0,0,0,0
1767.231,17,346,79660,346,202,5122,371,79660,0,0,0,0,0
1781.759,6,377,26395,215,98,8325,469,15292,162,69,11066,69,11103
0.264,17,2,178,1,29,0,29,57,1,93,0,93,121
1.61,6,25,8056,12,164,124,267,1288,13,869,109,1448,6768
1.284,6,48,19220,27,892,49,1360,13604,21,476,55,2715,5616
301.944,6,35,6477,18,286,17761,1314,2445,17,304,18871,1420,4032
209.202,17,4,240,2,32,209201,32,120,2,32,209201,32,120
383.913,6,18,1242,14,180,29531,180,916,4,110,20116,110,326
1798.239,1,278,29468,278,78,6491,78,29468,0,0,0,0,0
1799.897,6,250,25400,102,67,17819,659,9472,148,131,12243,1360,15928
4.862,6,3276,3299886,1096,333,4,343,63669,2180,1435,2,2876,3236217
280.431,17,4,296,2,30,280393,30,116,2,62,280370,62,180
762.673,1,4,224,4,28,254224,28,224,0,0,0,0,0
294.832,6,39,8474,16,158,19655,267,1437,23,509,13376,1400,7037
1795.614,17,447,39864,402,35,4477,288,25644,45,288,40016,288,14220
8.079,17,6,528,3,48,4033,48,228,3,72,4033,72,300
1741.258,6,91,6604,59,31,30021,31,3998,32,31,56168,31,2606
1747.862,6,148,9285,80,48,22124,208,5666,68,31,26084,31,3619
0.897,17,21,9583,9,420,112,1350,4036,12,434,55,1350,5547
12.518,17,118,56923,53,302,240,1350,17536,65,577,195,1350,39387
1746.557,6,94,7151,62,38,28632,205,4424,32,33,56332,98,2727
1773.287,6,180,15480,120,69,14901,69,8940,60,69,30050,69,6540
95.828,6,23,8478,12,337,58,673,1525,11,928,9569,1696,6953
41.751,6,452,205553,238,808,176,1152,191488,214,392,194,1152,14065
280.346,6,29,7392,13,158,23362,267,1317,16,603,18684,1400,6075
63.687,6,18,5747,11,268,6368,505,1249,7,842,115,1420,4498
1768.712,17,44,14784,44,308,41132,308,14784,0,0,0,0,0
65.319,6,92,60354,53,1186,1256,1368,51394,39,841,1712,2519,8960
251.798,2,3,96,3,8,125899,8,96,0,0,0,0,0
280.509,6,30,7432,14,158,21577,267,1357,16,678,18693,3456,6075
368.922,6,25,1651,17,177,23057,177,1117,8,110,9194,110,534
1774.684,1,59,4956,0,0,0,0,0,59,56,30598,56,4956
1798.283,17,449,39928,404,35,4462,288,25708,45,288,40019,288,14220
1784.047,17,142,11360,71,48,25485,48,5396,71,56,25485,56,5964
1792.29,17,180,14040,180,50,10012,50,14040,0,0,0,0,0
0.136,6,2,522,1,442,0,442,482,1,0,0,0,40
0.681,6,14,1745,7,288,80,288,600,7,426,77,434,1145
2.763,17,4,240,2,32,2762,32,120,2,32,2762,32,120
367.099,6,21,1419,15,177,26221,177,989,6,110,13099,110,430
1787.733,6,102,8228,68,64,26682,64,4896,34,58,54171,58,3332
1.992,17,4,344,2,47,0,47,150,2,69,0,75,194
9.736,6,16,3911,9,275,1217,275,643,7,992,790,1440,3268
0.143,6,12,2988,7,695,23,860,1762,5,479,33,939,1226
102.86,6,29,7392,13,158,8571,267,1317,16,603,6855,2036,6075
1.028,17,6,552,3,32,500,32,180,3,96,418,96,372
265.189,17,4,352,2,60,265188,60,176,2,60,265187,60,176
4.396,6,23,4478,12,213,399,597,1689,11,441,422,1408,2789
0.411,6,343,372282,96,194,4,230,5779,247,1443,1,4344,366503
0.145,6,12,3462,6,75,29,75,395,6,1373,29,1448,3067
38.811,17,4,1344,4,308,12937,308,1344,0,0,0,0,0
8.906,6,88,28516,45,555,202,1152,22346,43,444,206,1179,6170
1.185,6,26,8380,14,266,78,540,1924,12,1192,90,3151,6456
18.696,6,3222,3050496,2051,1408,9,1448,2984940,1171,776,15,1448,65556
8.998,6,88,28066,46,573,199,1152,21904,42,407,213,1152,6162
300.914,6,43,8847,23,315,13677,882,2249,20,445,511,2128,6598
120.353,2,3,96,3,8,60176,8,96,0,0,0,0,0
0.065,6,10,1495,5,507,16,507,727,5,556,16,556,768
1662.239,1,7,392,7,28,277039,28,392,0,0,0,0,0
1.375,6,48,19354,26,903,55,1440,13707,22,475,55,1440,5647
251.912,2,3,96,3,8,125956,8,96,0,0,0,0,0
1799.848,17,449,39928,404,35,4466,288,25708,45,288,40018,288,14220
0.088,17,2,586,1,46,0,46,74,1,484,0,484,512
1739.973,6,127,16086,77,78,22894,876,7012,50,165,35509,3495,9074
57.604,6,12,664,7,0,9600,0,380,5,0,14284,0,284
1788.72,6,4372,4326175,1524,127,1174,354,92044,2848,1470,628,4206,4234131
145.641,1,6,336,6,28,29128,28,336,0,0,0,0,0
37.346,17,42,6056,21,48,1866,48,1596,21,184,1866,308,4460
97.936,6,52,23110,29,872,3491,1460,10024,23,809,4443,1460,13086
9.068,1,9,756,0,0,0,0,0,9,56,1133,56,756
16.653,6,2868,2738180,1839,1410,8,1448,2680008,1029,776,16,1448,58172
773.018,6,89,8597,50,121,15775,208,6603,39,31,20337,31,1994
1793.562,17,142,11360,71,48,25622,48,5396,71,56,25622,56,5964
1785.859,6,447,26293,235,69,7631,69,13678,212,34,8463,64,12615
1775.483,17,73,3060,72,14,25006,14,3024,1,8,0,8,36
0.848,6,196,137998,106,1353,8,1432,130153,90,420,9,1432,7845
66.376,6,18,4371,7,341,11062,722,1396,11,342,6616,2026,2975
1680.539,17,12,498,11,14,168053,14,462,1,8,0,8,36
3.608,6,600,503506,357,1377,10,1420,489565,243,467,14,1883,13941
296.153,17,4,240,2,32,296152,32,120,2,32,296152,32,120
44.576,6,133,53792,66,769,532,1152,48815,67,458,671,1179,4977
1796.904,17,449,39928,404,35,4458,288,25708,45,288,40015,288,14220
1.934,6,115,87131,50,131,39,232,2529,65,1366,25,1430,84602
280.202,6,26,7272,12,158,25472,267,1277,14,775,21550,3445,5995
1.274,6,50,19878,28,871,47,1360,14222,22,433,52,1360,5656
67.854,17,4,1344,4,308,22618,308,1344,0,0,0,0,0
0.803,6,112,87871,57,131,14,232,2809,55,1726,14,4260,85062
0.014,17,2,476,1,39,0,39,67,1,381,0,381,409
148.904,1,17,1836,0,0,0,0,0,17,80,9306,80,1836
1795.257,6,152,16968,84,92,21629,722,7700,68,152,26790,1440,9268
280.051,6,28,7352,13,158,23337,267,1317,15,678,20000,3436,6035
21.864,17,4,824,2,48,21855,48,152,2,308,21855,308,672
0.205,1,2,163,2,53,205,78,163,0,0,0,0,0
191.68,6,32,8952,14,158,14744,267,1357,18,624,11271,1400,7595
9.622,6,1541,1333247,906,1417,10,1432,1303614,635,420,15,1432,29633
240.654,6,58,18667,29,828,8593,1418,15604,29,193,8592,580,3063
397.831,17,6,528,3,60,198914,60,264,3,60,198915,60,264
1795.147,17,80,3354,79,14,23014,14,3318,1,8,0,8,36
280.033,6,29,7392,13,158,23336,267,1317,16,603,18666,2800,6075
0.017,17,4,352,2,37,0,37,130,2,83,0,89,222
5.283,17,30,13046,14,611,406,1350,8953,16,227,212,1350,4093
0.445,6,12,1653,6,288,84,288,548,6,426,47,434,1105
2.019,6,24,5755,14,158,155,370,1355,10,999,223,1791,4400
158.349,6,25,6273,9,267,96,502,1166,16,343,10550,1420,5107
60.183,17,18,2822,18,128,3540,357,2822,0,0,0,0,0
0.012,17,2,451,1,41,0,41,69,1,354,0,354,382
197.427,6,29,11675,16,706,13161,1408,4383,13,1101,16451,1578,7292
2.365,6,13,2311,8,188,337,245,700,5,1407,527,1407,1611
1791.891,17,315,53096,315,140,5706,363,53096,0,0,0,0,0
1.353,6,25,8056,12,164,102,267,1288,13,1014,96,2736,6768
6.909,6,1162,952809,677,1360,10,1380,929166,485,383,14,1380,23643
0.024,6,13,3980,7,88,3,88,388,6,1670,4,1880,3592
1786.209,6,357,22629,208,69,8629,69,12460,149,69,12068,69,10169
65.373,17,4,352,2,60,65372,60,176,2,60,65372,60,176
240.241,6,54,19618,29,849,8579,1408,16814,25,187,10009,580,2804
280.033,6,30,7432,14,158,21541,267,1357,16,603,18665,2800,6075
1786.27,17,81,3396,80,14,22611,14,3360,1,8,0,8,36
1742.758,6,95,7203,63,38,28109,205,4476,32,33,56201,98,2727
1781.761,6,385,29281,222,116,8062,1189,16336,163,88,10998,485,12945
4.716,6,35,6209,20,206,248,314,2864,15,548,317,1179,3345
168.691,6,29,8832,14,158,12976,267,1357,15,858,12042,2045,7475
280.374,6,30,7432,13,158,23364,267,1317,17,543,17521,1400,6115
8.932,6,28,8762,17,547,558,1152,6707,11,537,858,1179,2055
1744.649,2,18,576,18,8,102626,8,576,0,0,0,0,0
240.27,6,58,18022,31,784,8008,1418,14970,27,182,9240,580,3052
36.418,6,48,15774,25,995,379,1360,10007,23,371,1645,1360,5767
132.912,6,30,7773,13,158,11076,267,1317,17,577,8290,2036,6456
1786.404,6,105,8484,68,66,26662,66,4964,37,60,49619,60,3520
971.008,17,8,922,8,87,138715,355,922,0,0,0,0,0
4.009,17,4,244,4,33,1336,33,244,0,0,0,0,0
280.958,6,29,7733,11,158,28095,267,1237,18,524,16518,1400,6496
0.522,17,18,8068,8,446,74,1350,3799,10,398,32,1350,4269
87.037,17,3,1028,3,314,43518,328,1028,0,0,0,0,0
599.072,6,9,546,6,31,119814,31,333,3,31,299526,31,213
2.444,6,6,340,3,0,1222,0,160,3,0,500,0,180
0.227,17,2,154,1,33,0,33,61,1,65,0,65,93
0.518,17,4,768,2,39,514,39,134,2,289,8,289,634
245.878,6,50,8559,24,168,10690,346,2496,26,360,9834,2800,6063
1794.043,1,58,4872,58,56,31474,56,4872,0,0,0,0,0
1787.028,17,139,11116,70,48,25898,48,5320,69,56,26279,56,5796
1796.174,17,142,11360,71,48,25659,48,5396,71,56,25659,56,5964
63.787,6,28,8298,12,129,5798,267,1134,16,724,4249,2840,7164
3.467,6,3,168,2,0,3467,0,104,1,0,0,0,64
4.506,6,10,1671,6,552,901,948,1348,4,159,1499,159,323
300.12,6,40,10384,21,658,14997,1440,4822,19,399,16663,1440,5562
213.934,6,82,25860,38,587,5782,1152,18558,44,395,4968,1179,7302
0.499,17,3,543,2,39,403,39,134,1,381,0,381,409
240.338,6,52,17818,27,791,9241,1418,14868,25,234,10013,580,2950
514.904,17,101,7676,101,48,5149,48,7676,0,0,0,0,0
0.136,17,2,212,1,46,0,46,74,1,110,0,110,138
0.077,17,2,180,1,30,0,30,58,1,94,0,94,122
0.264,17,2,420,1,39,0,39,67,1,325,0,325,353
1772.505,6,204,22330,130,75,13740,267,10057,74,132,24274,1414,12273
3.079,6,2,1253,1,0,0,0,40,1,1173,0,1173,1213
1797.459,17,449,39928,404,35,4460,288,25708,45,288,40017,288,14220
1753.866,1,54,4536,0,0,0,0,0,54,56,33091,56,4536
839.902,2,6,192,6,8,167980,8,192,0,0,0,0,0
300.986,6,54,30856,29,958,10749,1368,13979,25,1037,1214,2736,16877
0.935,6,32,11676,16,237,62,589,1814,16,1002,60,1438,9862
1786.398,6,102,8364,68,66,26662,66,4964,34,60,54130,60,3400
100.016,6,38,9968,16,141,6667,267,1495,22,446,4743,1420,8473
240.152,6,54,17381,29,764,8576,1408,14513,25,195,10006,580,2868
0.663,6,7,371,3,0,331,0,152,4,7,104,7,219
503.455,17,48,7056,24,48,21888,48,1824,24,190,21888,308,5232
4.302,6,38,7245,19,218,239,314,3383,19,516,225,1179,3862
0.314,6,20,7238,12,335,27,668,1974,8,1210,43,1906,5264
0.876,17,4,240,2,32,874,32,120,2,32,875,32,120
0.329,17,2,572,1,39,0,39,67,1,477,0,477,505
1.305,6,45,17306,25,891,54,1440,11730,20,433,59,1440,5576
1789.281,17,83,3480,82,14,22089,14,3444,1,8,0,8,36
0.148,17,2,339,1,33,0,33,61,1,250,0,250,278
1796.094,1,266,14896,266,28,6777,28,14896,0,0,0,0,0
2.081,17,4,1556,4,361,693,361,1556,0,0,0,0,0
0.192,6,46,21303,26,1087,7,1420,16282,20,467,9,1883,5021
0.023,17,2,398,1,43,0,43,71,1,299,0,299,327
0.122,6,10,1514,5,503,30,503,771,5,475,30,475,743
1.121,6,24,8004,13,164,79,267,1340,11,1216,95,3819,6664
0.85,6,11,1727,7,100,141,100,384,4,589,202,1152,1343
377.856,2,4,128,4,8,125952,8,128,0,0,0,0,0
3.491,6,2,88,2,0,0,0,88,0,0,0,0,0
4.211,17,7,491,5,31,1052,31,295,2,70,1142,70,196
504.29,2,4,128,4,8,168096,8,128,0,0,0,0,0
1786.308,6,103,8464,68,66,26661,66,4964,35,60,52535,60,3500
1770.367,6,102,9462,66,66,27236,66,5610,36,60,50579,60,3852
1789.448,17,142,11360,71,48,25563,48,5396,71,56,25563,56,5964
14.322,6,2298,2084899,1444,1364,9,1408,2035827,854,931,16,2801,49072
1790.373,1,58,4872,0,0,0,0,0,58,56,31410,56,4872
0.197,6,46,20823,26,1053,7,1420,15802,20,467,9,1883,5021
1796.265,6,356,22520,208,69,8677,69,12460,148,69,12219,69,10060
6.621,1,12,5944,12,467,601,548,5944,0,0,0,0,0
1766.998,1,58,4872,58,56,30999,56,4872,0,0,0,0,0
1110.181,6,88,9434,50,69,22653,722,4356,38,123,29999,2329,5078
0.024,17,2,196,1,62,0,62,90,1,78,0,78,106
39.719,17,11,836,11,48,3971,48,836,0,0,0,0,0
0.095,6,11,911,6,181,19,181,489,5,77,22,133,422
0.052,17,2,146,1,37,0,37,65,1,53,0,53,81
10.466,17,2,152,2,48,10466,48,152,0,0,0,0,0
1794.391,17,285,56023,285,168,6318,358,56023,0,0,0,0,0
115.857,6,51,9280,25,401,619,889,2332,26,327,4628,1360,6948
109.627,6,33,7916,10,141,4859,267,1255,23,336,4982,1452,6661
2.348,17,4,1560,4,362,782,362,1560,0,0,0,0,0
541.446,2,7,224,7,8,90241,8,224,0,0,0,0,0
1795.236,6,356,22520,208,69,8672,69,12460,148,69,12212,69,10060
0.128,17,4,284,2,32,0,32,120,2,54,0,60,164
1770.817,6,109,9986,70,64,25664,64,5904,39,58,46598,58,4082
1764.106,2,18,576,18,8,103770,8,576,0,0,0,0,0
1781.637,6,182,15629,121,69,14846,69,8980,61,69,29687,69,6649
0.062,17,2,136,1,32,0,32,60,1,48,0,48,76
116.294,17,4,352,2,60,116293,60,176,2,60,116293,60,176
148.613,6,26,14041,14,534,70,1288,2206,12,1620,13495,4429,11835
504.078,2,4,128,4,8,168026,8,128,0,0,0,0,0
1770.945,6,93,8556,62,63,29031,63,5177,31,57,59028,57,3379
9.831,6,17,2422,9,210,1228,210,920,8,545,1404,904,1502
993.503,6,128,15840,79,80,12737,267,6223,49,169,20693,1917,9617
1.409,6,10,1687,7,100,234,100,384,3,1179,576,1179,1303
1794.66,6,358,22669,209,69,8628,69,12569,149,69,12126,69,10100
0.391,6,21,5895,12,108,35,147,919,9,1153,48,2602,4976
300.827,6,52,15007,27,875,11570,1460,9050,25,290,611,1460,5957
31.574,6,7,328,2,0,31574,0,88,5,0,7891,0,240
2.708,17,2,154,1,33,0,33,61,1,65,0,65,93
4.007,17,4,352,2,48,3991,48,152,2,72,3992,72,200
58.939,6,472,208878,238,815,248,1152,194695,234,438,251,1179,14183
1799.1,1,78,6552,0,0,0,0,0,78,56,23364,56,6552
1769.447,1,58,4872,0,0,0,0,0,58,56,31042,56,4872
1788.218,17,87,3648,86,14,21037,14,3612,1,8,0,8,36
35.773,17,44,6468,22,48,1702,48,1672,22,190,1701,308,4796
0.993,6,33,12888,17,524,62,1460,3346,16,808,53,1460,9542
1.392,6,52,23363,29,1029,49,1440,17667,23,433,54,1440,5696
10.996,6,21,4482,11,275,1099,275,998,10,768,1200,1440,3484
1.591,6,12,2271,7,188,265,245,660,5,1407,337,1407,1611
0.044,17,2,152,1,40,0,40,68,1,56,0,56,84
1774.813,6,180,15480,120,69,14914,69,8940,60,69,30077,69,6540
1.437,6,49,19234,26,890,57,1460,13538,23,433,56,1460,5696
1.224,6,53,22090,31,943,40,1360,16389,22,400,50,1360,5701
0.78,17,4,368,2,32,511,32,120,2,96,534,96,248
1707.058,17,28,7686,14,30,131306,30,812,14,463,131311,463,6874
1756.238,6,105,6270,60,27,29765,27,3525,45,27,39913,27,2745
38.708,17,11,836,11,48,3870,48,836,0,0,0,0,0
1796.554,17,142,11360,71,48,25664,48,5396,71,56,25664,56,5964
7.009,6,1459,1316474,902,1380,7,1408,1282846,557,776,12,1408,33628
1771.32,6,101,9410,66,66,27251,66,5610,35,60,52094,60,3800
52.524,6,30,7297,14,155,4040,267,1346,16,441,3501,1420,5951
1.15,6,25,8056,12,164,88,267,1288,13,869,81,1408,6768
1796.953,17,446,39264,403,35,4470,288,25676,43,288,41922,288,13588
1792.0,6,356,22520,208,69,8656,69,12460,148,69,12190,69,10060
240.169,6,53,17589,28,788,8894,1402,14872,25,176,10006,580,2717
1787.689,6,104,8376,68,65,26681,65,4930,36,59,51074,59,3446
1500.037,17,26,1482,26,29,60001,29,1482,0,0,0,0,0
104.854,6,13140,12602756,8566,1392,12,1440,12360208,4574,776,22,1440,242548
0.372,6,13,1693,7,288,56,288,588,6,426,41,434,1105
1778.136,17,142,11360,71,48,25401,48,5396,71,56,25401,56,5964
68.641,17,4,240,2,32,68640,32,120,2,32,68639,32,120
1681.37,17,14,3843,7,30,280226,30,406,7,463,280226,463,3437
151.485,6,36,22223,20,224,7972,224,1428,16,1535,10096,2736,20795
11.09,6,33,10392,14,158,853,267,1357,19,689,612,1400,9035
1.008,17,2,677,1,300,0,300,328,1,321,0,321,349
60.077,2,2,64,2,8,60077,8,64,0,0,0,0,0
5.896,6,516,429045,310,1316,18,1368,413669,206,776,27,1473,15376
291.168,17,12,1131,6,33,58227,37,369,6,99,58227,136,762
1726.476,17,12,498,11,14,172647,14,462,1,8,0,8,36
0.433,17,16,8534,8,441,57,1350,3756,8,569,57,1350,4778
1.442,6,24,8004,12,164,112,267,1288,12,1014,109,2491,6716
1779.617,1,56,4704,0,0,0,0,0,56,56,32356,56,4704
1792.006,6,351,31176,203,103,8871,469,15460,148,127,12187,1452,15716
48.76,6,10,636,4,106,16253,106,274,6,90,9709,90,362
1746.17,6,116,8346,70,31,25306,31,4797,46,31,38803,31,3549
1.759,17,20,5190,20,231,92,389,5190,0,0,0,0,0
2.281,6,13,2311,8,188,325,245,700,5,1407,506,1407,1611
1740.629,6,87,6322,58,31,30537,31,3915,29,31,62165,31,2407
1776.253,17,73,3060,72,14,25017,14,3024,1,8,0,8,36
1764.362,1,53,4452,53,56,33930,56,4452,0,0,0,0,0
1786.78,6,102,8364,68,66,26668,66,4964,34,60,54128,60,3400
1.697,17,12,7287,6,654,339,1350,4093,6,504,205,1350,3194
1785.572,6,103,8464,68,66,26650,66,4964,35,60,52514,60,3500
1719.652,17,12,498,11,14,171965,14,462,1,8,0,8,36
1202.952,2,16,512,16,8,80196,8,512,0,0,0,0,0
202.596,17,4,240,2,32,202595,32,120,2,32,202595,32,120
117.888,6,20,4464,9,341,14736,722,1489,11,342,11761,1408,2975
0.249,17,2,776,2,360,249,360,776,0,0,0,0,0
4.573,6,37,7205,19,218,254,314,3383,18,516,253,1179,3822
1771.493,6,101,9278,66,64,27253,64,5544,35,58,52100,58,3734
0.012,6,10,1512,5,503,2,503,771,5,473,3,473,741
0.473,6,12,1653,6,288,88,288,548,6,426,53,434,1105
0.07,17,2,290,1,40,0,40,68,1,194,0,194,222
0.087,17,2,152,1,48,0,48,76,1,48,0,48,76
11.715,17,4,352,2,48,11697,48,152,2,72,11691,72,200
6.263,6,759,636017,444,1354,13,1368,613757,315,776,19,1473,22260
6.389,6,1160,1040523,716,1375,8,1408,1012771,444,931,14,2816,27752
37.923,17,22,1936,11,48,3791,48,836,11,72,3791,72,1100
0.038,17,4,820,2,36,33,36,128,2,318,33,318,692
1794.435,17,180,11520,180,36,10024,36,11520,0,0,0,0,0
93.052,6,32,16604,18,634,41,1360,3301,14,1414,7147,2720,13303
1796.461,6,394,27751,223,101,8092,469,16426,171,69,10565,69,11325
0.007,17,2,351,1,49,0,49,77,1,246,0,246,274
5.395,6,19,9263,8,275,770,275,599,11,913,446,1440,8664
0.001,6,2,104,2,0,0,0,104,0,0,0,0,0
1787.107,17,348,26448,348,48,5150,48,26448,0,0,0,0,0
0.064,17,2,322,1,33,0,33,61,1,233,0,233,261
1798.79,17,142,11360,71,48,25696,48,5396,71,56,25696,56,5964
1786.991,6,102,8296,68,65,26671,65,4930,34,59,54147,59,3366
105.606,6,44,8865,17,345,3776,720,1783,27,299,4057,2720,7082
273.511,17,4,240,2,32,273510,32,120,2,32,273510,32,120
1790.767,6,263,26210,101,67,17906,659,9398,162,114,11121,1440,16812
280.625,6,27,7312,12,158,25511,267,1277,15,775,20040,3465,6035
923.017,1,12,672,12,28,83910,28,672,0,0,0,0,0
147.954,17,4,352,2,60,147953,60,176,2,60,147953,60,176
0.31,6,22,5888,11,164,31,453,1402,11,781,29,2224,4486
280.191,6,29,7392,13,158,23349,267,1317,16,603,18678,1400,6075
270.266,17,4,358,2,33,270253,34,123,2,89,270251,114,235
1799.404,1,57,4788,57,56,32132,56,4788,0,0,0,0,0
0.285,17,4,334,2,39,192,39,134,2,72,0,72,200
11.122,6,19,4402,10,275,1235,275,958,9,768,791,1440,3444
1740.993,6,87,6322,58,31,30543,31,3915,29,31,62178,31,2407
1743.479,6,161,16404,86,69,20511,721,6923,75,161,23554,2840,9481
1799.999,6,239,18163,97,67,18749,576,9087,142,48,12764,142,9076
0.349,17,8,2758,8,316,49,355,2758,0,0,0,0,0
1.685,6,61,45665,39,1261,44,1408,38616,22,1179,71,3819,7049
0.004,17,3,819,1,137,0,137,165,2,299,1,299,654
69.1,6,28,7217,13,155,5758,267,1306,15,482,4935,1997,5911
28.829,6,32,8952,14,158,2217,267,1357,18,624,1691,1400,7595
125.254,2,2,64,2,8,125254,8,64,0,0,0,0,0
1775.457,1,58,4872,58,56,31148,56,4872,0,0,0,0,0
1785.105,17,142,11360,71,48,25501,48,5396,71,56,25499,56,5964
0.893,6,25,7383,13,257,74,748,1715,12,838,80,1418,5668
0.229,6,4,1037,2,0,224,0,104,2,853,6,853,933
1786.408,6,102,8364,68,66,26662,66,4964,34,60,54130,60,3400
0.14,6,7,423,4,43,35,43,259,3,0,19,0,164
252.409,2,3,96,3,8,126204,8,96,0,0,0,0,0
0.778,6,143,98722,79,1304,9,1432,91871,64,475,11,1871,6851
1794.965,6,384,34570,218,123,8271,1189,17718,166,132,10877,1452,16852
1773.17,6,200,22170,127,75,14072,267,9868,73,135,24623,2840,12302
17.164,6,2872,2492369,1644,1422,10,1448,2413529,1228,776,13,1448,78840
30.521,6,39,8718,20,227,1606,721,2401,19,693,1683,1440,6317
300.567,6,37,8408,20,286,15819,797,1976,17,478,527,2128,6432
1776.228,17,352,56561,352,132,5060,363,56561,0,0,0,0,0
1777.148,6,108,8724,70,66,25755,66,5044,38,60,48028,60,3680
96.14,17,4,240,2,32,96139,32,120,2,32,96139,32,120
240.203,6,53,17389,28,772,8896,1402,14590,25,186,10008,580,2799
1741.062,6,87,6322,58,31,30544,31,3915,29,31,62180,31,2407
0.758,6,30,8872,14,158,58,267,1357,16,763,36,2800,7515
245.801,6,27,3175,14,321,18907,321,2048,13,83,20482,83,1127
1773.602,6,180,15480,120,69,14904,69,8940,60,69,30054,69,6540
2.637,17,2,677,1,300,0,300,328,1,321,0,321,349
207.476,6,31,7813,14,158,15959,267,1357,17,577,12964,1400,6456
61.47,6,10,648,10,31,6830,31,648,0,0,0,0,0
0.174,6,3,453,2,241,174,241,321,1,92,0,92,132
1771.075,6,102,9462,66,66,27247,66,5610,36,60,50599,60,3852
5.959,6,39,7269,19,218,331,314,3383,20,513,298,1179,3886
0.375,6,12,1653,6,288,70,288,548,6,426,42,434,1105
0.036,6,2,80,1,0,0,0,40,1,0,0,0,40
1748.66,6,111,8908,70,52,25342,205,5387,41,37,43708,98,3521
2.035,17,14,5687,6,481,400,1350,3054,8,301,285,1350,2633
1786.119,6,104,8376,68,65,26658,65,4930,36,59,51028,59,3446
1680.661,1,15,840,15,28,120047,28,840,0,0,0,0,0
2.324,17,3,1170,3,362,1162,362,1170,0,0,0,0,0
1769.79,6,105,9759,68,65,26414,65,5758,37,59,49158,59,4001
8.39,6,78,24677,39,561,220,1152,18976,39,413,213,1152,5701
1.375,6,48,19809,27,934,52,1460,14193,21,476,59,2615,5616
4.048,6,34,6169,18,206,238,314,2784,16,548,251,1179,3385
1796.99,17,449,39928,404,35,4459,288,25708,45,288,40019,288,14220
1750.55,17,12,498,11,14,175055,14,462,1,8,0,8,36
23.842,6,22,2472,10,555,2647,888,1514,12,231,2166,231,958
4.746,6,39,7285,19,218,263,314,3383,20,442,236,1152,3902
1771.33,6,99,9240,66,65,27251,65,5577,33,59,55351,59,3663
0.05,17,4,352,2,60,50,60,176,2,60,49,60,176
126.319,6,57,13166,24,342,3087,1189,5424,33,291,3947,1420,7742
1.371,17,2,778,2,361,1371,361,778,0,0,0,0,0
12.976,6,1842,1768345,1164,1440,10,1448,1727117,678,776,18,1448,41228
12.511,17,3,984,3,300,6255,300,984,0,0,0,0,0
157.645,6,21,9034,11,301,93,595,1376,10,1207,17501,2568,7658
125.365,6,14,3143,7,92,20894,92,452,7,464,20864,1402,2691
7.908,6,1649,1409796,921,1433,8,1448,1358476,728,776,10,1448,51320
0.129,6,2,99,1,0,0,0,40,1,7,0,7,59
3.996,6,39,7269,20,218,210,314,3423,19,513,208,1179,3846
46.389,1,4,224,4,28,15463,28,224,0,0,0,0,0
1783.811,6,373,25959,215,98,8335,469,15223,158,69,11361,69,10736
1789.327,6,356,22520,208,69,8644,69,12460,148,69,12170,69,10060
1.988,6,62,18178,32,706,64,1360,9069,30,438,68,1360,9109
61.869,6,77,51119,46,1187,1374,1448,42776,31,747,2054,1448,8343
0.017,17,2,180,1,30,0,30,58,1,94,0,94,122
1743.81,6,109,8153,69,38,25644,205,4881,40,33,44707,98,3272
186.339,17,4,352,2,60,186338,60,176,2,60,186338,60,176
1789.119,17,142,11360,71,48,25558,48,5396,71,56,25558,56,5964
29.412,17,6,1236,3,48,14668,48,228,3,308,14672,308,1008
249.504,6,26,5066,12,189,10860,516,1432,14,279,19166,1452,3634
1780.485,17,140,11200,70,48,25803,48,5320,70,56,25803,56,5880
0.388,6,19,4982,12,193,34,358,1258,7,860,61,1460,3724
3.029,2,3,96,3,8,1514,8,96,0,0,0,0,0
1797.206,1,345,28980,345,56,5224,56,28980,0,0,0,0,0
125.386,6,18,4273,9,407,15673,722,1278,9,420,15650,1408,2995
1.27,6,8,432,4,0,423,0,216,4,0,316,0,216
1748.225,6,186,11770,93,53,19002,208,7120,93,31,18999,31,4650
7.138,6,1676,1571885,1077,1383,6,1408,1536073,599,931,11,2801,35812
1.05,17,2,148,2,46,1050,46,148,0,0,0,0,0
226.324,6,108,78471,69,1267,3328,1448,68247,39,629,1897,1448,10224
1.701,6,32,6300,16,138,113,267,1755,16,650,103,1380,4545
11.213,6,11,631,5,43,2803,43,311,6,0,2113,0,320
0.141,6,3,151,1,0,0,0,40,2,31,13,31,111
1.64,17,6,1230,3,36,817,36,192,3,318,817,318,1038
0.019,17,2,122,1,33,0,33,61,1,33,0,33,61
3.077,6,37,14093,18,478,181,1460,4131,19,764,150,1460,9962
78.021,6,81,56489,51,1198,1560,1368,48191,30,841,2137,2519,8298
1.527,6,48,18200,26,882,61,1360,12544,22,433,62,1360,5656
0.256,6,24,5962,12,164,23,453,1442,12,777,22,2206,4520
0.032,17,3,244,2,32,1,32,120,1,96,0,96,124
1797.109,17,142,11360,71,48,25672,48,5396,71,56,25672,56,5964
1771.405,6,101,9212,66,63,27252,63,5511,35,57,52097,57,3701
141.761,6,29,7392,13,158,11813,267,1317,16,603,9448,2036,6075
1752.425,1,66,5544,0,0,0,0,0,66,56,26960,56,5544
0.055,17,2,216,1,45,0,45,73,1,115,0,115,143
24.23,6,1960,1623288,1133,1371,21,1380,1581882,827,421,29,1923,41406
31.949,17,3,228,3,48,15974,48,228,0,0,0,0,0
1743.31,1,58,4872,58,56,30584,56,4872,0,0,0,0,0
1773.508,6,181,15589,120,69,14903,69,8940,61,69,29550,69,6649
363.776,6,56,13914,29,441,12992,1360,7815,27,263,1568,1360,6099
300.971,6,38,8383,21,269,15048,730,1949,17,478,546,2128,6434
0.945,6,31,12795,16,511,63,1460,3239,15,813,54,1460,9556
2.413,17,2,136,1,32,0,32,60,1,48,0,48,76
0.005,17,4,336,2,34,0,34,124,2,78,1,84,212
0.096,6,10,2115,6,597,18,1034,1438,4,513,31,513,677
280.432,6,28,7352,12,158,25493,267,1277,16,678,18691,2085,6075
1793.518,1,58,4872,0,0,0,0,0,58,56,31465,56,4872
296.047,1,4,224,4,28,98682,28,224,0,0,0,0,0
1786.732,6,106,8456,68,65,26667,65,4930,38,59,48287,59,3526
1794.09,17,80,3354,79,14,23001,14,3318,1,8,0,8,36
0.294,6,23,7296,11,257,29,748,1635,12,838,26,1408,5661
5.008,17,4,558,2,36,5003,36,128,2,187,5004,187,430
1749.897,6,119,12039,75,63,23647,722,6268,44,96,40685,1448,5771
14.905,6,134,51592,71,668,212,1152,44963,63,456,236,1179,6629
0.05,17,4,284,2,32,8,32,120,2,54,46,60,164
0.515,17,3,451,2,39,486,39,134,1,289,0,289,317
533.423,2,4,128,4,8,177807,8,128,0,0,0,0,0
316.2,6,64,13017,24,233,13747,1305,3556,40,253,8103,1460,9461
13.398,6,11,833,5,71,3349,71,339,6,83,1498,83,494
2.233,6,50,19224,28,950,82,1460,13523,22,400,88,1460,5701
0.685,6,22,4731,13,208,57,525,1716,9,634,74,2301,3015
0.006,17,2,422,1,72,0,72,100,1,294,0,294,322
16.308,17,18,2528,9,48,2036,48,684,9,176,2033,308,1844
8.072,6,1937,1818590,1246,1382,6,1408,1777994,691,931,11,2801,40596
1787.228,6,104,8376,68,65,26675,65,4930,36,59,51060,59,3446
1786.753,6,102,8364,68,66,26667,66,4964,34,60,54140,60,3400
1799.605,6,3225,3281930,1065,152,1691,957,66051,2160,1489,833,9926,3215879
240.659,2,3,96,3,8,120329,8,96,0,0,0,0,0
611.255,1,8,1072,8,106,87322,143,1072,0,0,0,0,0
0.404,6,46,16757,24,967,17,1380,11635,22,383,17,1380,5122
0.182,6,5,284,4,0,59,0,232,1,0,0,0,52
0.008,6,18,29652,1,0,0,0,40,17,1689,0,2736,29612
191.105,1,6,336,6,28,38221,28,336,0,0,0,0,0
366.302,6,63,24566,40,738,9392,1360,18615,23,358,586,1360,5951
7.025,6,1498,1382932,923,1419,7,1448,1348368,575,776,11,1448,34564
245.727,6,30,7432,13,158,20477,267,1317,17,543,15355,1400,6115
538.626,17,133,11209,63,86,8687,1350,7197,70,29,7789,60,4012
253.312,1,4,224,4,28,84437,28,224,0,0,0,0,0
0.084,6,2,1175,1,0,0,0,40,1,1095,0,1095,1135
11.677,6,1848,1594901,1125,1363,10,1380,1561739,723,421,16,1923,33162
0.407,6,12,1653,6,288,78,288,548,6,426,42,434,1105
280.195,6,30,7432,14,158,21553,267,1357,16,603,18677,2036,6075
1786.72,6,104,8376,68,65,26667,65,4930,36,59,51046,59,3446
3.185,6,2,88,2,0,0,0,88,0,0,0,0,0
5.278,6,40,7325,21,218,263,314,3463,19,516,278,1179,3862
0.005,17,2,296,1,49,0,49,77,1,191,0,191,219
241.426,6,57,9818,26,351,9656,1418,5288,31,193,8047,580,4530
3.286,17,51,19241,25,578,136,1350,15151,26,129,119,1350,4090
1771.997,6,180,15480,120,69,14890,69,8940,60,69,30032,69,6540
1634.957,1,8,848,8,78,233565,78,848,0,0,0,0,0
1743.729,17,14,5446,14,361,134133,361,5446,0,0,0,0,0
0.039,17,2,148,1,30,0,30,58,1,62,0,62,90
283.641,17,4,240,2,32,283640,32,120,2,32,283640,32,120
1764.403,2,14,448,14,8,135723,8,448,0,0,0,0,0
0.314,6,27,9085,13,257,26,667,1715,14,947,23,1408,7370
1759.731,1,8,448,8,28,251390,28,448,0,0,0,0,0
1746.636,6,95,7203,63,38,28171,205,4476,32,33,56337,98,2727
22.266,6,28,7352,12,158,2024,267,1277,16,603,1483,1400,6075
0.012,17,2,447,1,65,0,65,93,1,326,0,326,354
0.197,6,10,1512,5,503,49,503,771,5,473,49,473,741
0.066,6,10,1863,5,105,16,105,325,5,1326,16,1326,1538
0.245,17,3,1164,3,360,122,360,1164,0,0,0,0,0
1791.811,6,379,23923,215,69,8372,69,13223,164,66,10992,69,10700
0.861,6,10,1687,7,100,143,100,384,3,1179,306,1179,1303
0.674,6,14,1745,7,288,79,288,600,7,426,79,434,1145
0.546,6,22,7345,13,334,45,663,2021,9,1209,61,1946,5324
1792.027,6,102,8032,67,45,27151,205,4985,35,35,52700,98,3047
1792.739,6,356,22589,207,69,8702,69,12420,149,69,12110,69,10169
281.529,6,28,7352,12,158,25593,267,1277,16,603,18755,1400,6075
280.494,6,29,7392,13,158,23374,267,1317,16,678,18697,3456,6075
95.093,6,23,9166,12,304,93,597,1425,11,1041,9487,2720,7741
117.692,6,40,5871,16,144,1017,722,1998,24,187,5109,1448,3873
156.732,2,3,96,3,8,78366,8,96,0,0,0,0,0
1763.271,2,14,448,14,8,135636,8,448,0,0,0,0,0
1799.03,17,449,39928,404,35,4464,288,25708,45,288,40019,288,14220
1.205,6,24,8028,12,164,93,267,1312,12,1014,92,2411,6716
3.119,17,4,1560,4,362,1039,362,1560,0,0,0,0,0
1784.234,6,367,24643,213,87,8416,469,14136,154,69,11659,69,10507
5.915,6,1624,1495811,1021,1387,5,1408,1459791,603,931,9,2801,36020
1774.833,17,140,11200,70,48,25722,48,5320,70,56,25722,56,5880
0.096,6,16,4136,9,88,11,88,504,7,1670,15,1880,3632
125.801,2,2,64,2,8,125801,8,64,0,0,0,0,0
75.364,17,4,352,2,60,75363,60,176,2,60,75363,60,176
27.545,6,46,13187,22,200,1311,722,2691,24,794,1187,2760,10496
1789.613,6,368,23276,212,69,8481,69,12896,156,69,11545,69,10380
300.642,6,39,8458,20,278,15823,734,1945,19,441,472,1440,6513
309.917,6,25,6316,11,220,5521,518,1326,14,442,23833,2642,4990
0.011,17,3,618,2,32,1,32,120,1,470,0,470,498
115.085,17,4,1344,4,308,38361,308,1344,0,0,0,0,0
280.45,6,29,7392,13,158,23370,267,1317,16,603,18695,1400,6075
0.456,6,3,168,2,0,157,0,116,1,0,0,0,52
192.057,6,30,7519,7,138,32009,267,843,23,319,8728,1460,6676
0.044,17,2,475,1,40,0,40,68,1,379,0,379,407
280.491,6,27,7312,12,158,25499,267,1277,15,775,20027,3465,6035
1.823,6,27,10195,16,287,121,595,1507,11,1030,165,1420,8688
372.178,6,18,1242,14,180,28629,180,916,4,110,20061,110,326
60.661,6,12,1220,7,180,10110,180,732,5,110,15110,110,488
17.759,1,4,224,4,28,5919,28,224,0,0,0,0,0
614.268,17,18,1368,18,48,36133,48,1368,0,0,0,0,0
3.236,17,18,7514,9,497,404,1350,4728,9,281,397,1350,2786
240.76,6,64,20507,33,779,7523,1418,17315,31,195,8024,580,3192
0.054,6,9,1002,5,213,13,213,417,4,421,16,421,585
1788.464,17,87,3648,86,14,21040,14,3612,1,8,0,8,36
1787.149,6,102,8296,68,65,26673,65,4930,34,59,54151,59,3366
1788.895,17,142,11360,71,48,25555,48,5396,71,56,25555,56,5964
1796.319,17,180,14040,180,50,10035,50,14040,0,0,0,0,0
1792.001,6,370,23825,213,75,8452,469,13405,157,69,11487,69,10420
860.36,17,14,1384,14,70,66181,355,1384,0,0,0,0,0
21.439,17,2,642,1,300,0,300,328,1,286,0,286,314
0.679,6,53,20911,29,1028,24,1380,15664,24,355,26,1380,5247
0.014,17,2,558,1,32,0,32,60,1,470,0,470,498
285.281,17,4,240,2,32,285280,32,120,2,32,285280,32,120
34.088,17,20,1760,10,48,3786,48,760,10,72,3786,72,1000
1772.761,6,180,15480,120,69,14897,69,8940,60,69,30045,69,6540
1746.392,6,96,7255,62,38,28629,205,4424,34,33,52909,98,2831
111.49,6,23,9001,11,514,89,1236,2014,12,927,10120,1460,6987
1.067,17,4,947,2,33,1060,37,123,2,384,1057,463,824
1744.655,6,106,7911,67,38,26434,205,4715,39,33,45905,98,3196
164.495,6,73,47927,45,1168,3738,1448,39748,28,746,2282,1448,8179
225.825,6,26,10710,15,395,5897,555,2608,11,1092,22570,3932,8102
46.648,6,30,7297,14,155,3588,267,1346,16,441,3109,1420,5951
1752.407,17,164,13834,152,30,11605,37,8858,12,386,154703,463,4976
130.791,6,21,9136,11,499,89,1193,1971,10,1125,14514,2279,7165
2.71,6,22,5231,12,351,246,1382,2242,10,517,300,2433,2989
1789.635,1,58,4872,0,0,0,0,0,58,56,31397,56,4872
0.928,17,4,912,2,60,923,60,176,2,340,5,340,736
109.148,6,18,1844,6,226,4041,226,772,12,110,9906,110,1072
1.035,6,15,2638,8,288,147,288,640,7,568,108,853,1998
0.92,17,4,1006,2,40,913,40,136,2,407,913,407,870
61.703,6,63,41936,39,1181,1623,1448,33936,24,749,2672,1448,8000
0.414,6,21,5000,10,137,46,267,1092,11,577,39,1400,3908
0.276,17,2,684,2,314,276,320,684,0,0,0,0,0
20.149,6,23,5775,13,107,1679,159,1138,10,684,2237,1418,4637
1746.534,6,95,7203,63,38,28169,205,4476,32,33,56333,98,2727
0.502,6,28,7480,17,306,31,1087,2826,11,701,48,1696,4654
1.601,6,50,21322,29,907,57,1360,15706,21,476,68,2715,5616
0.054,17,4,284,2,32,1,32,120,2,54,42,60,164
1788.911,6,356,22520,208,69,8642,69,12460,148,69,12168,69,10060
1741.291,17,28,6580,28,207,64492,207,6580,0,0,0,0,0
50.454,6,37,9847,18,359,525,762,1873,19,554,2795,1928,7974
106.837,17,4,240,2,32,106836,32,120,2,32,106836,32,120
842.966,17,178,14776,145,35,5853,288,9228,33,140,25311,288,5548
126.6,17,10,880,5,48,31648,48,380,5,72,31647,72,500
1789.069,17,83,3480,82,14,22087,14,3444,1,8,0,8,36
52.28,6,36,8894,20,101,2751,317,1747,16,649,1762,1642,7147
14.512,6,22,4470,12,275,1319,275,1038,10,755,1387,1414,3432
0.511,17,3,543,2,39,121,39,134,1,381,0,381,409
12.196,6,2,142,2,31,12196,31,142,0,0,0,0,0
85.581,6,43,9587,19,265,1700,1189,2895,24,440,3719,1460,6692
1.632,6,31,6044,15,111,116,267,1499,16,650,98,1452,4545
1798.644,17,448,39896,403,35,4474,288,25676,45,288,40020,288,14220
782.111,2,7,224,7,8,130351,8,224,0,0,0,0,0
834.286,6,12,728,8,31,119183,31,444,4,31,278091,31,284
1743.772,1,56,4704,0,0,0,0,0,56,56,31704,56,4704
141.351,6,57,10815,25,224,5889,1189,3251,32,330,4553,1926,7564
240.233,6,53,18415,28,819,8897,1418,15403,25,213,10009,580,3012
1797.447,6,356,22520,208,69,8683,69,12460,148,69,12227,69,10060
11.09,6,103,34898,53,611,213,1152,28416,50,447,221,1179,6482
0.165,17,4,1574,4,365,55,373,1574,0,0,0,0,0
243.092,6,34,8586,16,326,16203,517,2157,18,910,14296,2816,6429
1790.489,17,761,45902,761,32,2355,37,45902,0,0,0,0,0
2.427,2,3,96,3,8,1213,8,96,0,0,0,0,0
10.503,6,43,8345,22,227,500,314,4062,21,491,512,1179,4283
1791.879,17,87,3648,86,14,21080,14,3612,1,8,0,8,36
341.399,17,6,2000,6,305,68279,308,2000,0,0,0,0,0
0.137,6,9,1002,5,213,34,213,417,4,421,40,421,585
201.459,17,4,240,2,32,201457,32,120,2,32,201458,32,120
0.384,6,28,7336,14,155,29,267,1341,14,603,27,2036,5995
1749.518,17,12,498,11,14,174951,14,462,1,8,0,8,36
541.467,2,8,256,8,8,77352,8,256,0,0,0,0,0
1.561,6,50,21150,28,956,57,1360,15494,22,433,64,1360,5656
0.028,17,2,221,1,50,0,50,78,1,115,0,115,143
371.119,6,23,1535,16,177,24741,177,1053,7,110,10385,110,482
1.235,6,6,328,4,0,411,0,216,2,0,1186,0,112
1751.339,6,113,9110,74,64,23990,64,5520,39,59,46085,116,3590
0.741,17,4,352,2,60,740,60,176,2,60,737,60,176
1.378,6,51,23356,29,1031,49,1460,17700,22,476,57,2615,5656
1.524,6,38,9848,21,440,76,1360,4392,17,476,82,2715,5456
164.495,17,4,352,2,60,164494,60,176,2,60,164494,60,176
1793.841,17,144,11520,72,48,25265,48,5472,72,56,25265,56,6048
0.979,17,4,624,2,64,978,64,184,2,192,859,192,440
5.281,6,43,8329,22,227,251,314,4062,21,489,250,1179,4267
0.232,17,8,2758,8,316,33,355,2758,0,0,0,0,0
1777.516,6,105,8406,68,64,26530,64,4896,37,58,49373,58,3510
16.565,6,325,266313,190,1341,87,1368,254083,135,899,122,2736,12230
15.197,6,21,6825,12,275,1381,275,1038,9,1353,1273,1440,5787
0.36,6,19,7099,11,318,35,600,1854,8,1205,50,1891,5245
85.209,17,4,352,2,60,85207,60,176,2,60,85208,60,176
240.211,6,52,17690,27,795,9238,1418,14929,25,181,10008,580,2761
1788.518,17,83,3480,82,14,22080,14,3444,1,8,0,8,36
38.781,17,11,836,11,48,3878,48,836,0,0,0,0,0
1792.574,6,4640,3850268,2096,131,855,350,118304,2544,1455,704,2816,3731964
599.644,6,10,617,7,31,99940,31,404,3,31,299020,31,213
562.997,17,6,444,3,30,281479,30,174,3,62,281475,62,270
1781.166,17,142,11360,71,48,25445,48,5396,71,56,25445,56,5964
0.848,17,4,820,2,36,843,36,128,2,318,843,318,692
0.061,6,9,1348,5,145,15,145,349,4,835,14,835,999
1681.616,17,14,3843,7,30,280267,30,406,7,463,280267,463,3437
1738.717,6,88,6417,58,31,30503,31,3927,30,31,59955,31,2490
1756.453,6,3738,4372707,1338,156,1313,924,81957,2400,1789,732,11216,4290750
85.282,17,2,672,2,308,85282,308,672,0,0,0,0,0
243.306,6,39,5545,20,302,12805,302,3766,19,83,13509,83,1779
1783.811,6,367,25581,213,99,8414,469,15005,154,69,11658,69,10576
1774.698,6,180,15480,120,69,14913,69,8940,60,69,30075,69,6540
108.276,6,995,488937,538,843,201,1152,464470,457,412,236,1179,24467
92.994,6,33,14370,16,488,322,1460,3127,17,959,5803,1460,11243
0.586,17,2,160,1,36,0,36,64,1,68,0,68,96
0.759,6,15,5933,8,128,108,128,552,7,1252,126,1472,5381
0.03,17,3,231,3,49,15,49,231,0,0,0,0,0
1.092,17,25,14086,13,850,91,1350,11414,12,194,94,1350,2672
280.209,6,27,7312,12,158,25473,267,1277,15,678,20010,2045,6035
14.055,6,299,242816,139,348,101,348,8360,160,1449,86,4344,234456
0.497,6,10,1042,5,213,124,213,417,5,421,104,421,625
0.033,17,2,136,1,32,0,32,60,1,48,0,48,76
189.255,6,66,11568,28,202,7009,1189,3557,38,294,5111,1420,8011
0.95,6,24,8663,14,264,73,700,1651,10,1100,86,2920,7012
38.494,17,11,836,11,48,3849,48,836,0,0,0,0,0
406.582,1,8,936,8,89,58083,142,936,0,0,0,0,0
19.68,17,12,1056,6,48,3934,48,456,6,72,3934,72,600
7.21,6,22,4426,12,213,655,597,1689,10,552,782,1767,2737
1.539,6,49,18587,26,844,61,1360,12891,23,433,60,1360,5696
0.196,17,5,1696,5,311,49,354,1696,0,0,0,0,0
5.332,6,40,7309,21,218,266,314,3463,19,513,282,1179,3846
1786.597,6,104,8444,68,66,26665,66,4964,36,60,51042,60,3480
0.005,17,4,420,2,33,0,33,122,2,121,2,145,298
234.583,17,4,240,2,32,234582,32,120,2,32,234582,32,120
1792.391,17,142,11360,71,48,25604,48,5396,71,56,25605,56,5964
75.371,6,36,7760,15,155,5383,267,1394,21,367,3766,1452,6366
5.594,6,40,8477,20,218,294,314,3423,20,607,280,1179,5054
1782.504,6,354,22440,207,69,8652,69,12420,147,69,12208,69,10020
1778.021,6,102,8228,68,64,26537,64,4896,34,58,53876,58,3332
1.421,17,4,240,2,32,1419,32,120,2,32,1420,32,120
1688.182,1,7,392,7,28,281363,28,392,0,0,0,0,0
1772.531,6,180,15480,120,69,14895,69,8940,60,69,30034,69,6540
34.933,17,20,1520,20,48,1838,48,1520,0,0,0,0,0
1770.514,6,99,9306,66,66,27238,66,5610,33,60,55324,60,3696
1739.973,6,162,11891,86,61,20470,208,6374,76,50,23195,224,5517
1.915,17,2,154,1,33,0,33,61,1,65,0,65,93
213.898,6,18,5839,10,784,23766,1360,3538,8,247,30524,272,2301
280.24,2,4,128,4,8,93413,8,128,0,0,0,0,0
36.893,6,48,10415,22,533,715,910,3107,26,312,1470,1460,7308
1701.633,17,12,498,11,14,170163,14,462,1,8,0,8,36
0.273,6,27,9098,13,262,22,690,1747,14,945,20,1408,7351
7.331,17,6,456,6,48,1466,48,456,0,0,0,0,0
1274.336,17,14,1117,7,31,212380,37,413,7,72,212381,136,704
366.87,6,27,1767,18,177,21580,177,1181,9,110,8798,110,586
1794.327,17,66,2766,65,14,28036,14,2730,1,8,0,8,36
1079.869,17,19,1769,19,65,59992,355,1769,0,0,0,0,0
146.247,17,14,1232,7,48,24372,48,532,7,72,24372,72,700
100.619,6,30,7432,13,158,8384,267,1317,17,543,6286,1400,6115
9.58,6,89,26613,45,546,217,1152,20371,44,407,216,1152,6242
0.095,6,9,1338,5,549,23,549,753,4,421,24,421,585
478.125,6,57,4396,27,88,14758,208,2948,30,31,16481,31,1448
280.427,6,31,7472,13,158,23368,267,1317,18,543,16493,1380,6155
1795.402,17,448,39896,403,35,4466,288,25676,45,288,40016,288,14220
1783.818,6,356,22520,208,69,8617,69,12460,148,69,12134,69,10060
27.883,6,28,7147,10,142,114,267,978,18,418,1629,1917,6169
93.653,6,63,39725,39,1142,2464,1368,31740,24,747,2680,1368,7985
1682.71,17,14,1036,7,30,280443,30,406,7,62,280443,62,630
0.187,6,14,2182,7,323,31,582,1006,7,396,23,580,1176
1767.303,6,100,7866,64,45,28052,205,4798,36,35,50488,98,3068
782.792,6,82,9369,44,85,18204,722,4095,38,117,20615,1448,5274
2.906,17,3,468,3,128,1453,128,468,0,0,0,0,0
374.583,6,18,1239,14,177,28814,177,913,4,110,20063,110,326
2.001,17,4,610,3,39,503,39,201,1,381,0,381,409
300.198,6,45,10442,23,611,13636,1360,4667,22,348,14286,2667,5775
3.241,6,40,24949,25,1093,135,1448,18801,15,893,188,1448,6148
549.721,1,22,1232,22,28,26177,28,1232,0,0,0,0,0
3.057,17,4,276,2,33,3051,33,122,2,49,3050,49,154
1783.877,1,342,28728,342,56,5231,56,28728,0,0,0,0,0
383.517,6,33,10366,21,159,19175,267,2926,12,772,728,1917,7440
1728.493,6,61,4452,40,33,44320,33,2740,21,31,86413,31,1712
32.159,17,18,1236,18,40,1891,41,1236,0,0,0,0,0
0.293,6,22,5040,10,137,32,267,1092,12,577,25,1400,3948
1787.368,6,102,8172,68,63,26677,64,4868,34,57,54159,58,3304
6.024,17,4,739,2,48,6020,48,152,2,265,6019,286,587
1742.58,6,96,7255,64,38,27660,205,4528,32,33,56199,98,2727
574.618,1,17,1768,0,0,0,0,0,17,76,35913,76,1768
0.499,6,30,16938,15,129,35,129,917,15,1269,35,1448,16021
1.294,6,47,18172,26,882,51,1360,12556,21,433,55,1360,5616
1798.634,17,578,154165,578,238,3117,422,154165,0,0,0,0,0
43.577,6,34,9488,14,327,124,1189,2535,20,472,2292,1917,6953
10.028,6,25,7132,9,154,1253,267,832,16,513,662,1460,6300
69.108,6,25,7097,12,155,6282,267,1266,13,589,5758,3426,5831
129.663,17,4,352,2,60,129662,60,176,2,60,129662,60,176
280.476,6,28,7352,12,158,25497,267,1277,16,678,18695,2760,6075
0.08,6,10,1723,6,578,15,997,1400,4,159,23,159,323
1796.764,1,345,28980,345,56,5223,56,28980,0,0,0,0,0
5.021,17,4,288,2,36,4999,36,128,2,52,5004,52,160
371.617,6,25,1651,17,177,23226,177,1117,8,110,9226,110,534
1788.149,6,358,22669,209,69,8596,69,12569,149,69,12082,69,10100
8.0,6,1346,1133180,739,1435,10,1448,1089212,607,776,12,1448,43968
285.092,6,21,1500,11,321,28508,321,901,10,83,31676,83,599
20.144,6,20,5366,12,107,1831,159,1074,8,967,2875,1675,4292
272.595,17,4,240,2,32,272594,32,120,2,32,272594,32,120
437.957,17,17,6603,17,360,27372,371,6603,0,0,0,0,0
0.01,17,4,420,2,33,3,33,122,2,121,2,145,298
1122.187,17,10,740,5,30,280540,30,290,5,62,280542,62,450
1.261,6,25,8056,12,164,98,267,1288,13,869,89,1448,6768
280.44,6,29,7392,14,158,21572,267,1357,15,678,20025,3456,6035
0.045,6,2,80,1,0,0,0,40,1,0,0,0,40
856.784,1,12,672,12,28,77889,28,672,0,0,0,0,0
882.539,2,6,192,6,8,176507,8,192,0,0,0,0,0
1149.661,6,241,17105,139,106,8330,469,10127,102,69,11382,69,6978
1766.738,6,261,25630,129,142,13802,208,19172,132,31,13483,31,6458
0.118,17,2,2748,2,1346,118,1346,2748,0,0,0,0,0
1795.115,1,266,14896,266,28,6774,28,14896,0,0,0,0,0
0.992,17,2,685,1,308,0,308,336,1,321,0,321,349
1744.657,2,26,832,26,8,69786,8,832,0,0,0,0,0
1.211,6,29,8671,15,236,73,625,2049,14,1008,77,1791,6622
1788.429,1,260,27560,260,78,6905,78,27560,0,0,0,0,0
97.068,6,46,9927,23,450,454,766,2801,23,387,4406,3488,7126
4.022,17,4,240,4,32,1340,32,240,0,0,0,0,0
187.18,17,4,240,2,32,187179,32,120,2,32,187179,32,120
0.307,6,26,9024,13,252,25,647,1692,13,949,25,2816,7332
300.384,6,83,14636,37,305,8342,1368,7125,46,232,6674,1368,7511
1.405,6,52,21498,29,913,50,1360,15802,23,433,56,1360,5696
368.593,6,21,1419,15,177,26328,177,989,6,110,12237,110,430
1785.807,6,115,13647,75,80,24132,500,5916,40,161,45787,1420,7731
51.66,6,8,2836,4,92,17220,92,296,4,1164,17057,1448,2540
0.0,17,1,1070,1,1042,0,1042,1070,0,0,0,0,0
0.579,6,4,160,2,0,579,0,80,2,0,1,0,80
59.922,6,9,1249,9,127,7490,127,1249,0,0,0,0,0
365.753,6,24,2351,17,141,22859,141,865,7,398,3905,419,1486
213.763,17,4,352,2,60,213761,60,176,2,60,213762,60,176
38.041,17,44,6468,22,48,1810,48,1672,22,190,1810,308,4796
3.061,17,4,1560,4,362,1020,362,1560,0,0,0,0,0
0.203,17,2,169,1,34,0,34,62,1,79,0,79,107
1120.903,17,10,2701,5,30,280207,30,290,5,454,280224,463,2411
248.425,6,67,13715,34,504,7527,1408,9863,33,163,7763,580,3852
78.497,6,30,5156,11,139,1182,152,722,19,244,4360,1485,4434
1779.814,1,342,28728,342,56,5219,56,28728,0,0,0,0,0
1789.851,1,263,14728,263,28,6831,28,14728,0,0,0,0,0
125.929,17,4,240,2,32,125928,32,120,2,32,125928,32,120
1784.838,6,364,25392,212,100,8458,469,14896,152,69,11820,69,10496
1.697,6,14,2351,8,188,242,245,700,6,703,288,1152,1651
84.103,17,4,288,2,36,84083,36,128,2,52,84085,52,160
4.359,17,4,824,2,48,4306,48,152,2,308,4333,308,672
299.796,6,6,364,4,31,99932,31,222,2,31,299772,31,142
280.608,6,30,7432,13,158,23384,267,1317,17,543,17532,1400,6115
240.284,6,46,9063,23,519,10921,1402,5891,23,196,10921,618,3172
7.94,6,19,9695,9,275,992,275,643,10,1440,842,1440,9052
907.016,6,53,4151,35,45,26676,205,2586,18,34,53336,98,1565
1791.503,17,395,129474,395,299,4546,422,129474,0,0,0,0,0
1788.299,1,114,6384,114,28,15825,28,6384,0,0,0,0,0
0.116,6,12,1755,7,314,19,500,1000,5,487,28,487,755
1799.735,1,58,4872,58,56,31574,56,4872,0,0,0,0,0
163.377,6,30,7432,14,158,12567,267,1357,16,603,10889,2036,6075
0.411,6,12,1653,6,288,79,288,548,6,426,43,434,1105
1.34,6,48,18949,26,940,53,1460,13293,22,433,55,1460,5656
1.036,17,4,560,2,64,870,64,184,2,160,761,160,376
1778.876,17,142,11360,71,48,25412,48,5396,71,56,25412,56,5964
79.675,17,4,1560,4,362,26558,548,1560,0,0,0,0,0
0.061,17,2,279,1,36,0,36,64,1,187,0,187,215
251.831,2,3,96,3,8,125915,8,96,0,0,0,0,0
97.463,6,79,54337,49,1207,2030,1368,46040,30,841,2134,2519,8297
8.146,1,9,756,0,0,0,0,0,9,56,1018,56,756
5.738,6,2,263,2,79,5738,128,263,0,0,0,0,0
0.473,6,12,1653,6,288,88,288,548,6,426,52,434,1105
1764.183,2,14,448,14,8,135706,8,448,0,0,0,0,0
579.49,6,27,2089,14,64,24915,64,1008,13,46,48284,58,1081
144.366,6,40,8244,16,141,9624,267,1495,24,304,6269,1420,6749
11.879,6,21,6825,11,275,1187,275,998,10,1353,1206,1440,5827
148.588,6,21,3550,7,92,24764,92,452,14,215,11416,1440,3098
0.516,6,82,54235,50,1276,10,1432,46784,32,513,15,1871,7451
1785.968,6,356,22520,208,69,8627,69,12460,148,69,12149,69,10060
21.301,17,42,11573,17,241,1329,1350,4579,25,251,886,1350,6994
18.988,6,99,30564,50,571,387,1152,23733,49,442,386,1179,6831
1794.323,17,66,2766,65,14,28036,14,2730,1,8,0,8,36
0.284,6,16,3769,8,75,40,75,586,8,1373,40,1448,3183
0.096,17,2,152,1,48,0,48,76,1,48,0,48,76
1772.072,6,180,15480,120,69,14891,69,8940,60,69,30034,69,6540
0.269,6,25,8816,13,227,22,547,1592,12,1098,24,2816,7224
0.014,6,9,1557,5,515,3,515,783,4,558,4,558,774
1786.614,1,345,28980,345,56,5193,56,28980,0,0,0,0,0
280.197,6,28,7352,13,158,23349,267,1317,15,678,20010,3436,6035
3.781,17,4,304,2,48,2904,48,152,2,48,1,48,152
300.732,6,44,9979,23,540,13669,1360,4244,21,348,613,2667,5735
0.171,6,3,132,2,0,15,0,92,1,0,0,0,40
3.004,17,4,296,4,46,1001,46,296,0,0,0,0,0
0.081,6,2,80,1,0,0,0,40,1,0,0,0,40
0.278,6,25,6039,12,164,25,453,1442,13,652,21,1448,4597
1751.117,17,12,498,11,14,175111,14,462,1,8,0,8,36
284.429,6,33,7661,15,149,20316,267,1502,18,543,16716,1400,6159
0.176,6,24,7176,12,155,16,267,1261,12,775,14,3445,5915
1799.4,1,345,28980,345,56,5230,56,28980,0,0,0,0,0
1361.255,1,12,978,12,53,123750,78,978,0,0,0,0,0
157.493,6,33,7874,12,141,14316,267,1335,21,355,7874,2840,6539
11.814,6,1865,1627305,1148,1363,10,1380,1594055,717,421,16,1923,33250
1750.756,6,95,7203,63,38,28238,205,4476,32,33,56465,98,2727
1363.967,6,166,25916,91,263,15155,799,16933,75,100,18398,223,8983
315.942,6,87,14769,38,190,8538,1305,4364,49,227,6579,2720,10405
15.029,6,6,328,4,0,5009,0,216,2,0,15008,0,112
528.427,1,7,392,7,28,88071,28,392,0,0,0,0,0
963.079,2,12,384,12,8,87552,8,384,0,0,0,0,0
3.741,6,34,6169,17,206,233,314,2744,17,456,217,1152,3425
10.075,6,78,21518,39,521,265,1152,16182,39,418,258,1152,5336
5.151,6,15,2264,6,279,994,279,902,9,174,621,272,1362
101.229,6,17,2341,10,324,11247,585,1177,7,396,16800,580,1164
1783.821,6,363,23076,209,69,8576,69,12569,154,69,11658,69,10507
1771.982,6,99,9306,66,66,27261,66,5610,33,60,55371,60,3696
0.968,1,10,840,10,56,107,56,840,0,0,0,0,0
1.48,6,47,20657,28,931,54,1360,15121,19,529,71,4075,5536
4.995,17,4,558,2,36,4990,36,128,2,187,4990,187,430
0.259,17,2,384,1,39,0,39,67,1,289,0,289,317
56.043,6,32,7771,11,156,9,267,1232,21,334,2801,2840,6539
240.311,6,40,8668,20,524,12647,1418,5764,20,232,12647,618,2904
2.03,17,3,358,2,40,2030,40,136,1,194,0,194,222
0.039,17,6,1548,3,60,14,60,264,3,400,13,400,1284
284.245,1,6,336,6,28,56849,28,336,0,0,0,0,0
86.407,6,30,7432,13,158,7200,267,1317,17,543,5398,1400,6115
230.333,17,4,304,2,48,230316,48,152,2,48,230316,48,152
1788.491,6,356,22520,208,69,8640,69,12460,148,69,12164,69,10060
1798.735,17,449,39928,404,35,4463,288,25708,45,288,40019,288,14220
180.68,6,24,2812,14,302,13898,302,1944,10,83,20073,83,868
1.219,6,25,5878,14,138,93,267,1533,11,975,111,1460,4345
4.955,6,185,133660,89,241,56,517,7517,96,1331,52,1408,126143
36.338,6,17,5751,10,272,4037,516,1220,7,849,113,1452,4531
0.358,6,27,9069,13,261,29,683,1728,14,943,26,1408,7341
1.558,6,48,19279,27,896,59,1360,13663,21,433,67,1360,5616
1.839,17,3,1008,3,308,919,308,1008,0,0,0,0,0
197.395,17,4,352,2,60,197394,60,176,2,60,197394,60,176
1744.665,2,24,768,24,8,75855,8,768,0,0,0,0,0
63.752,6,13,1079,12,43,5795,43,1019,1,0,0,0,60
297.226,6,63,8363,26,182,11888,585,3386,37,179,8256,580,4977
1.364,6,49,18876,27,864,52,1360,13220,22,476,55,2715,5656
1.57,6,50,18802,29,852,56,1360,13141,21,437,68,2715,5661
481.232,2,4,128,4,8,160410,8,128,0,0,0,0,0
8.044,6,79,24717,40,561,206,1152,19016,39,413,205,1152,5701
1736.994,1,50,4200,0,0,0,0,0,50,56,35448,56,4200
1784.633,17,140,11200,70,48,25864,48,5320,70,56,25864,56,5880
0.378,6,10,968,5,256,92,256,460,5,304,92,304,508
33.253,6,29,11481,15,752,2375,1360,3642,14,908,2545,1360,7839
1570.625,6,110,13109,69,83,23097,501,5450,41,167,39263,1420,7659
1799.421,1,60,5040,0,0,0,0,0,60,56,30498,56,5040
12.696,6,38,7249,18,218,746,314,3343,20,516,642,1179,3906
1783.962,17,85,3561,83,13,21753,14,3481,2,12,1783769,16,80
0.074,17,2,144,1,36,0,36,64,1,52,0,52,80
2.884,17,17,6765,8,520,407,1350,4386,9,236,356,1350,2379
1740.591,17,30,7050,30,207,60020,207,7050,0,0,0,0,0
1799.045,6,365,25570,213,99,8486,469,15005,152,69,11911,69,10565
379.136,6,27,1767,18,177,22302,177,1181,9,110,8808,110,586
1781.762,6,367,25981,213,105,8404,469,15405,154,69,11645,69,10576
313.696,6,61,32510,32,833,10114,1368,16685,29,950,11201,2736,15825
75.182,6,19,780,9,0,5409,0,364,10,0,8352,0,416
240.655,2,4,128,4,8,80218,8,128,0,0,0,0,0
0.029,17,2,384,1,32,0,32,60,1,296,0,296,324
11.798,6,30,6431,16,181,786,537,1766,14,652,828,1440,4665
1720.497,17,12,498,11,14,172049,14,462,1,8,0,8,36
13.924,6,96,29447,50,555,284,1152,23109,46,449,303,1179,6338
56.209,6,12,1055,6,332,11241,332,652,6,83,11203,83,403
55.091,6,26,7143,12,156,5008,267,1272,14,530,4237,2840,5871
244.602,6,53,9996,25,513,10191,1408,6013,28,193,9059,580,3983
0.413,6,8,335,4,0,137,0,164,4,7,68,7,171
50.531,6,16,3676,8,150,7218,174,624,8,681,7205,1452,3052
0.606,6,3,239,1,0,0,0,40,2,83,314,83,199
60.547,6,8,432,5,0,15136,0,268,3,0,30144,0,164
1772.371,6,180,15480,120,69,14893,69,8940,60,69,30035,69,6540
38.462,17,33,13014,16,430,2561,1350,7328,17,306,2401,1350,5686
240.284,6,45,7752,21,224,12014,584,2707,24,378,10446,957,5045
1.276,6,47,19191,27,893,49,1360,13615,20,476,58,2715,5576
4.179,6,32,6089,17,206,261,314,2744,15,548,280,1179,3345
93.378,17,4,240,2,32,93377,32,120,2,32,93377,32,120
1.31,17,2,154,1,33,0,33,61,1,65,0,65,93
1796.546,6,451,27527,241,69,7485,69,14125,210,43,8584,69,13402
166.606,6,29,7392,13,158,13883,267,1317,16,603,11103,1400,6075
0.971,6,51,33434,36,1167,27,1360,28332,15,561,57,2744,5102
0.046,17,2,180,1,30,0,30,58,1,94,0,94,122
0.382,6,12,1665,6,288,74,288,560,6,426,42,434,1105
12.064,6,2461,2291450,1574,1377,7,1408,2240662,887,931,13,2816,50788
1.619,6,50,18696,29,842,57,1360,13035,21,437,70,2715,5661
1.421,6,9,527,5,43,355,43,311,4,0,471,0,216
1.676,17,2,144,1,36,0,36,64,1,52,0,52,80
1784.879,6,362,24774,211,94,8499,469,14387,151,69,11899,69,10387
740.463,1,10,560,10,28,82273,28,560,0,0,0,0,0
1782.332,17,83,3480,82,14,22004,14,3444,1,8,0,8,36
0.632,6,3,187,1,0,0,0,40,2,31,263,31,147
1782.157,17,83,3480,82,14,22001,14,3444,1,8,0,8,36
311.927,6,21,1492,11,226,31192,226,822,10,110,11225,110,670
360.963,2,5,160,5,8,90240,8,160,0,0,0,0,0
300.786,6,45,9492,23,245,13672,633,1980,22,413,429,1360,7512
240.29,6,53,17748,28,794,8898,1418,14967,25,184,10011,580,2781
0.017,17,4,352,2,37,10,37,130,2,83,11,89,222
1.322,6,29,6387,14,164,101,267,1882,15,780,82,1460,4505
0.086,6,9,1343,5,145,21,145,349,4,830,24,830,994
261.706,6,78,14248,36,236,6070,1189,4530,42,320,6382,1420,9718
1772.511,6,202,22319,129,75,13847,267,10017,73,135,24611,2006,12302
0.234,6,2,80,0,0,0,0,0,2,0,0,0,80
280.305,6,28,7352,12,158,25482,267,1277,16,603,18683,1400,6075
1741.716,6,97,7338,64,38,27646,205,4528,33,33,54417,98,2810
0.069,6,10,767,5,186,17,186,454,5,45,13,45,313
1.358,6,45,18080,26,882,54,1360,12544,19,476,65,2715,5536
280.768,6,26,7475,11,181,28076,267,1168,15,570,20038,1400,6307
301.327,6,41,8909,22,280,14348,928,2345,19,445,510,3488,6564
0.023,17,2,136,1,32,0,32,60,1,48,0,48,76
0.891,6,10,1687,7,100,148,100,384,3,1179,316,1179,1303
280.23,6,27,7312,12,158,25475,267,1277,15,678,20013,2045,6035
0.898,6,30,13911,16,846,59,1360,6600,14,842,52,1360,7311
22.117,6,4366,4165640,2915,1353,7,1368,4085524,1451,931,15,2736,80116
280.746,6,31,7472,13,158,23395,267,1317,18,543,16510,1380,6155
300.244,6,33,12065,18,592,17661,1402,4522,15,844,17178,2804,7543
1792.162,1,58,4872,58,56,31441,56,4872,0,0,0,0,0
0.05,17,4,284,2,32,45,32,120,2,54,45,60,164
1675.153,1,7,392,7,28,279192,28,392,0,0,0,0,0
1.342,6,7,376,4,0,447,0,216,3,0,543,0,160
0.031,6,16,2969,8,391,3,588,1599,8,315,3,759,1370
0.08,6,10,1514,5,503,19,503,771,5,475,20,475,743
0.036,17,8,1670,8,180,5,219,1670,0,0,0,0,0
1.147,6,10,860,5,222,274,222,426,5,230,269,230,434
5.241,6,14,7913,6,275,1048,275,794,8,1359,503,1380,7119
1799.552,1,245,13720,245,28,7375,28,13720,0,0,0,0,0
11.389,6,2120,1932610,1330,1373,8,1408,1886866,790,776,14,1408,45744
1720.09,17,12,498,11,14,172009,14,462,1,8,0,8,36
1755.907,1,65,5460,65,56,27436,56,5460,0,0,0,0,0
280.588,6,57,8512,26,158,11223,267,1837,31,603,9351,2760,6675
303.436,6,206,123562,107,1131,2862,1448,44111,99,1092,475,1664,79451
351.307,17,5,1920,5,356,87826,356,1920,0,0,0,0,0
15.766,6,25,4660,13,204,1296,722,1715,12,579,1147,1448,2945
192.424,17,4,352,2,60,192423,60,176,2,60,192423,60,176
7.84,17,12,1764,6,48,1565,48,456,6,190,1565,308,1308
1787.868,17,294,57240,294,166,6101,358,57240,0,0,0,0,0
1793.974,17,144,11520,72,48,25267,48,5472,72,56,25267,56,6048
1740.746,6,87,6322,58,31,30539,31,3915,29,31,62169,31,2407
10.874,6,23,8063,8,402,1553,721,1530,15,539,762,1420,6533
20.815,17,4,5504,4,1348,6938,1348,5504,0,0,0,0,0
352.847,6,19,6297,3,106,53680,106,234,16,416,23502,1460,6063
1566.57,6,93,7465,61,66,26109,66,4354,32,59,50529,60,3111
1691.979,17,49,17224,49,323,35249,548,17224,0,0,0,0,0
0.281,6,21,5000,10,137,31,267,1092,11,577,27,1400,3908
353.755,6,42,19300,28,318,13102,1360,5615,14,1311,56,3510,13685
0.479,17,21,5929,9,324,58,1350,3176,12,201,39,1350,2753
39.296,6,2141,1670748,1169,1362,33,1380,1621358,972,421,40,1923,49390
0.008,17,2,245,1,37,0,37,65,1,152,0,152,180
1.349,6,47,17726,26,849,53,1360,12110,21,476,58,2715,5616
1781.845,6,435,28301,217,99,8249,469,15165,218,34,8211,64,13136
124.762,17,4,352,2,60,124761,60,176,2,60,124761,60,176
5.237,6,30,8872,15,158,374,267,1397,15,858,364,3436,7475
1683.005,17,14,1036,7,30,280493,30,406,7,62,280493,62,630
1781.65,6,352,22360,205,69,8733,69,12340,147,69,12202,69,10020
1774.127,6,181,15589,120,69,14908,69,8940,61,69,29562,69,6649
37.395,6,31,7262,18,124,2199,159,1704,13,695,3115,1418,5558
755.838,2,6,192,6,8,151167,8,192,0,0,0,0,0
8.201,6,18,6871,9,275,1025,275,643,9,1171,675,1440,6228
315.479,6,23,5479,9,133,39434,159,887,14,967,24267,1669,4592
1.274,17,27,16724,12,441,115,1350,5634,15,711,75,1350,11090
2.765,17,6,785,3,31,1378,31,177,3,174,1376,196,608
1793.199,17,144,11520,72,48,25254,48,5472,72,56,25254,56,6048
1788.934,6,362,22898,210,69,8559,69,12678,152,69,11844,69,10220
0.059,17,4,420,2,33,1,33,122,2,121,0,145,298
1.165,17,2,178,1,29,0,29,57,1,93,0,93,121
854.268,6,88,7591,55,69,15819,69,4063,33,69,26694,69,3528
457.882,17,79,35950,79,427,5870,453,35950,0,0,0,0,0
1799.429,1,16,896,16,28,119961,28,896,0,0,0,0,0
65.498,6,42,12854,19,450,165,1189,3924,23,533,2973,1460,8930
301.081,6,30,8870,14,419,23160,1002,2412,16,802,5468,1408,6458
0.251,17,2,304,1,60,0,60,88,1,188,0,188,216
280.185,6,28,7352,12,158,25471,267,1277,16,603,18678,1400,6075
188.361,6,13,772,4,106,62783,106,274,9,90,23543,90,498
0.912,6,16,2229,8,336,130,741,1349,8,274,105,396,880
1682.632,17,14,1036,7,30,280424,30,406,7,62,280428,62,630
0.427,17,2,180,1,30,0,30,58,1,94,0,94,122
1681.543,17,14,1036,7,30,280254,30,406,7,62,280255,62,630
4.046,6,38,7229,19,218,224,314,3383,19,513,211,1179,3846
0.467,6,12,1653,6,288,86,288,548,6,426,49,434,1105
367.029,6,20,1355,15,177,26216,177,977,5,110,15166,110,378
0.161,6,9,1339,5,145,40,145,349,4,826,50,826,990
1798.815,1,58,4872,0,0,0,0,0,58,56,31558,56,4872
0.042,6,13,3980,7,88,7,88,388,6,1670,8,2920,3592
0.11,6,10,1188,5,145,27,145,349,5,635,23,635,839
1799.899,6,276,23933,111,84,16362,369,11885,165,68,10974,1062,12048
290.334,1,3,180,3,32,145167,32,180,0,0,0,0,0
92.196,17,4,352,2,60,92195,60,176,2,60,92194,60,176
1778.447,6,84,6104,56,31,32335,31,3780,28,31,65868,31,2324
618.722,6,92,20631,42,323,15090,1460,10130,50,265,12618,1629,10501
1781.11,6,354,22440,207,69,8646,69,12420,147,69,12198,69,10020
0.021,17,3,660,2,64,13,64,184,1,448,0,448,476
115.73,6,1077,540199,590,847,196,1152,515928,487,398,237,1152,24271
1788.077,1,274,15344,274,28,6549,28,15344,0,0,0,0,0
1770.877,6,99,9240,66,65,27244,65,5577,33,59,55336,59,3663
1783.281,6,872,78156,448,213,3989,485,37580,424,72,4215,672,40576
280.491,6,30,7432,13,158,23374,267,1317,17,678,17528,4140,6115
280.437,6,29,7392,12,158,25494,267,1277,17,678,17524,2085,6115
0.763,6,23,7437,14,274,58,668,2109,9,1210,86,1946,5328
240.127,6,39,8652,19,165,13340,517,1990,20,623,12637,1402,6662
17.887,6,24,5065,11,255,1788,722,1591,13,310,1474,1408,3474
163.461,17,4,1344,4,308,54487,308,1344,0,0,0,0,0
59.784,6,595,277431,309,827,194,1152,260486,286,423,208,1179,16945
1799.351,17,450,39960,405,35,4453,288,25740,45,288,40019,288,14220
0.78,17,4,824,2,39,526,39,134,2,317,253,345,690
1791.227,6,356,22520,208,69,8653,69,12460,148,69,12184,69,10060
300.279,6,28,7011,13,158,25023,267,1317,15,636,21442,2076,5694
0.662,6,11,3650,6,170,128,170,490,5,1446,148,2675,3160
0.178,6,4,160,2,0,1,0,80,2,0,0,0,80
1793.104,1,58,4872,0,0,0,0,0,58,56,31457,56,4872
193.063,6,1727,851419,934,844,206,1152,811077,793,391,243,1179,40342
0.063,17,2,216,1,45,0,45,73,1,115,0,115,143
0.057,17,2,180,1,30,0,30,58,1,94,0,94,122
367.057,6,24,1575,15,177,26218,177,989,9,110,9141,110,586
20.823,17,4,1344,4,308,6941,308,1344,0,0,0,0,0
1787.181,6,102,8364,68,66,26674,66,4964,34,60,54143,60,3400
105.939,2,2,64,2,8,105939,8,64,0,0,0,0,0
591.022,6,118,21505,62,198,9688,469,9640,56,196,10741,1460,11865
157.375,6,28,12978,14,519,84,884,2681,14,972,12095,1503,10297
4.222,6,38,7229,19,218,234,314,3383,19,440,220,1152,3846
8.619,6,22,6636,7,154,1436,267,752,15,527,611,1997,5884
1791.255,6,249,36473,154,302,11707,302,26450,95,83,19055,83,10023
131.684,6,22,9571,12,372,63,802,1630,10,1505,14617,3117,7941
1797.545,1,58,4872,58,56,31535,56,4872,0,0,0,0,0
1.076,17,21,14668,12,1014,95,1350,12504,9,212,130,1350,2164
1192.062,2,8,256,8,8,170294,8,256,0,0,0,0,0
0.218,6,4,493,2,241,218,241,321,2,92,3,92,172
0.259,6,26,6149,14,181,19,537,1654,12,643,22,1542,4495
1750.505,6,198,13113,99,61,17862,208,8254,99,31,17859,31,4859
0.036,17,4,284,2,32,17,32,120,2,54,20,60,164
881.896,2,6,192,6,8,176379,8,192,0,0,0,0,0
9.997,6,15,2307,8,210,1425,210,856,7,545,1656,905,1451
0.073,17,4,1574,4,365,24,373,1574,0,0,0,0,0
31.056,17,6,638,6,78,6211,84,638,0,0,0,0,0
0.109,6,9,1002,5,213,27,213,417,4,421,20,421,585
1.591,6,46,17405,26,827,63,1360,11829,20,476,71,2720,5576
1787.485,6,102,8364,68,66,26678,66,4964,34,60,54161,60,3400
108.319,6,5202,4595059,3380,1281,31,1368,4495651,1822,931,59,2736,99408
1719.408,17,12,498,11,14,171940,14,462,1,8,0,8,36
209.356,6,22,4688,8,272,262,516,1140,14,298,16097,1452,3548
2.06,6,13,2311,8,188,294,245,700,5,1407,451,1407,1611
280.228,6,29,7392,13,158,23352,267,1317,16,603,18677,2036,6075
214.869,6,16,1161,7,31,35811,31,445,9,31,26836,31,716
192.876,6,22,6387,11,138,19286,267,1003,11,822,19286,1460,5384
1.801,6,27,10199,16,284,120,585,1497,11,1032,162,1412,8702
0.154,6,9,1343,5,145,38,145,349,4,830,24,830,994
0.165,6,43,17569,24,967,7,1420,12588,19,467,8,1883,4981
18.875,17,41,13549,21,455,942,1350,10158,20,141,991,1350,3391
53.739,6,30,7297,14,155,4133,267,1346,16,441,3582,1420,5951
122.081,17,4,352,2,60,122079,60,176,2,60,122080,60,176
2.072,17,2,144,1,36,0,36,64,1,52,0,52,80
132.657,6,41,8718,15,159,3678,267,1722,26,312,5306,2840,6996
0.199,6,2,80,1,0,0,0,40,1,0,0,0,40
0.424,6,7,295,4,0,141,0,164,3,7,107,7,131
13.66,17,4,3296,4,796,4553,1451,3296,0,0,0,0,0
1624.747,1,7,392,7,28,270791,28,392,0,0,0,0,0
0.026,6,18,6108,10,88,2,88,556,8,1305,3,1880,5552
1680.485,1,15,840,15,28,120034,28,840,0,0,0,0,0
33.39,6,27,4924,14,180,2568,722,1844,13,480,2768,2118,3080
3.992,6,11,467,6,0,798,0,248,5,7,742,7,219
0.169,1,2,112,2,28,169,28,112,0,0,0,0,0
2.117,17,2,685,1,308,0,308,336,1,321,0,321,349
1786.527,6,106,8644,70,66,25891,66,5044,36,60,51040,60,3600
240.19,6,53,19246,29,826,8577,1402,16392,24,199,10442,580,2854
2.353,6,270,284364,144,231,16,255,9872,126,2178,18,16416,274492
2.106,17,2,685,1,308,0,308,336,1,321,0,321,349
11.713,6,1873,1626812,1148,1363,10,1380,1593582,725,468,16,3303,33230
280.459,6,30,7432,14,158,21573,267,1357,16,678,18693,3456,6075
547.151,1,15,4972,15,303,39082,360,4972,0,0,0,0,0
105.643,6,91,60371,55,1217,1956,1448,50338,36,679,2834,1448,10033
1781.153,6,103,8395,68,65,26584,65,4930,35,59,52384,59,3465
316.95,6,102,35658,55,562,5869,1360,24749,47,322,6887,2720,10909
309.997,1,4,467,4,88,103332,105,467,0,0,0,0,0
504.368,2,4,128,4,8,168122,8,128,0,0,0,0,0
1657.805,6,105,11786,46,37,36839,37,2884,59,446,28582,446,8902
1335.421,6,266,16781,154,69,8728,69,9265,112,69,12030,69,7516
61.819,6,74,48738,44,1192,1437,1448,40449,30,746,2123,1448,8289
1784.998,6,233,27081,128,75,14055,267,9977,105,127,17159,1933,17104
0.168,6,27,7296,14,155,12,267,1341,13,603,13,2800,5955
82.666,6,21,8900,11,355,76,764,1539,10,1158,9166,2521,7361
33.707,6,36,5403,17,154,2106,722,1976,19,243,1861,1440,3427
6.744,6,18,10806,6,106,1348,106,354,12,996,612,1420,10452
4.651,6,41,7349,20,218,244,314,3423,21,440,219,1152,3926
1775.214,17,138,11040,69,48,26105,48,5244,69,56,26105,56,5796
33.611,6,31,5293,15,154,2400,722,1859,16,371,2227,2026,3434
382.902,17,11,836,11,48,38290,48,836,0,0,0,0,0
177.716,6,71,48159,45,1178,4039,1408,40073,26,960,2463,3847,8086
0.023,17,2,203,1,35,0,35,63,1,112,0,112,140
1794.671,17,87,3648,86,14,21113,14,3612,1,8,0,8,36
0.307,6,24,7437,12,334,27,663,1969,12,806,27,1408,5468
379.866,6,18,1242,14,180,29220,180,916,4,110,20079,110,326
3.399,17,3,1173,3,363,1699,363,1173,0,0,0,0,0
1777.482,17,142,11360,71,48,25392,48,5396,71,56,25392,56,5964
1746.141,6,94,6748,60,31,29595,31,4050,34,31,52904,31,2698
1783.288,17,142,11464,71,49,25475,136,5484,71,56,25475,72,5980
317.011,6,82,19655,38,330,8567,1460,9808,44,260,7368,3089,9847
7.56,6,612,513671,371,1314,19,1368,496475,241,776,30,1473,17196
42.384,17,14,1064,14,48,3260,48,1064,0,0,0,0,0
0.418,6,12,1653,6,288,82,288,548,6,426,44,434,1105
0.005,17,2,176,1,52,0,52,80,1,68,0,68,96
0.285,17,2,2384,2,1164,285,1164,2384,0,0,0,0,0
1.635,6,31,13206,18,517,96,1360,3351,13,1165,97,3921,9855
72.623,6,48,9092,24,360,491,766,2145,24,351,3148,2128,6947
0.249,17,2,152,1,48,0,48,76,1,48,0,48,76
3.204,17,5,295,5,31,801,31,295,0,0,0,0,0
0.01,17,2,353,1,36,0,36,64,1,261,0,261,289
1799.647,17,448,39896,403,35,4476,288,25676,45,288,40022,288,14220
6.081,6,20,6308,10,262,666,517,1316,10,893,666,2451,4992
1680.663,1,15,840,15,28,120047,28,840,0,0,0,0,0
0.326,6,28,9133,14,261,25,683,1780,14,943,24,1408,7353
1798.76,1,58,4872,0,0,0,0,0,58,56,31557,56,4872
957.819,1,14,784,14,28,73678,28,784,0,0,0,0,0
2.061,17,3,174,3,30,1030,30,174,0,0,0,0,0
0.357,6,2,421,1,0,0,0,40,1,341,0,341,381
6.134,17,4,240,2,32,6133,32,120,2,32,6133,32,120
1794.55,17,87,3648,86,14,21112,14,3612,1,8,0,8,36
54.323,6,36,8360,18,378,507,786,1886,18,478,3188,2128,6474
2.056,6,20,4960,10,137,228,267,1092,10,692,202,1467,3868
0.505,17,3,543,2,39,9,39,134,1,381,0,381,409
1602.924,6,24,3973,16,262,106861,413,2740,8,114,228963,269,1233
240.227,6,53,16641,28,731,8897,1402,13901,25,179,10009,580,2740
0.404,6,10,1671,6,552,80,948,1348,4,159,134,159,323
517.024,6,30,2180,16,31,28115,31,1080,14,31,39758,31,1100
1797.951,6,416,24920,208,69,8685,69,12460,208,34,8685,48,12460
0.062,17,2,144,1,36,0,36,64,1,52,0,52,80
1779.908,17,142,11360,71,48,25427,48,5396,71,56,25427,56,5964
1776.021,6,180,15480,120,69,14924,69,8940,60,69,30099,69,6540
33.633,6,30,5042,15,154,2402,722,1859,15,399,2389,1408,3183
280.273,6,28,7352,12,158,25479,267,1277,16,543,18681,1400,6075
2.465,6,14,2351,8,188,352,245,700,6,703,441,1152,1651
1750.747,17,12,498,11,14,175074,14,462,1,8,0,8,36
5.021,17,4,288,2,36,5004,36,128,2,52,5005,52,160
1031.755,17,47,17174,47,337,22429,548,17174,0,0,0,0,0
0.231,17,4,284,2,32,1,32,120,2,54,1,60,164
1740.916,6,87,6322,58,31,30542,31,3915,29,31,62175,31,2407
1770.648,6,99,9306,66,66,27240,66,5610,33,60,55329,60,3696
0.021,17,4,284,2,32,13,32,120,2,54,9,60,164
185.091,17,2,672,2,308,185091,308,672,0,0,0,0,0
0.451,6,28,6224,14,164,34,453,1570,14,651,31,2194,4654
0.269,6,22,5040,11,137,26,267,1132,11,577,26,1400,3908
0.225,17,2,780,2,362,225,362,780,0,0,0,0,0
300.169,6,47,16486,26,888,11999,1360,10844,21,399,15000,1360,5642
1798.519,17,447,39580,403,35,4473,288,25676,44,288,40950,288,13904
195.358,17,4,352,2,60,195357,60,176,2,60,195357,60,176
15.481,17,20,2940,10,48,1718,48,760,10,190,1715,308,2180
1772.082,6,180,15480,120,69,14891,69,8940,60,69,30033,69,6540
300.804,2,5,160,5,8,75201,8,160,0,0,0,0,0
7.379,6,6,336,2,0,7379,0,112,4,0,2367,0,224
1.166,6,24,8004,12,164,90,267,1288,12,1014,90,2423,6716
361.464,6,47,10410,29,284,12909,1360,4888,18,399,507,1360,5522
0.145,6,46,21155,26,1076,5,1420,16134,20,467,7,1883,5021
1777.213,17,140,11200,70,48,25756,48,5320,70,56,25756,56,5880
12.44,6,1867,1662045,1168,1368,10,1380,1628856,699,467,17,1923,33189
240.316,6,44,8468,22,449,11443,1418,5648,22,208,11443,580,2820
254.469,1,14,784,14,28,19574,28,784,0,0,0,0,0
87.666,6,19519,20573524,6361,650,13,652,365949,13158,1484,6,5792,20207575
0.412,6,10,1992,5,288,97,288,508,5,424,57,434,1484
0.082,17,2,322,1,33,0,33,61,1,233,0,233,261
7.484,17,3,228,3,48,3742,48,228,0,0,0,0,0
364.524,6,98,13628,49,158,7593,1189,4970,49,247,7594,1420,8658
1771.059,6,99,9240,66,65,27247,65,5577,33,59,55342,59,3663
223.349,6,33,8038,10,130,24815,267,1324,23,304,10151,1460,6714
1744.724,2,29,928,29,8,62311,8,928,0,0,0,0,0
0.756,6,26,5680,14,121,58,267,1295,12,650,61,1414,4385
0.052,17,2,273,1,35,0,35,63,1,182,0,182,210
11.935,6,1770,1629528,1151,1363,10,1420,1600417,619,475,19,1883,29111
1738.158,1,56,4704,0,0,0,0,0,56,56,31602,56,4704
1.356,6,23,7952,13,164,96,267,1340,10,1216,126,3859,6612
2.228,6,14,2351,8,188,318,245,700,6,703,396,1152,1651
10.522,6,95,30233,49,577,219,1152,23911,46,407,228,1152,6322
1740.678,17,30,20190,30,645,60023,645,20190,0,0,0,0,0
42.367,17,24,2112,12,48,3850,48,912,12,72,3850,72,1200
11.758,6,1859,1624810,1126,1389,10,1420,1591257,733,467,16,1883,33553
0.427,6,3,144,2,0,1,0,92,1,0,0,0,52
0.146,6,9,1050,5,261,36,261,465,4,421,40,421,585
240.201,6,53,18263,28,819,8896,1402,15401,25,194,10008,580,2862
129.044,6,19,6693,6,182,25808,267,979,13,648,10749,1942,5714
0.224,6,143,106612,76,345,2,345,4305,67,1520,2,2736,102307
4.624,6,45,8409,22,227,220,314,4062,23,427,199,1152,4347
1744.617,2,25,800,25,8,72692,8,800,0,0,0,0,0
253.765,17,4,352,2,60,253763,60,176,2,60,253764,60,176
294.844,1,4,224,4,28,98281,28,224,0,0,0,0,0
240.261,6,56,19799,30,808,8284,1408,16921,26,189,9610,580,2878
1771.769,1,110,6160,110,28,16254,28,6160,0,0,0,0,0
240.281,6,44,9290,21,528,12013,1408,5868,23,246,10921,617,3422
289.487,6,43,7710,22,147,13782,517,2047,21,456,14472,1418,5663
0.256,17,2,387,1,39,0,39,67,1,292,0,292,320
0.305,6,22,4442,11,165,30,456,1394,11,493,29,888,3048
172.847,17,4,240,2,32,172845,32,120,2,32,172846,32,120
22.442,6,14,820,6,0,4488,0,340,8,0,2145,0,480
122.025,6,53,30200,27,840,330,1460,6215,26,1207,4875,2149,23985
1798.907,17,448,39896,403,35,4474,288,25676,45,288,40021,288,14220
1.57,6,47,19085,27,885,60,1360,13509,20,433,71,1360,5576
62.388,6,76,52475,47,1193,1356,1368,44230,29,841,2218,2519,8245
240.215,6,53,17866,28,799,8896,1402,15063,25,186,10008,580,2803
11.749,6,1875,1623999,1135,1376,10,1420,1590178,740,467,15,1883,33821
10.525,6,18,5610,10,275,1169,275,958,8,1440,790,1440,4652
1743.604,6,95,7203,63,38,28122,205,4476,32,33,56236,98,2727
0.091,6,10,1671,6,552,17,948,1348,4,159,30,159,323
280.193,6,29,7392,13,158,23349,267,1317,16,603,18677,2036,6075
1787.07,6,108,8604,68,66,26672,66,4964,40,60,45818,60,3640
1674.613,2,12,384,12,8,152237,8,384,0,0,0,0,0
10.425,6,91,27354,46,565,231,1152,21072,45,447,231,1179,6282
7.222,6,1356,1254585,861,1381,8,1408,1224181,495,931,14,2801,30404
53.793,6,10,703,5,275,13448,275,483,5,0,2266,0,220
1746.78,6,96,7255,62,38,28635,205,4424,34,33,52920,98,2831
10.557,6,20,4390,11,275,1055,275,998,9,755,728,1414,3392
1778.55,17,140,11200,70,48,25775,48,5320,70,56,25775,56,5880
1787.922,6,370,25770,214,99,8393,469,15114,156,69,11534,69,10656
265.152,6,30,7432,13,158,22096,267,1317,17,543,16569,1400,6115
3.785,6,2,88,2,0,0,0,88,0,0,0,0,0
135.274,6,42,10969,21,865,776,1360,5234,21,348,6755,2667,5735
301.807,6,59,26633,34,1067,9145,1440,20602,25,358,401,1440,6031
1786.673,17,87,3648,86,14,21019,14,3612,1,8,0,8,36
1799.88,6,417,36978,188,67,9624,659,13898,229,88,7893,4658,23080
1790.536,6,356,22520,208,69,8649,69,12460,148,69,12180,69,10060
1772.856,6,180,15480,120,69,14897,69,8940,60,69,30047,69,6540
280.581,6,25,7094,11,181,28058,267,1168,14,595,21566,1400,5926
0.03,6,9,11624,1,0,0,0,40,8,1396,3,1396,11584
1735.935,1,56,4704,56,56,31562,56,4704,0,0,0,0,0
2.626,2,2,64,2,8,2626,8,64,0,0,0,0,0
0.975,17,6,606,3,33,478,33,183,3,113,476,145,423
1799.901,17,449,39928,404,35,4466,288,25708,45,288,40020,288,14220
1796.411,6,388,23800,208,69,8678,69,12460,180,45,10035,69,11340
1783.805,6,369,23385,213,69,8414,69,13005,156,69,11508,69,10380
6.826,6,488,436613,320,1307,20,1368,423213,168,776,39,1473,13400
1786.816,6,104,8376,68,65,26668,65,4930,36,59,51048,59,3446
1799.593,6,367,25650,214,99,8448,469,15045,153,69,11836,69,10605
310.016,6,51,23931,30,1043,10690,1408,16265,21,596,3210,2816,7666
14.41,17,4,1576,4,366,4803,548,1576,0,0,0,0,0
0.53,6,306,249034,169,198,3,253,10738,137,1725,3,7040,238296
0.183,6,27,7296,13,155,15,267,1301,14,543,13,1400,5995
0.284,6,12,2069,7,324,47,585,1009,5,396,62,580,1060
1.441,6,3,1560,1,0,0,0,40,2,1440,0,1440,1520
3.905,6,15,5185,4,288,1243,288,468,11,710,373,853,4717
198.113,17,4,530,2,36,198108,36,128,2,173,198108,187,402
13.702,6,29,4970,14,154,1036,722,1819,15,338,965,1448,3151
46.213,6,49,10455,23,533,709,910,3147,26,312,1843,1460,7308
3.894,17,5,290,5,30,973,30,290,0,0,0,0,0
1773.234,6,181,15589,120,69,14901,69,8940,61,69,29549,69,6649
1740.378,6,87,6322,58,31,30532,31,3915,29,31,62156,31,2407
40.262,6,1939,1691135,1182,1375,34,1380,1652556,757,355,53,1380,38579
0.038,17,2,279,1,36,0,36,64,1,187,0,187,215
240.188,6,53,17928,28,806,8895,1408,15171,25,181,10007,580,2757
0.885,17,2,148,2,46,885,46,148,0,0,0,0,0
1688.941,17,16,1265,8,30,241274,37,471,8,71,241274,136,794
16.215,17,17,8209,8,373,2308,1350,3215,9,526,2016,1350,4994
0.266,17,4,624,2,64,264,64,184,2,192,147,192,440
0.515,17,3,451,2,39,464,39,134,1,289,0,289,317
9.929,6,84,24565,42,533,242,1152,18744,42,413,235,1152,5821
19.048,17,21,13586,10,571,2112,1350,5994,11,662,1901,1350,7592
0.013,17,2,152,1,48,0,48,76,1,48,0,48,76
1326.024,6,134,11501,88,69,15241,69,6625,46,69,29466,69,4876
1.33,6,24,8004,12,164,103,267,1288,12,1014,103,2411,6716
1786.53,6,102,8364,68,66,26664,66,4964,34,60,54134,60,3400
280.292,6,24,7054,11,181,28029,267,1168,13,670,23351,1400,5886
0.026,6,3,127,1,0,0,0,40,2,7,0,7,87
5.255,6,40,7309,20,218,276,314,3423,20,513,261,1179,3886
45.947,17,44,11418,44,231,1068,389,11418,0,0,0,0,0
1797.79,1,196,20776,196,78,9219,78,20776,0,0,0,0,0
15.07,6,21,6416,10,154,1674,267,872,11,728,1506,3417,5544
1784.294,6,356,22520,208,69,8619,69,12460,148,69,12137,69,10060
0.275,6,22,4442,11,165,27,456,1394,11,493,26,888,3048
179.021,17,4,352,2,60,179020,60,176,2,60,179020,60,176
193.703,17,4,5508,4,1349,64567,1349,5508,0,0,0,0,0
121.033,17,3,228,3,48,60516,48,228,0,0,0,0,0
1799.83,6,277,33624,112,141,16213,1460,16536,165,126,10973,1460,17088
1769.68,6,128,17928,80,229,22400,1302,12363,48,91,37652,268,5565
249.072,17,4,304,4,48,83024,48,304,0,0,0,0,0
1.902,17,2,178,1,29,0,29,57,1,93,0,93,121
40.962,1,44,4576,0,0,0,0,0,44,76,952,76,4576
0.382,6,18,3068,9,282,47,531,1606,9,493,28,828,1462
0.004,17,2,294,1,48,0,48,76,1,190,0,190,218
7.949,17,16,3428,8,45,1129,45,584,8,327,1127,339,2844
10.232,6,15,3586,9,142,1279,142,506,6,945,2007,1380,3080
1790.31,6,342,31599,167,388,10785,841,12210,175,61,10287,1418,19389
1.956,6,18,2405,9,324,244,585,1121,9,396,242,580,1284
8.428,6,17,6735,9,275,1053,275,643,8,1440,767,1440,6092
3.044,6,16,3269,6,92,608,92,400,10,579,305,1408,2869
15.701,17,19,13441,11,985,1562,1350,11153,8,258,2232,1350,2288
1745.707,6,139,8801,76,49,23276,208,5382,63,31,28150,31,3419
14.806,6,6,360,1,0,0,0,60,5,0,3700,0,300
0.157,17,2,184,1,32,0,32,60,1,96,0,96,124
357.402,6,17,1190,13,180,29783,180,864,4,110,20098,110,326
0.049,17,2,116,1,30,0,30,58,1,30,0,30,58
1125.371,17,15,1143,9,30,140669,37,529,6,74,224276,136,614
726.317,17,80,6086,76,30,9684,37,4422,4,388,114162,463,1664
120.369,2,3,96,3,8,60184,8,96,0,0,0,0,0
200.047,6,31,8912,14,158,15388,267,1357,17,687,12497,2036,7555
0.148,6,10,1380,6,145,29,145,389,4,827,44,827,991
1798.164,17,450,39960,405,35,4450,288,25740,45,288,40024,288,14220
0.098,6,9,1346,5,145,24,145,349,4,833,28,833,997
0.016,17,2,283,1,31,0,31,59,1,196,0,196,224
291.734,6,249,40150,143,304,2054,304,28320,106,83,2778,83,11830
1796.85,1,152,8512,152,28,11899,28,8512,0,0,0,0,0
8.907,6,28,5887,15,197,636,314,2185,13,529,720,1179,3702
46.812,6,24,3187,13,177,3901,177,1923,11,110,4634,110,1264
1383.726,2,11,352,11,8,138372,8,352,0,0,0,0,0
1744.724,2,27,864,27,8,67104,8,864,0,0,0,0,0
60.152,17,5,1725,5,317,15038,317,1725,0,0,0,0,0
11.771,6,900,828660,593,1328,19,1368,808008,307,931,37,2736,20652
221.32,17,4,352,2,60,221319,60,176,2,60,221319,60,176
83.105,6,22,900,10,0,5540,0,408,12,0,7552,0,492
280.457,6,28,7352,12,158,25496,267,1277,16,678,18694,2085,6075
1799.456,17,449,39928,404,35,4465,288,25708,45,288,40015,288,14220
1790.743,6,363,25421,212,99,8486,469,14965,151,69,11938,69,10456
1784.071,6,356,22520,208,69,8618,69,12460,148,69,12136,69,10060
280.3,6,29,7392,13,158,23358,267,1317,16,603,18682,2036,6075
1748.591,6,100,7860,66,45,26901,205,4896,34,35,52980,98,2964
16.209,17,15,6190,7,511,2683,1350,3776,8,273,2299,1350,2414
601.607,2,7,224,7,8,100267,8,224,0,0,0,0,0
66.301,6,28,8662,15,434,4735,659,2126,13,585,5504,1408,6536
49.312,17,4,352,2,60,49311,60,176,2,60,49311,60,176
13.125,17,2,672,2,308,13125,308,672,0,0,0,0,0
79.805,6,30,7432,13,158,6650,267,1317,17,543,4985,1400,6115
300.656,6,42,8661,22,266,14316,720,2014,20,389,810,2720,6647
20.269,6,22,2706,12,210,1838,210,1068,10,545,2057,904,1638
1786.269,6,109,8830,71,66,25518,66,5150,38,60,48274,60,3680
828.437,6,101,17685,56,109,15062,721,6283,45,479,8736,1440,11402
2.239,6,27,9176,13,268,186,710,1794,14,947,169,1368,7382
1744.26,6,97,7307,63,38,28133,205,4476,34,33,52848,98,2831
1787.164,6,102,8364,68,66,26674,66,4964,34,60,54153,60,3400
0.001,6,3,2880,2,1368,1,1368,2840,1,0,0,0,40
553.896,1,6,336,6,28,110779,28,336,0,0,0,0,0
1140.078,17,164,12464,164,48,6994,48,12464,0,0,0,0,0
364.498,6,27,1767,18,177,21441,177,1181,9,110,8506,110,586
11.607,6,25,8473,13,275,967,275,1078,12,986,762,1440,7395
99.481,17,4,352,2,60,99480,60,176,2,60,99480,60,176
26.201,1,6,336,6,28,5240,28,336,0,0,0,0,0
34.51,6,4588,4313094,2985,1366,11,1408,4225074,1603,931,21,2816,88020
1750.454,6,97,7307,63,38,28233,205,4476,34,33,53034,98,2831
12.349,6,1890,1711434,1210,1364,10,1380,1679992,680,421,18,1923,31442
0.03,6,3,182,2,31,30,31,111,1,31,0,31,71
1786.686,6,142,19932,85,222,21270,1288,12959,57,104,31903,247,6973
1797.847,6,448,105243,201,468,8988,1440,71972,247,193,7307,1440,33271
280.413,6,30,7432,13,158,23367,267,1317,17,603,17522,2760,6115
294.27,6,31,5289,13,517,24521,517,1233,18,518,17309,1418,4056
1796.786,6,371,25879,216,99,8357,469,15194,155,69,11665,69,10685
366.259,6,21,1419,15,177,26161,177,989,6,110,12226,110,430
191.59,17,4,352,2,60,191589,60,176,2,60,191589,60,176
317.013,6,77,19025,39,315,8342,1460,9786,38,335,8563,1629,9239
0.04,17,2,164,1,46,0,46,74,1,62,0,62,90
200.599,6,9,515,5,43,50149,43,299,4,0,66864,0,216
653.339,6,12,728,8,31,93334,31,444,4,31,217775,31,284
1075.781,17,44,1848,44,14,25018,14,1848,0,0,0,0,0
0.335,6,27,9086,13,262,27,690,1735,14,945,25,1402,7351
0.469,6,27,8984,13,243,39,611,1656,14,941,33,1368,7328
1785.848,6,104,8376,68,65,26654,65,4930,36,59,51021,59,3446
258.41,1,6,336,6,28,51682,28,336,0,0,0,0,0
1.157,6,12,3702,6,170,228,170,490,6,964,193,1448,3212
16.735,6,25,4820,12,179,1521,722,1718,13,479,1376,2118,3102
274.088,17,4,352,2,60,274086,60,176,2,60,274087,60,176
0.127,17,2,572,1,39,0,39,67,1,477,0,477,505
33.588,6,33,5256,16,180,2224,721,1922,17,271,2086,1368,3334
34.15,6,26,10040,8,154,4878,267,792,18,709,1991,1452,9248
6.2,6,539,469552,336,1331,17,1368,454332,203,776,29,2736,15220
1680.427,1,15,870,15,30,120030,30,870,0,0,0,0,0
182.304,1,14,2423,14,145,14023,275,2423,0,0,0,0,0
1795.363,17,446,39036,402,35,4477,288,25380,44,282,40953,288,13656
0.008,6,3,182,2,31,8,31,111,1,31,0,31,71
0.009,17,2,402,1,59,0,59,87,1,287,0,287,315
1795.228,17,448,39896,403,35,4465,288,25676,45,288,40016,288,14220
125.673,2,2,64,2,8,125673,8,64,0,0,0,0,0
0.187,17,2,146,1,37,0,37,65,1,53,0,53,81
372.12,6,18,1242,14,180,28624,180,916,4,110,20061,110,326
71.788,17,4,240,2,32,71787,32,120,2,32,71787,32,120
4.007,17,8,1288,4,33,1333,33,244,4,233,1333,233,1044
0.927,6,25,9852,13,350,77,1041,1952,12,1058,69,1360,7900
281.294,6,28,7352,13,158,23441,267,1317,15,603,20078,2036,6035
1786.586,6,356,22520,208,69,8630,69,12460,148,69,12153,69,10060
0.032,17,2,467,1,33,0,33,61,1,378,0,378,406
1799.884,1,58,4872,58,56,31576,56,4872,0,0,0,0,0
280.459,6,28,7352,13,158,23371,267,1317,15,678,20025,3456,6035
280.318,17,4,296,2,30,280300,30,116,2,62,280298,62,180
0.056,1,9,756,9,56,7,56,756,0,0,0,0,0
3.075,17,3,422,2,32,3063,32,120,1,274,0,274,302
1.01,17,2,148,2,46,1010,46,148,0,0,0,0,0
1.964,1,2,112,2,28,1964,28,112,0,0,0,0,0
175.177,17,2,72,1,8,0,8,36,1,8,0,8,36
0.06,17,4,420,2,33,15,33,122,2,121,47,145,298
1785.969,6,357,22629,208,69,8627,69,12460,149,69,12066,69,10169
1.726,17,6,501,3,39,835,39,201,3,72,0,72,300
0.026,6,3,136,2,0,26,0,88,1,0,0,0,48
200.981,17,4,1560,4,362,66993,548,1560,0,0,0,0,0
2.12,6,14,2351,8,188,302,245,700,6,703,370,1152,1651
4.666,6,38,7229,19,218,259,314,3383,19,513,244,1179,3846
1.339,6,40,9985,22,502,63,1440,4444,18,400,68,1440,5541
1796.447,17,85,3564,84,14,21643,14,3528,1,8,0,8,36
367.205,6,25,1651,17,177,22950,177,1117,8,110,9920,110,534
82.045,17,2,122,2,33,82045,33,122,0,0,0,0,0
879.668,6,216,22159,113,139,7854,1189,9961,103,171,8623,1460,12198
143.475,17,4,352,2,60,143474,60,176,2,60,143474,60,176
34.332,1,40,4160,0,0,0,0,0,40,76,880,76,4160
1.594,6,20,3833,11,234,159,564,1504,9,463,176,1343,2329
17.147,17,23,6754,9,275,2139,1350,2730,14,259,1316,1350,4024
300.232,6,61,44116,38,145,8114,230,2636,23,2119,13646,6074,41480
0.035,17,2,357,1,44,0,44,72,1,257,0,257,285
1788.3,6,98,7421,65,38,27942,205,4611,33,33,55877,98,2810
261.112,17,4,240,2,32,261111,32,120,2,32,261111,32,120
1779.307,17,391,99813,391,227,4562,422,99813,0,0,0,0,0
1771.242,6,103,9514,66,66,27249,66,5610,37,60,49198,60,3904
0.331,6,28,9145,13,252,27,646,1694,15,832,22,1438,7451
0.954,17,2,677,1,300,0,300,328,1,321,0,321,349
1741.17,6,87,6322,58,31,30546,31,3915,29,31,62183,31,2407
201.581,17,4,352,2,60,201580,60,176,2,60,201580,60,176
4.243,6,13,2311,8,188,606,245,700,5,1407,996,1407,1611
0.516,6,22,7300,13,325,43,626,1984,9,1210,61,1946,5316
1680.495,17,29,6699,29,203,60017,203,6699,0,0,0,0,0
1.345,6,23,7952,11,164,114,267,1236,12,1014,103,2491,6716
5.488,6,40,7309,21,218,274,314,3463,19,440,291,1152,3846
0.071,17,4,352,2,60,53,60,176,2,60,56,60,176
240.166,6,53,15949,28,681,8894,1402,13049,25,199,10006,580,2900
1793.582,17,144,11520,72,48,25261,48,5472,72,56,25261,56,6048
3.96,17,3,222,3,46,1980,46,222,0,0,0,0,0
0.063,17,2,235,1,36,0,36,64,1,143,0,143,171
1787.755,6,102,8296,68,65,26682,65,4930,34,59,54170,59,3366
174.535,6,120,90529,76,1269,2327,1408,80119,44,811,1761,3847,10410
63.908,6,26,7073,7,140,10651,267,849,19,419,3545,1460,6224
9.054,6,81,24461,41,550,226,1152,18720,40,459,224,1179,5741
5.187,17,4,304,4,48,1729,48,304,0,0,0,0,0
503.278,2,4,128,4,8,167759,8,128,0,0,0,0,0
0.344,17,8,2766,8,317,49,356,2766,0,0,0,0,0
0.367,6,23,6012,12,181,33,537,1526,11,781,34,2224,4486
0.282,17,7,2382,7,312,47,356,2382,0,0,0,0,0
2.029,17,7,667,4,33,558,33,244,3,113,823,145,423
1782.689,1,122,6832,122,28,14732,28,6832,0,0,0,0,0
1744.727,2,30,960,30,8,60163,8,960,0,0,0,0,0
288.455,1,4,224,4,28,96151,28,224,0,0,0,0,0
0.748,17,3,238,2,30,725,30,116,1,94,0,94,122
318.46,17,18,1584,9,48,39805,48,684,9,72,39805,72,900
0.305,17,4,240,2,32,304,32,120,2,32,304,32,120
280.505,6,29,7392,13,158,23375,267,1317,16,603,18693,2076,6075
3.768,6,16,1875,8,304,538,304,1324,8,83,448,83,551
1778.021,1,60,5040,60,56,30135,56,5040,0,0,0,0,0
0.71,6,27,13011,15,853,50,1360,5751,12,1128,49,4445,7260
248.11,6,30,8872,14,158,19085,267,1357,16,858,16536,3456,7515
1710.131,1,8,448,8,28,244304,28,448,0,0,0,0,0
0.561,6,20,7252,13,337,46,674,2032,7,1212,85,1946,5220
1773.497,6,180,15480,120,69,14903,69,8940,60,69,30051,69,6540
1797.593,6,216,17246,80,76,22754,375,8397,136,50,13313,143,8849
6.035,17,4,1344,4,308,2011,308,1344,0,0,0,0,0
1760.507,6,80,3680,40,0,45141,0,2080,40,0,45141,0,1600
1787.05,6,356,22865,203,69,8846,69,12260,153,69,11756,69,10605
1796.83,17,144,11520,72,48,25307,48,5472,72,56,25307,56,6048
63.926,6,37,9187,16,327,138,1189,2615,21,440,3195,1420,6572
174.936,6,104,80213,70,1234,2535,1408,70321,34,811,3434,3847,9892
0.489,6,22,7354,13,335,40,668,2026,9,1210,55,1946,5328
34.543,6,33,6069,16,154,2302,721,1923,17,407,2145,2026,4146
111.008,6,30,18589,18,702,50,1360,4967,12,1875,10079,6247,13622
1.449,6,26,7430,14,350,110,1089,2316,12,771,130,1420,5114
5.117,6,43,7429,22,201,243,314,3503,21,440,243,1152,3926
0.387,6,10,1380,6,145,77,145,389,4,827,109,827,991
1794.351,17,66,2766,65,14,28036,14,2730,1,8,0,8,36
284.721,6,32,8535,13,158,23726,267,1317,19,537,15816,1400,7218
23.573,6,34,8942,16,303,1571,722,2769,18,605,1373,2760,6173
280.909,6,28,7352,13,158,23409,267,1317,15,603,20055,1400,6035
1795.949,17,447,39864,402,35,4478,288,25644,45,288,40019,288,14220
82.71,6,28,6789,12,207,7515,517,1463,16,641,5511,1418,5326
0.015,6,12,3702,6,170,2,170,490,6,964,2,1448,3212
11.625,6,1857,1602331,1109,1389,10,1420,1568166,748,526,15,3303,34165
0.312,17,2,167,1,39,0,39,67,1,72,0,72,100
0.152,6,9,1346,5,145,38,145,349,4,833,43,833,997
1780.564,17,142,11360,71,48,25436,48,5396,71,56,25436,56,5964
0.02,6,3,136,2,0,20,0,88,1,0,0,0,48
0.306,17,2,152,1,48,0,48,76,1,48,0,48,76
3.766,17,8,1132,4,31,1254,31,236,4,196,1253,196,896
962.534,2,9,288,9,8,120316,8,288,0,0,0,0,0
0.193,6,10,1671,6,552,38,948,1348,4,159,64,159,323
1757.909,6,99,7814,65,45,27467,205,4850,34,35,53259,98,2964
1718.392,17,21,8169,21,361,85919,361,8169,0,0,0,0,0
601.551,2,7,224,7,8,100258,8,224,0,0,0,0,0
0.081,17,4,414,2,50,1,50,156,2,101,73,107,258
1790.068,1,58,4872,0,0,0,0,0,58,56,31404,56,4872
1771.723,6,101,9410,66,66,27257,66,5610,35,60,52106,60,3800
177.395,6,41,24136,19,840,40,1360,5835,22,1160,8440,1696,18301
0.496,6,20,4960,10,137,55,267,1092,10,692,54,1467,3868
546.728,17,1165,568670,458,413,1196,1350,202308,707,490,774,1350,366362
10.766,6,20,4402,11,275,1076,275,998,9,758,749,1420,3404
88.43,6,35,8040,13,174,80,267,1573,22,348,4207,1460,6467
22.016,17,4,288,2,36,22015,36,128,2,52,22015,52,160
0.344,17,8,2774,8,318,49,357,2774,0,0,0,0,0
0.004,17,2,567,1,43,0,43,71,1,468,0,468,496
1625.313,1,7,392,7,28,270885,28,392,0,0,0,0,0
1.25,6,25,8056,12,164,96,267,1288,13,869,88,1440,6768
125.535,6,36,7877,14,155,9656,267,1346,22,331,5977,1420,6531
35.622,6,67,14248,33,335,416,766,3835,34,393,1075,1460,10413
45.28,6,31,7847,8,153,2644,267,1250,23,333,2057,1460,6597
128.724,6,42,25867,19,840,40,1460,5847,23,1193,5844,1460,20020
1772.518,6,180,15480,120,69,14895,69,8940,60,69,30035,69,6540
19.757,17,36,24410,18,742,1160,1350,13866,18,557,1160,1350,10544
0.62,17,3,451,2,39,446,39,134,1,289,0,289,317
300.287,6,48,29713,31,190,10009,444,2441,17,2398,15029,11264,27272
1776.277,17,73,3060,72,14,25017,14,3024,1,8,0,8,36
170.878,6,41,5949,20,148,8987,722,2236,21,187,8535,1408,3713
1.231,6,39,10473,21,513,61,1360,4977,18,433,62,1360,5496
0.03,1,5,740,5,120,7,120,740,0,0,0,0,0
125.379,6,14,3145,7,92,20896,92,452,7,465,20866,1448,2693
899.785,6,12,728,8,31,128540,31,444,4,31,299789,31,284
1779.206,17,140,11200,70,48,25785,48,5320,70,56,25785,56,5880
0.572,17,12,6353,6,615,114,1350,3860,6,387,78,1350,2493
14.48,6,24,6993,13,275,1206,275,1078,11,910,946,1440,5915
0.273,17,8,2750,8,315,39,354,2750,0,0,0,0,0
0.368,6,21,7203,13,318,30,600,1958,8,964,49,1471,5245
1789.551,6,349,22447,197,69,9130,69,12089,152,69,11850,69,10358
1.019,17,3,174,3,30,509,30,174,0,0,0,0,0
0.305,6,20,7238,12,335,27,668,1974,8,1210,42,1906,5264
4.655,6,10,587,6,43,931,43,371,4,0,562,0,216
1.045,17,4,580,2,40,1014,40,136,2,194,1001,194,444
0.577,17,2,152,1,48,0,48,76,1,48,0,48,76
0.021,17,2,148,1,30,0,30,58,1,62,0,62,90
822.697,6,9,1240,9,110,102837,110,1240,0,0,0,0,0
66.039,17,4,558,2,36,66034,36,128,2,187,66034,187,430
0.001,17,2,290,1,40,0,40,68,1,194,0,194,222
1.551,6,45,16910,26,792,62,1360,11374,19,476,74,2715,5536
0.43,6,12,1653,6,288,83,288,548,6,426,46,434,1105
0.556,6,10,1383,5,145,139,145,349,5,830,93,830,1034
1680.513,1,15,840,15,28,120036,28,840,0,0,0,0,0
1740.438,17,30,31680,30,1028,60015,1028,31680,0,0,0,0,0
0.397,6,10,1992,5,288,92,288,508,5,424,53,434,1484
150.0,6,33,15766,17,512,313,1360,3825,16,1026,9991,2720,11941
159.739,6,89,63468,57,1236,2852,1408,53668,32,738,2901,2439,9800
280.278,6,28,7352,13,158,23356,267,1317,15,678,20019,3436,6035
1719.478,17,12,498,11,14,171947,14,462,1,8,0,8,36
133.949,6,25,10716,13,746,53,1360,3536,12,1114,12165,3068,7180
3.008,17,4,340,2,37,2999,37,130,2,77,2999,77,210
0.139,6,13,4525,8,290,19,517,993,5,1088,32,1408,3532
61.84,6,21,8707,10,489,52,824,1995,11,681,6175,1408,6712
1.728,17,2,154,1,33,0,33,61,1,65,0,65,93
60.803,6,135,10663,119,134,515,174,5568,16,445,3483,1452,5095
1744.789,2,26,832,26,8,69791,8,832,0,0,0,0,0
0.01,17,2,412,1,48,0,48,76,1,308,0,308,336
334.605,6,60,10153,30,97,11537,267,2676,30,272,11537,4837,7477
0.0,17,1,960,1,932,0,932,960,0,0,0,0,0
280.367,6,29,7392,13,158,23363,267,1317,16,603,18686,2036,6075
18.805,17,25,5091,12,186,1707,1350,2569,13,166,1564,1350,2522
1788.448,6,359,22709,209,69,8598,69,12569,150,69,12002,69,10140
511.867,1,13,728,13,28,42655,28,728,0,0,0,0,0
205.844,6,132,95836,80,1299,2605,1448,83440,52,683,2760,2359,12396
3.399,17,10,785,5,31,841,31,295,5,70,838,70,490
4.009,17,8,1288,4,33,1332,33,244,4,233,1333,249,1044
0.153,1,2,112,2,28,153,28,112,0,0,0,0,0
1799.789,17,802,269460,802,307,2246,320,269460,0,0,0,0,0
1784.798,1,58,4872,0,0,0,0,0,58,56,31312,56,4872
9.515,17,27,14684,13,666,790,1350,9034,14,375,729,1350,5650
36.726,17,44,6468,22,48,1746,48,1672,22,190,1745,308,4796
1750.542,17,12,498,11,14,175054,14,462,1,8,0,8,36
1685.229,1,8,448,8,28,240747,28,448,0,0,0,0,0
1750.741,6,186,11385,93,47,19029,208,6766,93,31,19027,31,4619
42.435,17,44,6468,22,48,2020,48,1672,22,190,2020,308,4796
1.077,6,30,12083,16,525,71,1360,3310,14,820,69,1380,8773
1796.765,17,65,2730,65,14,28074,14,2730,0,0,0,0,0
5.128,17,3,208,2,36,5003,36,128,1,52,0,52,80
333.357,6,68,10749,33,100,10417,267,2934,35,237,9803,1917,7815
223.019,17,24,8754,24,336,9696,359,8754,0,0,0,0,0
280.263,6,29,7392,13,158,23355,267,1317,16,603,18682,1400,6075
136.381,17,10,585,10,30,15153,31,585,0,0,0,0,0
1.062,6,12,1653,6,288,208,288,548,6,426,107,434,1105
10.807,6,18,5610,10,275,1200,275,958,8,1440,805,1440,4652
4.778,6,18,3380,6,92,955,92,400,12,387,407,1448,2980
1775.435,17,72,3018,71,14,25363,14,2982,1,8,0,8,36
1782.081,6,107,8673,68,65,26598,65,4930,39,59,46894,59,3743
1653.441,1,8,448,8,28,236205,28,448,0,0,0,0,0
95.864,6,28,12949,15,519,63,884,2721,13,1077,7976,1503,10228
0.088,6,2,80,1,0,0,0,40,1,0,0,0,40
1750.839,6,95,7203,63,38,28239,205,4476,32,33,56469,98,2727
1797.047,6,1889,426907,887,371,2028,1408,185317,1002,294,1795,7040,241590
5.556,6,40,7325,21,218,277,314,3463,19,516,294,1179,3862
0.127,6,3,151,1,0,0,0,40,2,31,1,31,111
1771.759,6,99,9306,66,66,27257,66,5610,33,60,55364,60,3696
11.809,6,98,32091,49,592,246,1152,25649,49,447,239,1179,6442
1789.742,6,197,23386,103,80,17546,721,9125,94,233,19241,1414,14261
13.339,6,24,6993,13,275,1111,275,1078,11,910,832,1440,5915
301.05,6,45,10359,19,433,16716,910,2958,26,317,12036,4848,7401
49.0,6,12,5544,4,112,16333,112,280,8,822,6930,1460,5264
1700.481,17,12,498,11,14,170048,14,462,1,8,0,8,36
0.925,17,2,176,2,60,925,60,176,0,0,0,0,0
1791.81,1,58,4872,58,56,31435,56,4872,0,0,0,0,0
1.381,6,49,19312,27,896,53,1460,13656,22,529,57,4075,5656
1.002,6,10,1687,7,100,167,100,384,3,1179,369,1179,1303
1786.4,6,102,8364,68,66,26662,66,4964,34,60,54130,60,3400
10.996,6,20,4442,11,275,1099,275,998,9,768,775,1440,3444
0.015,17,4,314,2,31,0,31,118,2,70,1,70,196
106.876,6,21,9136,11,499,85,1193,1971,10,1125,11855,2279,7165
280.628,6,28,7352,13,158,23385,267,1317,15,775,20038,4836,6035
2.003,17,2,176,2,60,2003,60,176,0,0,0,0,0
22.243,6,27,7177,13,155,1853,267,1306,14,530,1710,3417,5871
369.795,6,25,1651,17,177,23112,177,1117,8,110,9225,110,534
240.401,6,66,24665,34,535,7284,1402,6633,32,861,7754,2804,18032
7.36,6,6,260,2,0,7360,0,84,4,0,2411,0,176
280.298,6,29,7392,13,158,23358,267,1317,16,603,18685,2036,6075
95.518,17,4,1344,4,308,31839,308,1344,0,0,0,0,0
0.39,6,7,371,4,0,130,0,204,3,7,101,7,167
0.138,17,4,588,2,48,116,48,152,2,190,119,308,436
136.569,6,28,12949,15,836,56,1360,5650,13,1127,11366,4445,7299
1.551,6,46,19078,27,887,59,1360,13542,19,476,74,2715,5536
1783.856,17,79,3312,78,14,23166,14,3276,1,8,0,8,36
1752.193,6,109,8141,69,38,25767,205,4850,40,32,44920,98,3291
92.406,17,4,352,2,60,92405,60,176,2,60,92405,60,176
300.248,6,135,21027,62,323,4922,1052,11025,73,137,4170,1408,10002
1750.799,17,12,498,11,14,175079,14,462,1,8,0,8,36
0.416,6,4,220,2,0,416,0,100,2,0,303,0,120
1786.028,1,77,6468,0,0,0,0,0,77,56,23500,56,6468
27.708,17,47,12038,23,328,1258,1350,8193,24,132,1203,1350,3845
4.595,6,7,476,1,0,0,0,40,6,31,468,31,436
1.56,17,25,6834,10,296,170,1350,3247,15,211,109,1350,3587
1.848,17,2,195,1,44,0,44,72,1,95,0,95,123
147.804,6,7,292,4,0,49268,0,164,3,0,73803,0,128
59.121,6,19,2810,12,253,5374,597,1685,7,190,8296,346,1125
1704.054,1,8,448,8,28,243436,28,448,0,0,0,0,0
5.681,6,40,7309,20,218,299,314,3423,20,440,285,1152,3886
0.455,6,12,1653,6,288,88,288,548,6,426,51,434,1105
240.36,6,43,8990,21,521,12015,1418,5789,22,227,11444,618,3201
43.877,6,25,6757,12,181,3988,267,1212,13,717,3655,2036,5545
0.203,6,10,1840,5,901,50,901,1169,5,403,50,403,671
0.052,17,2,214,1,39,0,39,67,1,119,0,119,147
168.051,6,22,7972,11,511,87,1194,2005,11,919,16787,1631,5967
2.952,6,30,8543,16,333,196,1007,2313,14,708,226,1452,6230
163.065,6,25,10081,12,523,61,1360,2629,13,988,13577,1360,7452
365.719,6,25,1654,17,180,22857,180,1120,8,110,9188,110,534
1783.149,1,342,28728,342,56,5229,56,28728,0,0,0,0,0
1788.232,1,262,14672,262,28,6851,28,14672,0,0,0,0,0
63.479,6,41,8710,20,371,579,766,1993,21,391,3167,3488,6717
0.083,17,2,390,1,46,0,46,74,1,288,0,288,316
0.036,6,4,222,2,31,36,31,111,2,31,2,31,111
1.379,6,41,8435,21,321,68,1168,2814,20,400,63,1360,5621
1786.616,6,104,8376,68,65,26665,65,4930,36,59,51043,59,3446
0.086,17,5,696,3,60,0,60,264,2,188,0,188,432
7.924,6,53,18816,27,371,304,1360,4164,26,755,271,1360,14652
230.377,17,4,352,2,60,230376,60,176,2,60,230375,60,176
157.009,17,4,352,2,60,157007,60,176,2,60,157008,60,176
11.867,6,1889,1640646,1145,1378,10,1420,1606665,744,467,15,1883,33981
5.831,6,5,339,3,131,2793,131,255,2,0,5587,0,84
33.491,6,32,5159,16,180,2221,722,1923,16,300,2221,1448,3236
279.908,1,12,672,12,28,25446,28,672,0,0,0,0,0
0.332,6,27,9054,13,247,27,624,1684,14,947,25,1408,7370
91.313,17,4,352,2,60,91312,60,176,2,60,91312,60,176
1775.95,6,181,15589,120,69,14923,69,8940,61,69,29593,69,6649
0.2,6,3,1014,1,863,0,863,903,2,31,200,31,111
0.011,6,11,3287,6,81,2,81,401,5,872,2,1448,2886
0.925,6,32,9870,19,674,51,1360,4848,13,561,60,2744,5022
1781.943,6,102,8296,68,65,26596,65,4930,34,59,53995,59,3366
67.573,17,7,2824,7,375,11262,548,2824,0,0,0,0,0
1791.364,6,457,27736,223,69,8069,69,13474,234,36,7688,69,14262
3.914,6,2,88,2,0,0,0,88,0,0,0,0,0
12.884,6,2284,2133496,1471,1373,8,1408,2086556,813,931,15,2801,46940
0.17,6,12,3462,6,75,34,75,395,6,1373,34,1448,3067
1700.465,17,12,498,11,14,170046,14,462,1,8,0,8,36
1787.261,6,102,8296,68,65,26675,65,4930,34,59,54156,59,3366
13.22,6,14,2351,8,125,1888,245,700,6,1407,2592,1407,1651
1796.068,17,31,7285,31,207,59868,207,7285,0,0,0,0,0
1681.949,17,14,1036,7,30,280322,30,406,7,62,280322,62,630
2.726,6,27,5836,13,135,227,267,1337,14,655,196,1380,4499
5.373,6,39,7269,19,218,298,314,3383,20,440,269,1152,3886
1.415,6,60,18018,30,699,48,1360,8909,30,438,48,1360,9109
0.026,1,2,1152,2,548,26,548,1152,0,0,0,0,0
1799.049,6,494,28572,276,69,6541,69,15456,218,35,8290,64,13116
1740.481,17,30,31620,30,1026,60016,1026,31620,0,0,0,0,0
12.028,17,20,4045,10,33,1334,33,610,10,315,1335,327,3435
1793.873,17,144,11520,72,48,25265,48,5472,72,56,25265,56,6048
0.028,6,14,4919,7,100,3,100,472,7,1018,4,1448,4447
306.707,6,8,416,7,0,51112,0,364,1,0,0,0,52
0.265,17,2,241,1,36,0,36,64,1,149,0,149,177
6.018,17,4,716,2,48,6007,48,152,2,254,6008,254,564
54.013,6,35,8390,18,401,519,888,1956,17,522,3365,3488,6434
1760.671,6,114,6860,64,26,27946,26,3780,50,26,35931,26,3080
197.842,6,30,8872,13,158,16486,267,1317,17,687,12358,1400,7555
29.917,6,34,15478,18,904,1759,1368,6370,16,1033,1991,2736,9108
1.072,6,31,10303,16,618,65,1460,3776,15,657,64,1460,6527
0.63,6,15,1785,8,288,67,288,640,7,426,75,434,1145
91.09,17,4,352,2,60,91089,60,176,2,60,91089,60,176
1793.841,6,244,35804,152,302,11879,302,26032,92,83,19712,83,9772
240.56,6,42,8172,21,515,12027,1402,5224,21,231,12027,580,2948
8.074,17,3,228,3,48,4037,48,228,0,0,0,0,0
8.416,6,77,24285,39,550,221,1152,18624,38,459,220,1179,5661
0.501,17,77,10509,40,121,12,427,5990,37,94,13,598,4519
5.014,17,4,558,2,36,5009,36,128,2,187,5009,187,430
240.719,2,3,96,3,8,120359,8,96,0,0,0,0,0
1782.179,17,142,11360,71,48,25459,48,5396,71,56,25459,56,5964
1793.965,17,66,2766,65,14,28030,14,2730,1,8,0,8,36
0.05,17,4,420,2,33,2,33,122,2,121,5,145,298
0.224,17,2,677,1,300,0,300,328,1,321,0,321,349
30.65,6,21,3558,11,210,3061,210,1048,10,664,3401,904,2510
0.518,17,3,543,2,39,277,39,134,1,381,0,381,409
1772.752,6,180,15480,120,69,14897,69,8940,60,69,30044,69,6540
240.194,6,55,20703,30,862,8282,1418,17959,25,205,10007,580,2744
1740.234,6,92,6668,60,31,29495,31,4062,32,31,56134,31,2606
0.061,17,3,451,2,39,56,39,134,1,289,0,289,317
0.887,6,10,1687,7,100,147,100,384,3,1179,314,1179,1303
899.581,1,4,224,4,28,299860,28,224,0,0,0,0,0
280.231,6,29,7392,13,158,23352,267,1317,16,603,18679,2800,6075
0.481,17,4,1344,4,308,160,308,1344,0,0,0,0,0
1.491,6,19,3781,10,234,165,564,1452,9,463,163,1343,2329
12.909,17,2,268,1,54,0,54,82,1,158,0,158,186
2.372,6,18,4830,8,215,338,517,1057,10,1071,226,1368,3773
55.255,6,70,23576,32,597,1782,1152,16828,38,435,1360,1179,6748
0.065,17,2,152,1,48,0,48,76,1,48,0,48,76
280.025,6,28,7352,13,158,23335,267,1317,15,678,19998,3436,6035
1781.781,6,512,83556,295,304,6060,304,59276,217,83,8248,83,24280
7.764,2,2,64,2,8,7764,8,64,0,0,0,0,0
38.24,17,22,1936,11,48,3818,48,836,11,72,3820,72,1100
1772.812,6,180,15480,120,69,14897,69,8940,60,69,30041,69,6540
15.537,17,12,6273,6,649,3100,1350,4065,6,340,3099,1350,2208
1.493,6,15,1291,8,222,210,222,772,7,231,245,231,519
0.954,6,21,9136,11,499,95,1193,1971,10,1125,77,2720,7165
1798.222,17,448,39896,403,35,4473,288,25676,45,288,40020,288,14220
0.078,6,10,1514,5,503,19,503,771,5,475,19,475,743
399.059,6,60,7812,29,121,14252,721,3086,31,141,13244,1448,4726
1786.181,6,104,8444,68,66,26659,66,4964,36,60,51031,60,3480
1.72,6,74,52184,44,1285,40,1440,44707,30,842,52,1440,7477
300.225,6,33,9798,15,549,21444,1408,3584,18,405,1951,1408,6214
9.028,6,40,21419,24,992,392,1368,15147,16,1072,588,2736,6272
427.989,17,164,6600,82,12,5277,16,3304,82,12,5283,16,3296
6.385,6,39,7269,21,218,319,314,3463,18,513,360,1179,3806
562.377,1,6,336,6,28,112475,28,336,0,0,0,0,0
12.16,6,813,722768,527,1302,22,1368,703232,286,776,41,1473,19536
1.668,17,3,1167,3,361,834,361,1167,0,0,0,0,0
3.941,17,2,656,2,300,3941,300,656,0,0,0,0,0
2.889,17,4,240,4,32,963,32,240,0,0,0,0,0
0.131,17,2,199,1,37,0,37,65,1,106,0,106,134
280.413,6,30,7432,14,158,21570,267,1357,16,678,18690,3456,6075
1773.868,6,180,15480,120,69,14906,69,8940,60,69,30058,69,6540
0.614,6,23,6001,13,108,51,147,959,10,927,67,2601,5042
1786.153,17,85,3564,84,14,21519,14,3528,1,8,0,8,36
1772.087,6,180,15480,120,69,14891,69,8940,60,69,30033,69,6540
1744.766,2,14,448,14,8,134212,8,448,0,0,0,0,0
1799.88,1,16,896,16,28,119992,28,896,0,0,0,0,0
63.228,17,3,228,3,48,31614,48,228,0,0,0,0,0
0.574,6,10,924,5,283,94,283,551,5,105,97,105,373
0.006,17,2,154,1,33,0,33,61,1,65,0,65,93
14.865,6,16,1113,8,222,2122,222,550,8,231,2122,231,563
0.001,2,3,96,3,8,0,8,96,0,0,0,0,0
6.092,6,45,8409,22,227,290,314,4062,23,489,264,1179,4347
1.026,17,4,668,2,39,960,39,134,2,239,0,239,534
1.618,6,40,8395,21,321,80,1168,2814,19,437,78,2715,5581
23.592,6,30,7432,13,158,1966,267,1317,17,543,1468,1400,6115
5.143,6,24,6809,12,257,458,517,1675,12,750,459,2451,5134
1795.906,17,138,11040,69,48,26410,48,5244,69,56,26410,56,5796
0.042,6,12,3704,6,171,6,171,491,6,964,7,1448,3213
0.001,6,2,1189,1,0,0,0,40,1,1097,0,1097,1149
0.168,6,2,170,1,0,0,0,40,1,90,0,90,130
0.086,17,2,180,1,30,0,30,58,1,94,0,94,122
0.0,1,1,256,1,228,0,228,256,0,0,0,0,0
125.604,2,2,64,2,8,125604,8,64,0,0,0,0,0
300.282,6,46,19101,26,979,12011,1408,13193,20,441,1765,1408,5908
1740.603,17,29,30624,29,1028,62164,1028,30624,0,0,0,0,0
0.287,17,2,167,1,39,0,39,67,1,72,0,72,100
1.608,6,51,19166,28,943,59,1460,13425,23,437,62,2615,5741
1774.74,17,140,11200,70,48,25720,48,5320,70,56,25720,56,5880
0.666,6,9,492,5,0,166,0,268,4,0,218,0,224
65.275,1,12,1248,0,0,0,0,0,12,76,5934,76,1248
19.85,17,18,7063,8,471,2831,1350,3997,10,278,2202,1350,3066
180.58,6,30,7432,13,158,15048,267,1317,17,543,11284,1400,6115
0.544,17,2,152,1,48,0,48,76,1,48,0,48,76
194.76,6,70,29066,36,363,576,1460,4215,34,1019,5897,1460,24851
3.89,17,3,183,3,33,1945,33,183,0,0,0,0,0
0.199,6,11,912,6,181,39,181,489,5,77,20,134,423
0.457,17,2,152,1,48,0,48,76,1,48,0,48,76
10.543,6,18,5610,10,275,1171,275,958,8,1440,790,1440,4652
1797.399,6,372,26402,212,99,8518,469,14965,160,69,11302,69,11437
378.427,6,18,1242,14,180,29109,180,916,4,110,20055,110,326
1799.362,6,386,29859,216,125,8369,469,17539,170,69,10645,69,12320
1.378,6,47,20761,28,938,51,1360,15225,19,476,66,2715,5536
0.022,6,10,1671,6,552,4,948,1348,4,159,7,159,323
639.756,6,58,22472,24,131,300,134,1780,34,996,19386,1448,20692
1.399,6,11,1727,7,100,233,100,384,4,589,378,1152,1343
0.096,6,2,80,1,0,0,0,40,1,0,0,0,40
228.345,17,4,304,4,48,76115,48,304,0,0,0,0,0
1.272,6,48,19196,27,890,48,1460,13580,21,433,55,1460,5616
377.818,17,3936,773690,3900,169,96,172,769966,36,75,7552,172,3724
1.717,6,25,8709,15,276,122,560,1432,10,981,170,1420,7277
1741.499,6,87,6322,58,31,30552,31,3915,29,31,62196,31,2407
1.387,6,50,20554,27,981,53,1460,14858,23,433,55,1460,5696
1786.69,6,104,8444,68,66,26667,66,4964,36,60,51045,60,3480
1789.183,17,142,11360,71,48,25559,48,5396,71,56,25559,56,5964
280.435,6,25,7232,12,158,25494,267,1277,13,775,23366,3465,5955
1790.964,1,342,28728,342,56,5252,56,28728,0,0,0,0,0
1797.435,6,1701,2143838,582,147,3093,861,38438,1119,1957,1607,8412,2105400
37.524,17,22,1936,11,48,3751,48,836,11,72,3751,72,1100
1.659,6,3,416,1,0,0,0,40,2,272,1228,272,376
689.522,2,9,288,9,8,86190,8,288,0,0,0,0,0
280.401,6,30,7432,13,158,23366,267,1317,17,603,17522,2760,6115
73.36,6,31,14492,15,576,65,1460,3513,16,1032,4881,1900,10979
0.705,6,22,7300,13,325,58,626,1984,9,1210,83,1946,5316
280.093,6,30,7432,14,158,21545,267,1357,16,603,18666,2800,6075
0.057,6,20,11469,12,125,5,125,793,8,2050,8,3012,10676
2.344,17,3,1176,3,364,1172,364,1176,0,0,0,0,0
1.366,6,45,15493,26,802,54,1360,9912,19,437,65,2715,5581
1.47,6,4,184,2,0,1470,0,88,2,0,0,0,96
33.605,6,33,5196,16,154,2240,722,1910,17,299,2088,1440,3286
0.026,17,2,180,1,30,0,30,58,1,94,0,94,122
135.352,6,109,84859,73,1246,1879,1408,74866,36,811,2836,3847,9993
64.921,6,37,9315,15,309,217,1189,2772,22,471,3091,1420,6543
0.475,6,23,7385,13,334,39,663,2021,10,967,48,1946,5364
176.139,17,4,288,2,36,176138,36,128,2,52,176138,52,160
8.677,6,29,7847,15,301,619,721,1810,14,683,543,2840,6037
112.947,6,21,4611,12,223,10267,722,1747,9,793,5137,1448,2864
593.896,6,112,7102,62,69,8939,69,3722,50,69,12120,69,3380
1763.758,2,14,448,14,8,135673,8,448,0,0,0,0,0
130.575,17,4,1344,4,308,43525,308,1344,0,0,0,0,0
1210.854,6,91,7942,59,59,20873,205,4970,32,42,39054,98,2972
86.693,17,6,528,3,48,43342,48,228,3,72,43341,72,300
1.876,17,2,148,2,46,1876,46,148,0,0,0,0,0
1619.487,1,7,392,7,28,269914,28,392,0,0,0,0,0
337.302,17,6,360,3,32,168650,32,180,3,32,168650,32,180
1785.327,17,136,10880,68,48,26646,48,5168,68,56,26646,56,5712
794.241,6,117,17413,72,131,11186,981,7613,45,194,18046,1460,9800
251.158,2,2,64,2,8,251158,8,64,0,0,0,0,0
1783.337,17,83,3480,82,14,22016,14,3444,1,8,0,8,36
280.183,6,26,7272,12,158,25471,267,1277,14,775,21549,3445,5995
280.196,6,23,7014,10,181,31132,267,1128,13,670,23348,1400,5886
1681.574,17,14,1036,7,30,280260,30,406,7,62,280260,62,630
392.602,6,23,1499,13,177,32716,177,861,10,110,14645,110,638
20.186,6,21,5418,12,107,1835,159,1074,9,967,2520,1659,4344
2.979,17,6,552,3,32,530,32,180,3,96,0,96,372
29.97,6,771,668347,467,1355,63,1368,646343,304,776,98,1473,22004
0.103,17,4,660,2,30,84,30,116,2,244,82,244,544
1.852,17,3,276,3,64,926,64,276,0,0,0,0,0
5.915,17,23,8580,10,438,657,1350,4660,13,273,405,1350,3920
1737.78,1,56,4704,56,56,31596,56,4704,0,0,0,0,0
95.186,6,761,353197,395,825,241,1152,333766,366,435,260,1179,19431
1.136,6,12,3462,6,75,227,75,395,6,1373,227,1448,3067
1772.275,6,180,15480,120,69,14893,69,8940,60,69,30035,69,6540
0.584,6,6,324,4,0,194,0,216,2,0,375,0,108
43.472,17,24,2112,12,48,3945,48,912,12,72,3950,72,1200
0.295,17,2,184,1,32,0,32,60,1,96,0,96,124
0.361,17,8,2774,8,318,51,357,2774,0,0,0,0,0
1794.443,17,142,11360,71,48,25634,48,5396,71,56,25634,56,5964
0.93,6,3,120,2,0,930,0,80,1,0,0,0,40
0.331,6,25,4623,12,165,30,456,1446,13,415,25,888,3177
1798.124,1,345,28980,345,56,5227,56,28980,0,0,0,0,0
33.269,17,7,2352,7,308,5544,308,2352,0,0,0,0,0
9.977,6,16,5255,9,275,1247,275,643,7,1440,829,1440,4612
1771.384,1,62,5208,0,0,0,0,0,62,56,29039,56,5208
14.668,6,1234,1086406,744,1380,19,1448,1056262,490,776,29,1448,30144
0.105,17,2,382,1,32,0,32,60,1,294,0,294,322
0.975,17,4,352,2,60,974,60,176,2,60,974,60,176
1751.144,6,219,17010,82,71,21617,337,8168,137,49,12876,143,8842
1794.582,6,21,1274,14,31,138044,31,777,7,31,299035,31,497
12.466,6,1968,1720723,1198,1380,10,1420,1685702,770,526,16,1883,35021
302.494,6,175,125804,104,1321,2936,1448,112507,71,532,2117,1448,13297
214.333,6,32,8952,14,158,16487,267,1357,18,624,12603,1400,7595
0.034,17,2,204,1,34,0,34,62,1,114,0,114,142
0.516,17,2,440,1,39,0,39,67,1,345,0,345,373
5.894,6,2,120,2,0,0,0,120,0,0,0,0,0
0.129,17,2,167,1,39,0,39,67,1,72,0,72,100
300.65,6,42,8715,22,280,14316,774,2068,20,389,793,2720,6647
0.694,6,4,220,2,0,694,0,100,2,0,305,0,120
1779.904,6,1414,341064,679,237,2625,1360,150104,735,579,2424,1360,190960
5.005,17,4,288,2,36,4994,36,128,2,52,4988,52,160
1740.834,17,29,6815,29,207,62172,207,6815,0,0,0,0,0
1347.691,6,137,11759,90,69,15142,69,6774,47,69,29297,69,4985
1326.151,6,134,11501,88,69,15243,69,6625,46,69,29469,69,4876
0.167,6,31,11757,17,322,10,733,3159,14,872,12,1408,8598
217.11,6,33,6995,17,168,13569,516,1695,16,423,14467,1452,5300
252.67,2,2,64,2,8,252670,8,64,0,0,0,0,0
11.023,6,18,5610,10,275,1224,275,958,8,1440,862,1440,4652
18.727,17,17,6725,9,482,2337,1350,4591,8,238,2670,1350,2134
0.551,6,27,9064,13,252,45,646,1694,14,947,40,1438,7370
5.171,6,40,7309,20,218,272,314,3423,20,513,257,1179,3886
0.098,6,4,239,2,0,50,0,104,2,31,0,31,135
9.558,6,85,24957,42,544,233,1152,19096,43,413,221,1152,5861
1786.364,6,109,9184,70,72,25889,293,5337,39,65,47007,247,3847
0.442,6,9,527,5,43,110,43,311,4,0,85,0,216
0.026,17,4,368,2,32,8,32,120,2,96,13,96,248
300.725,6,40,8453,21,245,15036,636,1878,19,414,892,2128,6575
1.358,6,39,8294,19,321,75,1164,2718,20,433,61,1360,5576
5.324,6,35,8469,18,419,313,944,2035,17,478,324,2720,6434
1.711,6,38,8254,19,321,95,1164,2718,19,433,83,1360,5536
1764.618,2,12,384,12,8,160419,8,384,0,0,0,0,0
1.514,6,26,6594,14,313,115,903,2129,12,663,136,1420,4465
1778.072,1,162,17172,162,78,11043,78,17172,0,0,0,0,0
1799.267,17,317,41140,159,170,11387,1350,31505,158,32,11460,61,9635
251.424,2,3,96,3,8,125712,8,96,0,0,0,0,0
40.037,6,15,2245,9,324,5004,585,1125,6,396,8005,580,1120
34.844,6,4427,4208859,2844,1400,12,1448,4121867,1583,776,21,1448,86992
1.244,6,10,1687,7,100,207,100,384,3,1179,490,1179,1303
241.229,6,52,21555,26,189,9648,689,2543,26,1039,9648,2804,19012
0.069,17,4,352,2,37,1,37,130,2,83,10,89,222
1799.895,1,58,4872,58,56,31577,56,4872,0,0,0,0,0
622.963,17,6,753,6,97,124592,355,753,0,0,0,0,0
280.528,6,29,7392,13,158,23377,267,1317,16,603,18695,2036,6075
1793.856,17,29,9512,29,300,64066,300,9512,0,0,0,0,0
1.627,6,10,1687,7,100,271,100,384,3,1179,684,1179,1303
251.575,2,2,64,2,8,251575,8,64,0,0,0,0,0
3.56,6,33,6129,17,206,222,314,2744,16,456,219,1152,3385
34.311,17,4,240,2,32,34309,32,120,2,32,34306,32,120
254.357,6,11,576,3,0,127178,0,152,8,0,35307,0,424
11.162,6,1708,1542332,1091,1362,10,1420,1513265,617,475,18,1883,29067
1.031,17,4,306,2,40,1009,41,137,2,56,1005,57,169
0.002,6,2,116,2,0,0,0,116,0,0,0,0,0
0.316,6,26,6066,13,164,26,453,1494,13,555,24,1542,4572
0.035,17,4,792,3,60,5,60,264,1,500,0,500,528
186.028,17,4,352,2,60,186027,60,176,2,60,186027,60,176
371.081,6,27,1767,18,177,21828,177,1181,9,110,8923,110,586
1765.364,1,172,18232,172,78,10323,78,18232,0,0,0,0,0
1786.383,17,88,3684,86,14,21014,14,3612,2,8,1786226,8,72
37.075,17,4,352,2,60,37073,60,176,2,60,37073,60,176
0.516,17,3,543,2,39,394,39,134,1,381,0,381,409
1.36,6,50,19639,27,916,52,1360,13943,23,433,53,1360,5696
2.075,17,3,1173,3,363,1037,363,1173,0,0,0,0,0
1.316,6,29,6149,14,154,101,267,1644,15,650,84,1452,4505
24.201,17,12,1056,6,48,4809,48,456,6,72,4821,72,600
0.056,17,3,244,2,32,0,32,120,1,96,0,96,124
3.775,1,3,168,3,28,1887,28,168,0,0,0,0,0
0.892,6,10,1687,7,100,148,100,384,3,1179,317,1179,1303
0.135,6,9,1340,5,145,33,145,349,4,827,15,827,991
0.412,17,2,154,1,33,0,33,61,1,65,0,65,93
1744.632,6,94,7151,62,38,28600,205,4424,32,33,56271,98,2727
252.034,2,2,64,2,8,252034,8,64,0,0,0,0,0
0.089,17,4,2887,2,691,89,1350,1439,2,696,46,1350,1448
144.733,6,20,3510,6,92,92,92,412,14,215,11117,1448,3098
1781.461,6,354,22440,207,69,8647,69,12420,147,69,12201,69,10020
10.254,6,83,24525,41,550,256,1152,18704,42,413,242,1152,5821
0.212,17,4,304,2,37,205,37,130,2,59,204,65,174
1745.43,6,95,7203,63,38,28152,205,4476,32,33,56297,98,2727
2.234,6,47,18748,26,927,89,1460,13132,21,433,95,1460,5616
8.76,6,14,1247,7,222,1458,222,728,7,231,1458,231,519
1787.02,17,87,3648,86,14,21023,14,3612,1,8,0,8,36
282.096,6,34,7821,14,158,21699,267,1357,20,435,14841,1400,6464
0.429,6,10,968,5,256,103,256,460,5,304,103,304,508
0.047,17,2,142,1,29,0,29,57,1,57,0,57,85
1772.091,6,180,15480,120,69,14891,69,8940,60,69,30031,69,6540
1749.55,17,12,498,11,14,174955,14,462,1,8,0,8,36
1.238,6,10,1687,7,100,206,100,384,3,1179,494,1179,1303
1786.311,6,102,8364,68,66,26661,66,4964,34,60,54127,60,3400
0.006,17,2,366,1,37,0,37,65,1,273,0,273,301
0.041,17,2,154,1,33,0,33,61,1,65,0,65,93
3.373,17,5,295,5,31,843,31,295,0,0,0,0,0
191.523,6,13,5586,4,106,63841,106,274,9,822,23911,1420,5312
0.476,6,12,1653,6,288,92,288,548,6,426,55,434,1105
0.501,17,3,451,2,39,119,39,134,1,289,0,289,317
1744.685,2,16,512,16,8,116312,8,512,0,0,0,0,0
0.656,17,11,4946,5,468,164,1350,2482,6,382,76,1350,2464
1798.51,17,776,46856,776,32,2320,37,46856,0,0,0,0,0
1796.665,17,448,39896,403,35,4469,288,25676,45,288,40018,288,14220
2.984,6,2,88,2,0,0,0,88,0,0,0,0,0
1788.734,6,355,22480,207,69,8683,69,12420,148,69,12167,69,10060
1799.566,1,345,28980,345,56,5231,56,28980,0,0,0,0,0
1786.816,6,102,8228,68,64,26668,64,4896,34,58,54143,58,3332
10.986,6,18,5550,10,275,1220,275,958,8,1420,887,1420,4592
300.805,6,63,38066,39,481,7915,1338,4033,24,1725,1672,8448,34033
87.057,6,29,9663,14,430,78,1360,2326,15,747,6206,1791,7337
0.449,6,65,100972,43,194,10,230,3023,22,4839,16,9856,97949
1772.385,6,180,15480,120,69,14893,69,8940,60,69,30031,69,6540
1.064,6,24,8622,15,195,76,389,1763,9,1276,100,3819,6859
29.22,6,11,774,3,106,14610,106,234,8,90,4147,90,540
69.501,6,170,131129,96,430,731,647,6422,74,1702,935,5632,124707
224.766,17,4,240,2,32,224765,32,120,2,32,224764,32,120
107.489,6,23,6177,9,272,102,516,1180,14,403,8260,1452,4997
76.26,6,30,7594,10,152,8473,267,1324,20,390,4004,1452,6270
0.007,17,2,399,1,34,0,34,62,1,309,0,309,337
23.892,6,9,577,0,0,0,0,0,9,31,2986,31,577
0.097,17,4,284,2,32,53,32,120,2,54,46,60,164
0.878,6,10,1687,7,100,146,100,384,3,1179,311,1179,1303
61.33,6,37,16032,22,810,2920,1448,9254,15,665,4363,1448,6778
1780.273,17,140,11192,71,48,25432,48,5396,69,56,25427,56,5796
7.389,17,6,528,3,48,3687,48,228,3,72,3688,72,300
0.005,17,2,399,1,39,0,39,67,1,304,0,304,332
13.488,6,2577,2330507,1534,1431,8,1448,2267431,1043,776,12,1448,63076
240.204,6,54,18235,29,822,8578,1402,15505,25,177,10008,580,2730
0.467,17,17,10581,9,881,57,1350,8181,8,272,60,1350,2400
0.5,17,3,451,2,39,425,39,134,1,289,0,289,317
15.062,6,6,328,4,0,5020,0,216,2,0,15022,0,112
1777.422,17,141,11276,71,48,25391,48,5396,70,56,25759,56,5880
240.18,6,53,17829,28,800,8895,1418,15070,25,181,10007,580,2759
1.267,6,25,8056,12,164,97,267,1288,13,869,90,1448,6768
3.893,6,11,467,6,0,778,0,248,5,7,715,7,219
280.42,6,28,7352,12,158,25492,267,1277,16,603,18689,1400,6075
1703.401,1,8,448,8,28,243343,28,448,0,0,0,0,0
2.251,6,4,220,2,0,2251,0,100,2,0,305,0,120
1769.885,6,99,9240,66,65,27229,65,5577,33,59,55305,59,3663
0.994,6,10,1687,7,100,165,100,384,3,1179,350,1179,1303
21.703,6,19,1455,10,222,2409,222,852,9,231,2711,231,603
1786.82,6,102,8364,68,66,26668,66,4964,34,60,54143,60,3400
300.917,6,50,10538,25,433,12538,910,3270,25,329,635,2720,7268
292.885,17,4,352,2,60,292884,60,176,2,60,292883,60,176
1786.432,6,103,8336,68,65,26663,65,4930,35,59,52538,59,3406
0.779,6,13,1981,7,288,124,288,876,6,426,117,434,1105
279.978,6,29,7392,14,158,21536,267,1357,15,678,19995,2800,6035
201.948,2,7,288,7,17,33658,24,288,0,0,0,0,0
5.027,17,4,288,2,36,5010,36,128,2,52,5005,52,160
0.009,6,2,80,1,0,0,0,40,1,0,0,0,40
1.199,6,5,5429,4,1307,167,1440,5389,1,0,0,0,40
1797.216,17,448,39896,403,35,4470,288,25676,45,288,40020,288,14220
1797.825,6,412,38028,229,121,7885,1189,18413,183,153,9876,2077,19615
300.352,6,77,56129,44,1304,6984,1440,49266,33,564,920,1440,6863
160.122,6,31,7677,9,155,183,267,1146,22,331,7624,1460,6531
1772.098,6,180,15480,120,69,14891,69,8940,60,69,30034,69,6540
0.838,6,10,2219,5,145,209,145,349,5,833,163,833,1870
198.533,17,4,352,2,60,198532,60,176,2,60,198532,60,176
0.013,17,2,672,2,308,13,308,672,0,0,0,0,0
1782.793,6,358,22669,209,69,8571,69,12569,149,69,12045,69,10100
1680.0,1,14,812,14,30,129230,30,812,0,0,0,0,0
92.33,2,4,128,4,8,30776,8,128,0,0,0,0,0
1670.163,1,7,742,7,78,278360,78,742,0,0,0,0,0
0.065,17,2,200,1,64,0,64,92,1,80,0,80,108
135.397,1,8,448,8,28,19342,28,448,0,0,0,0,0
1.506,6,51,23809,30,997,51,1460,18193,21,476,65,2615,5616
0.19,6,14,5720,8,290,27,517,993,6,1101,34,1418,4727
15.988,6,16,6331,3,189,7990,267,507,13,529,1331,1420,5824
0.012,17,2,600,1,36,0,36,64,1,508,0,508,536
16.851,6,6,328,4,0,5617,0,216,2,0,16796,0,112
1.155,6,25,8933,14,203,88,458,1406,11,1010,94,1360,7527
1794.726,6,280,33954,113,138,16023,1360,16342,167,130,10810,1360,17612
3.633,6,31,8331,14,116,279,147,1146,17,721,226,1608,7185
0.053,6,12,3702,6,170,9,170,490,6,964,6,1448,3212
2.385,6,24,3553,12,162,216,293,1458,12,402,191,1152,2095
3.518,17,5,295,5,31,879,31,295,0,0,0,0,0
1747.495,17,292,56883,292,166,6005,422,56883,0,0,0,0,0
243.538,6,14,1117,5,302,60884,302,558,9,83,30440,83,559
2.349,6,20,3833,11,234,234,564,1504,9,463,272,1343,2329
0.022,6,9,1930,5,666,5,666,934,4,780,7,780,996
34.521,6,3027,2855338,2104,1284,16,1408,2801132,923,1550,37,3819,54206
0.419,6,263,317944,112,189,3,290,6399,151,2038,2,10944,311545
79.164,6,32,7523,12,155,302,267,1266,20,388,4166,1420,6257
280.441,6,30,7432,13,158,23370,267,1317,17,543,17518,1400,6115
0.016,17,2,234,1,60,0,60,88,1,118,0,118,146
3.48,17,5,295,5,31,870,31,295,0,0,0,0,0
18.773,17,18,8846,8,615,2675,1350,5144,10,342,2075,1350,3702
61.644,6,23,7708,12,535,5604,1034,2251,11,812,6151,2736,5457
82.556,6,32,7722,12,155,29,267,1266,20,376,4344,3417,6456
153.747,6,73,45549,43,1166,3660,1408,37255,30,747,2122,1408,8294
3.833,17,2,656,2,300,3833,300,656,0,0,0,0,0
1.677,6,25,8787,15,289,119,599,1471,10,987,165,1452,7316
69.77,6,108,127120,55,430,1292,647,4206,53,2452,1305,8994,122914
2.079,17,4,580,2,40,2047,40,136,2,194,2047,194,444
0.709,6,27,16459,16,151,47,299,1435,11,1805,70,4224,15024
1740.264,1,65,5460,65,56,27191,56,5460,0,0,0,0,0
1176.837,17,803,56324,728,40,1618,41,49982,75,56,553,57,6342
1.284,6,41,11378,22,547,61,1360,5842,19,529,62,4075,5536
230.198,17,2,152,2,48,230198,48,152,0,0,0,0,0
257.565,6,292,252666,193,1308,1341,1368,233884,99,619,2268,2736,18782
240.183,6,52,17677,27,784,9237,1402,14749,25,202,10007,580,2928
10.02,2,3,96,3,8,5010,8,96,0,0,0,0,0
7.811,17,6,528,3,48,3899,48,228,3,72,3899,72,300
1776.22,1,8,848,8,78,253745,78,848,0,0,0,0,0
1778.622,17,140,11200,70,48,25776,48,5320,70,56,25776,56,5880
1798.061,17,114,9120,57,48,32108,48,4332,57,56,32108,56,4788
560.872,17,6,444,3,30,280414,30,174,3,62,280420,62,270
2.187,6,19,3781,10,234,243,564,1452,9,463,250,1343,2329
1753.211,6,182,11017,91,45,19480,208,6447,91,31,19474,31,4570
1799.588,17,448,39896,403,35,4476,288,25676,45,288,40014,288,14220
2.723,17,2,778,2,361,2723,361,778,0,0,0,0,0
0.072,17,2,245,1,32,0,32,60,1,157,0,157,185
369.617,6,25,1651,17,177,23101,177,1117,8,110,9206,110,534
103.18,17,4,304,4,48,34393,48,304,0,0,0,0,0
1750.053,17,12,498,11,14,175005,14,462,1,8,0,8,36
371.153,6,21,1419,15,177,26510,177,989,6,110,14339,110,430
243.298,17,4,1640,4,382,81099,1030,1640,0,0,0,0,0
2.371,6,41,10026,22,503,112,1460,4445,19,400,116,1460,5581
8.508,6,1439,1336657,908,1395,9,1408,1304369,531,931,15,2816,32288
20.466,6,17,2316,10,189,2274,517,1298,7,323,3409,499,1018
0.085,17,4,2876,2,689,85,1350,1434,2,693,40,1350,1442
364.78,6,23,1535,16,177,24318,177,1053,7,110,10352,110,482
15.394,6,262,184549,135,226,114,517,9022,127,1384,121,2736,175527
1794.699,17,87,3648,86,14,21114,14,3612,1,8,0,8,36
372.769,1,3,180,3,32,186384,32,180,0,0,0,0,0
1665.505,1,117,12402,117,78,14357,78,12402,0,0,0,0,0
1.765,6,3,144,1,0,0,0,40,2,0,25,0,104
0.009,6,10,1512,5,503,2,503,771,5,473,2,473,741
1797.311,6,191,18610,126,99,14378,469,11525,65,69,28074,69,7085
1739.399,6,92,6668,60,31,29481,31,4062,32,31,56109,31,2606
418.226,6,59,9921,30,117,14421,722,3086,29,378,14929,1380,6835
353.763,6,24,12013,3,106,576,106,234,21,575,17687,1300,11779
0.515,2,2,80,2,16,515,16,80,0,0,0,0,0
8.272,17,6,456,6,48,1654,48,456,0,0,0,0,0
1787.235,17,87,3648,86,14,21026,14,3612,1,8,0,8,36
0.533,17,2,476,1,39,0,39,67,1,381,0,381,409
1787.507,6,102,8296,68,65,26679,65,4930,34,59,54163,59,3366
0.193,6,10,1514,5,503,48,503,771,5,475,48,475,743
2.752,17,2,778,2,361,2752,361,778,0,0,0,0,0
92.476,6,37,8636,16,401,1757,889,1888,21,393,4617,4848,6748
1628.628,6,299,22322,148,146,11073,515,8763,151,39,10834,76,13559
694.589,1,18,1008,18,28,40858,28,1008,0,0,0,0,0
1777.165,6,181,15589,121,69,14809,69,9049,60,69,30102,69,6540
92.457,17,4,352,2,60,92456,60,176,2,60,92456,60,176
0.877,2,2,80,2,16,877,16,80,0,0,0,0,0
0.451,6,13,1693,6,288,83,288,548,7,426,42,434,1145
1773.685,17,140,11200,70,48,25705,48,5320,70,56,25705,56,5880
86.239,6,120,95010,79,1259,1105,1368,84750,41,738,2150,2736,10260
0.573,17,4,644,2,36,563,36,128,2,230,564,230,516
6.513,2,2,64,2,8,6513,8,64,0,0,0,0,0
136.061,6,117,86890,73,1275,1889,1448,76487,44,675,1713,1448,10403
6.517,6,14,2242,8,210,888,210,844,6,545,1188,904,1398
1790.745,1,138,7728,138,28,13071,28,7728,0,0,0,0,0
1.473,2,3,96,3,8,736,8,96,0,0,0,0,0
0.945,6,2,1494,1,0,0,0,40,1,1414,0,1414,1454
1.36,6,50,19255,27,887,52,1360,13559,23,433,53,1360,5696
5.032,17,4,558,2,36,5023,36,128,2,187,5022,187,430
324.472,17,8,1412,4,48,108156,48,304,4,249,108155,308,1108
15.422,17,20,2940,10,48,1712,48,760,10,190,1709,308,2180
97.864,6,46,9068,22,401,748,889,2200,24,327,4249,1360,6868
0.373,17,2,152,1,48,0,48,76,1,48,0,48,76
127.746,6,37,5420,22,180,6083,722,2236,15,300,1101,1448,3184
1740.977,6,87,6322,58,31,30543,31,3915,29,31,62175,31,2407
860.169,17,20,7089,20,326,45272,548,7089,0,0,0,0,0
1621.791,1,8,848,8,78,231684,78,848,0,0,0,0,0
0.97,6,29,5933,14,123,74,267,1428,15,650,64,1414,4505
1.373,6,38,8360,19,338,76,1270,2824,19,433,66,1440,5536
1797.317,17,240,45955,240,163,7520,377,45955,0,0,0,0,0
0.62,6,15,1785,8,288,66,288,640,7,426,74,434,1145
20.825,17,38,13475,17,552,1299,1350,9876,21,143,1039,1350,3599
8.531,6,1846,1674739,1145,1383,7,1408,1633623,701,931,11,2801,41116
1503.996,2,12,384,12,8,136726,8,384,0,0,0,0,0
1793.601,6,356,22520,208,69,8664,69,12460,148,69,12201,69,10060
3.196,2,3,96,3,8,1598,8,96,0,0,0,0,0
7.771,6,36,7437,18,231,457,314,3274,18,491,411,1179,4163
18.273,17,22,14576,10,517,2026,1350,5451,12,732,1658,1350,9125
1798.291,1,345,28980,345,56,5227,56,28980,0,0,0,0,0
1771.514,6,159,10119,85,49,21089,208,6198,74,31,24261,31,3921
75.689,6,31,7613,12,155,28,267,1266,19,398,4204,3417,6347
0.377,6,22,5936,12,108,34,147,919,10,922,40,1581,5017
240.738,17,4,352,2,60,240737,60,176,2,60,240737,60,176
1771.994,6,180,15480,120,69,14890,69,8940,60,69,30031,69,6540
1751.877,1,158,16748,158,78,11158,78,16748,0,0,0,0,0
0.015,17,2,572,1,53,0,53,81,1,463,0,463,491
1756.599,1,8,448,8,28,250942,28,448,0,0,0,0,0
185.533,6,307,259872,194,1368,961,1448,241368,113,589,1334,1448,18504
1.039,17,2,178,1,29,0,29,57,1,93,0,93,121
437.252,17,6,528,3,60,218625,60,264,3,60,218625,60,264
1785.623,6,104,8240,68,63,26651,63,4862,36,57,51014,57,3378
118.66,17,4,1344,4,308,39553,308,1344,0,0,0,0,0
1.674,6,13,2311,8,188,239,245,700,5,1407,353,1407,1611
0.01,17,2,390,1,46,0,46,74,1,288,0,288,316
2.052,17,4,314,2,31,2028,31,118,2,70,2027,70,196
5.03,17,3,208,2,36,5008,36,128,1,52,0,52,80
11.036,6,27,7969,13,226,919,721,1884,14,919,814,1440,6085
2.105,17,3,174,3,30,1052,30,174,0,0,0,0,0
13.924,6,18,1629,9,222,1739,222,1030,9,231,1739,231,599
300.729,6,28,6774,15,521,21479,1418,4436,13,416,25059,534,2338
0.112,6,9,1339,5,145,28,145,349,4,826,20,826,990
376.485,6,27,1767,18,177,22146,177,1181,9,110,9278,110,586
1795.15,17,448,39896,403,35,4465,288,25676,45,288,40019,288,14220
0.079,1,2,112,2,28,79,28,112,0,0,0,0,0
0.008,17,2,366,1,37,0,37,65,1,273,0,273,301
0.391,6,26,8868,13,227,32,547,1592,13,941,31,1438,7276
148.635,6,123,91540,78,1242,1930,1408,81075,45,811,2397,3847,10465
1745.841,6,94,7151,62,38,28620,205,4424,32,33,56305,98,2727
240.714,6,53,17974,28,799,8914,1418,15053,25,229,10029,580,2921
14.899,6,37,6976,19,119,827,147,1607,18,772,876,1608,5369
1712.344,1,8,448,8,28,244620,28,448,0,0,0,0,0
16.78,17,37,18445,19,667,930,1350,13207,18,263,985,1350,5238
1798.743,6,359,22709,209,69,8647,69,12569,150,69,12070,69,10140
1.434,6,52,23392,29,1031,51,1460,17696,23,433,56,1460,5696
0.453,17,2,180,1,30,0,30,58,1,94,0,94,122
280.32,6,30,7432,13,158,23360,267,1317,17,543,17516,1400,6115
7.172,6,46,8449,24,227,311,314,4142,22,489,327,1179,4307
0.0,17,1,88,1,60,0,60,88,0,0,0,0,0
0.845,6,30,12940,18,909,49,1360,8027,12,631,60,2744,4913
0.817,6,50,13805,24,553,35,1429,4856,26,438,31,1460,8949
1796.672,17,449,39928,404,35,4458,288,25708,45,288,40017,288,14220
1783.813,6,357,22629,208,69,8617,69,12460,149,69,12052,69,10169
121.775,6,60,39234,38,1174,3291,1448,31336,22,749,2925,1448,7898
105.744,6,53,14755,24,514,4597,1360,5156,29,525,3760,1360,9599
70.233,6,43,8907,20,410,672,882,2110,23,366,3185,2720,6797
228.135,17,4,352,2,60,228134,60,176,2,60,228134,60,176
1791.508,17,144,11520,72,48,25232,48,5472,72,56,25232,56,6048
0.058,17,2,214,1,39,0,39,67,1,119,0,119,147
0.705,6,10,924,5,283,117,283,551,5,105,117,105,373
1787.285,6,102,8296,68,65,26675,65,4930,34,59,54156,59,3366
3.016,17,2,251,1,31,0,31,59,1,164,0,164,192
8.717,6,35,8385,18,400,512,885,1952,17,478,532,1928,6433
0.263,17,8,2758,8,316,37,355,2758,0,0,0,0,0
0.177,17,2,198,1,39,0,39,67,1,103,0,103,131
3.431,6,24,6533,11,268,338,517,1385,13,744,282,1418,5148
1791.061,6,393,31922,221,92,8141,1189,15024,172,133,10473,1460,16898
3.0,17,2,148,2,46,3000,46,148,0,0,0,0,0
6.124,6,637,604703,426,1356,13,1368,589055,211,776,28,1473,15648
373.612,6,25,1654,17,180,23350,180,1120,8,110,9314,110,534
0.873,6,10,1687,7,100,145,100,384,3,1179,310,1179,1303
1770.888,1,58,4872,58,56,31068,56,4872,0,0,0,0,0
0.477,6,12,1653,6,288,91,288,548,6,426,42,434,1105
7.335,6,1301,1086380,714,1430,10,1448,1048788,587,776,12,1448,37592
1203.181,2,15,480,15,8,85941,8,480,0,0,0,0,0
0.346,17,21,13952,12,911,31,1350,11272,9,269,38,1350,2680
6.364,17,4,240,2,32,6363,32,120,2,32,6363,32,120
1783.604,17,140,11200,70,48,25849,48,5320,70,56,25849,56,5880
0.029,17,2,144,1,36,0,36,64,1,52,0,52,80
1785.846,6,243,24985,97,67,18601,616,9183,146,136,12315,2720,15802
246.438,6,38,3038,21,75,12321,138,1668,17,69,13411,69,1370
0.138,17,2,144,1,36,0,36,64,1,52,0,52,80
372.35,6,25,1651,17,177,23271,177,1117,8,110,9251,110,534
280.672,6,31,7541,13,158,23389,267,1317,18,500,16498,1400,6224
1719.634,17,13,534,11,14,171944,14,462,2,8,1719423,8,72
1794.431,6,356,22520,208,69,8668,69,12460,148,69,12206,69,10060
1.139,6,23,7952,12,164,88,267,1288,11,1216,97,3819,6664
35.859,17,40,5880,20,48,1886,48,1520,20,190,1886,308,4360
1749.195,6,100,7702,66,40,26910,205,4730,34,35,52992,108,2972
1.733,6,16,3676,8,150,247,174,624,8,681,235,1452,3052
221.779,17,6,360,3,32,110889,32,180,3,32,110889,32,180
204.008,1,5,280,5,28,51002,28,280,0,0,0,0,0
0.357,17,15,7560,7,665,58,1350,4854,8,310,45,1350,2706
0.187,6,29,7376,14,155,14,267,1341,15,543,12,1400,6035
0.98,6,27,11942,16,529,65,1360,3318,11,1167,82,3921,8624
8.453,6,23,8479,9,138,1056,267,923,14,873,646,3466,7556
0.767,17,22,13688,12,883,69,1350,10939,10,246,45,1350,2749
8.055,6,48,8529,24,198,350,314,4142,24,489,338,1179,4387
10.076,17,4,5484,4,1343,3358,1348,5484,0,0,0,0,0
167.251,6,21,8224,11,549,89,1309,2120,10,948,18563,1591,6104
7.04,6,42,7389,22,218,335,314,3503,20,513,355,1179,3886
34.212,6,4684,4518680,3142,1362,10,1408,4433832,1542,931,22,2801,84848
1745.458,6,95,7234,62,38,28614,205,4424,33,33,54537,98,2810
1.258,6,34,11209,18,562,74,1360,4161,16,639,72,1360,7048
53.765,17,6,528,3,48,26877,48,228,3,72,26877,72,300
12.441,6,13,740,6,0,2488,0,336,7,0,1874,0,404
0.266,17,3,507,2,39,261,39,134,1,345,0,345,373
30.279,6,37,8495,18,410,513,882,1982,19,441,1674,1440,6513
9.605,17,6,1236,3,48,4794,48,228,3,308,4792,308,1008
280.478,6,30,7432,13,158,23373,267,1317,17,603,17525,2760,6115
0.187,6,28,7336,13,155,15,267,1301,15,543,12,1300,6035
8.79,6,17,4130,9,275,1098,275,918,8,1440,1119,1440,3212
421.783,6,79,12030,38,136,11395,721,4653,41,337,10540,1440,7377
1797.796,17,449,39928,404,35,4461,288,25708,45,288,40011,288,14220
1.758,17,20,5180,20,231,92,388,5180,0,0,0,0,0
1788.866,6,356,22520,208,69,8641,69,12460,148,69,12169,69,10060
1.371,6,48,19130,27,885,52,1360,13514,21,476,59,2715,5616
1789.724,17,142,11360,71,48,25567,48,5396,71,56,25567,56,5964
0.284,6,26,9089,13,271,23,726,1771,13,947,22,2816,7318
180.048,6,29,7392,13,158,15004,267,1317,16,603,12000,2036,6075
4.794,6,40,7325,22,218,228,314,3503,18,516,267,1179,3822
280.039,6,27,7312,12,158,25458,267,1277,15,678,19999,2800,6035
23.933,17,44,10246,21,291,1195,1350,6706,23,125,1086,1350,3540
1740.909,6,100,7256,64,31,27633,31,4356,36,31,49739,31,2900
1.102,1,5,420,5,56,275,56,420,0,0,0,0,0
1797.135,1,267,28302,267,78,6756,78,28302,0,0,0,0,0
31.48,17,4,352,2,60,31479,60,176,2,60,31479,60,176
240.166,6,45,5787,21,236,12008,835,3000,24,189,10441,474,2787
88.761,6,25,11058,12,433,75,990,1823,13,967,7385,1460,9235
0.578,6,26,8934,13,248,48,631,1676,13,1095,45,2736,7258
687.494,6,100,13224,50,100,14030,267,4718,50,224,6658,1460,8506
2.984,1,3,168,3,28,1492,28,168,0,0,0,0,0
3.283,6,30,9432,14,257,249,517,1813,16,677,215,1418,7619
45.747,17,21,9044,10,595,5082,1350,6233,11,227,4571,1350,2811
240.128,6,39,5225,19,205,13340,517,2433,20,216,12638,851,2792
0.051,17,3,1173,1,137,0,137,165,2,476,1,476,1008
71.624,17,16,2352,8,48,10230,48,608,8,190,10230,308,1744
6.002,17,3,1008,3,308,3001,308,1008,0,0,0,0,0
274.841,1,2,120,2,32,274841,32,120,0,0,0,0,0
1799.742,1,114,12084,114,78,15926,78,12084,0,0,0,0,0
204.048,17,3,222,3,46,102024,46,222,0,0,0,0,0
0.036,17,2,152,2,48,36,48,152,0,0,0,0,0
5.016,17,4,542,2,36,5011,36,128,2,179,5011,187,414
1796.76,17,142,11360,71,48,25667,48,5396,71,56,25667,56,5964
0.011,17,3,1007,1,137,0,137,165,2,393,0,393,842
2.163,17,4,580,2,40,2034,40,136,2,194,2084,194,444
1797.775,17,448,39896,403,35,4472,288,25676,45,288,40019,288,14220
48.189,1,12,1164,12,69,4380,69,1164,0,0,0,0,0
309.418,6,27,5492,14,298,23801,1382,2353,13,373,25783,1420,3139
1799.999,6,225,19232,84,74,21686,301,8567,141,69,12857,1062,10665
1022.714,2,11,352,11,8,102271,8,352,0,0,0,0,0
0.09,17,4,284,2,32,66,32,120,2,54,25,60,164
1.217,17,13,5861,6,482,242,1350,3062,7,371,197,1350,2799
0.485,17,4,420,2,33,0,33,122,2,121,0,145,298
4.899,6,37,7205,18,218,288,314,3343,19,516,258,1179,3862
0.397,6,13,1693,7,288,64,288,588,6,426,41,434,1105
2.171,6,13,3463,7,188,361,245,660,6,1279,384,1407,2803
1785.859,6,367,25581,213,99,8423,469,15005,154,69,11672,69,10576
4.039,17,8,616,4,33,1339,33,244,4,65,1340,65,372
281.35,6,62,8894,29,158,10048,267,1957,33,467,8789,1400,6937
1794.145,17,80,3354,79,14,23001,14,3318,1,8,0,8,36
26.409,6,45,12925,21,199,1320,721,2438,24,732,1137,2840,10487
0.102,17,5,378,3,34,0,34,186,2,68,81,68,192
7.56,6,17,5164,9,150,945,174,664,8,835,1049,1452,4500
1781.288,6,100,7767,66,40,27404,205,4726,34,37,53969,177,3041
280.205,6,29,7392,14,158,21554,267,1357,15,678,20011,3436,6035
1288.541,6,90,11516,56,87,23428,500,4516,34,187,39043,1420,7000
1729.183,6,65,4748,42,33,42175,33,2889,23,31,78591,31,1859
0.198,6,46,21008,26,1066,7,1420,15987,20,467,10,2840,5021
1.314,6,40,11338,22,547,62,1360,5842,18,476,67,2715,5496
0.297,17,8,2774,8,318,42,357,2774,0,0,0,0,0
0.337,6,26,8892,13,227,28,547,1616,13,1098,27,2816,7276
1797.175,6,356,22520,208,69,8682,69,12460,148,69,12225,69,10060
1792.323,1,342,28728,342,56,5256,56,28728,0,0,0,0,0
1797.815,6,286,36610,117,144,15497,1360,17392,169,146,10700,1942,19218
2.206,17,4,518,3,39,855,39,201,1,289,0,289,317
1787.767,6,102,8296,68,65,26683,65,4930,34,59,54172,59,3366
1784.208,6,102,8364,68,66,26629,66,4964,34,60,54064,60,3400
2.52,17,4,624,4,128,840,128,624,0,0,0,0,0
2.384,17,2,136,1,32,0,32,60,1,48,0,48,76
7.306,17,3,228,3,48,3653,48,228,0,0,0,0,0
1798.342,6,363,24414,212,88,8522,469,14027,151,69,11987,69,10387
1781.892,17,142,11360,71,48,25455,48,5396,71,56,25455,56,5964
316.716,6,7,280,7,0,0,0,280,0,0,0,0,0
1.472,6,51,22465,29,976,52,1460,16809,22,476,60,2920,5656
751.414,17,13,1268,13,69,62617,352,1268,0,0,0,0,0
1797.39,1,268,28408,268,78,6731,78,28408,0,0,0,0,0
1756.57,6,3607,3964876,1283,148,1370,883,75124,2324,1675,756,12618,3889752
283.741,6,30,7432,13,158,23645,267,1317,17,603,17731,1380,6115
1798.625,6,350,28515,201,75,8993,267,13104,149,133,12152,1997,15411
1.036,6,10,1687,7,100,172,100,384,3,1179,384,1179,1303
8.792,17,55,43931,22,401,418,1350,9459,33,1016,207,1350,34472
0.515,17,3,451,2,39,97,39,134,1,289,0,289,317
0.071,17,2,192,1,60,0,60,88,1,76,0,76,104
1793.291,6,366,25541,213,100,8458,469,14936,153,69,11797,69,10605
1798.326,1,345,28980,345,56,5227,56,28980,0,0,0,0,0
7.98,6,18,6871,9,275,997,275,643,9,1171,632,1440,6228
0.422,6,12,1653,6,288,82,288,548,6,426,45,434,1105
1795.995,17,448,39896,403,35,4467,288,25676,45,288,40019,288,14220
1740.468,17,29,30624,29,1028,62159,1028,30624,0,0,0,0,0
214.739,17,4,240,2,32,214738,32,120,2,32,214737,32,120
0.549,17,3,543,2,39,206,39,134,1,381,0,381,409
0.349,6,21,7203,12,318,31,600,1906,9,964,42,1471,5297
347.323,6,52,8836,28,109,12856,721,2813,24,340,15092,2026,6023
9.559,6,15,3602,4,92,3186,92,296,11,303,938,2026,3306
184.868,6,48,13956,27,623,7110,1418,11393,21,209,9242,580,2563
8.247,6,1652,1497063,1026,1380,7,1408,1459847,626,931,12,2816,37216
1745.727,1,59,4956,59,56,30098,56,4956,0,0,0,0,0
5.005,17,32,14024,15,631,357,1350,9895,17,214,199,1350,4129
1787.467,6,102,8296,68,65,26678,65,4930,34,59,54161,59,3366
15.416,6,7,328,2,0,15416,0,88,5,0,3845,0,240
300.816,6,32,8331,18,204,17695,467,1820,14,525,5554,2694,6511
2.015,17,20,9135,11,606,198,1350,6976,9,211,246,1350,2159
1792.163,1,60,3360,60,28,30375,28,3360,0,0,0,0,0
7.936,2,2,64,2,8,7936,8,64,0,0,0,0,0
5.563,6,39,7269,19,218,309,314,3383,20,513,277,1179,3886
1798.209,17,449,39928,404,35,4462,288,25708,45,288,40025,288,14220
0.997,6,10,1687,6,100,199,100,344,4,589,242,1152,1343
1786.236,1,104,5824,104,28,17342,28,5824,0,0,0,0,0
130.453,17,8,2688,8,308,18636,308,2688,0,0,0,0,0
1741.585,17,30,20190,30,645,60054,645,20190,0,0,0,0,0
39.976,6,39,12128,20,633,2104,1360,4659,19,558,2210,1360,7469
62.64,6,23,9925,11,380,74,832,1613,12,977,5681,1360,8312
0.735,6,24,6470,13,314,59,910,2096,11,786,71,1460,4374
0.443,17,6,2008,6,306,88,354,2008,0,0,0,0,0
1773.415,6,182,15698,120,69,14902,69,8940,62,69,29068,69,6758
560.756,17,57,3648,57,36,10013,36,3648,0,0,0,0,0
280.235,6,29,7392,14,158,21556,267,1357,15,678,20014,3436,6035
0.024,17,2,122,1,33,0,33,61,1,33,0,33,61
1739.4,1,15,870,15,30,124242,30,870,0,0,0,0,0
1770.689,6,99,9240,66,65,27241,65,5577,33,59,55331,59,3663
100.022,6,21,9831,11,375,91,818,1599,10,1303,11097,3928,8232
10.95,6,19,4362,10,275,1216,275,958,9,758,766,1420,3404
0.025,17,2,122,1,33,0,33,61,1,33,0,33,61
0.309,17,5,1626,5,297,77,332,1626,0,0,0,0,0
15.066,6,1892,1680427,1183,1369,12,1380,1644545,709,515,21,1923,35882
0.181,17,3,3140,3,1018,90,1438,3140,0,0,0,0,0
280.808,6,29,7392,13,158,23400,267,1317,16,603,18705,2036,6075
1739.965,6,91,6604,59,31,29999,31,3998,32,31,56127,31,2606
280.423,6,30,7432,13,158,23368,267,1317,17,543,17515,1400,6115
0.348,6,24,6021,12,181,31,537,1526,12,643,29,1542,4495
240.598,6,57,18320,30,809,8296,1418,15357,27,172,9253,580,2963
0.232,6,8,807,5,304,58,304,560,3,83,111,83,247
1770.667,6,99,9240,66,65,27241,65,5577,33,59,55329,59,3663
1720.007,17,168,33914,168,173,10299,422,33914,0,0,0,0,0
1657.207,1,8,448,8,28,236743,28,448,0,0,0,0,0
29.309,6,40,9563,20,299,1542,721,3206,20,693,1532,1420,6357
20.186,6,22,5470,13,107,1682,159,1126,9,773,2521,1418,4344
0.415,17,2,152,1,48,0,48,76,1,48,0,48,76
15.5,17,10,880,5,48,3872,48,380,5,72,3871,72,500
300.305,6,28,9670,15,435,21450,1162,2554,13,804,2310,1440,7116
0.998,17,2,134,2,39,998,39,134,0,0,0,0,0
300.652,6,47,9036,24,286,13071,766,2208,23,346,677,2720,6828
280.33,6,28,7352,12,158,25484,267,1277,16,603,18683,1400,6075
1680.56,1,15,840,15,28,120040,28,840,0,0,0,0,0
0.02,17,4,284,2,32,13,32,120,2,54,10,60,164
1799.86,17,142,11360,71,48,25712,48,5396,71,56,25712,56,5964
17.503,17,8,608,8,48,2500,48,608,0,0,0,0,0
1792.537,17,87,3648,86,14,21088,14,3612,1,8,0,8,36
0.116,17,2,182,1,39,0,39,67,1,87,0,87,115
2.138,6,29,10365,17,367,133,833,1785,12,1012,186,1420,8580
8.937,6,50,9802,25,237,372,314,5034,25,470,360,1179,4768
0.044,17,2,284,1,54,0,54,82,1,174,0,174,202
14.419,6,662,582843,408,1353,34,1368,562507,254,931,56,2736,20336
6.223,6,12,945,6,222,1242,222,466,6,231,1242,231,479
0.228,17,2,152,1,48,0,48,76,1,48,0,48,76
252.092,2,2,64,2,8,252092,8,64,0,0,0,0,0
3.89,17,4,244,4,33,1296,33,244,0,0,0,0,0
1.098,17,4,377,2,33,1066,37,123,2,99,1058,136,254
1443.049,1,100,5600,100,28,14576,28,5600,0,0,0,0,0
1.392,6,48,18908,26,936,55,1460,13252,22,433,57,1460,5656
1.999,6,5,240,5,0,0,0,240,0,0,0,0,0
0.469,17,2,178,1,29,0,29,57,1,93,0,93,121
0.188,6,10,767,5,186,45,186,454,5,45,45,45,313
13.452,6,33,12721,21,831,672,1071,6919,12,517,1192,1408,5802
0.295,6,27,9042,13,247,24,624,1672,14,947,22,1408,7370
35.033,17,20,1760,10,48,3891,48,760,10,72,3891,72,1000
7.712,17,12,1764,6,48,1540,48,456,6,190,1540,308,1308
27.474,17,16,1408,8,48,3922,48,608,8,72,3922,72,800
721.962,2,4,128,4,8,240654,8,128,0,0,0,0,0
1750.834,6,95,7203,63,38,28239,205,4476,32,33,56471,98,2727
1773.869,6,149,9626,83,51,21632,208,6025,66,31,27287,31,3601
0.175,6,3,2615,2,1247,0,1360,2575,1,0,0,0,40
53.025,6,15,2286,11,837,5302,1452,2118,4,0,8053,0,168
1788.058,6,360,22749,209,69,8596,69,12569,151,69,11920,69,10180
0.054,6,19,3224,10,437,5,737,1852,9,224,6,694,1372
0.419,6,29,10339,15,423,29,1402,2482,14,791,31,1402,7857
1787.344,6,356,22520,207,69,8676,69,12420,149,69,12076,69,10100
10.652,6,16,3911,9,275,1331,275,643,7,992,957,1440,3268
0.016,6,7,414,3,31,8,31,175,4,31,1,31,239
280.198,6,28,7352,13,158,23349,267,1317,15,678,20011,2800,6035
0.859,6,10,1687,7,100,143,100,384,3,1179,305,1179,1303
8.558,6,1865,1755195,1172,1419,7,1448,1714495,693,776,12,1448,40700
7.952,6,18,6871,9,275,994,275,643,9,1171,637,1440,6228
116.272,6,18,732,8,0,16610,0,324,10,0,12918,0,408
0.301,17,2,152,1,48,0,48,76,1,48,0,48,76
11.792,6,68,20702,36,538,336,1152,15995,32,489,367,1179,4707
1728.953,1,8,448,8,28,246993,28,448,0,0,0,0,0
3.119,6,14,3586,7,75,519,75,459,7,1373,519,1448,3127
1739.085,6,87,6322,58,31,30510,31,3915,29,31,62109,31,2407
72.961,6,91,60008,56,1237,1326,1448,49965,35,586,2140,1448,10043
0.566,6,14,1745,7,288,66,288,600,7,426,66,434,1145
36.434,6,47,9108,23,401,706,889,2240,24,368,1578,3488,6868
240.241,6,57,18144,29,753,8579,1418,15082,28,199,8897,580,3062
0.005,6,2,80,1,0,0,0,40,1,0,0,0,40
1.501,6,50,21608,29,925,53,1360,15992,21,476,65,2715,5616
1795.993,17,87,3648,86,14,21129,14,3612,1,8,0,8,36
1.046,17,4,360,2,30,1000,30,116,2,94,1000,94,244
1777.108,17,142,11360,71,48,25386,48,5396,71,56,25386,56,5964
1771.088,6,99,9240,66,65,27247,65,5577,33,59,55344,59,3663
1799.598,1,58,4872,0,0,0,0,0,58,56,31571,56,4872
120.28,2,3,96,3,8,60140,8,96,0,0,0,0,0
1743.358,6,141,8912,77,49,22938,208,5453,64,31,27668,31,3459
12.77,6,28,5138,14,204,968,722,1796,14,435,967,1448,3342
0.439,17,8,2758,8,316,62,355,2758,0,0,0,0,0
9.863,17,2,672,2,308,9863,308,672,0,0,0,0,0
4.347,6,2,88,2,0,0,0,88,0,0,0,0,0
280.342,6,27,7312,12,158,25485,267,1277,15,678,20023,2045,6035
1680.437,1,15,870,15,30,120031,30,870,0,0,0,0,0
300.799,6,37,11472,21,577,15039,1408,4598,16,548,572,2816,6874
70.989,6,584,268124,305,823,233,1152,251118,279,417,254,1179,17006
5.394,6,16,3265,6,92,1078,92,400,10,463,558,1448,2865
0.247,6,19,4311,11,165,24,456,1394,8,498,34,888,2917
1774.38,1,63,5292,63,56,28619,56,5292,0,0,0,0,0
5.575,17,16,1209,9,40,686,41,617,7,56,923,57,592
280.194,6,29,7392,13,158,23349,267,1317,16,603,18676,1400,6075
0.872,6,2,1175,1,0,0,0,40,1,1095,0,1095,1135
0.068,6,10,1514,5,503,17,503,771,5,475,16,475,743
70.438,6,47,13022,23,632,530,1360,6008,24,464,3053,1360,7014
126.177,2,2,64,2,8,126177,8,64,0,0,0,0,0
1791.317,1,124,6944,124,28,14563,28,6944,0,0,0,0,0
157.519,6,22,8114,11,520,84,1223,2034,11,938,15735,1591,6080
0.168,17,4,588,2,48,160,48,152,2,190,158,308,436
0.028,17,2,167,1,39,0,39,67,1,72,0,72,100
477.245,6,66,9664,29,312,17043,1056,5578,37,163,13255,580,4086
37.81,6,8,460,2,0,37810,0,100,6,0,6276,0,360
17.616,6,38,9143,18,340,1023,722,2766,20,464,916,1380,6377
2.247,6,14,1518,8,304,321,304,1032,6,83,445,83,486
1.007,6,30,12373,15,525,71,1440,3258,15,850,58,1440,9115
1.348,6,32,6507,15,164,96,267,1922,17,650,74,1452,4585
1773.506,6,205,22439,130,75,13748,267,10057,75,132,23961,1460,12382
1770.191,6,173,25210,101,206,17701,827,15771,72,111,24931,234,9439
1773.299,6,180,15480,120,69,14901,69,8940,60,69,30051,69,6540
300.232,6,31,11832,17,592,18764,1402,4457,14,948,18480,2804,7375
10.495,6,1040,997974,662,1433,15,1448,973298,378,776,26,1448,24676
280.249,6,29,7392,13,158,23354,267,1317,16,543,18681,1400,6075
0.091,6,10,1752,6,592,17,1028,1429,4,159,29,159,323
0.132,1,10,840,10,56,14,56,840,0,0,0,0,0
1794.307,1,58,4872,0,0,0,0,0,58,56,31479,56,4872
1737.228,1,8,848,8,78,248175,78,848,0,0,0,0,0
1285.759,17,8,1552,8,166,183679,166,1552,0,0,0,0,0
176.09,6,32,14576,18,727,774,1360,6571,14,929,13533,1360,8005
1761.966,6,81,4340,40,26,45177,26,2144,41,26,44047,26,2196
4.099,6,39,7269,20,218,215,314,3423,19,513,214,1179,3846
382.427,6,21,1422,15,180,27316,180,992,6,110,12300,110,430
216.319,6,22,11325,22,565,10300,1402,11325,0,0,0,0,0
1.079,6,9,492,5,0,269,0,268,4,0,255,0,224
1.325,17,22,10806,12,666,117,1350,8334,10,219,143,1350,2472
1772.934,6,181,15589,120,69,14898,69,8940,61,69,29548,69,6649
1571.87,6,102,6118,55,26,29107,26,3260,47,26,34170,26,2858
7.39,6,1069,966197,670,1366,10,1408,940785,399,931,18,2816,25412
0.103,6,6,328,4,0,34,0,216,2,0,50,0,112
584.243,17,10,3360,10,308,64915,308,3360,0,0,0,0,0
1787.115,6,102,8364,68,66,26673,66,4964,34,60,54150,60,3400
2.405,6,5,284,3,0,1115,0,164,2,0,2230,0,120
11.011,6,20,7050,11,275,1101,275,998,9,1420,780,1420,6052
280.456,6,26,7272,12,158,25496,267,1277,14,775,21564,3465,5995
15.531,6,12,1355,7,284,2588,517,940,5,147,3828,147,415
0.092,6,10,1326,5,299,19,299,567,5,245,11,458,759
120.369,2,2,64,2,8,120369,8,64,0,0,0,0,0
0.309,17,2,172,1,50,0,50,78,1,66,0,66,94
4.089,6,10,538,7,69,680,69,418,3,0,1501,0,120
1.454,6,49,19169,29,880,51,1360,13548,20,437,66,2715,5621
1800.0,6,204,14152,74,46,24247,46,5916,130,46,13953,46,8236
0.026,17,2,567,1,43,0,43,71,1,468,0,468,496
150.798,6,22,9936,11,380,75,832,1613,11,1124,15066,1360,8323
38.835,1,44,4576,0,0,0,0,0,44,76,903,76,4576
1793.667,17,179,13962,179,50,10076,50,13962,0,0,0,0,0
0.601,6,10,968,5,256,132,256,460,5,304,134,304,508
1784.925,6,356,22658,207,69,8664,69,12420,149,69,12060,69,10238
0.457,6,30,7562,18,306,26,1089,2868,12,701,40,1728,4694
1797.748,17,449,39928,404,35,4460,288,25708,45,288,40015,288,14220
580.456,1,6,336,6,28,116091,28,336,0,0,0,0,0
1799.48,17,142,11360,71,48,25706,48,5396,71,56,25706,56,5964
132.927,6,39,8881,11,156,6347,267,1232,28,283,4922,1420,7649
0.005,17,2,574,1,32,0,32,60,1,486,0,486,514
1779.641,17,140,11200,70,48,25791,48,5320,70,56,25791,56,5880
0.049,17,4,284,2,32,30,32,120,2,54,23,60,164
1748.597,1,74,6216,74,56,23953,56,6216,0,0,0,0,0
0.009,6,3,182,2,31,9,31,111,1,31,0,31,71
1.605,6,24,9970,10,218,178,764,1622,14,950,113,2736,8348
99.852,6,46,8954,22,363,749,774,2085,24,346,4334,2128,6869
1796.4,17,448,39896,403,35,4468,288,25676,45,288,40021,288,14220
289.213,6,48,19907,20,1315,15221,1418,18150,28,293,10711,293,1757
17.861,17,20,7300,9,441,2229,1350,4227,11,251,1783,1350,3073
1771.527,6,101,9410,66,66,27254,66,5610,35,60,52100,60,3800
9.382,6,6,1257,4,327,3127,414,815,2,181,9196,270,442
1680.249,17,12,498,11,14,168024,14,462,1,8,0,8,36
1.516,6,47,19056,26,951,60,1460,13440,21,433,64,1460,5616
1799.502,6,243,46615,151,483,11996,483,36832,92,83,19774,102,9783
240.226,6,59,19909,30,807,8283,1418,16915,29,184,8579,580,2994
0.012,17,2,328,1,32,0,32,60,1,240,0,240,268
1.277,6,12,1304,6,256,249,256,756,6,304,252,304,548
1787.193,6,104,8376,68,65,26674,65,4930,36,59,51058,59,3446
1744.658,2,29,928,29,8,62309,8,928,0,0,0,0,0
1786.718,6,106,8388,68,64,26667,64,4896,38,58,48287,58,3492
1770.338,1,98,5488,98,28,18250,28,5488,0,0,0,0,0
1798.665,17,448,39896,403,35,4474,288,25676,45,288,40017,288,14220
2.54,17,26,7581,11,356,254,1350,4229,15,195,118,1350,3352
578.803,1,12,672,12,28,52618,28,672,0,0,0,0,0
5.016,17,4,288,2,36,5015,36,128,2,52,5016,52,160
1786.81,6,104,8510,69,66,26276,66,5070,35,60,52550,60,3440
0.272,6,9,1339,5,145,68,145,349,4,826,54,826,990
0.592,6,10,968,5,256,135,256,460,5,304,135,304,508
1772.721,6,180,15480,120,69,14896,69,8940,60,69,30042,69,6540
0.002,6,2,123,1,31,0,31,83,1,0,0,0,40
14.607,17,4,3100,4,747,4869,1451,3100,0,0,0,0,0
0.113,17,2,152,1,48,0,48,76,1,48,0,48,76
3.48,6,9,372,5,0,870,0,204,4,0,828,0,168
3.208,17,5,383,4,39,1069,39,268,1,87,0,87,115
0.262,6,3,802,2,413,262,413,493,1,269,0,269,309
27.17,17,16,1408,8,48,3879,48,608,8,72,3879,72,800
42.716,6,44,13294,19,928,1396,1360,7306,25,292,1772,2667,5988
1.815,6,54,19434,26,890,72,1440,13538,28,433,60,1440,5896
0.324,17,4,330,2,33,133,33,122,2,76,192,82,208
1684.447,2,24,768,24,8,73236,8,768,0,0,0,0,0
5.007,17,3,208,2,36,5007,36,128,1,52,0,52,80
1770.938,6,99,9174,66,64,27245,64,5544,33,58,55339,58,3630
0.16,6,9,1002,5,213,40,213,417,4,421,49,421,585
0.013,6,3,168,1,0,0,0,52,2,0,1,0,116
2.2,6,35,11993,19,254,122,658,1857,16,862,118,1460,10136
1796.52,17,448,39896,403,35,4468,288,25676,45,288,40017,288,14220
1791.39,6,432,26055,214,69,8410,69,12907,218,35,8255,48,13148
191.869,6,27,7312,12,158,17442,267,1277,15,678,13699,2045,6035
13.269,17,4,824,2,48,13211,48,152,2,308,13133,308,672
1790.505,6,126,15214,80,92,22664,501,6715,46,166,39786,1420,8499
0.193,17,2,558,1,32,0,32,60,1,470,0,470,498
0.057,17,2,152,2,48,57,48,152,0,0,0,0,0
0.231,17,8,2758,8,316,33,355,2758,0,0,0,0,0
240.169,6,54,18182,29,805,8577,1408,15211,25,207,10006,580,2971
0.97,6,24,6416,13,299,80,838,2019,11,988,96,1731,4397
4.589,6,30,10154,14,232,351,569,1678,16,848,304,1438,8476
94.804,6,24,9206,14,304,7292,597,1505,10,1214,10511,2720,7701
1754.004,6,186,11385,93,47,19065,208,6766,93,31,19062,31,4619
1786.387,6,106,8584,69,66,26270,66,5004,37,60,49619,60,3580
0.162,1,2,112,2,28,162,28,112,0,0,0,0,0
1743.717,6,95,7203,63,38,28124,205,4476,32,33,56234,98,2727
0.044,17,2,322,1,49,0,49,77,1,217,0,217,245
1793.635,17,177,13806,177,50,10191,50,13806,0,0,0,0,0
1783.45,6,102,8296,68,65,26618,65,4930,34,59,54041,59,3366
5.297,6,39,7269,20,218,278,314,3423,19,513,280,1179,3846
1779.962,6,354,22440,207,69,8640,69,12420,147,69,12191,69,10020
24.543,17,22,3352,11,48,2438,48,836,11,200,2437,308,2516
15.774,6,7,392,2,0,15774,0,112,5,0,3871,0,280
22.627,6,32,8237,19,129,1257,159,1927,13,703,1885,1669,6310
3.805,17,3,183,3,33,1902,33,183,0,0,0,0,0
0.086,17,2,417,1,44,0,44,72,1,317,0,317,345
290.24,6,105,10234,85,230,456,502,4556,20,324,15271,1420,5678
6.134,17,6,579,3,46,3064,46,222,3,91,3063,91,357
1784.474,1,225,12600,225,28,7966,28,12600,0,0,0,0,0
1117.731,6,105,12982,62,226,18323,1251,9059,43,68,26602,192,3923
10.823,17,15,17718,15,1153,773,1452,17718,0,0,0,0,0
0.045,17,2,185,1,45,0,45,73,1,84,0,84,112
160.721,6,17,1021,11,31,16055,31,688,6,31,32108,31,333
60.483,17,4,240,2,32,60482,32,120,2,32,60482,32,120
1794.669,17,80,3354,79,14,23008,14,3318,1,8,0,8,36
1.105,6,23,7952,12,164,85,267,1288,11,1216,94,2804,6664
0.459,6,12,1653,6,288,88,288,548,6,426,53,434,1105
377.207,6,18,1242,14,180,29015,180,916,4,110,20066,110,326
84.977,6,31,8912,14,158,6536,267,1357,17,687,5308,2036,7555
140.192,6,25,10208,12,549,71,1360,2709,13,995,11670,1360,7499
20.733,17,42,20580,21,667,1035,1350,14615,21,256,1035,1350,5965
298.912,1,4,224,4,28,99637,28,224,0,0,0,0,0
0.23,6,46,21038,26,1068,9,1420,16017,20,467,11,1883,5021
5.022,2,2,64,2,8,5022,8,64,0,0,0,0,0
1798.948,17,449,39928,404,35,4463,288,25708,45,288,40015,288,14220
129.085,6,26,9491,14,563,67,1351,2306,12,956,11718,3151,7185
0.4,6,7,295,4,0,133,0,164,3,7,108,7,131
0.214,6,9,527,5,43,53,43,311,4,0,70,0,216
560.463,17,6,1647,3,30,280226,30,174,3,463,280226,463,1473
10.989,6,6,328,4,0,3663,0,216,2,0,10768,0,112
0.008,17,2,574,1,32,0,32,60,1,486,0,486,514
7.884,6,71,20358,35,521,231,1152,15475,36,491,217,1179,4883
296.003,17,4,352,2,60,296002,60,176,2,60,296002,60,176
0.093,2,3,96,3,8,46,8,96,0,0,0,0,0
1758.463,17,190,43213,190,199,9304,422,43213,0,0,0,0,0
1771.17,6,99,9240,66,65,27248,65,5577,33,59,55346,59,3663
31.65,6,7,308,1,0,0,0,44,6,0,6310,0,264
0.366,6,10,968,5,256,89,256,460,5,304,88,304,508
104.565,6,48,9172,23,401,705,889,2264,25,327,4350,1360,6908
1.087,6,23,7952,12,164,84,267,1288,11,1216,92,2816,6664
8.542,6,85,26341,43,559,203,1152,20179,42,407,202,1152,6162
4.26,17,5,290,5,30,1065,30,290,0,0,0,0,0
0.821,6,21,9137,11,500,82,1194,1972,10,964,66,1360,7165
0.308,6,27,6136,12,164,28,453,1442,15,558,21,1408,4694
280.298,6,28,7352,12,158,25481,267,1277,16,603,18684,1400,6075
33.674,6,28,4937,15,180,2405,722,1858,13,479,2779,2026,3079
556.472,17,30,4528,15,48,39747,48,1140,15,197,39747,308,3388
0.013,17,2,558,1,32,0,32,60,1,470,0,470,498
1794.632,6,356,22520,208,69,8669,69,12460,148,69,12208,69,10060
0.433,6,55,23376,31,1061,14,1380,16206,24,515,16,1923,7170
340.188,6,548,254173,280,827,356,1152,237229,268,388,1273,1179,16944
2.704,2,3,96,3,8,1352,8,96,0,0,0,0,0
168.81,17,4,352,2,60,168808,60,176,2,60,168809,60,176
0.095,6,12,3462,6,75,19,75,395,6,1373,18,1448,3067
15.462,6,30,5024,14,154,1160,722,1819,16,296,997,1448,3205
1.665,6,13,2311,8,188,237,245,700,5,1407,354,1407,1611
3.785,6,21,6353,10,262,415,517,1316,11,744,373,1418,5037
1786.49,6,106,8524,68,66,26664,66,4964,38,60,48281,60,3560
5.996,6,14,2254,8,210,856,210,856,6,545,1193,904,1398
0.03,6,10,1514,5,503,7,503,771,5,475,7,475,743
1719.572,17,12,498,11,14,171957,14,462,1,8,0,8,36
1745.282,6,95,7203,63,38,28149,205,4476,32,33,56288,98,2727
71.102,6,21,860,10,0,5426,0,408,11,0,7108,0,452
7.793,6,18,6871,9,275,974,275,643,9,1171,947,1440,6228
33.077,6,614,512744,358,1354,92,1368,492631,256,780,128,2736,20113
249.718,1,16,896,16,28,16647,28,896,0,0,0,0,0
0.259,6,22,4442,11,165,25,456,1394,11,493,24,888,3048
4.136,17,10,1450,5,40,1032,40,340,5,194,1032,194,1110
0.38,6,12,3704,6,171,75,171,491,6,964,75,1448,3213
61.35,6,37,15984,22,805,2921,1408,9205,15,665,4363,1408,6779
0.058,17,2,245,1,32,0,32,60,1,157,0,157,185
1794.279,17,302,67329,302,194,5961,422,67329,0,0,0,0,0
1.371,6,48,18535,27,843,52,1360,12919,21,476,59,2715,5616
0.365,6,13,1693,7,288,58,288,588,6,426,39,434,1105
15.347,17,16,9189,8,821,2186,1350,6798,8,270,2186,1350,2391
1785.503,6,106,8644,70,66,25876,66,5044,36,60,51011,60,3600
0.202,6,46,21708,27,1041,7,1420,16727,19,467,10,1883,4981
1797.794,17,446,39832,401,35,4494,288,25612,45,288,40022,288,14220
0.072,17,2,390,1,46,0,46,74,1,288,0,288,316
44.932,6,47,19640,21,196,2239,214,1934,26,1383,1791,1642,17706
0.084,17,2,672,2,308,84,308,672,0,0,0,0,0
0.351,6,10,1669,6,551,70,947,1346,4,159,117,159,323
134.694,17,4,352,2,60,134693,60,176,2,60,134693,60,176
4.007,17,5,556,4,64,1324,64,368,1,160,0,160,188
0.817,17,16,10682,7,720,136,1350,5238,9,576,64,1350,5444
0.166,17,4,420,2,33,0,33,122,2,121,0,145,298
16.653,6,28,7217,13,155,1387,267,1306,15,482,1188,1997,5911
944.57,17,185,14060,185,48,5133,48,14060,0,0,0,0,0
248.51,6,9,522,2,106,248500,106,194,7,0,41416,0,328
560.964,17,6,444,3,30,280457,30,174,3,62,280460,62,270
1020.227,17,288,27442,140,107,7339,1350,18951,148,29,6936,60,8491
1.856,17,2,134,2,39,1856,39,134,0,0,0,0,0
0.978,6,25,6471,14,309,74,885,2111,11,783,97,1420,4360
0.631,6,3,120,2,0,631,0,80,1,0,0,0,40
154.626,1,12,4585,12,354,14056,376,4585,0,0,0,0,0
2.108,6,19,4545,10,282,234,547,1251,9,488,251,1420,3294
0.623,6,11,976,5,283,105,283,551,6,105,86,105,425
0.04,17,4,368,2,32,24,32,120,2,96,24,96,248
0.017,17,2,519,1,40,0,40,68,1,423,0,423,451
1782.132,6,354,22440,207,69,8651,69,12420,147,69,12206,69,10020
51.165,6,18,13010,2,214,1908,214,314,16,1204,3401,1440,12696
10.666,6,16,1507,9,213,1333,213,794,7,421,1389,421,713
1771.087,6,105,9654,67,65,26834,65,5694,38,59,47864,84,3960
1798.519,6,373,25559,216,92,8365,469,14863,157,69,11527,69,10696
1227.295,17,238,18088,238,48,5178,48,18088,0,0,0,0,0
1786.78,6,102,8296,68,65,26668,65,4930,34,59,54141,59,3366
1787.368,6,102,8296,68,65,26677,65,4930,34,59,54158,59,3366
1.936,6,25,8080,12,164,159,267,1312,13,869,146,1402,6768
1772.126,6,180,15480,120,69,14891,69,8940,60,69,30035,69,6540
1788.951,6,356,22520,208,69,8642,69,12460,148,69,12169,69,10060
0.05,6,10,1495,5,507,12,507,727,5,556,12,556,768
300.887,6,43,14057,24,832,13082,1360,8483,19,435,484,2667,5574
2.929,17,2,312,2,128,2929,128,312,0,0,0,0,0
69.49,6,20,10696,11,346,60,719,1510,9,1762,8670,3966,9186
1199.05,6,70,5378,46,41,26645,205,3313,24,34,52110,98,2065
310.434,6,65,42972,41,1172,7760,1448,34972,24,749,2675,1448,8000
1682.64,17,14,1036,7,30,280430,30,406,7,62,280435,62,630
1788.982,6,276,28843,114,82,15830,659,11993,162,132,11110,2720,16850
0.439,6,20,7238,12,335,39,668,1974,8,1210,61,1906,5264
1719.763,17,12,498,11,14,171976,14,462,1,8,0,8,36
11.366,6,23,6857,12,275,1033,275,1038,11,1073,634,1440,5819
1740.739,17,30,31680,30,1028,60025,1028,31680,0,0,0,0,0
502.891,17,7,2364,7,309,83815,312,2364,0,0,0,0,0
15.268,6,16,6184,5,221,3817,221,441,11,755,1513,1360,5743
29.801,6,20,3130,12,183,2709,517,1561,8,381,4256,499,1569
1781.444,17,142,11360,71,48,25449,48,5396,71,56,25449,56,5964
1564.153,2,16,512,16,8,104276,8,512,0,0,0,0,0
1797.794,17,448,39896,403,35,4472,288,25676,45,288,40018,288,14220
2.873,6,5,280,2,0,2873,0,100,3,0,1160,0,180
182.972,6,17,2471,5,188,1242,245,580,12,703,16612,1152,1891
11.116,6,22,4886,13,210,923,210,1338,9,616,1381,904,3548
280.248,6,28,7352,13,158,23354,267,1317,15,603,20016,2800,6035
1798.674,17,450,39960,405,35,4452,288,25740,45,288,40020,288,14220
1799.086,17,80,3354,79,14,23065,14,3318,1,8,0,8,36
136.972,17,4,240,2,32,136971,32,120,2,32,136970,32,120
280.935,6,30,7432,13,158,23411,267,1317,17,543,17548,1400,6115
1798.305,17,449,39928,404,35,4462,288,25708,45,288,40018,288,14220
130.169,1,8,448,8,28,18595,28,448,0,0,0,0,0
1792.58,6,372,25988,216,99,8337,469,15194,156,69,11563,69,10794
240.12,6,47,9400,23,209,10914,834,2704,24,453,10439,1408,6696
300.379,6,30,11710,18,582,17669,1408,4439,12,1106,21846,2816,7271
45.722,1,5,280,5,28,11430,28,280,0,0,0,0,0
1.62,6,2,1520,1,0,0,0,40,1,1440,0,1440,1480
92.831,6,44,10605,21,769,468,1360,4790,23,325,4211,1360,5815
1786.401,6,103,8401,69,65,26270,65,5035,34,59,54129,59,3366
15.046,6,1300,1235173,843,1391,17,1448,1206745,457,776,32,1448,28428
0.24,6,4,1037,2,0,208,0,104,2,853,33,853,933
1.173,17,2,178,1,29,0,29,57,1,93,0,93,121
278.381,17,4,352,2,60,278380,60,176,2,60,278380,60,176
1.455,6,24,11417,12,695,114,1237,3304,12,952,116,1360,8113
0.589,6,26,7256,13,155,49,267,1301,13,678,42,4200,5955
7.255,6,45,8718,22,231,345,314,4355,23,491,317,1179,4363
0.129,17,2,152,1,48,0,48,76,1,48,0,48,76
0.869,17,26,13992,13,779,72,1350,10496,13,240,64,1350,3496
0.158,1,2,112,2,28,158,28,112,0,0,0,0,0
40.864,17,11,836,11,48,4086,48,836,0,0,0,0,0
1793.604,17,87,3648,86,14,21101,14,3612,1,8,0,8,36
1795.133,17,80,3354,79,14,23014,14,3318,1,8,0,8,36
0.045,17,2,231,1,34,0,34,62,1,141,0,141,169
0.002,6,9,14136,1,0,0,0,40,8,1710,0,2736,14096
22.656,17,2,152,2,48,22656,48,152,0,0,0,0,0
61.902,6,53,32283,33,1085,1934,1368,24509,20,840,3245,2736,7774
0.067,6,4,160,2,0,0,0,80,2,0,1,0,80
280.445,6,30,7432,13,158,23370,267,1317,17,543,17525,1400,6115
899.748,6,12,728,8,31,128535,31,444,4,31,299806,31,284
1788.764,6,121,14516,79,84,22932,502,6390,42,161,43626,1452,8126
1680.522,17,12,498,11,14,168052,14,462,1,8,0,8,36
163.918,6,1483,757039,824,850,199,1152,724524,659,410,248,1179,32515
14.444,6,21,6825,12,275,1313,275,1038,9,1353,1179,1440,5787
1787.084,6,357,22767,206,69,8717,69,12380,151,69,11913,69,10387
2.032,6,13,2311,8,188,290,245,700,5,1407,444,1407,1611
1786.552,6,102,8364,68,66,26664,66,4964,34,60,54135,60,3400
497.846,6,102,6920,45,46,11283,46,2892,57,46,8890,46,4028
1796.603,1,58,4872,0,0,0,0,0,58,56,31519,56,4872
1791.881,1,58,4872,0,0,0,0,0,58,56,31436,56,4872
0.115,17,2,396,1,39,0,39,67,1,301,0,301,329
9.254,6,80,24421,41,550,231,1152,18720,39,459,236,1179,5701
0.201,6,9,1002,5,213,50,213,417,4,421,56,421,585
124.854,17,4,352,2,60,124853,60,176,2,60,124853,60,176
0.253,17,3,451,2,39,174,39,134,1,289,0,289,317
770.701,6,99,8351,35,76,22667,292,3610,64,58,12229,429,4741
0.734,6,21,8187,12,234,66,391,1216,9,1099,69,4428,6971
6.233,6,1171,1071522,717,1416,8,1448,1043238,454,776,13,1448,28284
0.17,6,3,395,2,275,1,275,355,1,0,0,0,40
0.701,6,181,176370,124,201,5,230,7837,57,3065,10,14080,168533
24.685,6,128,92903,56,131,448,232,2773,72,1363,346,1420,90130
0.783,6,23,5715,13,158,63,370,1315,10,999,85,1691,4400
20.127,6,21,5442,12,107,1829,159,1098,9,967,2515,1669,4344
11.572,17,2,780,2,362,11572,362,780,0,0,0,0,0
1771.792,6,101,9344,66,65,27258,65,5577,35,59,52108,59,3767
0.026,17,2,399,1,35,0,35,63,1,308,0,308,336
47.168,17,24,8754,24,336,2050,359,8754,0,0,0,0,0
413.805,1,156,16224,0,0,0,0,0,156,76,2669,76,16224
0.826,6,111,87369,59,131,14,232,2889,52,1753,16,4260,84480
367.118,6,25,1654,17,180,22944,180,1120,8,110,9217,110,534
0.215,17,4,284,2,32,0,32,120,2,54,0,60,164
33.559,6,29,4990,14,180,2581,722,1807,15,342,2383,1408,3183
602.37,6,36,6579,19,250,33465,1314,2516,17,307,37646,1380,4063
643.432,1,7,392,7,28,107238,28,392,0,0,0,0,0
6.764,6,42,7672,21,222,338,314,3730,21,516,325,1179,3942
0.734,6,25,7439,16,300,48,677,2745,9,721,87,1460,4694
1787.1,6,102,8296,68,65,26673,65,4930,34,59,54150,59,3366
1793.175,6,356,22520,208,69,8662,69,12460,148,69,12198,69,10060
495.851,6,32,2551,20,65,26097,65,1450,12,56,45065,59,1101
1535.964,6,95,13985,57,99,27427,721,6769,38,474,8753,1440,7216
1782.37,17,83,3480,82,14,22004,14,3444,1,8,0,8,36
1192.305,6,240,15258,137,70,8766,138,8378,103,69,11689,69,6880
959.74,6,91,9796,50,82,19581,721,4501,41,105,23988,1448,5295
210.383,17,4,288,2,36,210351,36,128,2,52,210352,52,160
1700.574,17,12,498,11,14,170057,14,462,1,8,0,8,36
1770.991,6,101,9410,66,66,27246,66,5610,35,60,52085,60,3800
1.12,6,31,8643,17,222,59,540,2056,14,859,73,1791,6587
0.243,17,2,152,1,48,0,48,76,1,48,0,48,76
300.821,6,39,9873,21,572,15041,1360,4320,18,401,505,2720,5553
0.018,6,2,173,2,46,18,62,173,0,0,0,0,0
0.467,6,12,1653,6,288,92,288,548,6,426,58,434,1105
3.127,17,49,38676,20,505,163,1350,10665,29,937,110,1350,28011
0.179,6,39,26622,20,185,9,524,1964,19,1478,9,3876,24658
1443.9,2,12,384,12,8,131263,8,384,0,0,0,0,0
1.459,6,48,18200,26,882,58,1360,12544,22,433,60,1360,5656
31.998,6,812,696082,485,1357,66,1368,673000,327,749,97,1368,23082
1799.928,6,366,25190,157,46,11346,46,10252,209,46,8653,46,14938
1772.366,6,180,15480,120,69,14893,69,8940,60,69,30038,69,6540
60.058,6,12,1398,7,302,10009,302,964,5,83,15011,83,434
3.055,17,4,240,2,32,3055,32,120,2,32,3055,32,120
1770.829,6,110,10167,70,65,25664,65,5939,40,59,45403,59,4228
0.378,6,26,9039,13,266,31,705,1750,13,943,29,1438,7289
479.318,17,38,3040,19,48,26627,48,1444,19,56,26627,56,1596
126.58,2,2,64,2,8,126580,8,64,0,0,0,0,0
21.813,6,9,527,5,43,5453,43,311,4,0,7259,0,216
5.229,6,40,7309,21,218,261,314,3463,19,513,275,1179,3846
11.64,17,8,704,4,48,3875,48,304,4,72,3875,72,400
2.156,17,15,5194,7,355,359,1350,2687,8,285,198,1350,2507
2.344,17,5,311,4,31,780,31,236,1,47,0,47,75
0.012,17,2,341,1,64,0,64,92,1,221,0,221,249
1624.318,2,15,480,15,8,116022,8,480,0,0,0,0,0
2.187,17,4,314,2,31,2144,31,118,2,70,2142,70,196
284.452,6,32,7991,14,143,21880,267,1426,18,531,16722,2036,6565
280.031,6,28,7352,12,158,25457,267,1277,16,543,18666,1400,6075
71.521,6,22,7994,11,511,87,1194,2005,11,791,7133,1440,5989
1798.661,1,57,4788,57,56,32118,56,4788,0,0,0,0,0
1797.652,17,180,14040,180,50,10042,50,14040,0,0,0,0,0
564.201,1,210,17640,210,56,2699,56,17640,0,0,0,0,0
0.08,17,4,352,2,37,30,37,130,2,83,51,89,222
280.627,6,28,7352,13,158,23385,267,1317,15,678,20041,2045,6035
1798.797,6,355,22549,205,69,8817,69,12409,150,69,12069,69,10140
33.365,17,4,240,2,32,33364,32,120,2,32,33364,32,120
7.1,6,6,280,2,0,7100,0,88,4,0,2364,0,192
0.385,17,4,334,2,39,153,39,134,2,72,0,72,200
180.185,6,30,7716,16,245,12011,538,1886,14,525,13859,1460,5830
1778.688,2,11,352,11,8,177868,8,352,0,0,0,0,0
5.312,17,3,208,2,36,5002,36,128,1,52,0,52,80
27.48,17,16,1408,8,48,3923,48,608,8,72,3923,72,800
1787.29,6,102,8296,68,65,26675,65,4930,34,59,54157,59,3366
63.887,6,27,7177,13,155,5323,267,1306,14,530,4913,2840,5871
173.731,6,30,7432,13,158,14477,267,1317,17,603,10855,2076,6115
1743.267,6,103,7619,63,38,28117,205,4476,40,33,44688,98,3143
5.719,6,34,6212,17,206,357,314,2744,17,464,340,1179,3468
299.2,17,4,352,2,60,299199,60,176,2,60,299199,60,176
1798.893,6,370,25839,215,99,8406,469,15154,155,69,11679,69,10685
280.47,6,29,7392,12,158,25497,267,1277,17,603,17523,1380,6115
10.47,6,1301,1135998,759,1410,13,1448,1100318,542,776,19,1448,35680
15.275,17,12,4647,6,362,3052,1350,2345,6,355,3047,1350,2302
5.054,17,4,288,2,36,5006,36,128,2,52,5006,52,160
75.705,6,32,7653,13,155,6308,267,1306,19,398,4205,3417,6347
601.625,2,6,192,6,8,120325,8,192,0,0,0,0,0
1800.0,6,206,14348,74,46,24247,46,5986,132,46,13740,46,8362
5.35,17,4,3964,4,963,1783,1451,3964,0,0,0,0,0
1773.21,1,60,5040,0,0,0,0,0,60,56,30054,56,5040
8.257,6,19,10943,5,101,2062,112,411,14,905,634,1420,10532
0.952,17,2,312,2,128,952,128,312,0,0,0,0,0
0.089,6,9,1339,5,145,22,145,349,4,826,25,826,990
92.225,17,4,352,2,60,92224,60,176,2,60,92224,60,176
39.294,17,22,1936,11,48,3918,48,836,11,72,3926,72,1100
1.041,17,3,451,2,39,610,39,134,1,289,0,289,317
1796.341,17,445,39232,402,35,4479,288,25644,43,288,41926,288,13588
1796.378,17,447,39864,402,35,4479,288,25644,45,288,40020,288,14220
617.858,6,136,38850,61,557,10297,1360,25395,75,197,8347,2720,13455
1786.809,6,354,22440,207,69,8673,69,12420,147,69,12238,69,10020
16.227,6,13,2133,8,324,2318,585,1073,5,396,3945,580,1060
1773.453,6,180,15480,120,69,14902,69,8940,60,69,30050,69,6540
0.105,17,2,136,1,32,0,32,60,1,48,0,48,76
280.469,6,30,7432,13,158,23372,267,1317,17,678,17526,3456,6115
1763.766,2,27,864,27,8,67837,8,864,0,0,0,0,0
962.536,2,11,352,11,8,96253,8,352,0,0,0,0,0
1777.56,6,29,5268,19,292,98753,413,3686,10,131,197486,269,1582
20.133,6,21,5418,12,107,1830,159,1074,9,773,2515,1402,4344
1.644,17,6,540,3,30,798,30,174,3,94,805,94,366
240.416,6,48,8656,24,449,10452,1418,5752,24,206,10452,580,2904
280.441,6,29,7392,13,158,23370,267,1317,16,603,18692,2036,6075
1790.761,6,355,22687,208,69,8651,69,12598,147,69,12265,69,10089
1786.274,17,87,3648,86,14,21014,14,3612,1,8,0,8,36
1796.523,17,959,308562,451,586,3989,1350,277070,508,33,3543,272,31492
2.151,17,4,518,3,39,535,39,201,1,289,0,289,317
1651.968,1,8,448,8,28,235995,28,448,0,0,0,0,0
1775.254,17,140,11200,70,48,25728,48,5320,70,56,25728,56,5880
2.74,17,4,624,4,128,913,128,624,0,0,0,0,0
1791.312,6,366,29362,206,75,8738,267,13511,160,133,11265,2077,15851
8.928,17,39,15378,18,271,523,1350,5396,21,447,444,1350,9982
106.35,17,4,352,2,60,106348,60,176,2,60,106349,60,176
217.24,6,29,7392,13,158,18103,267,1317,16,603,14480,2036,6075
76.131,6,26,6364,9,267,228,502,1166,17,322,4752,1420,5198
1776.464,1,172,18232,172,78,10388,78,18232,0,0,0,0,0
0.088,6,6,328,4,0,29,0,216,2,0,55,0,112
0.012,17,2,206,1,44,0,44,72,1,106,0,106,134
4.006,17,5,1160,5,204,1001,204,1160,0,0,0,0,0
38.703,17,44,6468,22,48,1842,48,1672,22,190,1842,308,4796
14.509,6,13,2133,8,324,2072,585,1073,5,396,3470,580,1060
317.076,6,43,11957,22,267,15098,1305,3316,21,519,15844,4649,8641
26.208,6,44,12908,21,208,1310,721,2512,23,728,1181,1440,10396
601.618,2,7,224,7,8,100269,8,224,0,0,0,0,0
1171.679,17,236,34692,118,48,10014,48,8968,118,190,10014,308,25724
67.293,6,78,49694,48,1174,1431,1448,41313,30,567,2245,1448,8381
9.859,6,1452,1336539,945,1364,10,1432,1311956,507,427,19,1432,24583
0.01,17,2,340,1,32,0,32,60,1,252,0,252,280
1.614,6,51,20535,28,912,59,1360,14839,23,433,63,1360,5696
61.861,6,22,8752,11,314,74,634,1415,11,983,6172,1360,7337
236.499,6,34,19558,22,915,11261,1231,13985,12,705,2414,1448,5573
1799.103,6,359,22709,209,69,8649,69,12569,150,69,12074,69,10140
240.196,6,54,19355,29,843,8578,1408,16707,25,167,10008,580,2648
0.377,6,10,968,5,256,92,256,460,5,304,92,304,508
1779.564,17,140,11200,70,48,25790,48,5320,70,56,25790,56,5880
1787.904,6,363,25352,211,100,8513,469,14856,152,69,11840,69,10496
12.018,17,12,864,6,33,2402,33,366,6,55,2401,61,498
1727.366,1,16,896,16,28,115157,28,896,0,0,0,0,0
1772.27,6,180,15480,120,69,14893,69,8940,60,69,30032,69,6540
15.26,17,19,11829,10,671,1687,1350,6991,9,509,1898,1350,4838
0.15,17,4,420,2,33,14,33,122,2,121,138,145,298
2.417,6,5,288,2,0,2243,0,112,3,0,1121,0,176
0.188,6,23,5910,13,164,15,453,1494,10,555,20,1542,4416
1762.931,1,8,448,8,28,251847,28,448,0,0,0,0,0
3.366,17,2,778,2,361,3366,361,778,0,0,0,0,0
280.11,6,30,7432,13,158,23342,267,1317,17,543,17502,1400,6115
1773.986,17,16,1265,8,30,253424,37,471,8,71,253424,136,794
1783.818,6,364,25392,212,100,8454,469,14896,152,69,11813,69,10496
2.138,6,10,1687,7,100,356,100,384,3,1179,934,1179,1303
1799.334,17,142,11360,71,48,25704,48,5396,71,56,25704,56,5964
78.04,17,4,1296,4,296,26013,300,1296,0,0,0,0,0
41.645,17,6,528,3,48,20818,48,228,3,72,20818,72,300
4.924,6,42,8289,21,227,246,314,4022,21,489,233,1179,4267
3.892,17,28,10181,12,453,353,1350,5781,16,247,239,1350,4400
350.834,1,12,1272,12,78,31894,78,1272,0,0,0,0,0
5.498,6,7,533,4,245,1746,245,409,3,0,2618,0,124
0.12,6,9,1340,5,145,30,145,349,4,827,37,827,991
182.783,6,163,110889,84,1209,229,1460,22743,79,1268,2341,1460,88146
255.777,17,4,340,2,37,255766,37,130,2,77,255769,77,210
1791.105,1,60,5040,0,0,0,0,0,60,56,30357,56,5040
33.714,6,90,27092,43,966,362,1101,15351,47,246,730,1460,11741
1787.37,6,102,8296,68,65,26677,65,4930,34,59,54158,59,3366
1798.816,1,59,4956,59,56,31014,56,4956,0,0,0,0,0
365.285,6,15,1270,6,226,73057,226,558,9,110,12961,110,712
1.579,6,37,8262,19,321,87,1164,2766,18,529,81,4075,5496
90.876,6,40,27070,17,754,47,1460,3730,23,1318,4124,1605,23340
3.263,17,24,11884,10,405,362,1350,4330,14,511,185,1350,7554
6.956,6,23,4478,13,213,579,597,1741,10,441,753,1448,2737
1671.232,1,7,392,7,28,278538,28,392,0,0,0,0,0
1783.809,6,427,25552,216,69,8296,69,12780,211,35,8494,64,12772
0.042,17,2,358,1,30,0,30,58,1,272,0,272,300
1778.243,17,73,3060,72,14,25045,14,3024,1,8,0,8,36
291.177,1,4,224,4,28,97059,28,224,0,0,0,0,0
169.289,6,33,13298,18,528,960,690,4449,15,748,12083,1360,8849
0.135,17,4,284,2,32,65,32,120,2,54,75,60,164
52.009,17,4,272,2,32,52006,32,120,2,48,52005,48,152
293.437,6,49,8362,22,128,13971,517,2335,27,417,11284,1418,6027
1263.349,2,11,352,11,8,126334,8,352,0,0,0,0,0
4.75,6,43,8329,21,227,237,314,4022,22,489,214,1179,4307
300.808,6,42,10668,23,678,13673,1360,5061,19,371,478,1360,5607
0.36,6,20,7151,11,318,35,600,1854,9,964,43,1471,5297
204.665,17,4,352,2,60,204664,60,176,2,60,204664,60,176
1797.962,6,356,22520,208,69,8685,69,12460,148,69,12230,69,10060
18.94,6,26,7068,13,155,1578,267,1306,13,581,1577,3417,5762
1740.472,6,87,6322,58,31,30534,31,3915,29,31,62159,31,2407
1050.627,1,88,9328,88,78,12076,78,9328,0,0,0,0,0
1799.331,1,58,4872,0,0,0,0,0,58,56,31567,56,4872
0.231,6,9,1346,5,145,57,145,349,4,833,43,833,997
0.139,17,4,420,2,33,1,33,122,2,121,75,145,298
61.629,6,36,15724,22,784,2934,1368,8998,14,748,4717,2519,6726
7.532,17,4,1344,4,308,2510,308,1344,0,0,0,0,0
1785.903,6,102,8364,68,66,26655,66,4964,34,60,54115,60,3400
0.588,6,10,861,5,222,145,222,426,5,231,145,231,435
20.454,17,32,7964,14,225,1571,1350,3542,18,217,1201,1350,4422
3.538,6,33,6129,17,206,221,314,2744,16,456,218,1152,3385
0.135,17,2,322,1,33,0,33,61,1,233,0,233,261
1740.608,6,87,6322,58,31,30536,31,3915,29,31,62164,31,2407
3.15,17,2,322,1,33,0,33,61,1,233,0,233,261
1772.848,6,180,15480,120,69,14897,69,8940,60,69,30041,69,6540
0.067,17,2,241,1,36,0,36,64,1,149,0,149,177
31.367,6,2897,2641390,1793,1391,17,1448,2578630,1104,776,28,1448,62760
119.198,6,25,6318,9,272,95,516,1180,16,345,7940,1452,5138
0.034,17,4,284,2,32,0,32,120,2,54,4,60,164
300.899,6,40,8800,21,317,15044,923,2154,19,419,480,1460,6646
2.987,1,3,168,3,28,1493,28,168,0,0,0,0,0
1787.23,6,104,8376,68,65,26675,65,4930,36,59,51060,59,3446
280.045,6,31,7472,14,158,21541,267,1357,17,543,17499,1400,6115
0.012,17,4,284,2,32,9,32,120,2,54,7,60,164
1772.001,6,180,15480,120,69,14890,69,8940,60,69,30032,69,6540
1.809,17,3,1176,3,364,904,364,1176,0,0,0,0,0
1.692,6,20,3833,11,234,169,564,1504,9,463,189,1343,2329
2.957,17,3,366,3,94,1478,94,366,0,0,0,0,0
1.345,6,47,21029,28,956,49,1360,15493,19,476,63,2715,5536
206.021,6,23,2653,12,324,18729,585,1281,11,396,20600,580,1372
1786.448,6,102,8296,68,65,26663,65,4930,34,59,54132,59,3366
11.011,17,34,7808,9,254,1344,1350,2541,25,182,457,1350,5267
0.426,6,113,87565,55,131,7,232,2729,58,1556,7,2840,84836
2.946,6,10,1687,7,100,491,100,384,3,1179,1345,1179,1303
2.015,6,19,3781,10,234,223,564,1452,9,463,218,1343,2329
12.407,6,1907,1685230,1194,1360,10,1380,1652411,713,387,17,1923,32819
1798.627,6,100,8012,65,51,28103,205,5130,35,31,52892,33,2882
0.12,6,12,3705,6,171,19,171,491,6,964,20,1448,3214
2.895,17,4,268,4,39,965,39,268,0,0,0,0,0
1.654,6,33,12099,19,507,91,1360,3339,14,818,111,2720,8760
1.429,6,24,8004,12,164,111,267,1288,12,1014,112,2491,6716
4.338,6,2,88,2,0,0,0,88,0,0,0,0,0
0.317,17,2,152,1,48,0,48,76,1,48,0,48,76
1.506,6,49,19217,27,889,57,1460,13561,22,433,62,1460,5656
2.897,17,22,11512,11,757,289,1350,8642,11,232,236,1350,2870
367.054,6,23,1535,16,177,24470,177,1053,7,110,10375,110,482
1740.703,6,87,6322,58,31,30538,31,3915,29,31,62167,31,2407
1795.745,17,80,3354,79,14,23022,14,3318,1,8,0,8,36
61.849,6,70,46330,43,1159,1472,1408,38192,27,840,2369,2439,8138
0.588,6,22,7342,13,335,49,668,2026,9,1210,68,1946,5316
280.454,6,27,7312,13,158,23371,267,1317,14,775,21569,3465,5995
0.342,6,26,8903,13,234,28,575,1620,13,942,27,1408,7283
0.59,17,30,6345,30,183,20,220,6345,0,0,0,0,0
58.859,6,11,1583,11,127,5885,127,1583,0,0,0,0,0
3.477,17,5,290,5,30,869,30,290,0,0,0,0,0
0.175,17,5,1735,5,319,43,354,1735,0,0,0,0,0
0.454,6,10,1677,6,555,90,951,1354,4,159,150,159,323
240.21,6,54,18061,29,802,8578,1402,15151,25,200,10008,580,2910
1797.172,17,138,11040,69,48,26428,48,5244,69,56,26428,56,5796
0.062,6,12,3702,6,170,10,170,490,6,964,8,1448,3212
78.982,6,10,408,2,0,85,0,84,8,0,11271,0,324
11.824,6,1905,1643646,1161,1363,10,1380,1607733,744,511,15,1923,35913
92.796,2,3,96,3,8,46398,8,96,0,0,0,0,0
1788.884,17,142,11360,71,48,25555,48,5396,71,56,25555,56,5964
61.223,6,26,7137,12,155,5565,267,1266,14,530,4708,2006,5871
0.12,6,9,1002,5,213,30,213,417,4,421,25,421,585
280.265,6,25,7094,11,181,28026,267,1168,14,595,21557,1400,5926
0.15,6,9,1346,5,145,37,145,349,4,833,39,833,997
5.014,6,21,6352,9,262,605,517,1264,12,744,440,1418,5088
507.797,6,43,7835,19,142,15044,516,1905,24,236,22074,1452,5930
1684.515,2,16,512,16,8,112301,8,512,0,0,0,0,0
3.238,6,13,1115,7,332,539,332,704,6,83,644,83,411
1747.017,6,96,7255,62,38,28639,205,4424,34,33,52927,98,2831
1787.778,17,87,3648,86,14,21032,14,3612,1,8,0,8,36
1738.645,6,87,6322,58,31,30502,31,3915,29,31,62094,31,2407
196.194,6,23,6198,12,290,17835,517,1213,11,1468,19602,2457,4985
28.699,17,4,240,2,32,28698,32,120,2,32,28698,32,120
1.987,17,4,1344,4,308,662,308,1344,0,0,0,0,0
1744.705,2,25,800,25,8,72696,8,800,0,0,0,0,0
0.638,6,116,76261,64,1270,10,1432,69890,52,475,12,1871,6371
1793.854,17,66,2766,65,14,28028,14,2730,1,8,0,8,36
1681.615,17,14,1036,7,30,280261,30,406,7,62,280261,62,630
378.57,2,3,96,3,8,189285,8,96,0,0,0,0,0
560.72,17,6,444,3,30,280351,30,174,3,62,280353,62,270
1797.524,17,366,44781,179,161,10096,1350,33912,187,30,9663,60,10869
165.304,6,23,940,9,0,5345,0,364,14,0,12714,0,576
0.312,17,2,776,2,360,312,360,776,0,0,0,0,0
286.515,1,16,896,16,28,19101,28,896,0,0,0,0,0
83.481,6,55,32858,34,1106,2529,1448,25012,21,749,3132,1448,7846
4.406,6,37,7205,19,218,244,314,3383,18,516,243,1179,3822
9.763,6,10,520,4,0,3254,0,204,6,0,1907,0,316
0.137,17,3,663,2,39,131,39,134,1,501,0,501,529
368.561,6,19,1303,14,177,28350,177,925,5,110,15165,110,378
0.893,6,27,8463,14,270,57,561,1945,13,997,61,2720,6518
1781.211,6,354,22440,207,69,8646,69,12420,147,69,12199,69,10020
884.671,17,15,5280,15,324,63190,548,5280,0,0,0,0,0
0.708,6,17,3016,9,282,88,531,1606,8,493,83,828,1410
0.047,17,2,212,1,46,0,46,74,1,110,0,110,138
1782.599,6,109,8682,71,64,25465,64,5016,38,58,48176,58,3666
0.306,6,26,8982,14,335,23,668,2102,12,1041,27,1906,6880
0.173,6,7,364,0,0,0,0,0,7,0,0,0,364
2.001,17,3,183,3,33,1000,33,183,0,0,0,0,0
1772.252,6,180,15480,120,69,14892,69,8940,60,69,30030,69,6540
99.924,6,22,8019,11,525,84,1237,2048,11,919,9975,1591,5971
0.322,6,2,116,1,0,0,0,52,1,0,0,0,64
1786.286,6,102,8296,68,65,26660,65,4930,34,59,54127,59,3366
85.648,6,42,10234,17,287,2076,1189,2991,25,415,3568,1420,7243
1610.278,6,161,13823,107,69,15191,69,7937,54,69,30382,69,5886
156.919,17,2,244,2,94,156919,94,244,0,0,0,0,0
289.897,6,291,47283,164,304,1778,304,33376,127,83,2299,83,13907
1797.714,6,380,26515,218,97,8284,469,15550,162,69,11163,69,10965
1789.095,6,372,25919,215,98,8360,469,15223,157,69,11467,69,10696
0.063,6,10,1495,5,507,15,507,727,5,556,15,556,768
2.621,17,2,476,1,39,0,39,67,1,381,0,381,409
1787.882,6,356,22520,208,69,8637,69,12460,148,69,12162,69,10060
210.352,6,68,45963,43,1188,5008,1408,37931,25,840,2566,2816,8032
116.822,17,3,1016,3,310,58411,316,1016,0,0,0,0,0
240.84,17,6,360,3,32,120419,32,180,3,32,120419,32,180
1741.014,17,30,31680,30,1028,60034,1028,31680,0,0,0,0,0
1.917,6,13,2311,8,188,273,245,700,5,1407,416,1407,1611
0.013,6,3,120,2,0,13,0,80,1,0,0,0,40
200.491,6,32,8952,14,158,15422,267,1357,18,624,11791,1400,7595
756.195,2,5,160,5,8,189048,8,160,0,0,0,0,0
630.534,2,4,128,4,8,210178,8,128,0,0,0,0,0
2.848,17,4,826,2,39,2843,39,134,2,318,2839,332,692
53.19,6,517,232663,265,816,201,1152,217078,252,423,210,1179,15585
1.214,6,28,8546,15,229,72,583,2007,13,1201,84,3151,6539
1.572,6,48,20157,28,895,58,1360,14581,20,476,73,2715,5576
0.09,17,7,2429,7,319,15,354,2429,0,0,0,0,0
35.521,6,13,780,4,0,1587,0,240,9,0,4418,0,540
1740.498,17,30,20190,30,645,60017,645,20190,0,0,0,0,0
1624.327,2,13,416,13,8,135360,8,416,0,0,0,0,0
280.44,6,29,7392,13,158,23370,267,1317,16,603,18692,2760,6075
1771.329,6,103,9514,66,66,27251,66,5610,37,60,49201,60,3904
87.451,6,23,10883,11,410,57,922,1702,12,1086,7938,1460,9181
131.974,17,4,352,2,60,131973,60,176,2,60,131973,60,176
5.023,17,4,558,2,36,5009,36,128,2,187,5013,187,430
103.255,17,10,3360,10,308,11472,308,3360,0,0,0,0,0
1740.377,6,87,6322,58,31,30532,31,3915,29,31,62156,31,2407
1789.36,17,83,3480,82,14,22090,14,3444,1,8,0,8,36
0.809,6,99,61428,57,1273,14,1432,52076,42,589,18,3303,9352
119.255,17,23,1748,23,48,5420,48,1748,0,0,0,0,0
3.377,17,4,304,2,48,3062,48,152,2,48,3057,48,152
1780.234,17,142,11360,71,48,25431,48,5396,71,56,25431,56,5964
366.812,6,25,1651,17,177,22925,177,1117,8,110,9202,110,534
1754.823,1,8,848,8,78,250689,78,848,0,0,0,0,0
0.125,17,2,586,1,46,0,46,74,1,484,0,484,512
65.425,6,31,7472,13,158,5452,267,1317,18,603,3845,2760,6155
0.172,6,3,120,2,0,0,0,80,1,0,0,0,40
1798.752,6,365,24563,212,87,8524,469,14096,153,69,11830,69,10467
1795.407,6,362,22898,210,69,8590,69,12678,152,69,11889,69,10220
0.021,17,3,996,3,304,10,333,996,0,0,0,0,0
15.195,17,16,8550,8,656,2165,1350,5476,8,356,2164,1350,3074
1790.89,1,342,28728,342,56,5251,56,28728,0,0,0,0,0
1.667,6,27,10173,16,284,111,584,1496,11,1029,150,1420,8677
5.349,6,42,7405,21,218,267,314,3463,21,442,255,1152,3942
0.365,6,22,7342,13,335,30,668,2026,9,1210,44,1906,5316
1038.15,6,91,11465,55,90,19225,501,4370,36,176,29658,1420,7095
349.988,6,42,10077,22,204,16666,1189,3545,20,440,2238,1460,6532
129.965,6,24,6632,8,156,18566,267,798,16,576,8660,1452,5834
38.0,17,20,1760,10,48,4221,48,760,10,72,4221,72,1000
200.641,6,5,267,3,0,100320,0,152,2,7,200319,7,115
31.07,17,2,462,2,203,31070,360,462,0,0,0,0,0
1681.464,17,14,3827,7,30,280242,30,406,7,460,280242,463,3421
300.611,6,31,8766,13,272,25050,750,1774,18,432,13451,1448,6992
0.004,6,2,258,1,178,0,178,218,1,0,0,0,40
1786.423,6,104,8376,68,65,26663,65,4930,36,59,51038,59,3446
0.256,17,4,768,2,39,251,39,134,2,289,14,289,634
11.752,6,15,3336,7,92,1958,92,572,8,1164,1559,1408,2764
1786.863,6,102,8296,68,65,26669,65,4930,34,59,54144,59,3366
1787.403,6,356,22520,208,69,8634,69,12460,148,69,12159,69,10060
0.075,6,10,766,5,185,16,185,453,5,45,18,45,313
11.558,6,1765,1580316,1061,1407,10,1448,1539020,704,776,16,1448,41296
1459.143,6,118,13457,67,69,20471,721,5656,51,122,29178,2026,7801
106.426,6,24,10294,13,433,66,990,1875,11,1138,10629,3928,8419
3.507,17,31,8170,16,301,231,1350,5277,15,164,248,1350,2893
124.501,6,9,522,2,106,124490,106,194,7,0,20748,0,328
0.586,6,14,1745,7,288,69,288,600,7,426,68,434,1145
0.01,17,3,544,2,60,0,60,176,1,340,0,340,368
1742.84,6,96,7255,62,38,28571,205,4424,34,33,52802,98,2831
41.974,17,23,4827,16,40,2796,41,1096,7,505,5845,505,3731
1770.703,6,104,9580,68,64,26428,64,5724,36,58,50588,58,3856
280.874,6,31,7472,14,158,21605,267,1357,17,543,17551,1400,6115
0.434,6,124,87907,58,131,7,232,2849,66,1351,6,1420,85058
390.079,6,23,1511,14,177,30006,177,925,9,110,10173,110,586
3.063,6,38,8324,19,332,170,1234,2788,19,433,148,1460,5536
1.66,6,65,47977,41,1247,41,1408,40824,24,1179,64,3819,7153
0.064,17,2,347,1,29,0,29,57,1,262,0,262,290
69.115,6,28,7223,13,156,5759,267,1312,15,482,4936,1997,5911
0.199,6,44,20210,26,1014,7,1420,15269,18,467,10,1883,4941
0.146,6,10,1514,5,503,36,503,771,5,475,36,475,743
0.308,6,21,7203,12,318,27,600,1906,9,964,37,1471,5297
0.931,6,10,1687,7,100,155,100,384,3,1179,331,1179,1303
76.32,6,108,28432,54,380,1440,1440,13307,54,404,1430,1440,15125
1787.2,6,364,25392,212,100,8470,469,14896,152,69,11835,69,10496
0.281,6,6,718,3,304,135,304,460,3,102,135,102,258
7.502,17,374,74480,370,172,19,172,74000,4,92,1729,172,480
1742.519,6,96,7286,63,38,28105,205,4476,33,33,54447,98,2810
116.418,6,58,15133,26,246,4649,721,4248,32,564,3749,1440,10885
182.919,17,4,240,2,32,182918,32,120,2,32,182918,32,120
1783.533,6,105,8475,68,65,26619,65,4930,37,59,49540,59,3545
1776.405,17,140,11200,70,48,25744,48,5320,70,56,25744,56,5880
1787.435,6,104,8444,68,66,26678,66,4964,36,60,51065,60,3480
68.263,1,6,636,6,78,13652,78,636,0,0,0,0,0
55.432,6,44,6609,22,304,2639,304,4496,22,83,2637,83,2113
2.218,6,30,5922,17,101,138,267,1497,13,650,178,1414,4425
1787.903,6,352,22222,205,69,8764,69,12271,147,69,12245,69,9951
1.399,6,48,18508,27,841,53,1360,12892,21,529,60,4075,5616
1798.259,17,179,13962,179,50,10102,50,13962,0,0,0,0,0
2.212,17,3,1173,3,363,1106,363,1173,0,0,0,0,0
39.331,17,24,1824,24,48,1710,48,1824,0,0,0,0,0
241.243,17,4,304,2,48,241235,48,152,2,48,241235,48,152
1739.121,6,87,6322,58,31,30510,31,3915,29,31,62110,31,2407
0.333,6,10,861,6,182,66,182,490,4,77,83,134,371
9.022,6,66,20318,34,547,273,1152,15611,32,427,282,1152,4707
37.739,17,22,1936,11,48,3773,48,836,11,72,3773,72,1100
0.866,6,11,1727,7,100,144,100,384,4,589,205,1152,1343
2.019,17,20,12661,10,439,224,1350,4672,10,770,183,1350,7989
0.111,17,2,358,1,32,0,32,60,1,270,0,270,298
3.876,17,4,296,4,46,1292,46,296,0,0,0,0,0
0.156,1,2,112,2,28,156,28,112,0,0,0,0,0
0.046,6,17,3164,8,456,5,793,1792,9,224,5,694,1372
1.27,6,47,18751,27,861,48,1360,13175,20,476,57,2715,5576
241.312,6,49,12301,25,257,10054,972,3417,24,635,10491,4224,8884
36.078,17,10,760,10,48,4008,48,760,0,0,0,0,0
1740.945,6,87,6322,58,31,30542,31,3915,29,31,62176,31,2407
7.63,6,24,3739,12,149,693,293,1527,12,432,670,1179,2212
902.447,2,7,224,7,8,150407,8,224,0,0,0,0,0
3.873,6,32,6105,17,206,242,314,2744,15,551,257,1179,3361
4.005,17,8,1288,4,33,1333,33,244,4,233,1333,233,1044
285.835,6,267,41862,145,304,1984,304,29104,122,83,2358,83,12758
31.175,6,11,684,3,106,15579,106,234,8,90,4450,90,450
1782.091,17,73,3060,72,14,25099,14,3024,1,8,0,8,36
300.602,6,41,8698,21,286,15030,766,2052,20,388,793,2720,6646
1723.044,17,13,534,11,14,172285,14,462,2,8,1722858,8,72
280.316,6,30,7432,13,158,23359,267,1317,17,543,17518,1400,6115
155.062,17,4,824,2,48,155057,48,152,2,308,155055,308,672
99.038,6,45,13234,16,263,6440,1189,3019,29,430,3536,1420,10215
214.126,6,31,8912,14,158,16471,267,1357,17,687,13377,1781,7555
1796.736,1,345,28980,345,56,5223,56,28980,0,0,0,0,0
38.02,6,150,64409,81,743,475,1152,57540,69,410,555,1152,6869
1788.992,6,360,24156,210,88,8559,469,13878,150,69,12003,69,10278
1799.24,1,55,4620,55,56,33319,56,4620,0,0,0,0,0
301.324,6,56,24108,32,1050,9720,1440,18117,24,358,397,1440,5991
1778.854,1,75,6300,0,0,0,0,0,75,56,24038,56,6300
1748.951,1,74,4144,74,28,23958,28,4144,0,0,0,0,0
307.5,17,6,2081,1,308,0,308,336,5,321,76626,321,1745
1.129,17,16,6707,8,480,161,1350,4066,8,302,146,1350,2641
23.643,6,3308,3085528,2140,1363,10,1408,3020128,1168,931,20,2816,65400
1799.113,17,449,39928,404,35,4464,288,25708,45,288,40017,288,14220
1773.378,6,180,15480,120,69,14902,69,8940,60,69,30049,69,6540
280.513,6,31,7472,13,158,23376,267,1317,18,543,16497,1380,6155
3.196,17,5,290,5,30,799,30,290,0,0,0,0,0
20.126,6,21,5417,12,107,1829,159,1074,9,773,2513,1418,4343
91.127,6,27,8042,11,261,79,467,1365,16,449,6063,2688,6677
9.676,6,1712,1621402,1080,1423,8,1448,1583862,632,776,15,1448,37540
0.075,1,2,112,2,28,75,28,112,0,0,0,0,0
1.419,6,23,7350,13,261,118,600,1989,10,964,115,1471,5361
0.671,6,32,8153,17,272,41,742,1801,15,521,38,3488,6352
1654.669,6,334,21364,196,69,8485,69,12049,138,69,12077,69,9315
1743.274,6,96,7286,63,38,28117,205,4476,33,33,54463,98,2810
0.036,17,2,154,1,33,0,33,61,1,65,0,65,93
240.273,6,41,5307,21,235,12011,751,2750,20,188,12644,508,2557
1700.428,17,12,498,11,14,170042,14,462,1,8,0,8,36
1.955,17,22,5698,22,231,93,388,5698,0,0,0,0,0
1.169,6,24,8004,12,164,90,267,1288,12,1014,90,2816,6716
300.952,6,41,10824,21,284,15047,789,2008,20,571,462,1460,8816
1797.728,17,142,11360,71,48,25681,48,5396,71,56,25681,56,5964
1795.268,1,67,5628,67,56,27201,56,5628,0,0,0,0,0
1798.374,1,345,28980,345,56,5227,56,28980,0,0,0,0,0
1728.452,1,8,448,8,28,246921,28,448,0,0,0,0,0
240.302,6,46,8551,24,449,10447,1402,5752,22,205,11442,580,2799
32.017,6,214,200994,74,132,438,318,4244,140,1393,230,1418,196750
280.55,6,31,7813,14,158,21580,267,1357,17,524,17533,1400,6456
34.765,17,10,760,10,48,3862,48,760,0,0,0,0,0
1782.893,6,102,8296,68,65,26610,65,4930,34,59,54024,59,3366
0.353,6,25,6032,12,164,32,453,1442,13,558,28,1448,4590
0.093,17,2,586,1,46,0,46,74,1,484,0,484,512
0.258,17,2,778,2,361,258,361,778,0,0,0,0,0
790.12,17,14,5951,14,397,60778,1114,5951,0,0,0,0,0
11.647,6,1860,1612343,1124,1380,10,1420,1578526,736,467,15,1883,33817
0.004,6,8,10260,1,0,0,0,40,7,1420,0,1420,10220
12.733,17,4,824,2,48,12713,48,152,2,308,12708,308,672
0.214,6,21,5824,12,164,19,453,1442,9,651,24,2194,4382
8.952,6,3,180,3,0,0,0,180,0,0,0,0,0
0.167,6,34,19966,17,133,10,133,1025,17,1289,10,1448,18941
300.471,6,36,18866,21,1019,15023,1368,13329,15,678,3863,1571,5537
300.573,6,12,927,6,177,60080,177,509,6,110,60080,110,418
1799.03,17,449,39928,404,35,4464,288,25708,45,288,40016,288,14220
73.841,6,30,7525,12,152,6712,267,1404,18,414,4334,1420,6121
8.192,6,19,9695,9,275,1024,275,643,10,1440,843,1440,9052
0.051,6,10,2023,6,728,10,1300,1700,4,159,16,159,323
75.806,6,31,7472,13,158,6317,267,1317,18,603,4456,2076,6155
66.64,6,21,8279,11,525,101,1237,2048,10,969,7382,2720,6231
0.259,6,9,1346,5,145,64,145,349,4,833,33,833,997
12.13,6,2266,2199323,1540,1355,7,1368,2156907,726,931,16,2736,42416
1.342,6,50,21089,28,952,49,1360,15433,22,433,55,1360,5656
120.909,17,4,1808,4,424,40303,548,1808,0,0,0,0,0
2.503,17,3,1173,3,363,1251,363,1173,0,0,0,0,0
3.05,17,8,1682,4,45,1001,45,292,4,319,1013,339,1390
0.027,17,2,338,1,36,0,36,64,1,246,0,246,274
1795.392,17,449,39928,404,35,4455,288,25708,45,288,40024,288,14220
1681.276,17,14,1036,7,30,280209,30,406,7,62,280208,62,630
40.002,17,11,836,11,48,4000,48,836,0,0,0,0,0
0.416,6,12,1665,6,288,77,288,560,6,426,45,434,1105
1797.677,17,448,39612,404,35,4460,288,25708,44,288,40951,288,13904
1323.518,2,14,448,14,8,101809,8,448,0,0,0,0,0
89.12,6,43,10186,19,533,1558,910,2927,24,349,3868,4848,7259
0.877,17,2,685,1,308,0,308,336,1,321,0,321,349
0.083,6,9,1339,5,145,20,145,349,4,826,24,826,990
1681.523,17,14,1036,7,30,280251,30,406,7,62,280251,62,630
5.435,6,22,9366,11,275,543,275,723,11,1024,447,1414,8643
0.083,17,7,2438,7,320,13,354,2438,0,0,0,0,0
1.324,6,24,8004,12,164,103,267,1288,12,1014,103,2736,6716
8.14,6,1307,1119915,785,1373,10,1420,1094814,522,420,15,1420,25101
291.556,6,57,8678,27,106,11211,517,2421,30,333,10052,1418,6257
1.809,6,2,80,0,0,0,0,0,2,0,0,0,80
294.094,17,4,272,2,40,294093,47,136,2,40,294093,47,136
240.693,2,4,128,4,8,80231,8,128,0,0,0,0,0
0.019,17,4,284,2,32,14,32,120,2,54,15,60,164
0.88,6,10,1687,7,100,146,100,384,3,1179,314,1179,1303
1.242,6,40,9928,21,440,62,1360,4392,19,476,59,2715,5536
1.361,6,39,11298,21,616,68,1460,5802,18,433,68,1460,5496
111.295,6,43,8769,21,401,789,889,2136,22,521,5293,2720,6633
1383.742,2,11,352,11,8,138374,8,352,0,0,0,0,0
13.209,17,2,152,2,48,13209,48,152,0,0,0,0,0
0.011,17,2,410,1,50,0,50,78,1,304,0,304,332
1.246,6,24,8004,12,164,96,267,1288,12,1014,96,2816,6716
11.785,6,21,1614,11,275,1178,275,1002,10,96,1200,96,612
1.456,6,9,379,5,0,364,0,204,4,7,417,7,175
0.153,17,2,305,1,41,0,41,69,1,208,0,208,236
0.161,17,2,179,1,43,0,43,71,1,80,0,80,108
11.575,6,25,8453,13,275,964,275,1078,12,983,757,1420,7375
0.239,17,2,144,1,36,0,36,64,1,52,0,52,80
45.993,6,31,8776,15,290,3285,965,2351,16,481,3065,3417,6425
0.293,6,2,84,1,0,0,0,44,1,0,0,0,40
231.863,17,6,528,3,48,115928,48,228,3,72,115927,72,300
0.069,17,8,2454,8,278,9,317,2454,0,0,0,0,0
4.748,6,28,8717,16,315,303,1091,2419,12,809,414,1368,6298
0.002,6,2,1839,1,0,0,0,40,1,1759,0,1759,1799
0.176,6,4,196,1,0,0,0,52,3,0,29,0,144
1798.591,17,448,39896,403,35,4474,288,25676,45,288,40017,288,14220
1773.344,6,181,15589,120,69,14902,69,8940,61,69,29550,69,6649
68.301,6,28,7217,13,155,5691,267,1306,15,482,4878,1997,5911
150.147,6,38,2831,17,92,9382,138,1232,21,69,7500,69,1599
1781.533,17,132,10560,66,48,27408,48,5016,66,56,27408,56,5544
183.893,17,6,2016,6,308,36778,308,2016,0,0,0,0,0
0.252,6,25,6116,12,181,22,537,1526,13,651,20,1448,4590
240.212,6,54,19225,29,779,8578,1408,16329,25,226,10008,580,2896
0.006,17,2,378,1,39,0,39,67,1,283,0,283,311
1770.941,6,103,9514,66,66,27245,66,5610,37,60,49190,60,3904
0.072,17,4,336,2,34,1,34,124,2,78,1,84,212
1.701,6,52,19173,29,873,60,1360,13432,23,400,68,1360,5741
1800.0,6,314,21612,130,46,13710,46,8870,184,46,9836,46,12742
1796.255,1,235,13160,235,28,7676,28,13160,0,0,0,0,0
1799.66,17,142,11360,71,48,25709,48,5396,71,56,25709,56,5964
300.726,6,43,15127,26,946,12029,1360,9600,17,439,535,4027,5527
1795.036,6,124,12317,78,62,23312,722,6423,46,92,39883,2026,5894
12.082,6,25,7943,13,370,1006,721,2010,12,681,998,2840,5933
23.021,6,34,8136,16,188,1534,721,1963,18,605,1343,1440,6173
1787.768,6,106,8504,68,64,26683,64,4896,38,58,48316,58,3608
1736.407,1,56,4704,56,56,31571,56,4704,0,0,0,0,0
1045.011,6,122,8330,45,46,23072,46,3502,77,46,13750,46,4828
421.087,2,7,224,7,8,70181,8,224,0,0,0,0,0
195.868,6,21,9794,17,489,12241,722,7253,4,1164,67,1402,2541
276.291,17,4,240,2,32,276288,32,120,2,32,276290,32,120
4.344,6,35,6209,18,206,255,314,2784,17,548,254,1179,3425
1789.541,6,476,27320,268,69,6702,69,14860,208,34,8645,64,12460
268.701,6,37,11956,16,158,17913,267,1437,21,743,13434,1400,10519
1797.502,17,448,39896,403,35,4471,288,25676,45,288,40014,288,14220
3.88,17,4,240,4,32,1293,32,240,0,0,0,0,0
0.059,17,2,339,1,33,0,33,61,1,250,0,250,278
21.3,6,23,3274,13,183,1775,517,1601,10,381,2365,499,1673
4.982,6,32,6089,17,206,311,314,2744,15,548,334,1179,3345
0.007,17,2,412,1,40,0,40,68,1,316,0,316,344
2.554,17,2,148,1,32,0,32,60,1,60,0,60,88
931.608,6,121,19774,57,89,16633,721,5315,64,371,14784,2840,14459
105.374,6,32,8952,14,158,8105,267,1357,18,624,6195,1400,7595
1784.181,6,356,22520,208,69,8619,69,12460,148,69,12137,69,10060
1.001,6,31,8452,16,263,56,586,2262,15,697,58,1360,6190
0.483,6,12,1653,6,288,91,288,548,6,426,56,434,1105
0.671,6,23,7367,14,261,51,602,2043,9,1612,73,3314,5324
199.949,6,36,6344,18,117,11761,516,2134,18,249,11485,1452,4210
3.067,17,2,170,1,37,0,37,65,1,77,0,77,105
1786.543,6,104,8376,68,65,26664,65,4930,36,59,51041,59,3446
1624.032,2,21,672,21,8,81201,8,672,0,0,0,0,0
3.801,17,4,1556,4,361,1267,361,1556,0,0,0,0,0
0.108,17,4,588,2,48,88,48,152,2,190,82,308,436
1783.806,6,363,24883,211,94,8494,469,14387,152,69,11813,69,10496
0.1,17,2,245,1,32,0,32,60,1,157,0,157,185
1772.119,6,184,15847,121,69,14767,69,8980,63,69,28576,69,6867
496.879,6,77,11454,42,91,12119,267,3432,35,220,14584,1997,8022
141.576,17,8,608,8,48,20225,48,608,0,0,0,0,0
71.857,6,15,620,7,0,4082,0,284,8,0,10263,0,336
139.604,6,77,49766,46,1181,3102,1408,41421,31,747,2053,1408,8345
0.069,6,2,80,1,0,0,0,40,1,0,0,0,40
4.115,17,10,900,5,30,1016,30,290,5,94,1020,94,610
31.199,17,4,352,2,60,31198,60,176,2,60,31198,60,176
125.394,6,13,3092,7,92,20899,92,452,6,581,25037,2026,2640
1.004,17,2,925,1,548,0,548,576,1,321,0,321,349
1786.927,6,108,8604,68,66,26670,66,4964,40,60,45815,60,3640
280.044,6,28,7352,13,158,23337,267,1317,15,678,20000,3436,6035
0.866,6,19,9088,11,510,86,1193,2003,8,1350,91,3639,7085
0.358,17,8,2750,8,315,51,354,2750,0,0,0,0,0
28.28,6,45,13145,22,200,1346,722,2689,23,866,1276,2760,10456
240.197,6,59,19462,30,814,8282,1418,16222,29,215,8578,580,3240
61.849,6,69,48362,44,1188,1438,1408,40328,25,960,2567,3847,8034
0.187,6,22,10013,11,136,18,136,716,11,1089,18,1448,9297
1.287,6,16,6056,9,70,159,133,504,7,1756,212,2440,5552
0.325,6,26,9033,13,257,27,667,1715,13,1105,25,2816,7318
1754.083,6,97,7307,63,38,28291,205,4476,34,33,53142,98,2831
240.166,6,52,17574,28,781,8894,1408,14751,24,223,10441,580,2823
37.897,17,11,836,11,48,3789,48,836,0,0,0,0,0
1797.508,6,356,22520,208,69,8683,69,12460,148,69,12227,69,10060
1.562,6,13,1344,7,256,259,256,796,6,304,311,304,548
1796.022,17,442,39136,398,35,4523,288,25232,44,288,40946,288,13904
0.195,17,3,543,2,39,189,39,134,1,381,0,381,409
0.025,17,4,368,2,32,1,32,120,2,96,0,96,248
0.142,17,2,223,1,36,0,36,64,1,131,0,131,159
70.154,17,10,585,10,30,7794,31,585,0,0,0,0,0
1.686,6,23,7727,14,282,129,578,1410,9,992,188,1452,6317
240.309,6,43,8395,22,449,11443,1408,5648,21,205,12015,580,2747
1744.704,6,95,7203,63,38,28140,205,4476,32,33,56267,98,2727
20.126,6,18,2368,10,189,2236,517,1298,8,323,2870,499,1070
35.742,6,37,8463,18,399,512,882,1950,19,441,1978,1440,6513
1795.229,17,448,39896,403,35,4465,288,25676,45,288,40016,288,14220
0.586,6,15,1785,8,288,59,288,640,7,426,68,434,1145
256.755,6,56,9579,29,657,9169,1418,6178,27,104,9874,580,3401
1797.619,17,768,46392,768,32,2343,37,46392,0,0,0,0,0
0.245,6,23,4519,11,165,24,456,1394,12,498,21,888,3125
1786.587,6,115,9256,74,66,24473,66,5336,41,60,44662,60,3920
11.775,6,1835,1614089,1140,1363,10,1380,1582047,695,421,16,1923,32042
25.089,6,25,7097,12,155,2280,267,1266,13,589,2089,3426,5831
21.463,17,2,642,1,300,0,300,328,1,286,0,286,314
5.01,17,4,558,2,36,5005,36,128,2,187,5002,187,430
33.057,17,40,5880,20,48,1736,48,1520,20,190,1737,308,4360
1.093,6,27,8420,15,222,65,540,1964,12,1192,83,3151,6456
52.661,6,21,5947,11,267,5266,502,1246,10,613,5841,1420,4701
2.089,6,33,6578,18,149,122,267,2073,15,650,133,1380,4505
0.43,6,58,25581,32,999,13,1380,18364,26,511,16,1923,7217
4.83,6,38,7229,20,218,254,314,3423,18,513,267,1179,3806
0.016,17,2,198,1,37,0,37,65,1,105,0,105,133
83.321,6,30,8872,14,158,6409,267,1357,16,763,5553,2036,7515
1781.595,17,142,11360,71,48,25451,48,5396,71,56,25451,56,5964
280.494,6,30,7432,13,158,23374,267,1317,17,603,17528,2760,6115
1789.962,6,356,22520,208,69,8647,69,12460,148,69,12176,69,10060
1799.482,17,450,39960,405,35,4454,288,25740,45,288,40023,288,14220
0.13,17,2,588,1,39,0,39,67,1,493,0,493,521
113.356,17,2,768,2,356,113356,356,768,0,0,0,0,0
1741.685,6,87,6322,58,31,30555,31,3915,29,31,62202,31,2407
1797.584,6,404,35601,186,67,9715,616,13607,218,90,8283,1360,21994
1744.713,2,14,448,14,8,134208,8,448,0,0,0,0,0
0.072,17,2,152,1,40,0,40,68,1,56,0,56,84
1793.745,1,58,4872,58,56,31469,56,4872,0,0,0,0,0
1745.236,6,95,7203,63,38,28148,205,4476,32,33,56289,98,2727
1785.855,6,366,23196,211,69,8504,69,12787,155,69,11596,69,10409
4.634,6,30,8872,14,158,356,267,1357,16,763,303,2076,7515
0.265,17,2,184,1,32,0,32,60,1,96,0,96,124
0.508,17,3,451,2,39,118,39,134,1,289,0,289,317
0.541,6,22,7376,13,273,45,663,2052,9,1209,63,1946,5324
0.272,17,4,284,2,32,259,32,120,2,54,15,60,164
1797.016,1,308,17248,308,28,5853,28,17248,0,0,0,0,0
2.409,6,13,2311,8,188,344,245,700,5,1407,539,1407,1611
26.74,17,4,240,2,32,26739,32,120,2,32,26739,32,120
1778.715,1,339,28476,339,56,5262,56,28476,0,0,0,0,0
1787.448,6,102,8296,68,65,26678,65,4930,34,59,54161,59,3366
1799.385,17,450,39960,405,35,4453,288,25740,45,288,40023,288,14220
336.516,6,169,130672,107,1305,3174,1408,116518,62,642,3367,2439,14154
1757.298,1,8,448,8,28,251042,28,448,0,0,0,0,0
61.379,6,37,15941,22,801,2922,1448,9163,15,665,4365,1448,6778
2.238,17,3,1008,3,308,1119,308,1008,0,0,0,0,0
0.137,17,2,588,1,39,0,39,67,1,493,0,493,521
31.561,6,7,396,1,0,0,0,60,6,0,6278,0,336
3.01,17,4,292,2,37,3003,37,130,2,53,3001,53,162
1.496,6,41,8429,21,320,74,1162,2808,20,400,69,1460,5621
1.024,17,3,618,2,32,902,32,120,1,470,0,470,498
199.224,17,4,352,2,60,199223,60,176,2,60,199223,60,176
1.763,17,4,240,2,32,1761,32,120,2,32,1761,32,120
47.152,6,37,8503,18,413,514,923,1991,19,441,2611,1460,6512
0.04,17,4,560,2,64,22,64,184,2,160,20,160,376
1785.856,6,365,24963,213,94,8423,469,14536,152,69,11826,69,10427
1791.664,17,140,11200,70,48,25965,48,5320,70,56,25965,56,5880
0.501,17,2,167,1,39,0,39,67,1,72,0,72,100
0.749,6,30,7560,17,306,46,1087,2826,13,601,61,1420,4734
3.602,17,5,872,4,64,1190,64,368,1,476,0,476,504
98.432,6,817,389754,437,826,225,1152,369422,380,427,259,1179,20332
1130.66,17,220,16720,220,48,5162,48,16720,0,0,0,0,0
0.52,17,2,780,2,362,520,362,780,0,0,0,0,0
0.051,17,2,198,1,39,0,39,67,1,103,0,103,131
1784.126,6,356,22520,208,69,8618,69,12460,148,69,12136,69,10060
1786.291,6,104,8376,68,65,26661,65,4930,36,59,51034,59,3446
9.687,6,205,167415,116,1190,84,1360,66609,89,1648,108,4428,100806
1786.872,6,104,8444,68,66,26669,66,4964,36,60,51050,60,3480
13.85,6,24,6993,13,275,1154,275,1078,11,910,883,1440,5915
180.461,2,3,96,3,8,90230,8,96,0,0,0,0,0
1787.904,6,356,22520,208,69,8637,69,12460,148,69,12162,69,10060
601.61,2,5,160,5,8,150402,8,160,0,0,0,0,0
1775.277,6,180,15480,120,69,14918,69,8940,60,69,30085,69,6540
240.818,6,55,13937,29,670,8599,1368,10908,26,185,9631,580,3029
0.0,17,1,62,1,34,0,34,62,0,0,0,0,0
249.224,17,16,2352,8,48,35601,48,608,8,190,35601,308,1744
1772.205,6,180,15480,120,69,14892,69,8940,60,69,30036,69,6540
300.736,2,5,160,5,8,75184,8,160,0,0,0,0,0
98.622,6,44,9812,17,327,6163,1189,2655,27,337,3792,1420,7157
251.627,6,23,10273,9,290,31453,517,1081,14,845,19355,2418,9192
1.331,17,6,936,3,64,656,64,276,3,192,657,192,660
61.771,17,6,1236,3,48,30879,48,228,3,308,30879,308,1008
0.473,6,105,66024,56,1278,8,1420,59773,49,534,9,3303,6251
1682.772,17,14,1036,7,30,280459,30,406,7,62,280459,62,630
0.345,17,2,180,1,30,0,30,58,1,94,0,94,122
1798.834,17,449,39928,404,35,4463,288,25708,45,288,40019,288,14220
1794.394,6,244,35804,152,302,11883,302,26032,92,83,19718,83,9772
122.624,1,22,1232,22,28,5839,28,1232,0,0,0,0,0
0.388,6,23,5080,11,137,38,267,1132,12,577,25,1400,3948
241.065,17,4,352,2,60,241064,60,176,2,60,241064,60,176
38.085,17,22,1936,11,48,3807,48,836,11,72,3807,72,1100
231.602,6,22,2609,12,324,21054,585,1281,10,396,25726,580,1328
2.377,6,13,2311,8,188,339,245,700,5,1407,522,1407,1611
1792.759,17,179,11456,179,36,10071,36,11456,0,0,0,0,0
1780.289,6,416,24984,208,69,8600,69,12460,208,34,8600,64,12524
240.192,6,53,17666,28,782,8895,1402,14758,25,200,10007,580,2908
1774.959,6,181,15589,120,69,14915,69,8940,61,69,29579,69,6649
6.362,6,39,7269,21,218,318,314,3463,18,513,358,1179,3806
0.269,6,25,4623,12,165,24,456,1446,13,415,20,888,3177
0.03,6,9,1557,5,515,7,515,783,4,558,9,558,774
11.981,6,6,328,4,0,3993,0,216,2,0,11859,0,112
0.537,17,3,451,2,39,307,39,134,1,289,0,289,317
0.251,17,2,776,2,360,251,360,776,0,0,0,0,0
0.041,17,4,368,2,32,36,32,120,2,96,0,96,248
16.541,6,14,2242,8,210,2362,210,844,6,545,3308,904,1398
361.009,2,5,160,5,8,90252,8,160,0,0,0,0,0
11.759,6,1867,1624670,1137,1375,10,1420,1591249,730,467,16,1883,33421
50.839,6,68,21309,32,565,1639,1152,15419,36,444,1445,1179,5890
1790.896,1,260,14560,260,28,6914,28,14560,0,0,0,0,0
0.051,17,2,206,1,44,0,44,72,1,106,0,106,134
24.257,1,6,336,6,28,4851,28,336,0,0,0,0,0
1787.658,6,102,8228,68,64,26681,64,4896,34,58,54168,58,3332
0.1,6,2,116,1,0,0,0,64,1,0,0,0,52
1.316,6,40,9928,21,440,65,1360,4392,19,476,61,2715,5536
0.504,17,4,352,2,60,502,60,176,2,60,502,60,176
1795.728,17,448,39896,403,35,4466,288,25676,45,288,40020,288,14220
82.816,6,14,3279,4,92,27605,92,296,10,350,9063,1408,2983
286.408,6,32,8034,15,187,20457,267,1919,17,603,17898,2760,6115
1788.588,17,140,11200,70,48,25921,48,5320,70,56,25921,56,5880
3.934,17,4,352,4,60,1311,60,352,0,0,0,0,0
1630.519,6,195,18873,101,69,16305,721,8783,94,185,17530,2828,10090
7.254,6,1389,1312539,898,1386,7,1408,1282331,491,931,14,2816,30208
369.018,6,25,1651,17,177,23063,177,1117,8,110,9204,110,534
371.344,6,25,1651,17,177,23209,177,1117,8,110,9232,110,534
1773.674,1,226,12656,226,28,7882,28,12656,0,0,0,0,0
1799.388,6,452,27260,224,69,8069,69,13238,228,35,7926,48,14022
0.04,6,3,156,3,0,0,0,156,0,0,0,0,0
72.134,6,60,39641,39,1145,1898,1408,31807,21,841,3073,2816,7834
153.376,6,118,91595,78,1247,1991,1408,81392,40,811,2146,3847,10203
1682.425,1,15,840,15,28,120173,28,840,0,0,0,0,0
1770.957,6,101,9410,66,66,27245,66,5610,35,60,52084,60,3800
0.054,6,14,5639,8,134,7,134,474,6,2456,10,2920,5165
15.776,17,22,9392,10,390,1749,1350,4181,12,406,1431,1350,5211
240.606,6,55,20363,30,833,8296,1418,17412,25,234,10024,580,2951
1773.734,6,180,15480,120,69,14905,69,8940,60,69,30057,69,6540
0.048,6,2,131,1,0,0,0,40,1,51,0,51,91
359.992,6,10,1435,10,103,39999,138,1435,0,0,0,0,0
281.701,6,31,7882,13,158,23475,267,1317,18,531,16545,2036,6565
317.027,6,79,19770,44,314,7372,1360,10343,35,381,9319,1929,9427
61.47,6,33,10809,19,343,3415,1282,3055,14,779,4708,1593,7754
0.006,6,2,104,1,0,0,0,52,1,0,0,0,52
310.161,6,68,11531,31,204,10338,1189,3698,37,288,5837,1420,7833
0.17,6,27,7296,13,155,14,267,1301,14,543,12,1400,5995
34.457,1,11,1144,0,0,0,0,0,11,76,3445,76,1144
5.84,6,13,5758,3,106,2920,106,234,10,639,630,1452,5524
300.81,6,49,10486,24,433,13078,910,3218,25,312,538,1460,7268
60.239,2,2,64,2,8,60239,8,64,0,0,0,0,0
1772.37,6,180,15480,120,69,14893,69,8940,60,69,30035,69,6540
414.814,17,7,2336,7,305,69135,308,2336,0,0,0,0,0
0.12,17,4,2876,2,689,120,1350,1434,2,693,84,1350,1442
7.53,6,21,4374,12,213,684,597,1689,9,552,918,1767,2685
370.889,6,18,1242,14,180,28529,180,916,4,110,20063,110,326
1797.54,17,446,38980,404,35,4460,288,25708,42,288,42950,288,13272
4.955,6,38,7245,19,218,275,314,3383,19,516,261,1179,3862
80.164,17,4,240,2,32,80162,32,120,2,32,80163,32,120
1764.261,2,12,384,12,8,160387,8,384,0,0,0,0,0
1.239,6,34,12938,20,691,65,1440,5687,14,667,81,1440,7251
1.238,6,24,8004,12,164,95,267,1288,12,1014,95,2331,6716
52.327,6,27,7177,13,155,4360,267,1306,14,530,4024,3417,5871
0.482,17,2,152,1,48,0,48,76,1,48,0,48,76
28.43,6,45,9707,23,291,1292,721,3260,22,616,1344,1440,6447
2.052,1,2,112,2,28,2052,28,112,0,0,0,0,0
1739.973,6,87,6322,58,31,30525,31,3915,29,31,62141,31,2407
16.273,6,17,1686,9,304,2034,304,1080,8,83,2181,83,606
78.495,6,11,6104,5,174,19623,174,378,6,1370,1612,1420,5726
0.109,6,12,3702,6,170,14,170,490,6,964,20,1448,3212
0.005,17,2,507,1,41,0,41,69,1,410,0,410,438
0.0,6,1,40,1,0,0,0,40,0,0,0,0,0
0.401,6,26,8995,13,252,33,647,1692,13,945,31,1438,7303
10.667,6,16,3911,9,275,1333,275,643,7,992,956,1440,3268
86.507,17,4,240,2,32,86506,32,120,2,32,86505,32,120
0.279,17,3,2906,3,940,139,1451,2906,0,0,0,0,0
75.773,17,4,1344,4,308,25257,308,1344,0,0,0,0,0
70.429,6,29,7395,13,155,5869,267,1306,16,453,4693,3417,6089
32.071,6,36,8284,18,348,542,730,1798,18,478,1877,2128,6486
1772.933,6,181,15589,120,69,14898,69,8940,61,69,29542,69,6649
151.901,6,219,182912,141,1338,1085,1448,167975,78,604,1969,1448,14937
44.045,6,5587,5222247,3462,1423,12,1448,5099343,2125,776,20,1448,122904
20.76,17,4,240,2,32,20759,32,120,2,32,20759,32,120
2.365,6,5,288,2,0,2199,0,112,3,0,1099,0,176
1786.315,6,104,8376,68,65,26661,65,4930,36,59,51034,59,3446
84.8,17,4,240,2,32,84799,32,120,2,32,84799,32,120
0.234,17,2,180,1,30,0,30,58,1,94,0,94,122
1790.246,6,378,24421,217,74,8288,469,13703,161,69,11188,69,10718
0.137,2,2,64,2,8,137,8,64,0,0,0,0,0
0.323,6,9,1340,5,145,80,145,349,4,827,55,827,991
4.245,17,5,290,5,30,1061,30,290,0,0,0,0,0
3.651,6,33,6129,17,206,228,314,2744,16,456,225,1152,3385
8.321,6,561,512298,371,1318,22,1368,497754,190,776,42,1473,14544
0.457,17,2,198,1,63,0,63,91,1,79,0,79,107
19.529,6,116,118870,60,343,331,442,6564,56,2144,350,7240,112306
1743.331,6,95,6910,62,31,28579,31,4247,33,31,54478,31,2663
1770.792,6,105,9700,68,65,26429,65,5758,37,59,49176,59,3942
1793.004,17,144,11520,72,48,25253,48,5472,72,56,25253,56,6048
1340.755,1,6,336,6,28,268151,28,336,0,0,0,0,0
6.829,6,39,7285,19,218,379,314,3383,20,516,346,1179,3902
70.314,6,511,223006,260,801,271,1152,207461,251,423,280,1179,15545
21.207,6,14,2589,8,187,3029,293,1075,6,635,1050,1179,1514
2.704,6,23,5564,13,151,225,380,1281,10,969,299,1731,4283
1.621,6,22,5935,11,108,161,147,879,11,922,161,1581,5056
182.676,6,24,4892,9,220,7855,516,1245,15,276,13041,1452,3647
3.057,17,4,304,2,48,3049,48,152,2,48,3048,48,152
1739.931,6,87,6322,58,31,30525,31,3915,29,31,62139,31,2407
2.763,6,2,88,2,0,0,0,88,0,0,0,0,0
0.006,17,2,507,1,41,0,41,69,1,410,0,410,438
0.664,17,21,14820,12,1016,54,1350,12536,9,225,73,1350,2284
1797.917,17,448,39612,404,35,4461,288,25708,44,288,40949,288,13904
1724.114,6,24,3624,16,241,114940,241,2568,8,92,246275,92,1056
4.213,6,34,6169,17,206,263,314,2744,17,548,248,1179,3425
1660.525,1,7,392,7,28,276754,28,392,0,0,0,0,0
240.274,6,46,9232,24,523,10446,1408,5964,22,235,11441,619,3268
560.965,17,6,444,3,30,280460,30,174,3,62,280458,62,270
1741.016,6,84,6104,56,31,31654,31,3780,28,31,64481,31,2324
421.145,2,4,128,4,8,140381,8,128,0,0,0,0,0
842.237,2,7,224,7,8,140372,8,224,0,0,0,0,0
1796.816,1,345,28980,345,56,5223,56,28980,0,0,0,0,0
280.282,6,26,7272,12,158,25480,267,1277,14,775,21556,3445,5995
207.565,17,10,1725,5,40,51889,40,340,5,249,51889,249,1385
3.993,17,5,1160,5,204,998,204,1160,0,0,0,0,0
1784.072,6,356,22520,208,69,8618,69,12460,148,69,12136,69,10060
1660.568,6,242,15551,129,73,12973,138,8334,113,49,10051,69,7217
4.697,6,38,7245,19,218,260,314,3383,19,516,247,1179,3862
0.122,17,2,602,1,46,0,46,74,1,500,0,500,528
11.693,6,36,8585,16,412,779,889,1908,20,391,513,3488,6677
3.486,17,5,295,5,31,871,31,295,0,0,0,0,0
544.901,1,11,1599,11,117,54490,207,1599,0,0,0,0,0
2.834,6,27,9554,16,228,188,471,1815,11,1457,266,2720,7739
469.055,1,3,318,3,78,234527,78,318,0,0,0,0,0
9.989,6,86,26413,43,560,237,1152,20211,43,447,231,1179,6202
378.191,2,4,128,4,8,126063,8,128,0,0,0,0,0
31.466,6,7,308,1,0,0,0,44,6,0,6271,0,264
240.33,6,43,9087,21,523,12016,1418,5815,22,235,11443,618,3272
5.021,17,4,288,2,36,4989,36,128,2,52,4990,52,160
55.678,17,3,1000,3,305,27839,308,1000,0,0,0,0,0
1.902,17,5,1808,5,333,475,361,1808,0,0,0,0,0
0.913,6,30,8443,16,270,51,629,2293,14,796,57,2720,6150
1744.084,6,95,7203,63,38,28130,205,4476,32,33,56249,98,2727
1789.437,1,274,15344,274,28,6554,28,15344,0,0,0,0,0
52.744,6,28,7217,13,155,4395,267,1306,15,482,3766,1997,5911
87.849,6,14,3888,8,127,12549,127,467,6,1056,17545,1704,3421
0.304,17,2,167,1,39,0,39,67,1,72,0,72,100
0.332,1,2,112,2,28,332,28,112,0,0,0,0,0
0.443,6,12,1653,6,288,84,288,548,6,426,50,434,1105
0.03,17,2,351,1,30,0,30,58,1,265,0,265,293
1.796,17,6,360,3,32,897,32,180,3,32,897,32,180
21.354,6,20,4133,8,152,3050,267,782,12,409,1917,1152,3351
33.546,6,29,4989,14,180,2580,722,1806,15,342,2381,1448,3183
541.399,2,5,160,5,8,135349,8,160,0,0,0,0,0
0.167,6,3,132,2,0,4,0,92,1,0,0,0,40
393.678,6,50,8373,22,134,13435,516,2096,28,224,14577,1452,6277
1741.189,6,87,6322,58,31,30547,31,3915,29,31,62185,31,2407
1.319,6,12,1323,6,283,227,283,886,6,105,227,105,437
111.378,6,30,14064,15,887,113,1460,5957,15,1070,7937,2079,8107
24.129,6,37,8495,18,410,510,882,1982,19,441,1332,1460,6513
1715.206,1,8,848,8,78,245029,78,848,0,0,0,0,0
0.036,17,2,144,1,36,0,36,64,1,52,0,52,80
2.189,6,60,29739,33,1087,68,1380,24277,27,383,81,1380,5462
10.01,17,3,211,2,37,10010,37,130,1,53,0,53,81
1637.347,1,7,392,7,28,272891,28,392,0,0,0,0,0
1770.355,6,101,9344,66,65,27236,65,5577,35,59,52066,59,3767
0.266,17,2,204,1,34,0,34,62,1,114,0,114,142
1791.369,6,356,22520,208,69,8653,69,12460,148,69,12186,69,10060
283.152,6,30,7432,13,158,23596,267,1317,17,543,17696,1400,6115
9.717,6,11,616,5,0,2429,0,280,6,0,1705,0,336
0.218,17,2,2748,2,1346,218,1346,2748,0,0,0,0,0
0.891,6,10,1687,7,100,148,100,384,3,1179,314,1179,1303
642.11,1,10,560,10,28,71345,28,560,0,0,0,0,0
233.542,17,2,908,2,426,233542,687,908,0,0,0,0,0
1781.764,6,359,22709,209,69,8566,69,12569,150,69,11958,69,10140
3.22,6,5,232,2,0,3220,0,88,3,0,1515,0,144
1772.354,6,180,15480,120,69,14893,69,8940,60,69,30037,69,6540
2.222,17,2,677,1,300,0,300,328,1,321,0,321,349
246.122,17,4,352,2,60,246121,60,176,2,60,246120,60,176
1790.088,6,370,23563,214,69,8404,69,12769,156,69,11548,69,10794
1.11,6,24,8004,12,164,85,267,1288,12,1014,85,2411,6716
0.686,6,10,924,5,283,127,283,551,5,105,126,105,373
0.005,17,2,421,1,52,0,52,80,1,313,0,313,341
1.892,17,3,264,3,60,946,60,264,0,0,0,0,0
0.326,6,24,6021,12,181,29,537,1526,12,643,27,1448,4495
1679.709,17,13,534,11,14,167951,14,462,2,8,1679517,8,72
28.83,6,10,644,3,106,14415,106,234,7,90,4771,90,410
1766.602,6,131,8010,71,26,25236,26,4284,60,26,29941,26,3726
8.411,6,1373,1118723,741,1416,11,1448,1076867,632,776,13,1448,41856
1636.788,1,7,392,7,28,272798,28,392,0,0,0,0,0
1741.366,17,29,6699,29,203,62191,203,6699,0,0,0,0,0
1.955,17,22,5709,22,231,93,389,5709,0,0,0,0,0
95.69,6,291,222206,172,1191,35,1408,72077,119,2085,810,11264,150129
132.051,6,20,8132,11,511,83,1194,2005,9,1151,16485,3151,6127
317.063,6,91,20697,43,304,7549,1360,10290,48,256,6742,1929,10407
0.31,6,26,8990,13,247,25,624,1672,13,947,24,1438,7318
22.919,6,6,328,4,0,7639,0,216,2,0,22905,0,112
0.171,17,4,588,2,48,163,48,152,2,190,162,308,436
4.427,6,38,7229,19,218,245,314,3383,19,513,231,1179,3846
0.257,17,2,152,1,48,0,48,76,1,48,0,48,76
368.317,6,18,1242,14,180,28332,180,916,4,110,20056,110,326
291.31,6,34,7024,16,262,19417,517,1628,18,744,17133,1418,5396
286.699,6,34,9025,13,143,23891,267,1386,21,485,14275,1400,7639
1746.019,6,109,8694,70,64,25304,64,5104,39,58,45945,58,3590
4.096,6,38,7229,19,218,227,314,3383,19,513,214,1179,3846
1.113,6,27,8420,15,222,67,540,1964,12,1192,84,3151,6456
203.663,17,4,352,2,60,203662,60,176,2,60,203662,60,176
1786.311,6,364,23047,211,69,8506,69,12718,153,69,11751,69,10329
145.792,6,24,6248,9,272,104,516,1180,15,372,10406,1452,5068
1733.639,1,54,3024,54,28,32710,28,3024,0,0,0,0,0
1709.852,1,8,448,8,28,244264,28,448,0,0,0,0,0
0.05,17,2,588,1,39,0,39,67,1,493,0,493,521
98.672,6,47,10332,22,533,523,910,3095,25,345,4105,2128,7237
1796.225,17,449,39928,404,35,4457,288,25708,45,288,40023,288,14220
1762.649,6,127,14328,69,86,25920,517,5347,58,282,30922,2448,8981
1787.586,6,102,8228,68,64,26680,64,4896,34,58,54166,58,3332
13.189,6,11,651,6,43,2637,43,375,5,0,3295,0,276
9.118,6,22,7423,10,286,740,722,1551,12,673,810,2760,5872
1208.762,17,181,13756,181,48,6715,48,13756,0,0,0,0,0
1756.727,1,90,9540,90,78,19738,78,9540,0,0,0,0,0
0.753,6,25,7541,14,274,57,668,2109,11,968,72,1946,5432
1745.465,6,96,7286,63,38,28152,205,4476,33,33,54539,98,2810
1.052,6,10,1380,5,145,263,145,349,5,827,197,827,1031
2.016,6,38,8254,19,321,112,1164,2718,19,433,102,1360,5536
0.082,1,2,112,2,28,82,28,112,0,0,0,0,0
1796.839,17,449,39416,404,34,4458,288,25444,45,282,40016,288,13972
66.661,6,17,6194,4,112,22220,112,280,13,489,5551,1452,5914
1.328,6,49,18573,27,843,51,1360,12917,22,476,53,2720,5656
1790.864,6,184,15778,121,69,14923,69,8980,63,69,28882,69,6798
1.305,6,8,342,4,0,435,0,164,4,7,300,7,178
1742.614,6,110,8317,67,38,26403,205,4746,43,32,41484,98,3571
1681.231,17,14,3843,7,30,280204,30,406,7,463,280204,463,3437
14.697,6,2175,2016260,1421,1365,10,1420,1981773,754,475,19,1883,34487
421.116,2,7,224,7,8,70186,8,224,0,0,0,0,0
1774.132,6,181,15589,121,69,14784,69,9049,60,69,30068,69,6540
369.651,6,18,1242,14,180,28434,180,916,4,110,20060,110,326
0.004,17,2,401,1,34,0,34,62,1,311,0,311,339
267.466,6,280,228223,179,1307,1502,1368,210671,101,614,1971,2519,17552
1741.039,6,87,6322,58,31,30544,31,3915,29,31,62177,31,2407
1.268,6,51,20485,30,905,43,1360,14824,21,437,55,2715,5661
10.489,6,16,3911,9,275,1311,275,643,7,992,951,1440,3268
498.621,6,215,82227,105,780,4794,1460,63619,110,278,4569,1638,18608
61.977,6,93,77533,39,349,839,517,2752,54,1688,1169,5656,74781
0.322,6,20,4960,10,137,35,267,1092,10,692,34,1467,3868
5.023,17,4,288,2,36,5003,36,128,2,52,5013,52,160
11.703,17,15,17682,15,1150,835,1451,17682,0,0,0,0,0
116.389,17,9,3028,9,308,14548,312,3028,0,0,0,0,0
7.994,6,18,6767,9,275,999,275,643,9,1150,647,1414,6124
1.382,6,39,8292,19,320,76,1162,2716,20,433,63,1460,5576
27.415,17,4,240,2,32,27413,32,120,2,32,27414,32,120
3.217,6,39,8732,16,320,214,1162,2644,23,343,137,1440,6088
1796.724,17,308,70648,308,201,5852,422,70648,0,0,0,0,0
1783.534,17,83,3480,82,14,22018,14,3444,1,8,0,8,36
1798.729,17,449,39928,404,35,4463,288,25708,45,288,40019,288,14220
1745.744,6,224,21526,110,83,16016,721,10574,114,168,15446,1440,10952
66.535,6,36,8340,18,367,520,787,1854,18,522,3904,4080,6486
76.33,17,4,352,2,60,76329,60,176,2,60,76329,60,176
771.076,6,50,3891,31,65,25702,65,2215,19,57,42832,59,1676
0.04,17,2,152,1,48,0,48,76,1,48,0,48,76
0.275,17,2,152,1,48,0,48,76,1,48,0,48,76
1749.572,6,101,7608,66,38,26916,205,4632,35,33,51447,98,2976
0.545,17,2,672,2,308,545,308,672,0,0,0,0,0
1769.591,6,99,9240,66,65,27224,65,5577,33,59,55294,59,3663
1767.945,1,58,4872,58,56,31016,56,4872,0,0,0,0,0
300.77,6,51,13289,26,884,12030,1460,7332,25,290,637,1460,5957
1789.644,17,138,11040,69,48,26318,48,5244,69,56,26318,56,5796
161.618,6,6,364,4,31,53872,31,222,2,31,161604,31,142
1798.45,17,448,39896,403,35,4473,288,25676,45,288,40023,288,14220
5.643,6,43,7429,22,218,268,314,3503,21,440,270,1152,3926
1780.807,6,354,22440,207,69,8644,69,12420,147,69,12197,69,10020
1758.63,17,237,55785,237,207,7451,422,55785,0,0,0,0,0
0.32,6,10,861,5,222,76,222,426,5,231,76,231,435
105.319,1,18,1512,18,56,6195,56,1512,0,0,0,0,0
1609.226,6,116,7394,66,49,24757,208,4557,50,31,32837,31,2837
11.286,6,21,6825,12,275,1026,275,1038,9,1353,783,1440,5787
0.036,17,2,392,1,43,0,43,71,1,293,0,293,321
29.445,6,4498,4284337,2883,1406,10,1448,4195693,1615,776,18,1448,88644
9.753,6,79,24365,41,550,243,1152,18704,38,459,255,1179,5661
0.843,6,9,2151,5,188,210,245,580,4,1407,185,1407,1571
181.226,17,5992,5646225,1926,41,94,1350,132898,4066,1327,44,1350,5513327
12.906,6,32,9856,16,422,847,1205,2530,16,720,847,1368,7326
1.627,6,27,10187,16,286,108,591,1503,11,1030,146,1420,8684
1162.76,6,69,5475,45,64,26426,64,3208,24,56,50548,58,2267
1797.593,17,449,39928,404,35,4460,288,25708,45,288,40022,288,14220
1771.743,6,99,9306,66,66,27257,66,5610,33,60,55363,60,3696
194.453,17,4,824,2,48,194443,48,152,2,308,194441,308,672
0.103,17,4,912,2,60,91,60,176,2,340,93,340,736
240.237,6,47,6309,22,210,11439,585,3061,25,176,10009,580,3248
1.637,6,50,19207,27,885,62,1360,13511,23,433,64,1360,5696
276.508,17,17,18926,17,1085,17281,1451,18926,0,0,0,0,0
0.02,17,2,300,1,58,0,58,86,1,186,0,186,214
370.938,6,18,1242,14,180,28533,180,916,4,110,20062,110,326
30.382,6,16,1495,11,280,3038,517,1080,5,101,5834,142,415
2.731,6,116,87276,50,131,55,232,2529,66,1368,36,1430,84747
263.344,2,5,160,5,8,65836,8,160,0,0,0,0,0
1772.402,6,180,15480,120,69,14894,69,8940,60,69,30035,69,6540
0.726,6,22,6138,11,316,71,592,1846,11,742,71,1408,4292
0.414,6,2,100,1,0,0,0,60,1,0,0,0,40
0.075,17,4,284,2,32,39,32,120,2,54,39,60,164
1.199,6,25,8056,12,164,92,267,1288,13,869,85,1440,6768
0.723,17,15,7156,7,605,113,1350,4432,8,312,90,1350,2724
149.496,6,37,15896,23,796,6795,1368,9169,14,748,4724,2736,6727
1639.896,1,7,392,7,28,273316,28,392,0,0,0,0,0
17.316,6,7,420,0,0,0,0,0,7,0,0,0,420
3.509,17,5,295,5,31,877,31,295,0,0,0,0,0
1798.573,6,372,25988,216,99,8365,469,15194,156,69,11603,69,10794
6.007,17,4,834,2,44,6001,44,144,2,317,6003,317,690
132.476,17,8,1176,4,48,44155,48,304,4,190,44154,308,872
1.024,6,23,6516,13,334,84,1010,2196,10,979,111,1691,4320
10.801,6,2240,2093175,1436,1380,7,1408,2046703,804,931,13,2816,46472
282.101,6,30,7432,13,158,23508,267,1317,17,543,17618,1400,6115
1743.271,6,96,7255,64,38,27670,205,4528,32,33,56222,98,2727
1772.255,6,193,11789,97,46,18460,208,7019,96,31,18652,31,4770
1373.217,6,124,8962,68,71,20478,208,5947,56,31,24964,31,3015
0.457,6,49,22400,28,1077,16,1380,17318,21,468,20,3303,5082
31.49,6,7,336,1,0,0,0,48,6,0,6296,0,288
1782.693,6,359,22709,209,69,8570,69,12569,150,69,11964,69,10140
0.668,6,11,976,5,283,113,283,551,6,105,91,105,425
4.162,17,4,352,2,48,4148,48,152,2,72,4148,72,200
0.066,17,2,251,1,31,0,31,59,1,164,0,164,192
0.061,17,2,189,1,45,0,45,73,1,88,0,88,116
35.119,17,10,888,9,35,4389,288,572,1,288,0,288,316
0.635,6,27,9041,13,255,52,661,1706,14,942,46,1368,7335
109.992,17,4,352,2,60,109991,60,176,2,60,109991,60,176
240.188,6,54,18374,29,814,8577,1402,15360,25,213,10007,580,3014
39.18,1,3,990,3,302,19590,322,990,0,0,0,0,0
1.193,6,32,6300,17,138,74,267,1795,15,650,75,1452,4505
1799.099,17,448,39896,403,35,4475,288,25676,45,288,40018,288,14220
1740.868,6,84,6104,56,31,31652,31,3780,28,31,64476,31,2324
1773.368,6,209,22042,135,117,13234,981,13356,74,81,24292,549,8686
1787.024,6,102,8296,68,65,26672,65,4930,34,59,54149,59,3366
0.216,6,3,144,2,0,5,0,92,1,0,0,0,52
1799.174,6,356,22520,208,69,8691,69,12460,148,69,12239,69,10060
240.233,6,46,8201,23,156,10919,517,2313,23,425,10919,1402,5888
1798.491,17,449,39928,404,35,4462,288,25708,45,288,40015,288,14220
127.417,6,74,10882,33,129,3981,267,3655,41,348,3184,1380,7227
0.537,6,56,25133,31,1039,17,1380,17956,25,558,20,1923,7177
31.77,6,28,7217,13,155,2647,267,1306,15,482,2268,2840,5911
0.634,6,6,324,4,0,211,0,216,2,0,383,0,108
0.089,6,10,1669,6,551,17,947,1346,4,159,29,159,323
114.168,17,4,352,2,60,114167,60,176,2,60,114167,60,176
361.407,1,5,995,5,171,90351,351,995,0,0,0,0,0
0.094,17,2,168,1,48,0,48,76,1,64,0,64,92
28.382,17,4,240,2,32,28381,32,120,2,32,28381,32,120
0.019,17,4,668,2,32,12,32,120,2,246,14,246,548
4.035,17,7,7079,2,723,4035,1350,1503,5,1087,900,1350,5576
1.859,6,3,404,2,248,768,248,364,1,0,0,0,40
72.286,6,31,8912,14,158,5560,267,1357,17,763,4510,2076,7555
1757.762,6,112,6718,63,26,28345,26,3716,49,26,36617,26,3002
197.442,6,32,6856,13,186,9247,502,1458,19,289,10964,1420,5398
1.52,6,2,111,0,0,0,0,0,2,31,1520,31,111
0.115,17,4,1371,4,314,38,353,1371,0,0,0,0,0
1750.976,17,12,498,11,14,175097,14,462,1,8,0,8,36
0.974,17,18,9645,9,629,115,1350,5919,9,386,116,1350,3726
1772.504,6,205,22439,130,75,13740,267,10057,75,132,23949,1460,12382
1779.789,17,140,11200,70,48,25793,48,5320,70,56,25793,56,5880
82.453,6,32,7722,12,155,7495,267,1266,20,376,4339,2006,6456
1785.634,17,140,11200,70,48,25878,48,5320,70,56,25878,56,5880
16.765,6,25,4662,13,275,1397,275,1086,12,768,1090,1440,3576
1797.753,6,359,22778,210,69,8601,69,12678,149,69,12107,69,10100
1.202,6,24,8004,11,164,101,267,1236,13,869,84,1402,6768
1770.642,1,97,5432,97,28,18444,28,5432,0,0,0,0,0
1789.983,17,87,3648,86,14,21058,14,3612,1,8,0,8,36
4.066,17,5,295,5,31,1016,31,295,0,0,0,0,0
234.262,17,4,352,2,60,234261,60,176,2,60,234260,60,176
1791.665,17,143,11436,72,48,25230,48,5472,71,56,25594,56,5964
24.153,6,5,293,4,31,8051,31,222,1,31,0,31,71
47.621,6,35,8415,17,410,550,882,1942,18,478,2792,2720,6473
1793.254,17,83,3480,82,14,22138,14,3444,1,8,0,8,36
1786.46,6,104,8376,68,65,26663,65,4930,36,59,51039,59,3446
69.976,17,4,352,2,60,69975,60,176,2,60,69975,60,176
1759.41,1,8,448,8,28,251344,28,448,0,0,0,0,0
0.006,17,2,342,1,59,0,59,87,1,227,0,227,255
3.329,17,25,7369,10,269,369,1350,2976,15,264,231,1350,4393
1797.758,6,369,25799,215,99,8400,469,15154,154,69,11746,69,10645
5.237,6,43,8329,22,227,249,314,4062,21,489,248,1179,4267
280.375,17,4,240,2,32,280374,32,120,2,32,280374,32,120
62.633,6,14,1518,8,304,8947,304,1032,6,83,12525,83,486
1792.902,6,336,21996,196,69,9194,69,12049,140,69,12898,69,9947
0.317,17,2,237,1,72,0,72,100,1,109,0,109,137
64.34,6,24,7060,5,156,16085,267,678,19,374,3567,1460,6382
0.078,6,9,1002,5,213,19,213,417,4,421,23,421,585
31.84,6,63,51561,24,115,1384,269,1595,39,1369,837,2804,49966
317.016,6,109,35941,58,523,5561,1360,24872,51,310,6337,1929,11069
28.286,6,50,12808,24,957,678,1360,6811,26,290,1124,1360,5997
1741.112,6,87,6322,58,31,30545,31,3915,29,31,62181,31,2407
1.311,6,25,8056,12,164,101,267,1288,13,869,93,1408,6768
404.661,17,56,4678,52,30,7934,37,3030,4,384,114289,463,1648
255.837,17,4,352,2,60,255836,60,176,2,60,255835,60,176
1774.938,6,186,16134,120,69,14915,69,8940,66,69,27305,69,7194
0.44,6,12,1653,6,288,85,288,548,6,426,50,434,1105
571.663,1,6,336,6,28,114332,28,336,0,0,0,0,0
1787.288,1,58,4872,0,0,0,0,0,58,56,31355,56,4872
1786.599,6,106,8456,68,65,26665,65,4930,38,59,48284,59,3526
0.549,6,22,7462,12,350,49,753,1696,10,873,59,1499,5766
7.59,6,68,21139,34,575,230,1152,16336,34,491,221,1179,4803
255.15,6,10,718,4,106,85050,106,274,6,90,50997,90,444
1.147,6,202,153225,117,1328,9,1420,145534,85,475,13,1883,7691
0.011,17,5,824,3,32,3,32,180,2,294,7,294,644
240.177,6,52,18070,27,806,9237,1402,15124,25,204,10007,580,2946
1796.297,17,447,39864,402,35,4479,288,25644,45,288,40024,288,14220
0.404,17,2,152,1,48,0,48,76,1,48,0,48,76
11.341,6,18,5610,10,275,1260,275,958,8,1440,903,1440,4652
34.733,6,47,13322,23,937,702,1460,7560,24,399,1502,1460,5762
0.478,6,6,324,4,0,159,0,216,2,0,280,0,108
40.557,1,22,1232,22,28,1931,28,1232,0,0,0,0,0
1788.58,6,123,13214,79,85,22930,510,6398,44,126,41591,1380,6816
1786.479,6,104,8504,69,66,26271,66,5004,35,60,52540,60,3500
10.898,6,85,24605,43,533,259,1152,18784,42,459,258,1179,5821
3.142,6,7,300,4,0,989,0,168,3,0,1483,0,132
1.421,6,46,18969,26,947,56,1460,13393,20,476,64,2615,5576
1707.4,1,8,448,8,28,243914,28,448,0,0,0,0,0
725.389,6,146,9221,85,69,8635,69,5125,61,69,12089,69,4096
1786.654,17,440,48451,194,143,9249,1350,33219,246,33,7292,62,15232
30.184,6,11,1003,6,332,6036,332,652,5,83,7524,83,351
1786.636,6,159,25854,94,483,19210,483,19881,65,83,27915,83,5973
0.381,17,2,290,1,40,0,40,68,1,194,0,194,222
1799.792,6,356,22520,208,69,8694,69,12460,148,69,12243,69,10060
0.046,6,12,3631,6,99,8,99,419,6,964,7,1448,3212
240.222,6,62,21023,30,854,8283,1418,17795,32,194,7748,580,3228
126.607,17,10,880,5,48,31649,48,380,5,72,31648,72,500
11.016,6,18,4266,10,275,1224,275,958,8,992,846,1440,3308
0.922,6,10,1687,7,100,153,100,384,3,1179,330,1179,1303
1796.013,17,767,46250,767,32,2344,37,46250,0,0,0,0,0
1790.452,17,142,11360,71,48,25577,48,5396,71,56,25577,56,5964
0.0,1,1,170,1,142,0,142,170,0,0,0,0,0
4.689,6,9,379,5,0,1172,0,204,4,7,1500,7,175
1789.955,6,376,26148,217,98,8286,469,15372,159,69,11328,69,10776
1786.029,6,363,22938,210,69,8545,69,12678,153,69,11747,69,10260
0.802,17,18,7430,9,501,100,1350,4766,9,268,93,1350,2664
39.002,6,6,328,4,0,13000,0,216,2,0,38989,0,112
0.178,6,34,17114,16,173,11,319,1532,18,1219,9,1588,15582
1794.345,17,259,53150,259,177,6954,422,53150,0,0,0,0,0
297.985,1,8,448,8,28,42569,28,448,0,0,0,0,0
1.526,6,51,19342,27,892,58,1460,13606,24,433,56,1460,5736
301.028,6,32,8352,13,204,25071,467,1500,19,391,16714,1448,6852
1796.323,17,449,39928,404,35,4457,288,25708,45,288,40022,288,14220
50.654,17,4,1344,4,308,16884,308,1344,0,0,0,0,0
38.518,17,22,1672,22,48,1834,48,1672,0,0,0,0,0
1748.364,6,99,7814,65,45,27318,205,4850,34,35,52973,98,2964
3.745,6,15,3195,8,49,535,92,511,7,463,51,1448,2684
1.669,6,27,10179,16,285,111,587,1499,11,1029,149,1420,8680
1789.057,17,142,11360,71,48,25557,48,5396,71,56,25557,56,5964
0.544,6,23,7271,12,257,49,748,1663,11,838,51,1418,5608
33.556,6,30,5065,15,180,2396,721,1882,15,342,2381,2026,3183
284.693,17,4,240,2,32,284692,32,120,2,32,284692,32,120
32.739,6,4528,4252195,2947,1364,11,1408,4165319,1581,931,20,2801,86876
1770.249,6,99,9240,66,65,27234,65,5577,33,59,55317,59,3663
0.059,17,2,1358,2,651,59,651,1358,0,0,0,0,0
1786.451,17,87,3648,86,14,21017,14,3612,1,8,0,8,36
240.797,6,58,24226,26,548,9631,1418,6297,32,903,7767,1418,17929
2.947,6,2,88,2,0,0,0,88,0,0,0,0,0
1682.926,17,14,1036,7,30,280479,30,406,7,62,280478,62,630
92.759,6,20,8483,11,549,89,1308,2119,9,1198,11570,3151,6364
1468.971,1,16,896,16,28,97931,28,896,0,0,0,0,0
0.627,6,12,1653,6,288,120,288,548,6,426,90,434,1105
10.995,6,17,1354,11,275,1099,275,1002,6,96,1200,96,352
5.953,6,5,220,5,0,0,0,220,0,0,0,0,0
1740.97,17,134,10720,67,48,26378,48,5092,67,56,26378,56,5628
1742.89,6,95,7203,63,38,28111,205,4476,32,33,56215,98,2727
0.186,17,5,1497,5,271,46,316,1497,0,0,0,0,0
3.008,6,7,300,4,0,1002,0,168,3,0,1292,0,132
1791.657,1,287,16072,287,28,6264,28,16072,0,0,0,0,0
1720.784,17,13,534,11,14,172059,14,462,2,8,1720607,8,72
2.897,1,3,168,3,28,1448,28,168,0,0,0,0,0
1.588,6,47,19256,27,897,61,1360,13680,20,476,72,2715,5576
12.761,17,4,352,2,60,12760,60,176,2,60,12760,60,176
1772.855,6,180,15480,120,69,14897,69,8940,60,69,30042,69,6540
8.507,6,79,24717,40,561,218,1152,19016,39,413,216,1152,5701
1776.077,2,23,736,23,8,80730,8,736,0,0,0,0,0
0.027,17,4,368,2,35,19,35,126,2,93,18,99,242
77.003,17,4,352,2,60,77002,60,176,2,60,77002,60,176
1744.523,6,97,7307,63,38,28137,205,4476,34,33,52853,98,2831
6.221,6,14,5889,3,98,3105,106,325,11,639,621,1420,5564
1.282,6,24,6404,13,296,106,826,2007,11,988,127,1731,4397
0.04,1,2,212,2,78,40,78,212,0,0,0,0,0
1795.728,17,449,39928,404,35,4455,288,25708,45,288,40018,288,14220
10.933,6,1735,1527244,1008,1426,10,1448,1480400,727,776,14,1448,46844
12.797,6,29,14764,12,187,1163,187,970,17,1191,627,1460,13794
1634.033,1,8,448,8,28,233433,28,448,0,0,0,0,0
259.829,6,30,6769,15,290,18559,517,1405,15,762,17238,2420,5364
0.533,6,20,7151,12,318,46,600,1906,8,1205,72,1851,5245
1741.0,6,124,12253,76,62,23213,722,6287,48,91,37034,1408,5966
3.057,17,6,1368,3,60,1525,60,264,3,340,38,340,1104
0.311,6,27,9098,13,257,25,669,1714,14,949,23,2804,7384
31.593,6,7,308,1,0,0,0,44,6,0,6301,0,264
1.091,17,4,308,2,33,895,33,122,2,65,0,65,186
1.197,6,41,11378,22,547,57,1360,5842,19,476,57,2715,5536
1443.904,2,13,416,13,8,120325,8,416,0,0,0,0,0
1800.0,6,216,17190,80,75,22405,337,8341,136,50,13333,143,8849
1.033,6,49,13749,24,551,44,1429,4840,25,464,42,1986,8909
1751.146,6,186,11385,93,47,19034,208,6766,93,31,19031,31,4619
0.289,6,20,4960,10,137,32,267,1092,10,692,30,1467,3868
1007.513,1,5,280,5,28,251878,28,280,0,0,0,0,0
126.857,6,51,16833,26,991,448,1360,11031,25,399,5278,1360,5802
2.757,6,10,1838,5,899,689,899,1167,5,403,689,403,671
1773.325,6,180,15480,120,69,14901,69,8940,60,69,30048,69,6540
0.0,17,7,2179,7,283,0,317,2179,0,0,0,0,0
300.237,6,38,12367,21,592,15011,1408,4712,17,676,15233,2816,7655
1772.511,6,201,22210,129,75,13847,267,10017,72,136,24959,2006,12193
0.08,17,2,245,1,32,0,32,60,1,157,0,157,185
0.068,6,10,1514,5,503,16,503,771,5,475,17,475,743
617.947,6,87,15335,35,124,18174,615,4212,52,237,12114,1360,11123
317.116,6,72,19491,36,352,9060,1360,9932,36,352,9055,1360,9559
80.406,6,23,10229,11,433,62,990,1771,12,995,7298,1360,8458
240.561,6,41,8562,20,574,12660,1418,5645,21,227,12027,580,2917
1.412,6,41,11976,22,612,67,1360,6440,19,433,67,1360,5536
0.166,17,2,238,1,59,0,59,87,1,123,0,123,151
1771.35,6,99,9306,66,66,27251,66,5610,33,60,55352,60,3696
375.965,6,39,7478,19,143,15025,516,1910,20,280,19782,1452,5568
125.59,2,2,64,2,8,125590,8,64,0,0,0,0,0
0.281,17,4,1574,4,365,93,373,1574,0,0,0,0,0
31.977,6,218,178155,97,133,333,323,6549,121,1412,266,2816,171606
1744.594,2,27,864,27,8,67099,8,864,0,0,0,0,0
6.889,6,1113,1002799,672,1413,10,1448,975203,441,776,15,1448,27596
0.021,17,2,500,1,60,0,60,88,1,384,0,384,412
1791.895,1,58,4872,58,56,31436,56,4872,0,0,0,0,0
1770.447,6,99,9240,66,65,27237,65,5577,33,59,55321,59,3663
1.361,6,38,8252,19,320,75,1162,2716,19,433,65,1460,5536
0.014,17,2,176,1,48,0,48,76,1,72,0,72,100
1774.353,17,140,11200,70,48,25715,48,5320,70,56,25715,56,5880
1745.345,6,95,7203,63,38,28150,205,4476,32,33,56287,98,2727
386.179,6,23,1538,16,180,25745,180,1056,7,110,10401,110,482
1739.52,6,96,6962,62,31,28516,31,4209,34,31,52711,31,2753
1786.859,6,102,8296,68,65,26669,65,4930,34,59,54144,59,3366
280.481,6,30,7432,13,158,23373,267,1317,17,543,17525,1400,6115
1785.867,6,368,23276,212,69,8463,69,12896,156,69,11521,69,10380
0.344,6,22,4442,11,165,34,456,1394,11,493,32,888,3048
70.744,6,7,413,4,0,21501,0,220,3,37,3058,37,193
1.58,6,30,10426,18,367,92,833,1825,12,1014,135,1414,8601
1744.713,2,16,512,16,8,116314,8,512,0,0,0,0,0
1791.303,17,144,11520,72,48,25229,48,5472,72,56,25229,56,6048
63.412,6,40,9964,19,706,608,1360,4322,21,435,3162,2667,5642
148.704,6,63,42425,40,1199,3812,1448,34475,23,843,2793,2359,7950
1744.281,6,95,7203,63,38,28133,205,4476,32,33,56259,98,2727
0.499,17,3,451,2,39,142,39,134,1,289,0,289,317
14.356,6,45,11464,19,237,797,335,3856,26,547,557,1179,7608
1786.747,6,105,8481,69,65,26275,65,5035,36,59,51046,59,3446
1798.204,17,764,46132,764,32,2356,37,46132,0,0,0,0,0
112.007,2,3,96,3,8,56003,8,96,0,0,0,0,0
1797.549,6,361,22858,210,69,8600,69,12678,151,69,11983,69,10180
1778.827,6,102,8228,68,64,26549,64,4896,34,58,53900,58,3332
0.026,6,6,897,3,483,11,483,639,3,102,11,102,258
0.059,17,2,279,1,36,0,36,64,1,187,0,187,215
11.012,6,20,7130,11,275,1101,275,998,9,1440,779,1440,6132
1755.46,1,61,6466,61,78,29257,78,6466,0,0,0,0,0
15.251,6,8,344,3,0,7625,0,124,5,0,3802,0,220
1777.912,6,78,17543,44,336,41346,1360,8579,34,330,53870,1360,8964
1743.92,1,56,4704,56,56,31707,56,4704,0,0,0,0,0
1.242,6,48,19990,28,884,46,1360,14414,20,476,56,2715,5576
1792.468,6,366,25541,213,100,8455,469,14936,153,69,11792,69,10605
0.276,6,25,8960,13,252,23,646,1694,12,1105,24,2804,7266
152.337,6,81,18104,37,302,2967,1189,5125,44,448,3539,1917,12979
18.598,6,48,9568,24,246,808,314,4408,24,419,731,1179,5160
240.251,6,55,19803,30,817,8283,1418,17091,25,200,10009,580,2712
170.551,6,21298,20079273,13944,1360,12,1408,19692129,7354,931,23,2816,387144
16.358,17,22,5903,10,262,1810,1350,2906,12,221,1479,1350,2997
4.554,6,40,7309,20,218,239,314,3423,20,513,226,1179,3886
0.013,17,4,768,2,39,8,39,134,2,289,8,289,634
1771.871,1,59,4956,59,56,30549,56,4956,0,0,0,0,0
286.245,6,26,1793,14,330,22018,330,1074,12,83,26021,83,719
280.043,6,28,7352,13,158,23336,267,1317,15,678,20000,4200,6035
104.773,6,99,73863,57,1250,410,1360,56120,42,1070,2550,2720,17743
10.782,6,20,4442,11,275,1078,275,998,9,768,752,1440,3444
1773.005,6,215,24517,135,89,13231,981,11307,80,135,22442,1997,13210
1.616,6,50,21002,28,946,59,1360,15346,22,433,67,1360,5656
91.459,6,41,11093,15,290,2283,1189,2644,26,411,3657,1917,8449
104.345,17,4,1344,4,308,34781,308,1344,0,0,0,0,0
3.13,17,2,778,2,361,3130,361,778,0,0,0,0,0
40.61,17,6,528,3,48,20285,48,228,3,72,20295,72,300
0.483,6,10,968,5,256,110,256,460,5,304,110,304,508
4.726,6,3,132,3,0,0,0,132,0,0,0,0,0
100.238,6,28,12912,15,830,58,1360,5613,13,1127,8339,4445,7299
1784.88,6,194,20495,126,111,14279,965,12075,68,83,26636,405,8420
13.551,6,942,790661,576,1297,23,1368,766965,366,776,36,2736,23696
0.282,6,22,7333,12,334,25,663,1969,10,1209,30,1906,5364
0.044,17,4,398,2,44,40,44,144,2,99,40,99,254
7.383,17,6,528,3,48,3685,48,228,3,72,3686,72,300
135.436,17,4,240,2,32,135435,32,120,2,32,135435,32,120
262.106,6,28,7352,12,158,23827,267,1277,16,603,17471,1400,6075
10.774,6,20,4442,11,275,1077,275,998,9,768,737,1440,3444
126.996,6,21,8512,11,545,110,1329,2108,10,998,14086,2720,6404
11.88,17,11,5083,7,445,1980,1350,3314,4,414,3936,1350,1769
1798.69,17,448,39896,403,35,4474,288,25676,45,288,40019,288,14220
4.714,6,16,3934,8,170,673,170,602,8,964,671,1448,3332
0.993,6,29,8500,15,222,61,540,1964,14,852,62,1360,6536
1786.661,6,104,8444,68,66,26666,66,4964,36,60,51043,60,3480
0.062,17,2,178,1,35,0,35,63,1,87,0,87,115
280.495,6,44,13266,20,181,14760,267,2256,24,717,12195,3436,11010
3.218,17,3,228,2,48,3045,48,152,1,48,0,48,76
6.474,6,10,843,5,279,1618,279,547,5,0,1575,0,296
0.149,6,44,20293,26,1020,5,1420,15352,18,467,8,1883,4941
1790.362,17,85,3561,83,13,21831,14,3481,2,12,1790161,16,80
0.217,1,2,112,2,28,217,28,112,0,0,0,0,0
3.541,17,4,240,4,32,1180,32,240,0,0,0,0,0
373.691,6,25,1651,17,177,23355,177,1117,8,110,9266,110,534
1798.17,6,354,22440,207,69,8728,69,12420,147,69,12316,69,10020
0.675,6,14,1745,7,288,84,288,600,7,426,82,434,1145
0.002,6,3,151,1,0,0,0,40,2,31,1,31,111
0.871,6,25,6440,13,295,72,822,2003,12,790,78,1420,4437
1795.736,17,450,40244,404,35,4455,288,25708,46,288,39130,288,14536
1508.221,6,85,9685,42,262,36784,517,2980,43,744,35908,1418,6705
19.141,6,1470,1326454,871,1438,21,1448,1287942,599,776,31,1448,38512
15.509,6,2441,2239587,1546,1369,9,1408,2188383,895,931,17,2816,51204
16.806,6,26,7110,8,146,2400,267,1058,18,484,978,1420,6052
300.591,6,38,8391,20,271,15820,738,1917,18,441,497,1440,6474
11.876,6,2333,2193880,1511,1374,7,1408,2146472,822,931,14,2816,47408
154.459,17,8,608,4,48,51482,48,304,4,48,51482,48,304
1620.562,1,14,812,14,30,124658,30,812,0,0,0,0,0
0.206,17,2,260,1,61,0,61,89,1,143,0,143,171
12.265,6,2400,2230765,1536,1374,7,1408,2181173,864,931,14,2816,49592
286.716,17,4,240,2,32,286714,32,120,2,32,286715,32,120
5.015,17,4,558,2,36,5006,36,128,2,187,5004,187,430
280.489,6,28,7352,13,158,23374,267,1317,15,603,20031,2076,6035
1793.158,17,144,11520,72,48,25255,48,5472,72,56,25255,56,6048
0.396,17,2,172,1,50,0,50,78,1,66,0,66,94
237.559,17,4,240,2,32,237557,32,120,2,32,237558,32,120
240.657,6,44,6205,20,214,12664,585,2978,24,179,10461,580,3227
388.541,6,26,1703,17,177,24283,177,1117,9,110,8215,110,586
1772.923,6,196,12648,98,57,18277,208,7798,98,31,18274,31,4850
11.805,6,1730,1608202,1135,1365,10,1420,1580111,595,427,19,1420,28091
280.747,6,29,7392,13,158,23395,267,1317,16,603,18711,2036,6075
1744.557,6,95,7203,63,38,28138,205,4476,32,33,56266,98,2727
1795.072,17,444,39200,400,35,4498,288,25296,44,288,40949,288,13904
1760.285,1,56,4704,56,56,32005,56,4704,0,0,0,0,0
107.268,6,33,16580,15,426,55,956,1923,18,994,6301,1440,14657
27.126,17,4,240,2,32,27124,32,120,2,32,27125,32,120
8.669,6,42,8776,21,360,433,734,1990,21,370,424,1440,6786
737.932,6,56,4448,29,65,23436,65,2005,27,54,28378,59,2443
0.363,17,8,2758,8,316,51,355,2758,0,0,0,0,0
0.067,6,11,819,6,186,11,186,506,5,45,15,45,313
3.085,17,3,201,3,39,1542,39,201,0,0,0,0,0
1780.523,17,142,11360,71,48,25435,48,5396,71,56,25435,56,5964
197.924,17,8,2684,8,307,28274,320,2684,0,0,0,0,0
1799.629,17,449,39928,404,35,4465,288,25708,45,288,40023,288,14220
7.566,17,6,528,3,48,3778,48,228,3,72,3777,72,300
0.017,17,3,215,2,33,0,33,122,1,65,0,65,93
1776.932,17,75,3141,73,13,24677,14,3061,2,12,1776756,16,80
195.515,6,30,14663,17,617,911,1360,4417,13,1387,16281,4080,10246
280.329,6,29,7392,13,158,23360,267,1317,16,603,18681,1400,6075
4.3,6,38,7229,19,218,238,314,3383,19,513,224,1179,3846
0.077,17,2,198,1,37,0,37,65,1,105,0,105,133
0.523,17,2,384,1,39,0,39,67,1,289,0,289,317
0.247,6,21,5000,10,137,27,267,1092,11,577,23,1400,3908
1792.479,17,142,11360,71,48,25606,48,5396,71,56,25606,56,5964
1783.08,6,1433,467392,690,260,2587,1360,153101,743,883,2402,6544,314291
5.553,17,26,6676,10,262,617,1350,2908,16,207,234,1350,3768
174.899,17,4,240,2,32,174898,32,120,2,32,174898,32,120
280.395,6,28,7352,13,158,23366,267,1317,15,678,20024,3456,6035
7.174,6,17,3502,10,210,797,210,948,7,545,1194,905,2554
10.166,6,82,24469,42,549,247,1152,18728,40,459,253,1179,5741
1739.775,6,128,9361,73,75,24163,208,6231,55,31,32211,31,3130
90.868,17,20,1760,10,48,10095,48,760,10,72,10095,72,1000
1.687,6,27,10173,16,284,112,584,1496,11,1029,151,1420,8677
1796.453,17,449,39928,404,35,4457,288,25708,45,288,40019,288,14220
1796.28,17,449,39928,404,35,4457,288,25708,45,288,40023,288,14220
0.094,6,9,1340,5,145,23,145,349,4,827,24,827,991
10.979,6,18,4266,10,275,1219,275,958,8,992,883,1440,3308
127.482,6,9,522,2,106,127470,106,194,7,0,21245,0,328
21.439,17,22,3116,11,48,2142,48,836,11,179,2142,308,2280
94.847,6,29,7392,13,158,7903,267,1317,16,603,6320,1400,6075
11.151,6,21,6825,12,275,1013,275,1038,9,1353,767,1440,5787
3.923,17,4,352,4,60,1307,60,352,0,0,0,0,0
11.514,6,2,1175,1,0,0,0,40,1,1095,0,1095,1135
15.81,17,4,352,2,60,15809,60,176,2,60,15809,60,176
0.005,17,2,358,1,30,0,30,58,1,272,0,272,300
1791.444,6,370,25908,213,99,8450,469,15005,157,69,11482,69,10903
8.266,6,20,6851,10,275,918,275,683,10,1150,841,1414,6168
164.496,6,23,940,9,0,6069,0,364,14,0,12652,0,576
1680.921,1,15,840,15,28,120065,28,840,0,0,0,0,0
1799.402,6,363,24414,212,88,8527,469,14027,151,69,11993,69,10387
0.153,6,9,1346,5,145,38,145,349,4,833,43,833,997
11.819,6,1858,1634156,1110,1416,10,1432,1599967,748,467,15,1871,34189
1786.45,6,106,8574,68,65,26663,65,4930,38,59,48278,59,3644
0.154,17,2,290,1,40,0,40,68,1,194,0,194,222
1793.923,17,87,3648,86,14,21104,14,3612,1,8,0,8,36
1787.22,6,104,8376,68,65,26674,65,4930,36,59,51059,59,3446
3.486,17,4,1556,4,361,1162,361,1556,0,0,0,0,0
0.405,17,3,244,2,32,328,32,120,1,96,0,96,124
273.091,6,18,5839,10,784,30343,1360,3538,8,247,38979,272,2301
0.005,6,2,104,1,0,0,0,64,1,0,0,0,40
84.794,6,22,4566,10,341,9421,722,1540,12,299,7689,1448,3026
1314.111,6,150,10324,55,46,24335,46,4362,95,46,13978,46,5962
1791.79,6,354,22302,207,69,8698,69,12351,147,69,12245,69,9951
125.719,6,21,2281,12,304,11429,304,1540,9,83,15339,83,741
0.847,6,20,5984,11,282,84,548,1292,9,721,94,1452,4692
0.542,6,27,9167,13,282,45,769,1814,14,943,38,1368,7353
0.059,17,2,213,1,54,0,54,82,1,103,0,103,131
397.41,17,23,8206,23,328,18064,548,8206,0,0,0,0,0
240.219,6,55,18996,30,772,8283,1408,16245,25,180,10008,580,2751
300.132,6,29,8791,16,404,20008,1241,2492,13,802,5572,1448,6299
0.158,6,41,14460,22,857,7,1420,9479,19,420,8,1420,4981
268.475,1,3,180,3,32,134237,32,180,0,0,0,0,0
6.033,6,1499,1377996,946,1379,6,1408,1344576,553,931,10,2801,33420
1670.238,1,7,392,7,28,278373,28,392,0,0,0,0,0
3.213,6,2,88,2,0,0,0,88,0,0,0,0,0
1799.682,17,142,11360,71,48,25709,48,5396,71,56,25709,56,5964
1.496,6,47,19735,27,931,57,1440,14159,20,433,68,1440,5576
1784.273,6,365,23087,211,69,8496,69,12787,154,69,11661,69,10300
1.699,6,13,2311,8,188,242,245,700,5,1407,360,1407,1611
1740.663,17,28,6580,28,207,64469,207,6580,0,0,0,0,0
280.861,6,30,7432,13,158,23405,267,1317,17,543,17545,1400,6115
0.045,17,4,284,2,32,26,32,120,2,54,22,60,164
14.109,6,2335,2127315,1473,1366,9,1408,2077827,862,931,16,2801,49488
1682.822,17,14,1036,7,30,280461,30,406,7,62,280464,62,630
1795.198,17,80,3354,79,14,23015,14,3318,1,8,0,8,36
278.629,17,4,240,2,32,278628,32,120,2,32,278628,32,120
14.076,6,8,440,5,0,3519,0,268,3,0,6522,0,172
301.006,6,51,10073,27,375,11577,766,3074,24,354,650,3488,6999
280.538,6,25,7102,11,181,28053,267,1172,14,670,21571,1400,5930
461.718,1,7,887,7,98,76953,117,887,0,0,0,0,0
8.257,6,419,337611,250,1285,32,1368,324159,169,931,48,2736,13452
281.695,6,31,7476,13,158,23474,267,1317,18,543,16565,1400,6159
205.898,17,4,352,2,60,205897,60,176,2,60,205896,60,176
0.236,17,2,157,1,31,0,31,59,1,70,0,70,98
1785.858,6,353,22262,206,69,8711,69,12311,147,69,12231,69,9951
853.171,1,41,4346,41,78,21329,78,4346,0,0,0,0,0
0.157,6,3,156,2,0,154,0,104,1,0,0,0,52
0.748,17,2,778,2,361,748,361,778,0,0,0,0,0
2.606,6,29,10877,15,746,186,1360,3617,14,836,189,1360,7260
0.133,6,2,80,1,0,0,0,40,1,0,0,0,40
1773.304,6,180,15480,120,69,14901,69,8940,60,69,30051,69,6540
1781.175,17,142,11360,71,48,25445,48,5396,71,56,25445,56,5964
252.002,2,3,96,3,8,126001,8,96,0,0,0,0,0
2.595,6,2,88,2,0,0,0,88,0,0,0,0,0
224.508,6,28,10742,7,156,26663,267,758,21,571,11224,1460,9984
65.37,6,39,15983,23,722,2971,1448,9153,16,748,4318,2896,6830
240.287,6,43,8949,21,519,12014,1402,5774,22,224,11441,618,3175
61.978,6,75,48099,44,1170,1441,1368,39751,31,841,2058,2736,8348
1.556,6,48,18740,27,858,59,1360,13124,21,476,67,2715,5616
64.174,17,4,352,2,60,64172,60,176,2,60,64173,60,176
11.67,6,93,27333,48,562,248,1152,21051,45,447,259,1179,6282
0.008,17,2,447,1,37,0,37,65,1,354,0,354,382
1751.884,6,95,7203,63,38,28256,205,4476,32,33,56502,98,2727
8.119,1,9,756,9,56,1014,56,756,0,0,0,0,0
1750.632,6,97,7307,63,38,28236,205,4476,34,33,53037,98,2831
0.019,17,4,624,2,64,17,64,184,2,192,4,192,440
1795.44,17,449,39928,404,35,4455,288,25708,45,288,40021,288,14220
1.416,6,4,172,2,0,1416,0,84,2,0,1028,0,88
1799.151,17,449,39928,404,35,4464,288,25708,45,288,40017,288,14220
1791.77,6,359,22709,209,69,8614,69,12569,150,69,12025,69,10140
0.048,6,3,120,1,0,0,0,40,2,0,47,0,80
1800.0,6,219,18580,80,71,22405,301,8073,139,69,13043,1062,10507
240.36,6,41,8292,22,449,11445,1418,5648,19,206,13352,580,2644
0.013,6,2,92,1,0,0,0,52,1,0,0,0,40
36.674,17,16,2352,8,48,5238,48,608,8,190,5238,308,1744
280.033,6,30,7432,13,158,23336,267,1317,17,543,17500,1400,6115
3.79,17,25,15630,11,636,375,1350,7309,14,566,288,1350,8321
267.283,17,4,352,2,60,267282,60,176,2,60,267281,60,176
0.015,6,13,3980,7,88,2,88,388,6,1670,3,2920,3592
297.422,6,68,11379,32,158,9588,721,4291,36,376,8492,1440,7088
251.981,2,3,96,3,8,125990,8,96,0,0,0,0,0
0.013,17,2,575,1,37,0,37,65,1,482,0,482,510
23.43,6,32,8778,15,340,1673,721,2645,17,605,1453,1440,6133
1.309,6,48,18828,27,864,50,1360,13212,21,433,56,1360,5616
0.069,17,2,144,1,36,0,36,64,1,52,0,52,80
1744.746,6,95,7203,63,38,28141,205,4476,32,33,56276,98,2727
37.938,6,25,7097,12,155,3448,267,1266,13,589,3160,3426,5831
1.275,6,50,19173,29,878,45,1360,13512,21,437,55,2715,5661
0.96,17,21,14018,12,929,87,1350,11493,9,252,112,1350,2525
2.719,17,4,1556,4,361,906,361,1556,0,0,0,0,0
3.024,17,3,180,3,32,1512,32,180,0,0,0,0,0
0.212,6,9,1338,5,549,53,549,753,4,421,44,421,585
1790.039,17,180,26820,180,121,10000,121,26820,0,0,0,0,0
1793.961,17,180,14040,180,50,10022,50,14040,0,0,0,0,0
460.422,1,6,336,6,28,92084,28,336,0,0,0,0,0
38.698,17,22,1936,11,48,3868,48,836,11,72,3868,72,1100
140.075,17,8,2688,8,308,20010,308,2688,0,0,0,0,0
1778.959,17,56,2346,55,14,32939,14,2310,1,8,0,8,36
61.174,6,39,22875,21,127,3058,128,1351,18,1732,3591,4380,21524
1745.472,6,90,6540,60,31,29584,31,4050,30,31,60181,31,2490
0.136,17,2,588,1,39,0,39,67,1,493,0,493,521
281.29,6,30,7639,12,143,25571,267,1346,18,506,16522,1400,6293
240.13,6,103,98875,46,184,5336,518,3688,57,1808,4287,5632,95187
145.908,6,85,57439,51,1217,2918,1368,48935,34,841,1880,2519,8504
0.194,17,2,136,1,32,0,32,60,1,48,0,48,76
1787.161,17,87,3648,86,14,21025,14,3612,1,8,0,8,36
68.218,17,4,240,2,32,68217,32,120,2,32,68216,32,120
1770.859,6,101,9410,66,66,27243,66,5610,35,60,52081,60,3800
0.687,6,471,479019,148,183,4,230,8253,323,1414,2,2816,470766
5.064,6,1028,859914,457,153,11,251,19068,571,1440,8,5680,840846
286.38,6,41,8554,18,158,16845,267,1517,23,509,12981,1400,7037
40.364,17,31,10022,14,394,3102,1350,5916,17,213,2520,1350,4106
6.703,2,4,192,4,24,2234,32,192,0,0,0,0,0
1560.945,1,14,784,14,28,120072,28,784,0,0,0,0,0
0.168,6,10,1380,6,145,33,145,389,4,827,49,827,991
0.078,17,4,284,2,32,0,32,120,2,54,0,60,164
1741.357,17,28,6580,28,207,64494,207,6580,0,0,0,0,0
0.155,17,8,7074,3,909,77,1350,2812,5,824,27,1350,4262
1797.08,17,448,39896,403,35,4470,288,25676,45,288,40024,288,14220
3.671,17,4,240,4,32,1223,32,240,0,0,0,0,0
167.314,6,1590,1569884,599,263,279,307,39128,991,1509,165,4615,1530756
1.261,6,117,87644,51,131,25,232,2569,66,1351,16,1430,85075
24.971,17,4,320,2,48,24966,48,152,2,56,24963,56,168
11.567,6,105,34530,53,630,222,1152,27968,52,407,222,1152,6562
7.163,6,33,8282,16,207,477,721,2098,17,611,436,1414,6184
1.592,6,45,17008,26,800,63,1360,11472,19,433,76,1360,5536
1.003,6,2,120,2,0,0,0,120,0,0,0,0,0
160.533,6,19,780,7,0,4052,0,284,12,0,14592,0,496
8.035,6,8,1217,4,585,2678,585,789,4,212,2621,212,428
1788.795,6,241,24895,96,67,18828,616,9131,145,138,12421,4658,15764
1770.838,6,102,9711,68,69,26430,233,5914,34,59,53658,82,3797
7.615,6,36,7149,18,218,447,314,3343,18,513,431,1179,3806
17.562,6,7895,7929773,5239,1436,3,1448,7786997,2656,776,6,1448,142776
1786.585,6,102,8296,68,65,26665,65,4930,34,59,54136,59,3366
1784.715,1,76,8056,76,78,23796,78,8056,0,0,0,0,0
2.764,6,2,80,1,0,0,0,40,1,0,0,0,40
18.862,17,35,7606,16,199,1255,1350,3636,19,180,1045,1350,3970
0.074,6,12,965,6,182,14,182,490,6,77,9,134,475
1.729,6,50,19603,27,913,66,1360,13907,23,433,69,1360,5696
1771.168,6,111,10231,71,65,25302,65,6003,40,59,45412,59,4228
5.673,6,38,7229,20,218,298,314,3423,18,513,316,1179,3806
1777.496,17,142,11360,71,48,25392,48,5396,71,56,25392,56,5964
1798.501,17,449,150860,449,307,4014,324,150860,0,0,0,0,0
1789.667,17,138,11040,69,48,26318,48,5244,69,56,26318,56,5796
5.374,6,37,7189,19,218,298,314,3383,18,513,300,1179,3806
1776.011,6,211,24219,134,89,13353,981,11198,77,136,23367,1917,13021
532.675,17,7,539,7,49,88779,49,539,0,0,0,0,0
1786.251,6,102,8296,68,65,26660,65,4930,34,59,54125,59,3366
0.851,6,27,5740,13,125,70,267,1275,14,650,59,1452,4465
31.622,6,6,360,0,0,0,0,0,6,0,0,0,360
1783.714,17,83,3480,82,14,22021,14,3444,1,8,0,8,36
2.092,17,3,1170,3,362,1046,362,1170,0,0,0,0,0
0.399,6,8,320,4,0,88,0,160,4,0,58,0,160
70.792,6,49,9044,23,345,682,720,2095,26,327,2826,1360,6949
111.56,6,44,8713,15,142,7968,267,1461,29,253,3979,1420,7252
83.659,17,4,240,2,32,83658,32,120,2,32,83658,32,120
0.142,6,46,21782,27,1046,5,1420,16801,19,467,7,1883,4981
1798.388,17,448,39896,403,35,4473,288,25676,45,288,40014,288,14220
0.62,6,3,120,2,0,620,0,80,1,0,0,0,40
0.087,6,10,767,5,186,17,186,454,5,45,20,45,313
1669.068,1,8,448,8,28,238438,28,448,0,0,0,0,0
1796.669,17,449,39928,404,35,4458,288,25708,45,288,40021,288,14220
2.102,6,4,220,2,0,2102,0,100,2,0,304,0,120
3.011,17,7,986,4,34,1000,34,248,3,218,1498,218,738
0.165,6,4,196,2,0,54,0,104,2,0,165,0,92
131.495,6,23,9977,12,523,62,1360,2605,11,1384,13137,3934,7372
0.259,17,3,451,2,39,189,39,134,1,289,0,289,317
2.574,6,12,1040,6,283,501,283,615,6,105,479,105,425
1788.866,6,356,22520,208,69,8641,69,12460,148,69,12168,69,10060
300.552,6,17,1199,7,177,50063,177,573,10,110,33375,110,626
0.115,6,9,1339,5,145,28,145,349,4,826,35,826,990
438.301,1,11,796,8,28,62614,28,448,3,88,908,88,348
0.33,17,2,152,1,48,0,48,76,1,48,0,48,76
1792.214,17,73,3060,72,14,25242,14,3024,1,8,0,8,36
1681.629,17,16,1265,8,30,240230,37,471,8,71,240231,136,794
43.397,6,31,16807,18,440,2552,999,2110,13,1573,3605,4080,14697
4.734,6,38,7229,20,218,249,314,3423,18,513,262,1179,3806
600.449,2,7,224,7,8,100074,8,224,0,0,0,0,0
1.416,6,24,8004,12,164,110,267,1288,12,1014,109,2736,6716
44.174,17,15,7808,8,655,6310,1350,5466,7,306,2519,1350,2342
1796.227,17,447,39296,404,35,4457,288,25708,43,288,41923,288,13588
1794.587,1,58,4872,58,56,31483,56,4872,0,0,0,0,0
1781.759,6,356,22520,208,69,8607,69,12460,148,69,12120,69,10060
1787.906,6,349,22309,199,69,9029,69,12031,150,69,11999,69,10278
0.074,17,2,373,1,34,0,34,62,1,283,0,283,311
1741.45,6,110,8162,68,38,25991,205,4798,42,33,42469,98,3364
599.271,6,9,546,6,31,119854,31,333,3,31,299593,31,213
1789.194,1,214,11984,214,28,8399,28,11984,0,0,0,0,0
51.451,6,39,30338,26,227,2058,517,2747,13,3363,4283,7097,27591
1742.631,6,95,7203,63,38,28106,205,4476,32,33,56204,98,2727
1741.191,17,28,6580,28,207,64488,207,6580,0,0,0,0,0
1790.256,1,65,3640,65,28,27972,28,3640,0,0,0,0,0
1776.681,17,73,3060,72,14,25023,14,3024,1,8,0,8,36
4.465,6,64,46200,25,284,186,889,3015,39,1246,117,1418,43185
1786.934,6,103,8401,69,65,26278,65,5035,34,59,54146,59,3366
1091.357,17,216,16416,216,48,5076,48,16416,0,0,0,0,0
3.519,17,5,295,5,31,879,31,295,0,0,0,0,0
0.98,6,26,9043,14,264,75,700,1651,12,985,71,1360,7392
1790.634,1,58,4872,58,56,31414,56,4872,0,0,0,0,0
1799.385,17,448,39896,403,35,4476,288,25676,45,288,40018,288,14220
2.64,6,9,810,4,133,878,147,559,5,51,658,51,251
282.819,6,50,9360,22,105,13467,267,2149,28,264,10468,1420,7211
6.1,6,47,8489,25,227,254,314,4182,22,427,278,1152,4307
5.427,6,34,8222,17,175,339,721,2089,17,681,328,2840,6133
3.084,17,6,870,3,40,1525,40,204,3,194,1526,194,666
1786.682,6,106,8524,68,66,26666,66,4964,38,60,48286,60,3560
40.24,6,27,7177,13,155,3353,267,1306,14,530,3094,3417,5871
723.46,6,104,16771,61,304,12057,304,11752,43,83,17224,83,5019
3.156,6,2,88,2,0,0,0,88,0,0,0,0,0
237.591,6,70,14632,28,303,8799,1189,5983,42,224,5791,1420,8649
1798.579,6,303,20538,181,69,9992,69,11449,122,69,14864,69,9089
2.986,6,7,380,4,0,995,0,216,3,0,1480,0,164
1793.464,17,87,3648,86,14,21099,14,3612,1,8,0,8,36
1.407,6,48,19110,26,952,56,1460,13454,22,433,57,1460,5656
106.403,6,21,1534,11,39,10639,39,611,10,50,11822,63,923
280.474,6,30,7432,13,158,23372,267,1317,17,603,17524,2076,6115
1786.583,6,102,8228,68,64,26665,64,4896,34,58,54136,58,3332
1787.736,17,87,3648,86,14,21032,14,3612,1,8,0,8,36
1785.328,17,87,3648,86,14,21003,14,3612,1,8,0,8,36
258.488,6,49,8263,22,326,12306,1132,4741,27,162,9940,580,3522
175.403,6,22,6188,7,272,540,516,1100,15,373,12521,1452,5088
674.914,1,10,560,10,28,74990,28,560,0,0,0,0,0
1247.961,6,118,13504,68,85,18626,501,5215,50,149,25416,1420,8289
260.91,17,4,240,2,32,260909,32,120,2,32,260908,32,120
0.157,17,4,284,2,32,85,32,120,2,54,87,60,164
0.016,17,5,1757,5,323,4,354,1757,0,0,0,0,0
1792.194,1,198,11088,198,28,9097,28,11088,0,0,0,0,0
0.105,17,2,396,1,39,0,39,67,1,301,0,301,329
1787.675,6,117,13727,75,80,24157,500,5916,42,161,43599,1420,7811
1788.732,17,83,3480,82,14,22083,14,3444,1,8,0,8,36
3.572,17,2,178,1,29,0,29,57,1,93,0,93,121
5.123,6,33,6145,17,206,320,314,2744,16,551,323,1179,3401
300.231,6,33,12041,15,593,21444,1408,4346,18,676,17660,2816,7695
1799.876,17,7768,372864,3889,20,462,20,186672,3879,20,463,20,186192
342.402,17,6,2016,6,308,68480,308,2016,0,0,0,0,0
1793.987,6,363,24308,211,83,8542,965,13614,152,74,11880,405,10694
0.304,17,2,152,1,48,0,48,76,1,48,0,48,76
1785.433,6,354,22440,207,69,8667,69,12420,147,69,12228,69,10020
8.018,17,12,1764,6,48,1601,48,456,6,190,1600,308,1308
0.344,17,17,7365,8,533,49,1350,4488,9,291,36,1350,2877
1796.11,6,355,22480,207,69,8718,69,12420,148,69,12217,69,10060
1.404,6,10,924,5,283,282,283,551,5,105,271,105,373
0.013,17,2,323,1,33,0,33,61,1,234,0,234,262
1683.511,17,14,1036,7,30,280582,30,406,7,62,280582,62,630
1776.673,17,140,11200,70,48,25748,48,5320,70,56,25748,56,5880
1745.454,6,94,7151,62,38,28614,205,4424,32,33,56293,98,2727
61.715,17,6,528,3,48,30850,48,228,3,72,30850,72,300
3.769,6,16,3249,9,49,471,92,563,7,463,44,1448,2686
1786.349,6,104,8376,68,65,26661,65,4930,36,59,51036,59,3446
574.582,17,8,704,4,48,191524,48,304,4,72,191524,72,400
5.612,6,15,3212,6,92,1122,92,400,9,579,649,1408,2812
3.903,1,2,257,2,100,3903,125,257,0,0,0,0,0
1797.322,6,378,26366,218,97,8282,469,15481,160,69,11302,69,10885
1740.729,6,87,6322,58,31,30539,31,3915,29,31,62168,31,2407
1.361,6,50,18966,29,864,48,1360,13305,21,437,58,2715,5661
0.007,17,2,390,1,61,0,61,89,1,273,0,273,301
106.504,6,116,84172,72,1250,1500,1408,73763,44,811,2221,3847,10409
1787.27,6,105,8416,68,65,26675,65,4930,37,59,49642,59,3486
0.091,6,10,1669,6,551,18,947,1346,4,159,30,159,323
12.287,6,2,80,1,0,0,0,40,1,0,0,0,40
12.208,6,1947,1688315,1176,1381,10,1420,1653254,771,467,15,1883,35061
1781.977,17,44,14784,44,308,41441,308,14784,0,0,0,0,0
240.308,6,35,7967,18,449,14135,1408,5428,17,205,15018,580,2539
0.487,6,119,212504,81,183,6,230,4769,38,5715,9,18304,207735
1750.617,17,12,498,11,14,175061,14,462,1,8,0,8,36
1680.538,17,12,498,11,14,168053,14,462,1,8,0,8,36
6.268,6,1330,1198460,818,1386,7,1408,1167172,512,931,11,2801,31288
1795.25,1,144,8064,144,28,12554,28,8064,0,0,0,0,0
120.294,6,23,10681,12,444,90,1023,1856,11,1196,12012,2720,8825
10.99,6,21,4486,11,275,1099,275,998,10,768,690,1440,3488
0.434,6,13,1693,7,288,71,288,588,6,426,47,434,1105
1787.723,17,324,24624,324,48,5534,48,24624,0,0,0,0,0
0.157,17,6,460,3,40,4,41,206,3,56,4,57,254
7.811,6,740,635710,457,1319,16,1368,616330,283,776,26,1473,19380
1.388,6,24,8004,12,164,107,267,1288,12,1014,109,2491,6716
0.006,17,2,330,1,30,0,30,58,1,244,0,244,272
6.017,6,576,519647,370,1338,15,1368,503855,206,776,28,2736,15792
299.521,6,7,435,4,31,99840,31,222,3,31,149756,31,213
18.5,6,30,8872,14,158,1423,267,1357,16,858,1228,2760,7515
29.309,6,18,3214,10,411,3256,585,1774,8,334,4094,580,1440
1771.202,1,58,4872,0,0,0,0,0,58,56,31073,56,4872
1794.144,1,58,4872,58,56,31476,56,4872,0,0,0,0,0
1787.758,6,102,8160,68,63,26682,63,4862,34,57,54169,57,3298
126.2,6,15,5574,9,477,15742,1024,1829,6,701,25195,1591,3745
1798.441,6,370,25839,215,99,8403,469,15154,155,69,11677,69,10685
0.5,6,21,7217,12,318,44,599,1905,9,967,61,1906,5312
2.84,6,40,21174,21,762,142,1360,6206,19,1183,149,1360,14968
369.476,6,27,1767,18,177,21733,177,1181,9,110,8803,110,586
1404.861,17,14,1117,7,31,234138,37,413,7,72,234137,136,704
3.955,6,73,44538,39,856,104,1440,11008,34,1286,115,1440,33530
33.75,6,32,5146,16,154,2250,722,1912,16,342,2236,1448,3234
1769.364,6,99,9240,66,65,27220,65,5577,33,59,55289,59,3663
0.391,6,27,9059,13,252,32,647,1704,14,945,29,1408,7355
291.897,17,4,352,2,60,291895,60,176,2,60,291896,60,176
0.016,17,5,1562,5,284,4,315,1562,0,0,0,0,0
1714.463,17,14,2716,14,166,131881,166,2716,0,0,0,0,0
1796.242,17,142,11360,71,48,25660,48,5396,71,56,25660,56,5964
380.845,6,14,1056,9,112,47604,112,824,5,0,95208,0,232
1790.613,6,376,23803,215,69,8367,69,13223,161,69,11190,69,10580
1.884,17,6,552,3,32,942,32,180,3,96,920,96,372
0.08,17,4,284,2,32,0,32,120,2,54,68,60,164
1646.092,6,308,28120,165,77,10037,267,11043,143,159,11592,2006,17077
1772.136,6,181,15589,120,69,14891,69,8940,61,69,29534,69,6649
57.858,6,35,10392,16,819,50,1360,4768,19,373,3204,2667,5624
37.13,6,27,7177,13,155,3094,267,1306,14,530,2855,3417,5871
1783.375,17,83,3480,82,14,22016,14,3444,1,8,0,8,36
0.831,6,3,151,1,0,0,0,40,2,31,1,31,111
0.497,6,21,7290,12,335,44,668,1974,9,968,61,1475,5316
0.495,6,14,2181,8,324,70,585,1061,6,396,97,580,1120
1785.894,17,87,3648,86,14,21010,14,3612,1,8,0,8,36
1743.028,6,95,7203,63,38,28113,205,4476,32,33,56216,98,2727
377.859,2,3,96,3,8,188929,8,96,0,0,0,0,0
20.161,6,21,6076,12,147,1832,318,1233,9,873,2516,1669,4843
1790.229,6,391,36104,191,308,9422,841,13932,200,61,8995,1546,22172
0.218,6,12,3705,6,171,42,171,491,6,964,42,1448,3214
86.77,6,28,13408,15,489,346,1360,3081,13,1399,7220,3928,10327
1787.482,17,73,3060,72,14,25175,14,3024,1,8,0,8,36
10.872,6,20,4442,11,275,1087,275,998,9,768,761,1440,3444
1785.189,1,138,7728,138,28,13030,28,7728,0,0,0,0,0
1755.082,1,8,448,8,28,250726,28,448,0,0,0,0,0
0.129,6,3,144,0,0,0,0,0,3,0,0,0,144
735.173,6,149,10910,73,86,10170,86,4122,76,39,9802,63,6788
601.597,2,5,160,5,8,150399,8,160,0,0,0,0,0
51.573,6,10,648,10,31,5730,31,648,0,0,0,0,0
4.204,6,9,437,6,31,840,31,283,3,34,64,34,154
284.205,6,33,7552,14,158,21861,267,1357,19,543,15787,1400,6195
1.343,6,47,18538,27,845,51,1360,12962,20,433,61,1360,5576
19.413,6,29,8561,9,121,1075,267,976,20,521,1020,1452,7585
1798.622,6,363,24414,212,88,8524,469,14027,151,69,11987,69,10387
0.027,17,2,280,1,64,0,64,92,1,160,0,160,188
4.192,6,14,3144,8,49,598,92,511,6,579,88,1448,2633
300.138,6,43,10796,23,697,13634,1440,5149,20,371,15787,1440,5647
0.123,6,11,1369,7,284,20,517,928,4,112,34,156,441
0.921,6,10,1687,7,100,153,100,384,3,1179,326,1179,1303
91.01,6,27,7931,14,211,7000,516,1619,13,723,7576,1452,6312
63.263,6,38,5670,23,154,2875,722,2334,15,364,1116,2026,3336
9.616,6,84,26957,43,562,228,1152,20835,41,447,233,1179,6122
300.877,6,45,16685,25,1005,12536,1460,11083,20,399,457,1460,5602
25.873,6,37,8493,19,401,1437,889,2020,18,441,499,1360,6473
0.339,6,26,6066,13,164,28,453,1494,13,555,26,1542,4572
1785.439,17,87,3648,86,14,21005,14,3612,1,8,0,8,36
0.014,17,2,158,1,34,0,34,62,1,68,0,68,96
1788.599,1,238,25228,238,78,7546,78,25228,0,0,0,0,0
1793.124,6,361,28631,209,117,8620,1189,15768,152,99,11873,1414,12863
1771.586,6,99,9306,66,66,27255,66,5610,33,60,55359,60,3696
15.691,6,69,20246,35,520,461,1152,15459,34,427,462,1152,4787
1.843,17,4,352,2,37,1,37,130,2,83,1,89,222
280.327,6,30,7432,13,158,23360,267,1317,17,543,17515,1300,6115
180.179,17,2,541,2,242,180179,298,541,0,0,0,0,0
11.882,6,13,2129,8,322,1697,581,1069,5,396,2957,580,1060
1796.937,1,345,28980,345,56,5223,56,28980,0,0,0,0,0
259.774,6,1705,858557,937,849,277,1152,820915,768,384,338,1179,37642
1738.543,6,87,6322,58,31,30500,31,3915,29,31,62090,31,2407
0.073,6,2,92,1,0,0,0,52,1,0,0,0,40
1740.878,6,87,6322,58,31,30541,31,3915,29,31,62173,31,2407
371.572,6,18,1239,14,177,28582,177,913,4,110,20059,110,326
39.057,6,27,11238,8,277,5572,517,1292,19,559,2167,1408,9946
7.007,17,44,21541,23,500,317,1350,12152,21,419,348,1350,9389
1401.147,17,16,4081,8,30,200163,37,471,8,423,200163,463,3610
13.008,6,2365,2198461,1508,1379,8,1408,2149233,857,931,14,2801,49228
49.167,1,4,224,4,28,16389,28,224,0,0,0,0,0
1795.555,1,59,4956,59,56,30957,56,4956,0,0,0,0,0
184.132,17,9,378,9,14,23016,14,378,0,0,0,0,0
116.853,17,4,352,2,60,116852,60,176,2,60,116852,60,176
0.086,17,2,154,1,41,0,41,69,1,57,0,57,85
0.204,6,13,3768,7,171,28,171,555,6,964,36,1448,3213
1749.555,17,12,498,11,14,174955,14,462,1,8,0,8,36
348.705,6,49,26981,30,1038,12024,1408,19247,19,748,3404,1408,7734
253.307,6,52,3322,28,76,9381,138,1810,24,69,11013,69,1512
112.43,17,4,352,2,60,112429,60,176,2,60,112429,60,176
294.402,6,70,9132,32,182,9496,585,3746,38,189,7956,580,5386
15.234,17,5,380,5,48,3808,48,380,0,0,0,0,0
0.263,6,4,263,1,31,0,31,83,3,0,131,0,180
1734.355,17,144,24426,144,141,12128,389,24426,0,0,0,0,0
18.773,17,34,7201,14,190,1441,1350,3064,20,178,986,1350,4137
8.95,6,80,24405,40,550,229,1152,18664,40,413,222,1152,5741
128.689,6,22,4512,10,407,14298,722,1354,12,316,11679,1408,3158
3.362,17,3,1176,3,364,1681,364,1176,0,0,0,0,0
8.008,6,16,9397,4,186,2663,267,541,12,929,724,1460,8856
108.163,6,36,18975,18,708,44,1360,4354,18,1068,6354,1360,14621
0.143,6,3,144,2,0,0,0,104,1,0,0,0,40
0.131,6,2,116,2,24,131,24,116,0,0,0,0,0
1720.59,17,12,498,11,14,172059,14,462,1,8,0,8,36
371.024,6,23,1535,16,177,24734,177,1053,7,110,10748,110,482
1781.555,17,73,3060,72,14,25092,14,3024,1,8,0,8,36
1781.766,6,367,25581,213,99,8404,469,15005,154,69,11645,69,10576
83.271,6,36,8491,18,410,519,882,2018,18,521,4889,2720,6473
1.568,6,49,19660,29,914,56,1360,14039,20,437,71,2715,5621
184.109,17,4,240,2,32,184108,32,120,2,32,184107,32,120
240.397,6,44,8447,22,449,11446,1418,5648,22,205,11446,580,2799
1.749,17,74,38701,40,717,44,1350,29838,34,232,46,1350,8863
1784.954,6,106,8377,69,63,26249,63,4902,37,57,49580,57,3475
172.302,6,42,16219,21,572,205,1360,4332,21,848,8606,1712,11887
27.114,17,4,240,2,32,27113,32,120,2,32,27111,32,120
20.105,2,2,64,2,8,20105,8,64,0,0,0,0,0
31.593,6,39,12128,20,633,1662,1360,4659,19,558,1745,1360,7469
1792.14,17,29,9512,29,300,64005,300,9512,0,0,0,0,0
1789.114,1,248,26288,248,78,7243,78,26288,0,0,0,0,0
37.708,17,22,1936,11,48,3769,48,836,11,72,3769,72,1100
0.071,17,2,586,1,46,0,46,74,1,484,0,484,512
0.763,6,24,5754,13,158,62,370,1315,11,799,74,1460,4439
1787.037,6,106,8456,68,65,26672,65,4930,38,59,48294,59,3526
4.112,17,5,295,5,31,1028,31,295,0,0,0,0,0
300.775,6,43,11652,24,542,13077,1408,4569,19,608,786,4942,7083
0.594,6,10,924,5,283,99,283,551,5,105,99,105,373
8.787,6,16,1402,8,275,1255,275,878,8,96,1115,96,524
10.989,6,17,4226,9,275,1373,275,918,8,992,887,1440,3308
0.143,17,2,206,1,44,0,44,72,1,106,0,106,134
99.544,6,67,44822,43,1153,2370,1408,36840,24,960,2675,3847,7982
1745.271,6,95,7203,63,38,28149,205,4476,32,33,56293,98,2727
0.404,17,2,152,1,48,0,48,76,1,48,0,48,76
1685.0,2,12,384,12,8,153181,8,384,0,0,0,0,0
2.109,6,32,11973,19,513,117,1460,3382,13,805,144,2361,8591
318.071,6,67,16784,37,306,8835,1360,7650,30,495,10963,4658,9134
1799.07,6,167,13894,90,85,20214,264,8397,77,60,23667,224,5497
150.888,6,18379,17733902,12359,1357,12,1408,17416198,6020,931,25,2801,317704
1.526,6,46,18121,26,882,61,1460,12545,20,433,70,1460,5576
8.341,6,1027,883809,599,1394,13,1448,856889,428,776,19,1448,26920
33.584,6,29,5024,15,154,2398,721,1893,14,479,2568,2026,3131
1792.176,1,58,4872,58,56,31441,56,4872,0,0,0,0,0
1772.466,6,180,15480,120,69,14894,69,8940,60,69,30033,69,6540
1795.158,1,256,14336,256,28,7039,28,14336,0,0,0,0,0
0.024,17,2,214,1,39,0,39,67,1,119,0,119,147
1788.829,17,488,60752,237,160,7579,1350,44768,251,35,7155,1350,15984
4.156,6,39,7269,20,218,218,314,3423,19,513,216,1179,3846
1.356,6,11,1727,7,100,226,100,384,4,589,365,1152,1343
528.944,1,16,896,16,28,35262,28,896,0,0,0,0,0
92.672,6,678,336981,373,838,249,1071,321673,305,517,304,1152,15308
1748.223,2,29,928,29,8,62436,8,928,0,0,0,0,0
0.022,6,2,131,1,0,0,0,40,1,51,0,51,91
240.263,6,50,17803,26,852,9610,1418,14994,24,221,10445,580,2809
7.38,6,24,9522,12,275,670,275,771,12,1375,643,1420,8751
755.715,2,7,224,7,8,125952,8,224,0,0,0,0,0
1466.36,6,111,10976,62,62,24036,722,5103,49,87,30545,1402,5873
462.772,17,38,3040,19,48,25709,48,1444,19,56,25708,56,1596
6.087,17,4,1172,2,46,6009,46,148,2,484,5989,484,1024
12.481,6,27,8557,14,275,960,275,1118,13,986,914,1440,7439
2.906,17,4,624,4,128,968,128,624,0,0,0,0,0
1772.641,6,180,15480,120,69,14896,69,8940,60,69,30036,69,6540
300.229,6,32,15422,20,974,15801,1402,9822,12,828,3185,1503,5600
0.042,17,8,2454,8,278,6,317,2454,0,0,0,0,0
0.117,17,2,2382,2,1163,117,1163,2382,0,0,0,0,0
280.489,6,30,7432,13,158,23374,267,1317,17,603,17528,2076,6115
316.986,6,107,35843,58,511,5561,1360,24854,49,310,6601,1929,10989
167.123,17,15,1140,15,48,11937,48,1140,0,0,0,0,0
1787.395,6,102,8296,68,65,26677,65,4930,34,59,54159,59,3366
0.919,6,10,1687,7,100,153,100,384,3,1179,331,1179,1303
0.01,17,2,672,2,308,10,308,672,0,0,0,0,0
0.043,6,2,1440,1,0,0,0,40,1,1360,0,1360,1400
1795.41,17,447,39352,402,35,4477,288,25380,45,282,40015,288,13972
0.309,17,119,108639,43,147,7,1350,7532,76,1302,3,1350,101107
1680.445,17,28,29568,28,1028,62238,1028,29568,0,0,0,0,0
205.644,17,4,352,2,60,205643,60,176,2,60,205643,60,176
1792.933,1,58,4872,58,56,31454,56,4872,0,0,0,0,0
20.147,6,20,5366,12,107,1831,159,1074,8,967,2876,2816,4292
0.199,17,2,640,2,292,199,292,640,0,0,0,0,0
1796.007,17,444,39200,400,35,4501,288,25296,44,288,40952,288,13904
0.002,17,4,368,2,64,0,64,184,2,64,1,64,184
1.337,6,29,6038,16,138,89,267,1613,13,650,98,1452,4425
0.965,17,3,215,2,33,895,33,122,1,65,0,65,93
317.926,6,46,8122,21,134,14894,516,2056,25,253,13242,1452,6066
0.976,17,4,240,2,32,975,32,120,2,32,975,32,120
1773.096,6,180,15480,120,69,14899,69,8940,60,69,30050,69,6540
1740.465,6,100,7256,64,31,27626,31,4356,36,31,49727,31,2900
1746.923,6,94,7151,62,38,28638,205,4424,32,33,56339,98,2727
1742.55,6,95,7203,63,38,28105,205,4476,32,33,56203,98,2727
1786.176,17,142,11360,71,48,25516,48,5396,71,56,25516,56,5964
1790.615,1,179,10024,179,28,10059,28,10024,0,0,0,0,0
300.878,6,38,8462,20,286,15828,797,1988,18,478,17690,2720,6474
0.052,6,2,92,1,0,0,0,52,1,0,0,0,40
57.695,6,8,5063,3,100,28847,100,224,5,1158,14355,1179,4839
3.786,6,30,8340,14,164,275,267,1400,16,869,239,1368,6940
0.258,17,3,451,2,39,173,39,134,1,289,0,289,317
124.888,17,7,2474,7,325,20814,548,2474,0,0,0,0,0
1.01,17,2,677,1,300,0,300,328,1,321,0,321,349
0.053,6,29,7835,17,131,3,131,1023,12,618,4,1000,6812
0.613,6,10,924,5,283,103,283,551,5,105,103,105,373
1680.779,17,12,498,11,14,168077,14,462,1,8,0,8,36
9.087,6,885,763013,539,1337,16,1368,738341,346,776,25,1473,24672
0.038,17,2,912,1,308,0,308,336,1,548,0,548,576
51.813,17,4,240,2,32,51812,32,120,2,32,51812,32,120
1.618,6,47,19237,27,896,62,1360,13661,20,433,75,1360,5576
1772.226,6,181,15589,120,69,14892,69,8940,61,69,29534,69,6649
122.145,17,5,1672,5,306,30536,308,1672,0,0,0,0,0
6.159,6,165,137465,103,907,60,1360,15530,62,2296,91,10880,121935
0.772,6,15,2217,7,336,128,740,1308,8,192,84,374,909
330.6,6,36,3096,24,69,14373,69,1788,12,69,30035,69,1308
1742.394,6,114,11172,72,93,24540,205,7656,42,31,42490,33,3516
1798.08,6,100,6484,64,47,28540,208,4114,36,31,51360,31,2370
1769.017,1,65,7432,65,86,27640,173,7432,0,0,0,0,0
34.138,6,31,5093,15,154,2438,722,1858,16,342,2263,1448,3235
2.289,6,14,2351,8,188,327,245,700,6,703,405,1152,1651
261.249,17,4,352,2,60,261247,60,176,2,60,261247,60,176
1795.346,1,110,11660,110,78,16471,78,11660,0,0,0,0,0
11.016,6,13,5848,3,106,5508,106,234,10,650,1200,1460,5614
1789.956,6,356,22589,207,69,8689,69,12420,149,69,12094,69,10169
1744.669,2,16,512,16,8,116311,8,512,0,0,0,0,0
369.919,6,23,1535,16,177,24661,177,1053,7,110,10384,110,482
1781.479,6,181,15589,121,69,14845,69,9049,60,69,30187,69,6540
0.078,17,2,642,1,300,0,300,328,1,286,0,286,314
0.469,6,25,6082,13,108,39,147,959,12,773,40,1608,5123
300.791,6,39,9823,21,571,15039,1360,4301,18,399,506,1360,5522
11.333,6,1755,1566565,1108,1363,10,1380,1536443,647,421,17,1923,30122
11.498,6,6,364,0,0,0,0,0,6,31,2299,31,364
1742.573,6,99,7411,63,38,28106,205,4476,36,33,49782,98,2935
1786.992,6,102,8296,68,65,26671,65,4930,34,59,54148,59,3366
0.227,6,35,10116,19,297,12,517,2029,16,619,14,1871,8087
0.051,6,10,1514,5,503,12,503,771,5,475,12,475,743
280.455,6,30,7432,13,158,23371,267,1317,17,603,17525,2760,6115
6.239,2,2,64,2,8,6239,8,64,0,0,0,0,0
1798.113,17,465,139640,465,272,3875,422,139640,0,0,0,0,0
1772.236,6,180,15480,120,69,14892,69,8940,60,69,30032,69,6540
41.084,6,25,5219,6,341,8216,722,1332,19,206,2271,1408,3887
71.163,6,73,49326,46,1166,1581,1408,39779,27,903,2371,2816,9547
1750.715,17,12,498,11,14,175071,14,462,1,8,0,8,36
16.124,6,7,304,2,0,16124,0,84,5,0,3852,0,220
0.178,17,2,2732,2,1338,178,1338,2732,0,0,0,0,0
1776.846,17,140,11200,70,48,25750,48,5320,70,56,25750,56,5880
8.221,17,3,228,3,48,4110,48,228,0,0,0,0,0
0.341,6,9,1021,4,188,7,245,540,5,277,85,277,481
280.432,6,28,7352,13,158,23369,267,1317,15,603,20027,2760,6035
259.864,17,45,53046,45,1150,5906,1451,53046,0,0,0,0,0
64.033,6,4,270,4,31,21344,31,270,0,0,0,0,0
3.94,17,5,295,5,31,985,31,295,0,0,0,0,0
1786.742,6,102,8228,68,64,26667,64,4896,34,58,54139,58,3332
1753.158,6,183,11234,92,47,19265,208,6695,91,31,19476,31,4539
369.929,6,27,1767,18,177,21760,177,1181,9,110,8940,110,586
1741.28,6,91,6604,59,31,30022,31,3998,32,31,56168,31,2606
15.112,6,2610,2432471,1678,1371,8,1408,2379343,932,931,16,2801,53128
1772.166,6,180,15480,120,69,14892,69,8940,60,69,30030,69,6540
280.292,6,29,7392,13,158,23357,267,1317,16,603,18684,2036,6075
18.969,6,3073,2919360,1963,1408,9,1448,2856976,1110,776,16,1448,62384
1747.291,6,97,7307,63,38,28182,205,4476,34,33,52936,98,2831
0.043,17,2,157,1,31,0,31,59,1,70,0,70,98
8.97,6,80,24725,41,560,224,1152,19008,39,461,229,1179,5717
1762.953,6,185,11137,93,45,19162,208,6558,92,31,19370,31,4579
1785.871,6,107,9035,70,71,25882,292,5302,37,64,49605,247,3733
36.586,6,2210,1929124,1343,1375,27,1380,1883630,867,468,42,3303,45494
197.348,6,28,7352,13,158,16445,267,1317,15,678,14094,2045,6035
1789.948,6,355,22480,207,69,8689,69,12420,148,69,12176,69,10060
1755.964,6,104,6218,60,27,29761,27,3525,44,27,40835,27,2693
255.381,6,10,562,3,106,127688,106,234,7,0,42561,0,328
0.848,17,3,1167,3,361,424,361,1167,0,0,0,0,0
4.576,6,23,4490,12,213,416,597,1689,11,552,436,1767,2801
12.021,17,16,2720,8,33,1716,33,488,8,251,1716,323,2232
11.895,6,24,6896,6,154,2379,267,712,18,419,674,1460,6184
1.402,6,60,18415,29,707,50,1360,8989,31,430,46,1360,9426
1793.823,17,19,6273,19,302,99656,1438,6273,0,0,0,0,0
3.999,17,3,222,3,46,1999,46,222,0,0,0,0,0
37.675,6,71,18808,37,336,39,1360,9973,34,392,1137,1360,8835
0.536,6,2,131,0,0,0,0,0,2,51,536,51,131
1786.504,6,104,8444,68,66,26664,66,4964,36,60,51040,60,3480
155.209,2,4,128,4,8,51736,8,128,0,0,0,0,0
0.005,17,2,146,1,37,0,37,65,1,53,0,53,81
170.793,6,62,16224,32,634,5509,1368,13197,30,207,5888,580,3027
1780.294,17,136,10880,68,48,26571,48,5168,68,56,26571,56,5712
0.355,6,27,9043,13,252,29,647,1692,14,945,26,1408,7351
294.8,6,35,8046,12,158,25473,267,1277,23,365,13399,1400,6769
1747.773,6,95,7203,63,38,28189,205,4476,32,33,56369,98,2727
1799.984,6,152,15937,83,71,21951,721,6603,69,149,25563,2840,9334
10.82,6,1718,1496662,1018,1416,10,1432,1464429,700,420,15,1432,32233
300.868,6,24,9724,14,297,23132,844,1783,10,1505,33414,4477,7941
190.5,6,7,524,4,106,63500,106,380,3,0,1520,0,144
0.129,17,2,396,1,39,0,39,67,1,301,0,301,329
1.777,6,70,51934,45,1240,40,1408,43321,25,1043,66,2816,8613
288.248,1,4,326,4,53,96082,78,326,0,0,0,0,0
1792.881,17,180,11520,180,36,10016,36,11520,0,0,0,0,0
369.587,6,19,1294,14,180,28429,180,916,5,110,15045,110,378
1749.258,6,95,7203,63,38,28213,205,4476,32,33,56418,98,2727
5.643,6,41,11839,18,158,331,416,1580,23,846,237,1440,10259
1798.445,6,365,25032,213,94,8483,469,14536,152,69,11909,69,10496
0.05,1,2,163,2,53,50,78,163,0,0,0,0,0
1792.678,1,243,13608,243,28,7407,28,13608,0,0,0,0,0
0.436,6,7,1256,4,509,145,509,689,3,435,108,435,567
0.012,17,2,383,1,39,0,39,67,1,288,0,288,316
10.747,6,17,4186,10,275,1194,275,958,7,1468,994,2840,3228
1799.882,6,366,25472,212,100,8530,469,14896,154,69,11763,69,10576
1.26,6,4,184,2,0,1260,0,88,2,0,1024,0,96
430.753,17,23,1472,23,36,19579,36,1472,0,0,0,0,0
326.291,6,268,221356,175,1300,1875,1408,204235,93,646,1727,3847,17121
12.924,6,22,8669,11,215,1292,517,1249,11,1138,1291,1408,7420
1764.529,1,61,5124,0,0,0,0,0,61,56,29408,56,5124
1681.283,1,15,840,15,28,120091,28,840,0,0,0,0,0
271.339,17,4,352,2,60,271338,60,176,2,60,271338,60,176
0.51,6,11,901,6,222,98,222,466,5,231,123,231,435
1770.285,6,101,9344,66,65,27235,65,5577,35,59,52064,59,3767
31.996,6,126,79649,60,182,542,237,3541,66,1204,127,2119,76108
1740.747,17,30,31680,30,1028,60025,1028,31680,0,0,0,0,0
1798.169,6,1460,2308628,598,126,3011,331,39341,862,2826,2088,11216,2269287
0.575,6,14,1745,7,288,67,288,600,7,426,66,434,1145
7.0,6,14,1247,7,222,1165,222,728,7,231,1165,231,519
0.36,17,8,2742,8,314,51,353,2742,0,0,0,0,0
0.677,17,14,6530,6,541,122,1350,3414,8,361,88,1350,3116
1.482,6,38,8254,19,321,82,1164,2718,19,433,71,1360,5536
16.463,17,4,352,2,60,16462,60,176,2,60,16462,60,176
1.483,6,50,18833,28,920,54,1460,13132,22,400,62,1460,5701
56.516,6,38,8364,18,352,519,743,1810,20,441,2967,1460,6554
208.105,6,30,7432,13,158,17342,267,1317,17,543,13005,1400,6115
1741.375,6,87,6322,58,31,30550,31,3915,29,31,62185,31,2407
85.681,6,45,8871,22,363,459,774,2073,23,366,3888,2128,6798
1799.992,17,3536,169728,1760,20,1022,20,84480,1776,20,1013,20,85248
0.36,6,12,1653,6,288,65,288,548,6,426,40,434,1105
40.347,17,4,824,2,48,40340,48,152,2,308,40341,308,672
1.07,17,4,377,2,33,1020,37,123,2,99,1025,136,254
1745.225,6,95,7203,63,38,28148,205,4476,32,33,56290,98,2727
7.198,6,67,20166,35,540,211,1152,15459,32,489,223,1179,4707
4.038,17,7,7079,2,723,4038,1350,1503,5,1087,580,1350,5576
1794.041,17,144,11520,72,48,25268,48,5472,72,56,25268,56,6048
54.789,6,40,8627,18,371,569,766,1901,22,364,2603,1360,6726
1784.927,17,138,11040,69,48,26248,48,5244,69,56,26248,56,5796
371.409,6,25,1651,17,177,23213,177,1117,8,110,9222,110,534
1.325,6,54,21443,30,961,45,1460,15662,24,400,49,1460,5781
1.125,17,8,672,4,34,373,34,248,4,78,372,84,424
1740.563,17,30,7050,30,207,60019,207,7050,0,0,0,0,0
1.427,6,48,19466,27,909,54,1460,13850,21,433,62,1460,5616
1.629,6,52,19244,28,946,60,1460,13463,24,400,60,1460,5781
31.54,6,7,308,1,0,0,0,44,6,0,6289,0,264
1648.029,6,318,23483,189,102,8766,469,14528,129,69,12875,69,8955
0.91,6,11,1727,7,100,151,100,384,4,589,215,1152,1343
8.156,17,4,272,2,32,8144,32,120,2,48,8138,48,152
1.007,17,5,760,3,32,500,32,180,2,262,8,278,580
8.16,1,9,756,0,0,0,0,0,9,56,1020,56,756
11.674,6,1850,1612380,1120,1385,10,1420,1578959,730,526,16,3303,33421
2.378,6,20,3356,10,187,236,293,1341,10,402,236,1152,2015
16.425,6,10,2221,8,211,2346,267,958,2,1179,248,1179,1263
1786.762,17,87,3648,86,14,21020,14,3612,1,8,0,8,36
1785.757,1,136,11424,136,56,13227,56,11424,0,0,0,0,0
0.232,17,2,2384,2,1164,232,1164,2384,0,0,0,0,0
317.029,6,84,20180,39,360,8342,1360,9893,45,273,7202,4649,10287
66.218,6,24,10342,13,825,5518,1448,4810,11,707,6603,1448,5532
1784.551,6,368,23345,213,69,8417,69,12936,155,69,11587,69,10409
6.479,6,30,8872,14,158,498,267,1357,16,858,422,2085,7515
378.006,2,3,96,3,8,189003,8,96,0,0,0,0,0
1.715,6,28,8997,17,368,107,837,1789,11,966,163,1420,7208
1794.257,1,168,9408,168,28,10744,28,9408,0,0,0,0,0
0.015,17,2,194,1,61,0,61,89,1,77,0,77,105
8.877,6,40,25448,26,1058,355,1368,19352,14,1072,664,2519,6096
0.673,6,11,976,5,283,116,283,551,6,105,92,105,425
1799.681,17,768,46308,768,32,2346,37,46308,0,0,0,0,0
2.397,6,6,340,3,0,1107,0,164,3,0,1106,0,176
1791.185,17,386,52842,182,187,9896,1350,39278,204,38,8821,1350,13564
1665.532,6,325,21266,183,76,8788,469,11446,142,69,11812,69,9820
371.291,6,18,1239,14,177,28560,177,913,4,110,21117,110,326
0.209,6,10,584,5,44,52,44,312,5,0,50,0,272
158.317,17,10,3360,10,308,17590,308,3360,0,0,0,0,0
285.664,6,23,1612,12,321,25969,321,953,11,83,28566,83,659
0.104,17,4,284,2,32,50,32,120,2,54,55,60,164
1771.045,6,99,9240,66,65,27246,65,5577,33,59,55341,59,3663
74.491,6,26,14092,13,286,56,549,1423,13,1348,6197,2720,12669
55.381,6,35,8463,18,410,518,882,2030,17,521,3451,3488,6433
1795.861,17,449,39928,404,35,4456,288,25708,45,288,40020,288,14220
6.434,6,65,21003,35,575,189,1152,16376,30,489,213,1179,4627
240.221,6,54,17899,29,791,8579,1408,14970,25,202,10009,580,2929
5.531,6,18,3584,9,105,691,182,910,9,437,668,1343,2674
1748.609,1,58,4872,58,56,30677,56,4872,0,0,0,0,0
1770.192,6,99,9240,66,65,27233,65,5577,33,59,55315,59,3663
378.084,2,3,96,3,8,189042,8,96,0,0,0,0,0
1796.162,1,279,29574,279,78,6461,78,29574,0,0,0,0,0
630.311,2,6,192,6,8,126062,8,192,0,0,0,0,0
6.988,6,67,20470,33,552,218,1152,15683,34,489,203,1179,4787
3.34,6,11,1727,7,100,556,100,384,4,1179,1027,1179,1343
1.995,1,3,252,3,56,997,56,252,0,0,0,0,0
1791.97,6,356,22520,208,69,8656,69,12460,148,69,12190,69,10060
0.73,6,6,544,1,0,0,0,40,5,152,131,152,504
4.877,6,16,3270,6,92,975,92,400,10,579,495,1408,2870
1766.542,17,114,21686,114,162,15633,422,21686,0,0,0,0,0
1.904,17,3,1173,3,363,952,363,1173,0,0,0,0,0
240.208,6,55,18897,30,807,8282,1408,16100,25,186,10008,580,2797
192.726,17,9,2968,9,301,24090,308,2968,0,0,0,0,0
1720.514,17,12,498,11,14,172051,14,462,1,8,0,8,36
1.504,6,7,1567,4,100,501,100,264,3,1179,618,1179,1303
0.064,17,2,152,1,48,0,48,76,1,48,0,48,76
1756.166,6,95,7203,63,38,28325,205,4476,32,33,56640,98,2727
0.046,17,4,284,2,32,40,32,120,2,54,40,60,164
1799.854,1,64,5376,64,56,28569,56,5376,0,0,0,0,0
27.537,6,21,11892,5,124,6884,126,480,16,1076,1826,1929,11412
240.286,6,43,8907,21,523,12014,1408,5811,22,216,11442,618,3096
64.123,6,48,10415,23,533,612,910,3147,25,329,2666,2128,7268
0.107,17,4,588,2,48,97,48,152,2,190,97,308,436
0.093,6,6,328,4,0,31,0,216,2,0,39,0,112
10.113,6,951,751339,463,287,21,287,29643,488,1432,20,2736,721696
19.321,6,25,6757,12,181,1756,267,1212,13,717,1607,2036,5545
0.098,6,4,208,0,0,0,0,0,4,0,0,0,208
1789.469,6,416,24920,208,69,8644,69,12460,208,34,8644,64,12460
117.494,6,59,14829,29,401,549,889,2540,30,527,4046,1360,12289
240.178,6,53,17752,28,781,8895,1402,14751,25,211,10007,580,3001
0.853,6,19,9056,11,499,85,1193,1971,8,1350,89,2720,7085
1772.38,6,174,14964,116,69,15412,69,8642,58,69,31091,69,6322
240.21,17,4,240,2,32,240209,32,120,2,32,240208,32,120
110.024,17,25,1090,24,13,4783,58,1006,1,56,0,56,84
55.176,6,32,7765,11,155,10,267,1226,21,334,2758,1997,6539
0.017,17,3,244,2,32,0,32,120,1,96,0,96,124
280.25,6,29,7392,13,158,23354,267,1317,16,603,18680,1400,6075
847.843,6,51,3935,30,46,29229,205,2264,21,35,42382,98,1671
73.324,17,20,1760,10,48,8146,48,760,10,72,8146,72,1000
18.666,6,3192,3001396,2066,1374,8,1408,2938180,1126,931,16,2816,63216
1744.824,6,97,7307,63,38,28142,205,4476,34,33,52860,98,2831
5.022,17,4,288,2,36,4990,36,128,2,52,4990,52,160
0.268,6,25,8861,13,242,22,610,1655,12,1095,23,2816,7206
239.029,17,61,3389,29,25,8400,32,1565,32,29,7667,40,1824
11.013,17,8,704,4,48,3668,48,304,4,72,3667,72,400
0.523,6,27,9120,13,261,43,683,1728,14,950,39,2816,7392
428.546,17,158,6360,77,12,5638,16,3104,81,12,5351,16,3256
35.768,1,4,224,4,28,11922,28,224,0,0,0,0,0
0.296,17,2,167,1,39,0,39,67,1,72,0,72,100
0.506,17,3,451,2,39,414,39,134,1,289,0,289,317
225.696,17,4,240,2,32,225695,32,120,2,32,225694,32,120
0.06,17,2,160,1,48,0,48,76,1,56,0,56,84
1679.571,17,12,498,11,14,167957,14,462,1,8,0,8,36
8.991,6,4,240,3,0,4495,0,180,1,0,0,0,60
0.005,17,2,413,1,53,0,53,81,1,304,0,304,332
373.674,6,25,1651,17,177,23354,177,1117,8,110,9234,110,534
0.344,6,20,4960,10,137,38,267,1092,10,692,36,1467,3868
1772.234,6,180,15480,120,69,14892,69,8940,60,69,30035,69,6540
1772.022,6,180,15480,120,69,14890,69,8940,60,69,30032,69,6540
1796.663,17,415,29184,404,35,4458,288,25708,11,288,40023,288,3476
1.397,6,24,8004,12,164,108,267,1288,12,1014,108,2491,6716
1.894,17,4,252,3,31,946,31,177,1,47,0,47,75
0.108,1,10,840,10,56,12,56,840,0,0,0,0,0
1.692,6,14,2351,8,188,241,245,700,6,703,286,1152,1651
0.207,6,10,2115,6,597,41,1034,1438,4,513,31,513,677
33.398,6,30,5101,15,180,2385,722,1872,15,349,2372,2026,3229
20.793,6,13,2259,5,275,5198,275,479,8,1440,2539,1440,1780
11.856,6,25,8473,13,275,988,275,1078,12,986,857,1440,7395
127.464,17,4,304,2,48,127447,48,152,2,48,127447,48,152
105.433,6,24,11210,13,622,46,1360,3698,11,1176,10531,2720,7512
1.339,6,49,18213,28,876,49,1440,12552,21,400,57,1440,5661
668.965,1,60,3360,60,28,11338,28,3360,0,0,0,0,0
19.592,6,18,5990,9,145,2449,145,650,9,830,2422,830,5340
1776.882,17,73,3060,72,14,25026,14,3024,1,8,0,8,36
1793.119,17,140,11200,70,48,25987,48,5320,70,56,25987,56,5880
8.066,6,1264,1106620,785,1362,10,1380,1082990,479,468,16,3303,23630
42.186,17,4,240,2,32,42185,32,120,2,32,42185,32,120
161.576,17,4,352,2,60,161575,60,176,2,60,161575,60,176
1.299,6,44,21440,25,1074,54,1460,15018,19,627,61,1460,6422
1.242,6,42,11418,22,547,59,1360,5842,20,476,56,2715,5576
1797.185,6,356,22520,208,69,8682,69,12460,148,69,12225,69,10060
18.303,6,2791,2664385,1848,1365,9,1408,2610685,943,776,19,1408,53700
6.701,6,940,874767,626,1358,10,1380,857965,314,421,21,1923,16802
0.637,6,22,7300,13,325,53,626,1984,9,1210,75,1946,5316
1766.549,1,87,4872,87,28,20541,28,4872,0,0,0,0,0
0.054,6,2,92,1,0,0,0,52,1,0,0,0,40
37.529,17,18,740,8,13,5360,16,332,10,12,4154,16,408
0.575,17,20,13458,9,568,71,1350,5365,11,707,46,1350,8093
144.661,6,32,8952,14,158,11127,267,1357,18,687,8502,1781,7595
0.941,6,27,8420,14,266,61,540,1924,13,994,64,1791,6496
3.806,17,5,738,4,32,1262,32,240,1,470,0,470,498
1681.927,17,14,1036,7,30,280304,30,406,7,62,280312,62,630
1781.016,6,359,23854,208,81,8603,469,13398,151,69,11873,69,10456
2.046,6,50,19865,27,932,78,1460,14169,23,433,80,1460,5696
4.769,6,39,7269,19,218,264,314,3383,20,513,235,1179,3886
912.002,6,114,8592,43,68,21000,310,4061,71,48,13028,78,4531
1.216,6,26,9564,13,164,86,267,1388,13,1070,86,2816,8176
0.134,6,4,160,2,0,134,0,80,2,0,0,0,80
1.195,17,2,1430,2,687,1195,687,1430,0,0,0,0,0
371.578,6,23,1535,16,177,24771,177,1053,7,110,10383,110,482
1748.684,6,97,7307,63,38,28204,205,4476,34,33,52981,98,2831
56.207,6,15,2237,8,324,8029,585,1073,7,396,9329,580,1164
0.487,17,3,451,2,39,263,39,134,1,289,0,289,317
1787.642,6,104,8308,68,64,26681,64,4896,36,58,51071,58,3412
12.751,6,25,4653,13,204,1048,722,1708,12,579,1144,1408,2945
4.573,6,38,7229,19,218,254,314,3383,19,513,239,1179,3846
0.043,17,2,212,1,46,0,46,74,1,110,0,110,138
0.011,17,4,680,2,33,6,33,122,2,251,6,323,558
11.788,17,8,704,4,48,3925,48,304,4,72,3925,72,400
11.903,6,1891,1645487,1144,1384,10,1420,1611386,747,467,15,1883,34101
47.719,6,519,460374,219,153,217,230,12479,300,1455,159,2896,447895
1.385,6,48,15866,26,822,55,1460,10165,22,437,56,2615,5701
1799.237,6,369,25937,213,99,8486,469,15005,156,69,11605,69,10932
0.006,17,2,389,1,35,0,35,63,1,298,0,298,326
1740.821,17,30,20190,30,645,60028,645,20190,0,0,0,0,0
16.74,6,25,4654,14,275,1287,275,1122,11,768,1196,1440,3532
1789.884,17,140,11200,70,48,25940,48,5320,70,56,25940,56,5880
0.959,6,35,8212,19,241,53,619,1818,16,574,53,4848,6394
1786.113,6,365,23156,212,69,8464,69,12689,153,69,11749,69,10467
240.479,6,58,24311,26,548,9618,1418,6295,32,860,7757,1418,18016
0.024,17,2,664,1,308,0,308,336,1,300,0,300,328
41.531,6,43,13226,20,181,2183,267,2256,23,772,1887,3436,10970
1795.664,17,449,39928,404,35,4455,288,25708,45,288,40016,288,14220
5.78,6,40,7309,21,218,289,314,3463,19,513,306,1179,3846
0.935,6,10,1687,7,100,155,100,384,3,1179,333,1179,1303
1.485,6,14,2351,8,188,212,245,700,6,703,248,1152,1651
1779.933,17,140,11200,70,48,25796,48,5320,70,56,25796,56,5880
0.274,2,2,64,2,8,274,8,64,0,0,0,0,0
1798.645,6,367,25650,214,99,8444,469,15045,153,69,11830,69,10605
1771.189,6,114,10608,73,66,24599,66,6220,41,60,44277,60,4388
0.104,6,11,2017,7,324,17,585,1009,4,396,30,580,1008
301.674,6,68,46516,44,1168,7015,1408,38534,24,960,2678,3847,7982
96.815,6,23,10250,13,579,50,1360,2871,10,1393,10743,2720,7379
143.17,6,23,9705,11,380,73,832,1613,12,950,13003,1460,8092
0.358,6,5,260,2,0,115,0,104,3,0,140,0,156
1.062,17,11,5464,5,656,248,1350,3422,6,312,198,1350,2042
0.051,17,4,284,2,32,26,32,120,2,54,28,60,164
369.552,6,18,1242,14,180,28427,180,916,4,110,20057,110,326
1772.327,6,180,15480,120,69,14893,69,8940,60,69,30037,69,6540
69.094,6,27,7177,12,155,6281,267,1266,15,482,4934,1420,5911
134.609,6,770,355457,391,833,345,1152,334110,379,386,355,1152,21347
0.402,17,4,368,2,32,328,32,120,2,96,303,96,248
1.032,17,2,456,1,60,0,60,88,1,340,0,340,368
1796.701,17,234,56503,234,213,7711,422,56503,0,0,0,0,0
1767.166,17,323,85771,323,237,5488,422,85771,0,0,0,0,0
374.808,6,18,1242,14,180,28831,180,916,4,110,20073,110,326
1786.698,17,87,3648,86,14,21019,14,3612,1,8,0,8,36
11.034,6,22,4474,12,275,1003,275,1038,10,755,694,1414,3436
1770.074,6,101,9344,66,65,27231,65,5577,35,59,52058,59,3767
19.682,17,6,456,6,48,3936,48,456,0,0,0,0,0
0.36,17,4,288,2,36,327,36,128,2,52,328,52,160
1796.566,6,355,22480,207,69,8721,69,12420,148,69,12221,69,10060
0.334,17,2,304,1,60,0,60,88,1,188,0,188,216
1798.016,1,345,28980,345,56,5226,56,28980,0,0,0,0,0
280.196,17,4,1098,2,30,280191,30,116,2,463,280191,463,982
1797.343,6,366,25679,213,99,8478,469,15005,153,69,11822,69,10674
1748.348,6,130,12777,77,62,23004,722,6351,53,87,33614,1408,6426
1781.864,6,104,8444,68,66,26594,66,4964,36,60,50907,60,3480
1.29,6,54,22101,30,1005,44,1460,16320,24,400,48,1460,5781
37.673,6,172,133783,86,158,443,264,4106,86,1597,441,8160,129677
0.056,17,3,208,2,36,2,36,128,1,52,0,52,80
1799.883,17,6652,319296,3326,20,541,20,159648,3326,20,541,20,159648
299.543,6,6,364,4,31,99847,31,222,2,31,299533,31,142
318.058,6,63,18487,34,369,9638,1360,9530,29,457,11353,1360,8957
1772.506,6,180,15480,120,69,14895,69,8940,60,69,30037,69,6540
245.966,17,4,240,2,32,245965,32,120,2,32,245965,32,120
5.264,6,11,2070,8,241,752,241,1766,3,92,112,92,304
0.874,17,2,586,1,46,0,46,74,1,484,0,484,512
169.242,6,15,997,9,31,21135,31,561,6,31,33817,31,436
2.213,6,56,24616,31,971,73,1360,18764,25,476,84,2715,5852
31.645,6,37,8201,18,311,876,619,1687,19,441,1750,1440,6514
1.095,1,10,280,10,0,0,0,280,0,0,0,0,0
21.389,17,40,18779,17,388,1334,1350,7085,23,480,970,1350,11694
110.686,6,35,8417,11,155,188,267,1226,24,327,4811,1997,7191
1.072,6,28,8460,15,222,63,540,1964,13,994,72,1791,6496
277.94,1,4,224,4,28,92646,28,224,0,0,0,0,0
1782.302,17,140,11200,70,48,25830,48,5320,70,56,25830,56,5880
234.312,17,4,240,2,32,234311,32,120,2,32,234311,32,120
11.484,6,28,11413,14,275,883,275,1118,14,1080,848,1420,10295
1790.425,6,197,25253,109,304,16577,304,17336,88,83,20579,83,7917
505.284,1,16,896,16,28,33685,28,896,0,0,0,0,0
1.298,17,2,178,1,29,0,29,57,1,93,0,93,121
1785.175,17,142,11360,71,48,25501,48,5396,71,56,25501,56,5964
8.173,6,26,7748,13,256,681,721,1806,13,774,529,1420,5942
0.186,17,2,157,1,31,0,31,59,1,70,0,70,98
1797.624,17,449,39928,404,35,4460,288,25708,45,288,40019,288,14220
0.365,6,12,3462,6,75,72,75,395,6,1373,73,1448,3067
1788.882,6,460,26680,252,69,7127,69,14220,208,34,8641,64,12460
0.005,17,2,206,1,29,0,29,57,1,121,0,121,149
1.575,6,47,19894,28,880,58,1360,14358,19,529,75,4075,5536
63.78,6,37,10233,19,783,492,1360,4711,18,435,3741,2667,5522
76.427,6,44,9878,22,450,614,766,2761,22,389,3632,4848,7117
53.2,6,10,648,10,31,5911,31,648,0,0,0,0,0
1786.605,6,147,25558,88,346,20535,1302,18748,59,101,30802,241,6810
0.167,17,2,221,1,35,0,35,63,1,130,0,130,158
291.826,6,36,8656,17,326,18236,517,2209,19,778,16210,1418,6447
0.402,17,5,1757,5,323,100,354,1757,0,0,0,0,0
1797.005,17,448,39896,403,35,4470,288,25676,45,288,40021,288,14220
0.775,17,25,17787,14,1049,59,1350,15086,11,217,74,1350,2701
281.83,6,30,7432,13,158,23485,267,1317,17,543,17593,1400,6115
122.493,6,12,2271,7,188,20415,245,660,5,1407,30561,1407,1611
0.706,17,2,685,1,308,0,308,336,1,321,0,321,349
1736.127,1,8,448,8,28,248018,28,448,0,0,0,0,0
1777.468,1,60,5040,60,56,30126,56,5040,0,0,0,0,0
255.479,17,4,240,2,32,255478,32,120,2,32,255478,32,120
3.115,17,2,134,2,39,3115,39,134,0,0,0,0,0
125.398,17,4,558,2,36,125388,36,128,2,187,125384,187,430
1781.762,6,394,24088,209,69,8566,69,12500,185,43,9683,69,11588
1798.302,6,370,25908,214,99,8442,469,15114,156,69,11601,69,10794
1740.652,17,30,31680,30,1028,60022,1028,31680,0,0,0,0,0
1681.302,17,14,1036,7,30,280214,30,406,7,62,280212,62,630
35.852,6,16,3447,9,49,4481,92,563,7,503,147,1448,2884
0.177,6,44,20751,26,1053,7,1420,15810,18,467,9,1883,4941
4.302,17,4,1354,2,300,3305,300,656,2,321,3300,321,698
32.754,6,10,580,3,0,16377,0,160,7,0,5426,0,420
1787.129,6,356,22520,208,69,8633,69,12460,148,69,12157,69,10060
0.814,6,10,1687,7,100,135,100,384,3,1179,274,1179,1303
1.591,6,49,19560,26,913,63,1440,13864,23,433,63,1440,5696
36.546,17,22,1936,11,48,3646,48,836,11,72,3652,72,1100
1741.475,17,29,6815,29,207,62195,207,6815,0,0,0,0,0
1.368,6,37,8212,19,320,76,1162,2716,18,529,70,4075,5496
8.628,17,4,1344,4,308,2876,308,1344,0,0,0,0,0
1771.495,1,50,4200,50,56,36152,56,4200,0,0,0,0,0
240.207,6,55,19295,30,825,8282,1418,16435,25,194,10008,580,2860
240.297,6,43,9002,21,519,12014,1402,5776,22,230,11442,618,3226
0.218,6,22,5960,12,181,19,537,1526,10,651,23,1402,4434
170.51,17,3,192,3,36,85255,36,192,0,0,0,0,0
0.158,6,3,120,2,0,0,0,80,1,0,0,0,40
1434.24,17,779,247891,382,557,3764,1350,223630,397,33,3618,361,24261
114.845,6,35,8477,18,414,526,928,2044,17,521,7167,3488,6433
211.407,6,9,515,5,43,52851,43,299,4,0,70467,0,216
371.024,6,19,1303,14,177,28540,177,925,5,110,15165,110,378
0.339,6,29,7077,17,242,21,645,2383,12,701,29,1734,4694
0.532,6,22,7342,13,335,44,668,2026,9,1210,61,1946,5316
1792.148,1,342,28728,342,56,5255,56,28728,0,0,0,0,0
1661.981,1,7,392,7,28,276996,28,392,0,0,0,0,0
1.133,6,4,220,2,0,1133,0,100,2,0,303,0,120
4.133,6,24,8663,14,275,317,557,1389,10,981,440,1420,7274
0.106,17,2,196,1,62,0,62,90,1,78,0,78,106
782.044,2,6,192,6,8,156408,8,192,0,0,0,0,0
0.774,6,11,1727,7,100,129,100,384,4,589,173,1152,1343
25.988,17,4,352,2,60,25987,60,176,2,60,25987,60,176
289.304,6,40,4244,19,324,16072,584,1716,21,180,14465,580,2528
0.059,6,3,144,2,0,59,0,92,1,0,0,0,52
1772.735,6,180,15480,120,69,14896,69,8940,60,69,30040,69,6540
1798.594,1,58,4872,58,56,31554,56,4872,0,0,0,0,0
1799.436,17,142,11360,71,48,25706,48,5396,71,56,25706,56,5964
0.25,6,22,5967,12,181,22,537,1526,10,652,26,1408,4441
1785.78,6,104,8376,68,65,26653,65,4930,36,59,51019,59,3446
0.274,17,2,178,1,29,0,29,57,1,93,0,93,121
98.724,17,3,1044,3,320,49362,336,1044,0,0,0,0,0
1747.672,6,95,7203,63,38,28188,205,4476,32,33,56363,98,2727
1784.721,6,180,15480,120,69,14997,69,8940,60,69,30240,69,6540
1791.867,6,244,35804,152,302,11866,302,26032,92,83,19690,83,9772
74.975,6,15,620,7,0,4042,0,284,8,0,10708,0,336
1770.947,6,103,9448,66,65,27245,65,5577,37,59,49189,59,3871
1787.628,6,451,29406,222,97,8088,965,14950,229,37,7840,96,14456
94.726,6,24,6233,8,267,115,502,1126,16,343,6309,1420,5107
240.137,6,42,9497,20,168,12638,346,2240,22,609,11434,2801,7257
1.698,6,48,19665,27,924,65,1460,14049,21,433,76,1460,5616
1.234,17,2,776,2,360,1234,360,776,0,0,0,0,0
70.203,6,49,11439,20,278,3694,1189,3318,29,386,2502,1460,8121
1.277,6,39,9888,20,502,67,1460,4352,19,433,61,1460,5536
0.044,17,4,288,2,33,0,33,122,2,55,40,61,166
1798.919,17,449,39928,404,35,4463,288,25708,45,288,40023,288,14220
5.296,6,42,7405,21,201,264,314,3463,21,516,251,1179,3942
1787.449,17,87,3648,86,14,21028,14,3612,1,8,0,8,36
1771.994,6,180,15480,120,69,14890,69,8940,60,69,30032,69,6540
4.995,6,40,7309,20,218,262,314,3423,20,513,249,1179,3886
7.473,6,1605,1441117,945,1438,7,1448,1398637,660,776,11,1448,42480
41.705,6,27,7177,13,155,3475,267,1306,14,530,3207,3417,5871
852.979,17,19,4871,10,40,94775,41,688,9,436,82875,505,4183
1787.676,6,361,23134,207,69,8678,69,12420,154,69,11682,69,10714
361.488,6,47,10687,29,305,12910,1360,5165,18,399,508,1360,5522
2.08,17,3,174,3,30,1040,30,174,0,0,0,0,0
138.356,6,36,7882,17,130,8647,267,1604,19,367,7678,1460,6278
5.77,6,44,12077,22,190,273,561,2508,22,867,266,1440,9569
0.414,17,2,166,1,47,0,47,75,1,63,0,63,91
1774.41,6,2619,1001055,1190,907,1492,1408,775969,1429,222,1242,4224,225086
29.287,6,38,9290,19,321,1627,721,3018,19,687,1570,1420,6272
1799.631,17,449,39928,404,35,4465,288,25708,45,288,40017,288,14220
0.806,6,20,5948,12,281,73,544,1328,8,859,103,2642,4620
160.791,17,8,2688,8,308,22970,308,2688,0,0,0,0,0
1786.964,17,87,3648,86,14,21023,14,3612,1,8,0,8,36
1799.286,6,374,26068,217,98,8330,469,15303,157,69,11532,69,10765
1.784,6,25,8766,15,285,127,588,1460,10,986,176,1420,7306
1740.492,17,29,6815,29,207,62160,207,6815,0,0,0,0,0
10.271,6,6,516,0,0,0,0,0,6,69,2054,69,516
11.314,6,18,4087,10,275,1257,275,683,8,768,877,1440,3404
20.421,17,36,6652,17,195,1274,1350,3804,19,121,1132,1350,2848
0.204,6,16,2993,9,282,25,531,1606,7,338,32,777,1387
1630.277,1,8,448,8,28,232896,28,448,0,0,0,0,0
39.049,17,22,1936,11,48,3904,48,836,11,72,3904,72,1100
0.478,6,50,20302,27,1002,18,1380,15140,23,421,19,1923,5162
2.4,6,41,8665,21,213,120,564,1989,20,451,114,2128,6676
810.392,17,10,821,5,31,202568,37,297,5,76,202585,136,524
0.848,6,20,5948,11,281,84,544,1288,9,716,94,1420,4660
1039.39,6,58,4580,33,65,25378,65,2360,25,50,43303,59,2220
1787.908,6,377,28671,218,126,8239,469,17550,159,69,11315,69,11121
0.644,6,19,7099,12,318,58,600,1906,7,1205,91,1851,5193
0.444,17,2,152,1,48,0,48,76,1,48,0,48,76
835.318,17,358,21590,358,32,2339,37,21590,0,0,0,0,0
378.043,2,4,128,4,8,126014,8,128,0,0,0,0,0
0.025,17,2,466,1,33,0,33,61,1,377,0,377,405
184.014,6,28,7352,13,158,15334,267,1317,15,678,13138,3436,6035
0.511,6,23,7437,14,274,39,668,2109,9,1210,58,1946,5328
10.573,6,13,2133,8,324,1510,585,1073,5,396,2639,580,1060
1.296,6,49,16127,27,775,49,1360,10426,22,400,53,1360,5701
1766.195,6,173,14551,92,106,19408,208,10412,81,31,22073,31,4139
1655.881,1,23,2789,23,93,75267,117,2789,0,0,0,0,0
30.714,6,6,378,2,106,30672,106,194,4,0,10227,0,184
1772.161,6,180,15480,120,69,14892,69,8940,60,69,30034,69,6540
366.801,6,25,1651,17,177,22925,177,1117,8,110,9173,110,534
1410.187,17,13,946,7,30,235001,30,406,6,62,282003,62,540
1779.367,17,142,11360,71,48,25419,48,5396,71,56,25419,56,5964
21.054,6,22,3222,13,183,1754,517,1601,9,381,2627,499,1621
168.85,17,8,704,4,48,56280,48,304,4,72,56280,72,400
139.969,6,42,25867,19,840,41,1460,5847,23,1193,6356,1460,20020
513.642,1,5,580,5,88,128410,88,580,0,0,0,0,0
280.425,6,28,7352,12,158,25493,267,1277,16,678,18691,2085,6075
0.038,6,10,1823,6,108,7,108,428,4,1179,11,1179,1395
9.983,17,42,7327,13,204,831,1350,3023,29,120,355,1350,4304
1797.114,17,448,39896,403,35,4470,288,25676,45,288,40019,288,14220
1263.365,2,14,448,14,8,97181,8,448,0,0,0,0,0
12.404,6,27,4803,13,204,1019,722,1708,14,393,940,1440,3095
1.622,6,48,18709,27,855,62,1360,13093,21,476,70,2720,5616
3.012,17,4,338,2,34,3004,34,124,2,79,3003,79,214
1.017,17,2,178,1,29,0,29,57,1,93,0,93,121
1790.511,6,350,31343,196,103,9182,469,15111,154,124,11702,1420,16232
1795.816,17,448,39896,403,35,4467,288,25676,45,288,40017,288,14220
1638.873,2,10,320,10,8,182097,8,320,0,0,0,0,0
0.066,6,10,1512,5,503,16,503,771,5,473,16,473,741
1781.519,17,142,11360,71,48,25450,48,5396,71,56,25450,56,5964
39.929,6,23,3286,13,183,3327,517,1613,10,381,4434,499,1673
1798.206,17,449,39928,404,35,4462,288,25708,45,288,40018,288,14220
0.013,17,2,415,1,34,0,34,62,1,325,0,325,353
1794.854,1,238,13328,238,28,7573,28,13328,0,0,0,0,0
1681.265,17,16,1265,8,30,240177,37,471,8,71,240178,136,794
1754.908,6,102,7970,66,45,26998,205,4902,36,35,50131,98,3068
0.292,17,2,152,1,40,0,40,68,1,56,0,56,84
160.568,17,47,1880,34,12,4865,12,1360,13,12,3579,12,520
1.762,17,20,5180,20,231,92,388,5180,0,0,0,0,0
0.216,6,45,20981,26,1067,8,1420,16000,19,526,11,3303,4981
384.944,6,18,1242,14,180,29611,180,916,4,110,20059,110,326
6.593,6,66,20126,34,540,199,1152,15419,32,489,204,1179,4707
0.877,6,10,1687,7,100,146,100,384,3,1179,316,1179,1303
184.305,6,30,10851,10,216,6563,503,1270,20,516,9696,1420,9581
10.2,6,88,26525,45,561,231,1152,20323,43,447,236,1179,6202
5.956,6,11,2997,5,92,1489,92,348,6,2329,1153,2329,2649
285.105,6,21,1509,11,330,28509,330,910,10,83,31677,83,599
44.281,6,5,293,4,31,14760,31,222,1,31,0,31,71
0.899,6,11,1727,7,100,149,100,384,4,589,215,1152,1343
0.26,17,3,451,2,39,156,39,134,1,289,0,289,317
11.981,6,98,27170,50,521,244,1152,20768,48,407,249,1152,6402
2.459,6,13,2311,8,188,351,245,700,5,1407,554,1407,1611
17.4,6,11,480,4,0,5800,0,172,7,0,2814,0,308
0.052,17,2,152,1,40,0,40,68,1,56,0,56,84
1.344,6,49,17359,28,810,49,1360,11698,21,437,58,2715,5661
1741.657,6,87,6322,58,31,30555,31,3915,29,31,62201,31,2407
15.959,6,31,10142,15,452,1139,751,2597,16,609,1062,1448,7545
1787.281,17,87,3648,86,14,21026,14,3612,1,8,0,8,36
1.015,6,10,861,5,222,251,222,426,5,231,250,231,435
186.52,6,50,7099,25,304,7771,304,4664,25,83,7730,83,2435
2.159,17,29,8849,14,312,163,1350,4760,15,244,151,1350,4089
0.254,6,4,220,2,0,254,0,104,2,0,0,0,116
2.052,17,2,170,1,37,0,37,65,1,77,0,77,105
252.322,2,2,64,2,8,252322,8,64,0,0,0,0,0
1779.033,17,140,11200,70,48,25782,48,5320,70,56,25782,56,5880
566.011,6,60,7919,29,118,20214,721,3297,31,143,15891,1448,4622
0.005,17,2,362,1,61,0,61,89,1,245,0,245,273
0.249,6,43,19768,25,1062,10,1432,14827,18,467,13,1871,4941
1776.785,6,276,34678,110,151,16299,1360,17150,166,131,10767,1360,17528
2.4,6,115,87080,50,131,48,232,2529,65,1365,33,1430,84551
240.26,17,4,736,2,31,240251,34,119,2,280,240250,283,617
0.507,17,3,451,2,39,35,39,134,1,289,0,289,317
1659.963,1,54,3024,54,28,31320,28,3024,0,0,0,0,0
7.615,6,12,945,6,222,1520,222,466,6,231,1520,231,479
1681.248,17,14,1036,7,30,280204,30,406,7,62,280205,62,630
5.314,6,522,484426,345,1343,14,1368,470558,177,931,29,2736,13868
698.389,17,100,7643,51,40,13967,41,3498,49,56,14545,57,4145
280.264,6,29,7392,13,158,23355,267,1317,16,603,18682,2036,6075
1795.901,17,448,39612,404,35,4456,288,25708,44,288,40948,288,13904
778.8,1,16,896,16,28,51920,28,896,0,0,0,0,0
106.464,6,36,8245,18,339,529,671,1771,18,478,6252,2128,6474
1798.295,17,449,39928,404,35,4462,288,25708,45,288,40016,288,14220
0.037,17,2,152,2,48,37,48,152,0,0,0,0,0
23.44,6,3336,3172799,2204,1363,10,1408,3109271,1132,776,20,1408,63528
0.181,6,9,1002,5,213,45,213,417,4,421,46,421,585
1799.999,6,219,18883,80,76,22405,349,8373,139,69,13043,1062,10510
1786.312,6,364,23047,211,69,8506,69,12787,153,69,11749,69,10260
26.239,6,35,8180,17,188,1639,721,2007,18,605,1357,1440,6173
132.982,1,2,252,2,98,132982,105,252,0,0,0,0,0
371.057,6,23,1535,16,177,24737,177,1053,7,110,10380,110,482
0.571,6,32,8267,15,401,40,888,1835,17,441,26,1460,6432
0.293,17,2,152,1,48,0,48,76,1,48,0,48,76
281.369,6,30,7432,13,158,23447,267,1317,17,543,17583,1400,6115
218.99,6,256,214868,164,1351,1343,1448,197812,92,584,2404,1448,17056
1740.493,6,95,7203,63,38,28072,205,4476,32,33,56135,98,2727
1666.096,1,8,448,8,28,238013,28,448,0,0,0,0,0
229.977,6,18,1404,5,177,57452,177,622,13,110,19150,110,782
610.784,6,183,19263,90,114,6862,1189,8086,93,201,6277,1917,11177
1.387,17,26,15077,14,783,104,1350,11364,12,281,122,1350,3713
2.059,6,24,8004,12,164,156,267,1288,12,1014,158,2331,6716
1.31,6,37,8409,19,277,72,761,1936,18,441,67,1360,6473
1796.219,17,444,39200,400,35,4501,288,25296,44,288,40946,288,13904
231.546,6,29,7392,13,158,19295,267,1317,16,603,15433,2036,6075
10.12,6,86,26909,43,558,240,1152,20707,43,447,234,1179,6202
240.52,6,6,370,4,106,80173,106,274,2,0,1025,0,96
1769.115,1,58,4872,0,0,0,0,0,58,56,31037,56,4872
82.073,6,799,390393,429,840,191,1152,370088,370,392,221,1152,20305
1787.565,6,102,8296,68,65,26680,65,4930,34,59,54164,59,3366
840.701,17,8,592,4,30,280230,30,232,4,62,280229,62,360
377.57,17,20,3648,10,48,41951,48,760,10,260,41951,308,2888
32.157,6,499,511164,175,109,184,323,11384,324,1513,99,4254,499780
1791.762,1,257,14392,257,28,6999,28,14392,0,0,0,0,0
4.981,17,4,530,2,36,4976,36,128,2,173,4976,187,402
20.205,17,37,7239,16,172,1344,1350,3208,21,163,1008,1350,4031
126.857,17,9,684,9,48,15857,48,684,0,0,0,0,0
19.868,17,24,3528,12,48,1805,48,912,12,190,1805,308,2616
661.78,2,6,192,6,8,132356,8,192,0,0,0,0,0
120.779,6,32,8952,14,158,9290,267,1357,18,624,7093,1400,7595
143.364,6,26,7272,12,158,13033,267,1277,14,905,11023,4845,5995
230.065,1,2,112,2,28,230065,28,112,0,0,0,0,0
1787.066,17,87,3648,86,14,21024,14,3612,1,8,0,8,36
2.883,17,4,232,4,30,961,30,232,0,0,0,0,0
185.997,6,12,673,3,0,92998,0,152,9,7,23214,7,521
413.582,6,42,7412,21,142,13736,516,1985,21,254,20674,1452,5427
1798.324,17,194,46773,194,213,9317,422,46773,0,0,0,0,0
0.179,6,46,20148,26,1004,7,1420,15127,20,467,9,1883,5021
103.736,1,18,1872,0,0,0,0,0,18,76,6102,76,1872
1385.287,6,340,20512,170,69,8196,69,10250,170,35,8196,64,10262
2.997,6,41,10081,23,440,136,1360,4540,18,400,164,1360,5541
300.318,6,62,30546,32,190,9687,444,2565,30,1100,8341,1551,27981
76.578,6,9951,9514460,6609,1361,11,1408,9335048,3342,931,22,2801,179412
369.541,6,18,1242,14,180,28426,180,916,4,110,20071,110,326
300.11,6,43,10090,23,579,13633,1440,4443,20,371,15785,1440,5647
0.773,6,10,924,5,283,149,283,551,5,105,149,105,373
636.074,6,45,3595,29,66,22716,66,2084,16,58,42379,60,1511
14.569,6,49,19664,25,455,605,1024,3891,24,1055,627,1708,15773
1410.74,6,143,12275,94,69,15169,69,7072,49,69,29390,69,5203
8.62,6,22,6456,7,154,1436,267,752,15,566,604,1460,5704
300.784,2,4,128,4,8,100261,8,128,0,0,0,0,0
1787.824,1,256,14336,256,28,7011,28,14336,0,0,0,0,0
0.312,6,14,2235,7,507,52,507,831,7,556,52,556,1404
1.178,6,22,7900,11,164,100,267,1236,11,1216,100,3819,6664
0.255,17,2,167,1,39,0,39,67,1,72,0,72,100
0.763,6,10,1687,7,100,127,100,384,3,1179,257,1179,1303
0.041,17,2,224,1,52,0,52,80,1,116,0,116,144
1790.828,17,89,3737,87,14,20823,15,3655,2,13,1305126,18,82
1796.739,17,457,68194,220,188,8204,1350,47601,237,58,7607,1350,20593
177.12,6,13,5674,5,112,44280,112,320,8,837,25280,1917,5354
0.053,17,2,193,1,46,0,46,74,1,91,0,91,119
0.125,6,9,1346,5,145,31,145,349,4,833,29,833,997
1791.367,1,342,28728,342,56,5253,56,28728,0,0,0,0,0
0.048,6,10,859,6,181,9,181,489,4,77,13,133,370
1.451,6,50,21122,28,954,53,1360,15466,22,476,59,2715,5656
1106.87,6,56,4378,30,66,26140,66,2190,26,49,44271,60,2188
20.235,6,37,8434,18,389,508,852,1920,19,441,1116,1460,6514
93.74,6,23,9077,11,378,68,800,1607,12,872,8509,1460,7470
21.865,6,9,577,0,0,0,0,0,9,31,2733,31,577
0.578,6,22,7356,13,337,48,674,2032,9,1212,67,1946,5324
0.261,17,3,234,2,39,82,39,134,1,72,0,72,100
1772.687,6,180,15480,120,69,14896,69,8940,60,69,30039,69,6540
0.192,6,12,3462,6,75,38,75,395,6,1373,38,1448,3067
3.91,6,21,3905,11,234,391,564,1516,10,463,412,1343,2389
1780.942,1,67,5628,0,0,0,0,0,67,56,26983,56,5628
869.307,1,8,652,8,53,124186,78,652,0,0,0,0,0
1699.505,17,12,498,11,14,169950,14,462,1,8,0,8,36
0.071,17,2,157,1,31,0,31,59,1,70,0,70,98
5.843,6,47,8489,24,211,254,293,4142,23,489,254,1179,4347
138.073,17,4,558,2,36,138068,36,128,2,187,138068,187,430
5.193,6,37,7189,19,218,288,314,3383,18,513,288,1179,3806
5.623,6,40,7309,20,218,295,314,3423,20,513,281,1179,3886
1791.547,1,342,28728,342,56,5253,56,28728,0,0,0,0,0
0.898,6,10,1687,7,100,149,100,384,3,1179,316,1179,1303
294.093,1,3,269,3,61,147046,78,269,0,0,0,0,0
1797.24,17,449,39928,404,35,4459,288,25708,45,288,40018,288,14220
1.257,6,52,21311,29,901,44,1360,15615,23,476,48,2715,5696
1785.412,6,358,22807,210,69,8542,69,12678,148,69,12145,69,10129
3.763,6,7,400,3,0,1881,0,160,4,0,1018,0,240
1629.8,1,7,392,7,28,271633,28,392,0,0,0,0,0
113.422,17,4515,4133993,1548,41,73,1350,107636,2967,1329,38,1350,4026357
0.042,17,2,201,1,40,0,40,68,1,105,0,105,133
7.076,6,14,3168,8,49,1010,92,523,6,1164,1378,1448,2645
1780.067,6,354,22440,207,69,8641,69,12420,147,69,12192,69,10020
0.009,17,3,556,2,64,2,64,184,1,344,0,344,372
1772.783,6,180,15480,120,69,14897,69,8940,60,69,30039,69,6540
0.059,6,12,3704,6,171,11,171,491,6,964,6,1448,3213
0.982,6,161,129249,102,1331,9,1432,122589,59,428,16,1871,6660
8.027,6,53,19820,29,912,286,1360,14039,24,400,340,1360,5781
0.001,17,2,254,1,47,0,47,75,1,151,0,151,179
22.175,17,2,152,2,48,22175,48,152,0,0,0,0,0
1747.767,1,129,7224,129,28,13654,28,7224,0,0,0,0,0
1778.125,17,79,3312,78,14,23092,14,3276,1,8,0,8,36
0.139,17,4,420,2,33,1,33,122,2,121,127,145,298
63.259,6,63,42050,40,1185,1622,1408,34112,23,840,2862,2439,7938
629.8,2,5,160,5,8,157450,8,160,0,0,0,0,0
1787.775,17,61,20449,61,307,29796,308,20449,0,0,0,0,0
0.21,17,2,194,1,61,0,61,89,1,77,0,77,105
13.053,6,15,2307,8,210,1863,210,856,7,545,2157,905,1451
109.842,6,21,2128,11,332,10984,332,1268,10,83,12151,83,860
1.171,6,23,6426,13,313,93,906,2092,10,982,123,1771,4334
1741.385,17,29,19517,29,645,62192,645,19517,0,0,0,0,0
0.072,17,4,420,2,33,0,33,122,2,121,1,145,298
150.544,17,4,1808,4,424,50181,548,1808,0,0,0,0,0
1795.186,17,449,39928,404,35,4454,288,25708,45,288,40017,288,14220
0.122,6,10,1865,6,649,24,1141,1542,4,159,40,159,323
1686.635,6,170,14730,108,69,14876,69,8046,62,68,27649,69,6684
9.046,6,71,21259,36,554,258,1152,16416,35,491,258,1179,4843
11.901,6,1826,1636114,1156,1363,10,1380,1605069,670,467,17,1923,31045
14.126,6,17,2425,9,211,1765,211,922,8,545,2015,904,1503
1774.917,17,140,11200,70,48,25723,48,5320,70,56,25723,56,5880
317.12,6,55,12335,30,131,10935,615,3764,25,581,13206,1360,8571
5.118,6,41,7349,22,218,243,314,3503,19,513,265,1179,3846
61.849,6,66,46175,43,1161,1472,1408,38246,23,960,2801,3847,7929
1.129,6,52,13853,24,549,49,1429,4824,28,438,41,1460,9029
1795.229,17,448,39612,404,35,4454,288,25708,44,288,40948,288,13904
366.544,17,66,4994,37,40,10181,41,2539,29,56,13029,57,2455
6.035,6,42,7409,22,218,287,314,3503,20,516,304,1179,3906
5.164,17,3,208,2,36,5028,36,128,1,52,0,52,80
1780.526,17,142,11360,71,48,25435,48,5396,71,56,25435,56,5964
0.39,17,2,152,1,48,0,48,76,1,48,0,48,76
3.0,17,2,144,2,44,3000,44,144,0,0,0,0,0
1.435,6,37,8218,19,321,79,1168,2722,18,476,73,2615,5496
1.381,6,10,1687,7,100,230,100,384,3,1179,567,1179,1303
126.797,6,54,9720,24,399,5512,841,3312,30,219,4372,1408,6408
0.014,17,2,350,1,39,0,39,67,1,255,0,255,283
0.996,6,35,13729,19,764,55,1360,6157,16,692,54,1360,7572
0.106,17,2,2752,2,1348,106,1348,2752,0,0,0,0,0
339.208,6,54,8269,30,111,11696,517,3256,24,468,14747,1418,5013
1.323,6,46,17908,26,866,52,1360,12332,20,433,60,1360,5576
13.454,6,19,6745,10,275,1494,275,958,9,1353,1373,1440,5787
7.973,6,18,6871,9,275,996,275,643,9,1171,681,1440,6228
1.266,6,45,16711,25,839,52,1360,11135,20,433,57,1360,5576
1741.617,1,15,840,15,28,124401,28,840,0,0,0,0,0
118.658,6,26,3513,14,180,9127,595,1816,12,266,10779,580,1697
318.042,6,75,19610,37,338,8834,1360,9971,38,337,8591,1360,9639
10.677,6,20,4442,11,275,1067,275,998,9,768,732,1440,3444
1673.852,1,8,448,8,28,239121,28,448,0,0,0,0,0
1797.607,17,448,39896,403,35,4471,288,25676,45,288,40018,288,14220
12.682,6,6,328,4,0,4227,0,216,2,0,12449,0,112
84.48,17,8,10988,8,1345,12068,1348,10988,0,0,0,0,0
1772.312,6,180,15480,120,69,14893,69,8940,60,69,30033,69,6540
0.05,6,11,818,6,185,9,185,505,5,45,11,45,313
258.808,6,513,421687,315,1366,824,1448,392151,198,519,1269,1448,29536
0.024,17,4,420,2,33,16,33,122,2,121,16,145,298
24.025,6,3113,2901922,1960,1400,12,1448,2837290,1153,776,20,1448,64632
33.662,6,30,5043,15,154,2404,722,1859,15,400,2390,2026,3184
556.098,1,29,3016,0,0,0,0,0,29,76,19860,76,3016
1784.181,6,357,22698,207,69,8661,69,12420,150,69,11974,69,10278
1787.225,6,468,27000,260,69,6900,69,14540,208,34,8633,64,12460
26.254,6,44,12335,18,520,183,1368,4587,26,373,1042,2736,7748
1785.641,17,87,3648,86,14,21007,14,3612,1,8,0,8,36
1781.504,17,142,11360,71,48,25449,48,5396,71,56,25449,56,5964
0.496,17,3,451,2,39,342,39,134,1,289,0,289,317
51.856,1,6,1153,6,164,10371,183,1153,0,0,0,0,0
6.045,6,1821,1681605,1145,1390,5,1408,1641789,676,931,8,2801,39816
1786.67,17,87,3648,86,14,21019,14,3612,1,8,0,8,36
1.117,6,26,8108,14,164,73,267,1392,12,1014,86,2816,6716
3.923,6,32,6089,17,206,245,314,2744,15,548,260,1179,3345
32.703,2,2,64,2,8,32703,8,64,0,0,0,0,0
0.009,17,4,352,2,37,4,37,130,2,83,6,89,222
1798.604,17,449,39928,404,35,4463,288,25708,45,288,40018,288,14220
1772.501,6,204,22330,130,75,13740,267,10057,74,132,24279,1460,12273
1773.151,6,180,15480,120,69,14900,69,8940,60,69,30046,69,6540
1746.019,6,95,7203,63,38,28161,205,4476,32,33,56311,98,2727
0.922,17,4,560,2,64,894,64,184,2,160,889,160,376
1.452,6,47,19830,27,938,55,1460,14254,20,476,66,2615,5576
39.744,17,22,1936,11,48,3973,48,836,11,72,3973,72,1100
1773.182,17,224,52314,224,205,7951,422,52314,0,0,0,0,0
36.162,17,40,5880,20,48,1902,48,1520,20,190,1902,308,4360
12.437,17,17,16856,6,912,102,1350,5640,11,991,1240,1350,11216
240.226,6,60,20902,33,849,7506,1418,17877,27,179,9239,580,3025
132.988,17,2,386,2,165,132988,165,386,0,0,0,0,0
1759.973,6,80,4160,40,0,45124,0,2080,40,0,45124,0,2080
1125.234,17,791,55600,710,40,1587,41,48748,81,56,590,57,6852
1755.91,1,8,448,8,28,250844,28,448,0,0,0,0,0
290.994,6,40,12495,18,290,17116,517,1597,22,975,13856,1408,10898
82.569,6,36,7882,14,155,6351,267,1346,22,332,3931,1420,6536
17.859,6,2394,2278498,1522,1418,11,1448,2228466,872,776,20,1448,50032
1796.311,17,242,24344,242,72,7453,346,24344,0,0,0,0,0
0.849,6,8,440,5,0,212,0,268,3,0,406,0,172
6.771,6,27,7384,11,155,677,267,1226,16,459,450,3426,6158
128.146,6,36,7307,17,207,8006,517,1759,19,456,7116,1418,5548
80.185,6,73,47871,45,1166,1822,1408,39684,28,960,2280,3847,8187
1787.908,6,356,22520,208,69,8637,69,12460,148,69,12162,69,10060
0.433,6,50,21737,28,1030,16,1380,16615,22,421,18,1923,5122
1680.756,17,13,534,11,14,168056,14,462,2,8,1680558,8,72
1797.943,17,448,39896,403,35,4472,288,25676,45,288,40017,288,14220
287.704,6,34,3497,17,324,17981,585,1589,17,169,15148,580,1908
0.003,6,2,99,1,0,0,0,40,1,7,0,7,59
124.353,6,25,7469,13,220,10362,516,1406,12,619,11294,1452,6063
1.324,6,27,5689,13,140,110,267,1224,14,650,95,1452,4465
1.26,6,11,1727,7,100,210,100,384,4,589,337,1152,1343
13.353,6,11,612,7,0,2225,0,380,4,0,4446,0,232
85.272,17,4,240,2,32,85271,32,120,2,32,85271,32,120
102.334,6,23,10009,12,531,65,1360,2637,11,1384,10219,3934,7372
141.324,6,34,19800,21,1010,7066,1360,11982,13,1040,11757,4445,7818
1740.616,6,87,6322,58,31,30537,31,3915,29,31,62164,31,2407
369.584,6,18,1242,14,180,28429,180,916,4,110,20059,110,326
280.209,6,27,7312,12,158,25473,267,1277,15,678,20013,2045,6035
10.973,6,99,31678,52,566,215,1152,25316,47,407,232,1152,6362
20.107,6,17,2316,10,189,2234,517,1298,7,323,3348,499,1018
1794.215,1,58,4872,58,56,31477,56,4872,0,0,0,0,0
2.3,6,13,2311,8,188,328,245,700,5,1407,511,1407,1611
1740.795,17,30,7050,30,207,60027,207,7050,0,0,0,0,0
1791.437,1,189,20034,189,78,9528,78,20034,0,0,0,0,0
15.43,6,7,380,2,0,15430,0,100,5,0,3811,0,280
1778.221,17,79,3312,78,14,23093,14,3276,1,8,0,8,36
15.424,17,6,528,3,48,7707,48,228,3,72,7707,72,300
30.133,6,9,372,7,0,5022,0,284,2,0,1476,0,88
0.434,6,10,1514,5,503,108,503,771,5,475,108,475,743
38.772,17,22,1936,11,48,3873,48,836,11,72,3871,72,1100
0.158,1,2,112,2,28,158,28,112,0,0,0,0,0
0.533,17,2,384,1,39,0,39,67,1,289,0,289,317
1771.32,6,105,9759,68,65,26437,65,5758,37,59,49199,59,4001
1684.588,2,25,800,25,8,70191,8,800,0,0,0,0,0
1783.671,6,117,13597,77,81,23469,501,6030,40,156,45732,1420,7567
1798.138,17,760,45872,760,32,2369,37,45872,0,0,0,0,0
23.172,6,43,10367,21,736,463,1360,4592,22,348,1094,2667,5775
125.627,6,30,11131,16,553,8369,1396,3077,14,1463,9656,2120,8054
1787.906,6,366,25679,210,99,8554,469,14885,156,69,11534,69,10794
1787.905,6,376,23803,215,69,8354,69,13223,161,69,11174,69,10580
1681.327,17,14,3827,7,30,280219,30,406,7,460,280219,463,3421
33.739,6,30,5067,15,154,2409,721,1883,15,400,2395,2026,3184
57.536,17,12,1056,6,48,11505,48,456,6,72,11505,72,600
38.571,6,27,7177,13,155,3214,267,1306,14,530,2966,3417,5871
35.078,6,30,5091,15,180,2505,722,1858,15,349,2475,1448,3233
300.445,6,64,42346,40,1194,7703,1448,34347,24,749,2698,1448,7999
1735.213,2,27,864,27,8,66738,8,864,0,0,0,0,0
0.836,17,13,7994,7,802,138,1350,5813,6,335,160,1350,2181
0.338,6,23,7802,13,318,27,600,1970,10,884,36,1471,5832
11.007,6,20,5694,11,275,1100,275,998,9,1440,743,1440,4696
204.371,17,4,240,2,32,204370,32,120,2,32,204369,32,120
251.255,17,4,352,2,60,251254,60,176,2,60,251253,60,176
14.067,6,8,456,3,0,7033,0,164,5,0,3459,0,292
1794.294,2,27,864,27,8,69011,8,864,0,0,0,0,0
0.57,6,21,9743,12,410,51,922,1742,9,1271,55,3056,8001
1.345,6,50,19285,27,890,51,1360,13589,23,433,52,1360,5696
126.54,6,7,424,4,112,42180,112,280,3,0,1512,0,144
1740.459,6,89,6426,58,31,30534,31,3915,31,31,58013,31,2511
0.132,6,10,1380,6,145,26,145,389,4,827,41,827,991
12.025,6,11,460,6,0,2405,0,244,5,0,3002,0,216
1783.793,6,416,24920,208,69,8617,69,12460,208,34,8617,48,12460
1744.214,6,95,7203,63,38,28132,205,4476,32,33,56254,98,2727
0.092,17,2,362,1,46,0,46,74,1,260,0,260,288
580.103,1,6,489,6,53,116020,78,489,0,0,0,0,0
1785.939,6,104,8376,68,65,26655,65,4930,36,59,51024,59,3446
1773.389,6,185,15887,122,69,14656,69,9020,63,69,28600,69,6867
136.718,17,4,352,2,60,136717,60,176,2,60,136717,60,176
1764.977,2,20,640,20,8,92893,8,640,0,0,0,0,0
3.933,17,8,1856,8,204,561,204,1856,0,0,0,0,0
72.98,6,33,7852,12,141,6634,267,1335,21,333,3641,1452,6517
1.16,6,106,65200,52,153,22,258,2725,54,1182,18,1473,62475
280.245,6,30,7432,15,158,20017,267,1397,15,678,20013,3436,6035
1784.045,6,122,14401,77,85,23474,502,6258,45,162,40544,1420,8143
1.957,17,3,687,3,201,978,207,687,0,0,0,0,0
0.075,6,8,1213,5,581,18,581,837,3,212,23,212,376
1773.013,6,180,15480,120,69,14899,69,8940,60,69,30043,69,6540
17.383,17,16,5020,7,360,2887,1350,2722,9,227,2163,1350,2298
1770.387,6,103,9448,66,65,27236,65,5577,37,59,49174,59,3871
50.946,6,44,8884,21,399,491,882,2118,23,388,2309,1928,6766
0.061,17,2,2750,2,1347,61,1347,2750,0,0,0,0,0
6.891,6,41,7535,22,215,328,314,3689,19,513,367,1179,3846
26.68,2,2,64,2,8,26680,8,64,0,0,0,0,0
280.317,6,28,7352,12,158,25483,267,1277,16,603,18686,1400,6075
68.404,17,6,2016,6,308,13680,308,2016,0,0,0,0,0
1745.389,6,151,9613,81,51,21817,208,5914,70,31,25291,31,3699
0.506,17,3,451,2,39,77,39,134,1,289,0,289,317
4.062,17,5,290,5,30,1015,30,290,0,0,0,0,0
10.834,6,2067,1992469,1375,1374,7,1408,1951821,692,776,15,1408,40648
240.791,6,58,18274,28,812,8914,1418,15273,30,179,8300,580,3001
0.339,6,22,7286,11,270,33,797,1660,11,1009,33,2374,5626
27.26,6,3270,3067510,2143,1354,12,1408,3004242,1127,776,24,1408,63268
10.17,6,1247,1158625,764,1435,13,1448,1127745,483,776,20,1448,30880
0.204,6,25,7216,12,155,18,267,1261,13,678,15,2045,5955
122.079,6,20,8734,11,306,62,577,1392,9,1394,15243,3932,7342
1381.886,6,274,17377,159,69,8746,69,9603,115,69,12121,69,7774
3.821,17,10,900,5,30,943,30,290,5,94,947,94,610
1782.694,17,83,3480,82,14,22008,14,3444,1,8,0,8,36
132.198,6,22,8174,11,520,82,1223,2034,11,812,13202,1440,6140
1787.717,6,268,32796,108,143,16706,1440,16009,160,128,11242,1440,16787
1750.261,6,95,7203,63,38,28230,205,4476,32,33,56451,98,2727
1794.063,17,179,11456,179,36,10079,36,11456,0,0,0,0,0
159.151,17,4,824,2,48,159142,48,152,2,308,159142,308,672
43.72,6,27,6552,9,271,5465,417,967,18,402,1923,1440,5585
1783.214,17,83,3480,82,14,22014,14,3444,1,8,0,8,36
18.883,17,27,7267,11,230,1885,1350,2845,16,248,1256,1350,4422
1779.747,17,142,11360,71,48,25424,48,5396,71,56,25424,56,5964
1.364,6,51,18979,29,861,48,1360,13278,22,437,56,2715,5701
0.367,6,23,5974,13,108,30,147,959,10,922,40,2601,5015
1.356,6,38,8258,19,321,75,1168,2722,19,433,65,1360,5536
11.709,6,1922,1627412,1135,1378,10,1420,1591654,787,425,14,1883,35758
3.185,6,11,467,6,0,637,0,248,5,7,750,7,219
171.835,17,19,18740,19,958,9546,1452,18740,0,0,0,0,0
0.01,17,2,368,1,36,0,36,64,1,276,0,276,304
1784.954,17,142,11360,71,48,25499,48,5396,71,56,25499,56,5964
15.044,6,27,7183,13,156,1253,267,1312,14,530,1156,3417,5871
280.231,6,30,7432,13,158,23352,267,1317,17,543,17512,1300,6115
159.801,17,4,328,2,46,159794,47,148,2,62,159795,63,180
1.012,6,10,861,5,222,248,222,426,5,231,247,231,435
7.38,6,14,5716,4,106,2460,106,274,10,718,758,1460,5442
7.392,6,1796,1697976,1159,1388,6,1408,1660188,637,931,11,2816,37788
0.442,6,16,6416,8,126,61,126,550,8,1088,56,1448,5866
1770.621,6,104,9883,68,70,26427,234,5948,36,60,50586,83,3935
0.109,17,2,2754,2,1349,109,1349,2754,0,0,0,0,0
222.636,1,22,1232,22,28,10601,28,1232,0,0,0,0,0
10.768,6,19,4402,10,275,1196,275,958,9,768,747,1440,3444
281.869,17,7,2352,7,308,46978,308,2352,0,0,0,0,0
280.459,6,30,7432,14,158,21573,267,1357,16,678,18692,3456,6075
1789.954,6,355,22480,207,69,8689,69,12420,148,69,12176,69,10060
1772.538,6,180,15480,120,69,14895,69,8940,60,69,30035,69,6540
246.043,17,21,7056,21,308,12302,308,7056,0,0,0,0,0
139.672,6,22,9200,11,499,80,1193,1995,11,964,13948,1360,7205
10.958,6,20,4442,11,275,1095,275,998,9,768,774,1440,3444
1.312,6,48,19328,27,900,50,1460,13712,21,433,56,1460,5616
1786.344,6,104,8444,68,66,26661,66,4964,36,60,51035,60,3480
0.333,17,8,2774,8,318,47,357,2774,0,0,0,0,0
0.167,6,4,184,3,0,0,0,144,1,0,0,0,40
1729.217,6,65,4748,42,33,42176,33,2889,23,31,78591,31,1859
1743.962,6,94,7151,62,38,28589,205,4424,32,33,56251,98,2727
1798.349,1,345,28980,345,56,5227,56,28980,0,0,0,0,0
1740.491,17,30,31605,30,1025,60016,1028,31605,0,0,0,0,0
61.732,6,26,7137,12,155,5612,267,1266,14,530,4747,2006,5871
164.356,6,137,104876,86,1279,1933,1368,94053,51,742,1880,2736,10823
1685.98,17,12,498,11,14,168598,14,462,1,8,0,8,36
1794.91,6,367,23512,209,69,8629,69,12638,158,69,11432,69,10874
126.169,6,32,7855,11,155,34,267,1226,21,361,6308,3426,6629
0.012,6,10,1510,5,657,2,657,925,5,317,2,317,585
161.979,6,42,20732,21,555,724,787,4287,21,1197,8092,3928,16445
1781.745,17,278,56402,278,174,6432,422,56402,0,0,0,0,0
72.619,17,4,300,2,47,72618,47,150,2,47,72618,47,150
1744.59,6,123,8037,70,52,25283,208,4956,53,31,33540,31,3081
0.034,6,2,92,2,0,0,0,92,0,0,0,0,0
4.995,6,43,8329,21,227,249,314,4022,22,427,225,1152,4307
5.039,17,4,288,2,36,5003,36,128,2,52,5006,52,160
1795.179,1,60,5040,60,56,30426,56,5040,0,0,0,0,0
1792.88,6,360,22818,209,69,8619,69,12569,151,69,11952,69,10249
599.045,6,9,546,6,31,119809,31,333,3,31,299518,31,213
0.149,6,9,527,5,43,37,43,311,4,0,41,0,216
1785.514,6,102,8228,68,64,26649,64,4896,34,58,54103,58,3332
0.161,6,7,423,4,43,40,43,259,3,0,30,0,164
194.57,6,14,832,8,26,27795,26,468,6,26,38904,26,364
1796.566,17,142,11360,71,48,25665,48,5396,71,56,25665,56,5964
98.64,17,4,352,2,60,98639,60,176,2,60,98639,60,176
1.282,6,10,1687,7,100,213,100,384,3,1179,508,1179,1303
7.01,6,162,198438,103,133,68,201,4687,59,3479,118,22624,193751
4.265,6,38,7229,19,218,236,314,3383,19,440,222,1152,3846
0.827,17,4,368,2,32,814,32,120,2,96,693,96,248
0.081,6,9,1002,5,213,20,213,417,4,421,23,421,585
224.744,17,4,240,2,32,224742,32,120,2,32,224743,32,120
1786.305,6,106,8524,68,66,26661,66,4964,38,60,48275,60,3560
5.365,6,10,2191,5,188,1341,245,580,5,1407,1275,1407,1611
1.277,17,17,5475,7,316,212,1350,2412,10,278,122,1350,3063
3.304,17,4,1568,4,364,1101,364,1568,0,0,0,0,0
0.022,6,2,149,1,0,0,0,40,1,69,0,69,109
0.118,17,2,396,1,39,0,39,67,1,301,0,301,329
1772.995,6,205,22508,130,75,13744,267,10057,75,133,23959,2828,12451
47.829,6,2843,2617499,1711,1442,27,1448,2546995,1132,931,42,2896,70504
629.64,2,5,160,5,8,157410,8,160,0,0,0,0,0
1748.576,6,120,8156,71,56,24979,208,5173,49,31,36419,31,2983
2.008,6,3,168,0,0,0,0,0,3,0,0,0,168
0.008,6,6,7540,1,0,0,0,40,5,1448,2,1448,7500
410.773,17,7,2586,7,341,68462,548,2586,0,0,0,0,0
8.627,6,22,6636,7,154,1437,267,752,15,527,615,1420,5884
184.13,6,72,14716,30,277,6349,1189,6200,42,235,4484,1420,8516
240.226,6,57,20630,31,837,8007,1418,17539,26,216,9608,580,3091
1792.007,6,356,22520,208,69,8657,69,12460,148,69,12190,69,10060
368.311,6,18,1242,14,180,28331,180,916,4,110,20070,110,326
5.016,17,4,288,2,36,4999,36,128,2,52,4999,52,160
15.963,6,118,39619,58,647,280,1152,32737,60,447,265,1179,6882
1745.065,6,97,7307,63,38,28146,205,4476,34,33,52868,98,2831
0.073,17,4,368,2,32,1,32,120,2,96,0,96,248
1657.625,1,8,448,8,28,236803,28,448,0,0,0,0,0
0.045,6,12,3462,6,75,8,75,395,6,1373,9,1448,3067
79.772,6,37,5547,18,144,4692,722,2090,19,246,4422,1408,3457
1787.577,6,126,15224,81,90,22344,502,6763,45,162,40624,1420,8461
12.603,1,2,112,2,28,12603,28,112,0,0,0,0,0
0.014,6,14,4044,8,88,2,88,452,6,1670,2,1880,3592
560.463,17,6,1619,3,30,280193,30,174,3,453,280228,463,1445
348.248,1,56,7342,56,103,6331,131,7342,0,0,0,0,0
3.37,6,22,6401,10,262,369,517,1316,12,744,302,1418,5085
0.215,6,22,5040,11,137,21,267,1132,11,577,20,1400,3908
0.326,17,2,144,1,36,0,36,64,1,52,0,52,80
360.934,2,5,160,5,8,90233,8,160,0,0,0,0,0
1791.606,6,356,22520,208,69,8655,69,12460,148,69,12187,69,10060
1778.587,17,140,11200,70,48,25776,48,5320,70,56,25776,56,5880
3.066,17,8,704,4,37,1020,37,260,4,83,1020,89,444
1799.999,6,213,16682,79,72,22692,347,8048,134,48,13533,78,8634
0.156,6,46,21246,26,1083,6,1420,16225,20,467,7,1883,5021
0.75,6,11,1727,7,100,125,100,384,4,589,168,1152,1343
11.045,6,22,6446,10,274,1222,517,1362,12,744,1000,1408,5084
127.808,6,18,3374,7,92,21301,92,452,11,293,12751,1408,2922
0.007,6,3,327,2,103,2,138,287,1,0,0,0,40
1787.42,6,102,8296,68,65,26677,65,4930,34,59,54160,59,3366
0.113,6,13,2037,8,329,16,500,1082,5,687,28,687,955
240.206,6,57,21053,31,827,8006,1418,18162,26,191,9607,580,2891
0.182,6,3,321,2,177,10,177,281,1,0,0,0,40
1681.238,1,15,870,15,30,120088,30,870,0,0,0,0,0
18.439,17,40,18526,20,631,968,1350,13191,20,238,968,1350,5335
0.005,17,2,162,1,36,0,36,64,1,70,0,70,98
70.321,6,18,732,8,0,7546,0,324,10,0,7807,0,408
644.626,17,7,2448,7,321,107437,376,2448,0,0,0,0,0
280.49,6,31,7472,13,158,23374,267,1317,18,543,16495,1380,6155
280.498,6,30,7432,13,158,23374,267,1317,17,543,17524,1400,6115
0.061,17,2,488,1,60,0,60,88,1,372,0,372,400
1.355,6,10,1687,7,100,225,100,384,3,1179,541,1179,1303
0.055,17,3,244,2,32,41,32,120,1,96,0,96,124
1.256,6,43,11515,24,547,54,1360,5934,19,437,60,2715,5581
2.624,6,29,10365,17,367,164,833,1785,12,1012,230,1420,8580
163.183,6,386,318642,192,791,22,1360,14047,194,1604,844,6269,304595
0.025,6,5,4031,1,0,0,0,40,4,1277,2,1440,3991
359.964,17,48,17508,48,336,7658,359,17508,0,0,0,0,0
733.689,1,4,224,4,28,244563,28,224,0,0,0,0,0
1781.689,6,279,33113,114,132,15766,1460,16025,165,126,10863,1460,17088
1752.916,6,94,7151,62,38,28736,205,4424,32,33,56532,98,2727
1799.319,17,449,39928,404,35,4464,288,25708,45,288,40016,288,14220
1743.757,1,54,4536,0,0,0,0,0,54,56,32901,56,4536
1794.063,17,180,11520,180,36,10022,36,11520,0,0,0,0,0
1759.082,6,98,4440,49,0,36647,0,2440,49,1,36647,1,2000
1786.043,6,104,8376,68,65,26657,65,4930,36,59,51027,59,3446
1771.328,6,101,9344,66,65,27251,65,5577,35,59,52094,59,3767
377.89,2,3,96,3,8,188945,8,96,0,0,0,0,0
28.209,6,11,808,10,31,3125,31,768,1,0,0,0,40
1788.22,6,356,22520,208,69,8638,69,12460,148,69,12164,69,10060
300.474,6,100,99604,43,145,7153,230,2824,57,1737,5365,5608,96780
1746.838,6,137,8544,76,46,23291,208,5205,61,31,29109,31,3339
47.639,6,6289,5904498,4098,1362,11,1408,5785902,2191,931,21,2816,118596
216.367,1,40,3360,40,56,5547,56,3360,0,0,0,0,0
4.604,6,38,7229,19,218,255,314,3383,19,513,241,1179,3846
383.14,6,36,7358,20,134,20165,516,2016,16,361,25535,1452,5342
0.298,6,27,7296,13,155,24,267,1301,14,603,17,2036,5995
40.229,6,52,9523,29,153,1436,721,3011,23,619,1820,1414,6512
76.777,6,16,1183,8,177,10968,177,649,8,110,9211,110,534
3.013,6,3,180,3,0,0,0,180,0,0,0,0,0
29.982,1,2,120,2,32,29982,32,120,0,0,0,0,0
9.99,17,2,158,2,51,9990,51,158,0,0,0,0,0
0.965,6,10,1687,7,100,160,100,384,3,1179,354,1179,1303
21.443,6,25,4807,17,236,1340,1232,2785,8,399,1076,1294,2022
21.546,6,23,4617,10,204,2394,722,1539,13,342,1775,1448,3078
0.385,17,2,152,1,48,0,48,76,1,48,0,48,76
6.104,6,1660,1528076,1043,1387,5,1408,1491328,617,931,9,2801,36748
11.478,17,8,704,4,48,3823,48,304,4,72,3822,72,400
0.033,17,2,330,1,30,0,30,58,1,244,0,244,272
1684.503,17,12,498,11,14,168450,14,462,1,8,0,8,36
1792.792,1,58,4872,58,56,31452,56,4872,0,0,0,0,0
25.441,17,31,8569,14,319,1954,1350,4858,17,190,1588,1350,3711
1299.939,6,224,26054,115,133,11401,721,15317,109,192,12034,1420,10737
1.603,6,44,13568,23,700,72,1360,7952,21,433,69,1360,5616
1667.989,1,8,448,8,28,238284,28,448,0,0,0,0,0
1764.317,2,16,512,16,8,117621,8,512,0,0,0,0,0
1744.234,6,94,7151,62,38,28594,205,4424,32,33,56258,98,2727
0.056,17,2,179,1,43,0,43,71,1,80,0,80,108
13.01,6,84,24581,41,533,325,1152,18720,43,459,302,1179,5861
300.531,6,81,14634,38,291,8121,1368,7223,43,224,7154,1368,7411
1799.252,17,448,39896,403,35,4475,288,25676,45,288,40020,288,14220
0.218,17,2,304,1,60,0,60,88,1,188,0,188,216
38.389,17,22,1936,11,48,3832,48,836,11,72,3834,72,1100
271.101,6,9,524,2,0,31083,0,112,7,0,45181,0,412
1750.507,17,12,498,11,14,175050,14,462,1,8,0,8,36
67.339,6,44,16537,25,810,2805,1448,9458,19,506,3585,1448,7079
1.582,17,18,6871,9,478,193,1350,4556,9,229,193,1350,2315
1785.854,6,361,22927,209,69,8585,69,12569,152,69,11826,69,10358
1.45,6,10,1687,7,100,241,100,384,3,1179,593,1179,1303
0.083,6,10,1321,5,585,20,585,841,5,212,14,212,480
1786.613,6,354,23047,204,75,8801,469,12769,150,69,11989,69,10278
1786.995,17,87,3648,86,14,21023,14,3612,1,8,0,8,36
0.262,6,25,6032,12,164,23,453,1442,13,651,20,2194,4590
15.771,6,7,392,2,0,452,0,112,5,0,3839,0,280
17.04,17,4,352,2,60,17039,60,176,2,60,17039,60,176
2.733,6,4,220,1,0,0,0,52,3,0,1261,0,168
1.35,6,10,1687,7,100,225,100,384,3,1179,551,1179,1303
73.421,6,14,1910,2,179,0,267,438,12,110,6673,160,1472
1787.903,6,367,25581,213,99,8433,469,15005,154,69,11685,69,10576
7.826,6,1770,1457688,947,1437,8,1448,1400552,823,776,9,1448,57136
1.886,17,3,1173,3,363,943,363,1173,0,0,0,0,0
8.304,6,9,1914,5,183,2076,267,571,4,589,528,1152,1343
52.186,6,25,7097,12,155,4744,267,1266,13,589,4348,3426,5831
1745.35,1,64,5376,64,56,27703,56,5376,0,0,0,0,0
1533.682,1,20,1120,20,28,80720,28,1120,0,0,0,0,0
1.323,1,10,840,10,56,147,56,840,0,0,0,0,0
0.015,17,2,492,1,43,0,43,71,1,393,0,393,421
0.399,6,10,1992,5,288,97,288,508,5,424,54,434,1484
37.963,17,44,6468,22,48,1807,48,1672,22,190,1807,308,4796
7.544,1,20,1680,20,56,397,56,1680,0,0,0,0,0
1778.636,17,140,11200,70,48,25777,48,5320,70,56,25777,56,5880
88.014,6,90,62177,56,1221,1600,1408,53022,34,614,2660,1408,9155
0.014,17,2,407,1,33,0,33,61,1,318,0,318,346
1795.18,17,80,3354,79,14,23015,14,3318,1,8,0,8,36
148.656,17,4,352,2,60,148655,60,176,2,60,148655,60,176
0.325,17,2,168,1,48,0,48,76,1,64,0,64,92
1763.336,6,303,18882,176,69,10076,69,10421,127,69,13994,69,8461
0.27,6,33,19125,17,127,14,127,1019,16,1438,16,2896,18106
240.607,2,4,128,4,8,80202,8,128,0,0,0,0,0
1786.015,6,115,9256,74,66,24465,66,5336,41,60,44648,60,3920
1773.906,6,183,15738,121,69,14782,69,8980,62,69,29077,69,6758
1796.297,6,358,22738,208,69,8677,69,12529,150,69,12052,69,10209
0.869,6,10,1687,7,100,144,100,384,3,1179,309,1179,1303
3.001,1,3,168,3,28,1500,28,168,0,0,0,0,0
46.851,6,19,4425,10,267,5205,501,1205,9,476,5844,1420,3220
743.045,6,176,18335,91,116,7722,1189,7478,85,201,8845,1460,10857
0.521,17,3,543,2,39,420,39,134,1,381,0,381,409
1.151,17,3,1164,3,360,575,360,1164,0,0,0,0,0
1743.236,6,94,7151,62,38,28577,205,4424,32,33,56220,98,2727
5.943,17,3,1008,3,308,2971,308,1008,0,0,0,0,0
4.999,17,4,288,2,36,4982,36,128,2,52,4981,52,160
1.334,6,25,6081,13,108,111,147,959,12,662,102,1430,5122
1791.091,6,356,22520,208,69,8652,69,12460,148,69,12184,69,10060
3.327,6,3,168,0,0,0,0,0,3,0,0,0,168
0.94,6,10,1687,7,100,156,100,384,3,1179,331,1179,1303
1772.266,6,187,15967,123,69,14526,69,9129,64,69,28127,69,6838
0.024,17,3,821,1,137,0,137,165,2,300,24,300,656
11.023,1,9,756,0,0,0,0,0,9,56,1377,56,756
3.508,6,32,6089,17,206,219,314,2744,15,548,232,1179,3345
81.4,6,41,10572,21,812,569,1360,4970,20,479,4275,4027,5602
0.313,17,2,180,1,30,0,30,58,1,94,0,94,122
308.992,6,25,1741,13,330,25749,330,1022,12,83,28089,83,719
9.221,17,4,352,2,60,9220,60,176,2,60,9220,60,176
280.659,6,29,7392,13,158,23388,267,1317,16,543,18709,1400,6075
20.162,6,30,12045,9,133,2520,267,901,21,605,1005,1420,11144
0.014,17,2,310,1,33,0,33,61,1,221,0,221,249
0.426,6,2,116,1,0,0,0,52,1,0,0,0,64
8.334,6,70,20766,36,559,238,1152,15979,34,489,245,1179,4787
281.16,6,30,7432,13,158,23430,267,1317,17,603,17569,2076,6115
2.963,6,12,507,6,0,592,0,248,6,7,556,7,259
1.362,6,48,19326,27,899,52,1460,13710,21,476,58,2615,5616
1797.859,6,452,27515,222,69,8135,69,13503,230,36,7850,69,14012
1.176,17,6,1808,3,64,574,64,276,3,482,6,504,1532
1788.992,1,256,14336,256,28,7015,28,14336,0,0,0,0,0
0.032,17,4,284,2,32,20,32,120,2,54,19,60,164
127.525,6,9,522,2,106,127510,106,194,7,0,21251,0,328
1786.749,17,140,11200,70,48,25894,48,5320,70,56,25894,56,5880
293.246,6,68,11375,31,165,9768,721,4216,37,333,8137,1440,7159
1794.778,17,142,11360,71,48,25639,48,5396,71,56,25639,56,5964
0.069,17,2,263,1,36,0,36,64,1,171,0,171,199
0.721,17,19,12072,8,470,103,1350,3988,11,706,66,1350,8084
0.619,6,12,1653,6,288,118,288,548,6,426,67,434,1105
5.191,17,2,148,2,46,5191,46,148,0,0,0,0,0
281.086,17,8,2688,8,308,40155,308,2688,0,0,0,0,0
241.271,17,6,528,3,60,120635,60,264,3,60,120635,60,264
0.008,17,2,376,1,39,0,39,67,1,281,0,281,309
1789.2,6,358,22669,209,69,8601,69,12569,149,69,12089,69,10100
30.317,6,45,9795,22,299,1443,722,3287,23,557,1358,1380,6508
1.933,6,28,8891,17,286,120,591,1543,11,863,172,1380,7348
0.196,6,25,7216,13,155,16,267,1301,12,775,17,4836,5915
1787.074,6,104,8444,68,66,26672,66,4964,36,60,51054,60,3480
1681.598,1,15,840,15,28,120114,28,840,0,0,0,0,0
61.441,6,9,468,9,0,0,0,468,0,0,0,0,0
1772.314,6,180,15480,120,69,14893,69,8940,60,69,30036,69,6540
7.987,6,15,4050,8,275,1141,275,878,7,1440,1003,1440,3172
28.636,2,2,64,2,8,28636,8,64,0,0,0,0,0
1.495,17,19,14133,12,933,135,1350,11540,7,342,242,1350,2593
1775.906,17,73,3060,72,14,25012,14,3024,1,8,0,8,36
176.093,6,74,47259,44,1183,4095,1448,38969,30,746,2124,1448,8290
1693.335,17,16,1265,8,30,241900,37,471,8,71,241900,136,794
6.451,6,17,6625,5,275,1612,275,479,12,566,474,2840,6146
0.572,6,12,1653,6,288,108,288,548,6,426,69,434,1105
1787.06,6,102,8364,68,66,26672,66,4964,34,60,54150,60,3400
66.138,6,37,10233,19,783,495,1360,4711,18,435,3879,2667,5522
1770.872,6,104,9883,68,70,26430,234,5948,36,60,50593,83,3935
0.089,6,10,1378,5,145,22,145,349,5,825,18,825,1029
1.371,6,48,18846,27,865,52,1360,13230,21,476,59,2715,5616
0.032,17,3,392,2,60,13,60,176,1,188,0,188,216
0.266,1,2,112,2,28,266,28,112,0,0,0,0,0
11.366,17,3,984,3,300,5683,300,984,0,0,0,0,0
1764.651,2,14,448,14,8,135742,8,448,0,0,0,0,0
1786.37,6,104,8376,68,65,26662,65,4930,36,59,51036,59,3446
128.05,6,24,9863,12,410,56,922,1742,12,953,11628,2720,8121
280.414,6,29,7392,13,158,23367,267,1317,16,678,18691,2760,6075
1771.052,6,99,9174,66,64,27246,64,5544,33,58,55342,58,3630
1763.552,2,12,384,12,8,160322,8,384,0,0,0,0,0
1.227,6,47,18718,27,859,47,1360,13142,20,476,56,2715,5576
0.528,6,23,7428,14,273,40,663,2104,9,1209,62,2736,5324
4.442,6,50,20022,25,416,185,1360,4052,25,787,176,1360,15970
3.879,17,4,352,2,48,3867,48,152,2,72,3867,72,200
1090.749,17,216,16416,216,48,5073,48,16416,0,0,0,0,0
0.004,17,2,378,1,30,0,30,58,1,292,0,292,320
1786.069,6,373,25959,215,98,8346,469,15223,158,69,11376,69,10736
668.198,17,50,3984,27,48,25699,48,2052,23,56,25694,56,1932
0.506,17,24,10093,11,516,48,1350,5992,13,287,39,1350,4101
1781.723,1,8,848,8,78,254531,78,848,0,0,0,0,0
17.169,17,4,824,2,48,17127,48,152,2,308,17143,308,672
27.155,17,8,608,8,48,3879,48,608,0,0,0,0,0
0.444,6,10,968,5,256,109,256,460,5,304,109,304,508
771.052,17,192,18415,90,110,8652,1350,12508,102,29,7634,61,5907
1.402,6,38,8254,19,321,77,1164,2718,19,433,67,1360,5536
1770.451,6,154,21021,91,182,19671,826,13126,63,100,28554,234,7895
0.015,6,12,3462,6,75,3,75,395,6,1373,3,1448,3067
0.004,17,2,558,1,32,0,32,60,1,470,0,470,498
8.779,6,36,8457,18,410,516,917,1984,18,441,506,1460,6473
2.7,1,5,779,5,127,675,173,779,0,0,0,0,0
1659.591,17,14,582,13,14,138299,14,546,1,8,0,8,36
1783.157,17,164,15184,82,70,22013,952,8104,82,58,22013,72,7080
5.018,17,4,288,2,36,5005,36,128,2,52,4998,52,160
0.127,17,2,574,1,32,0,32,60,1,486,0,486,514
43.225,17,33,9857,15,392,3087,1350,6312,18,168,2536,1350,3545
1.373,6,50,19431,27,901,52,1360,13735,23,433,53,1360,5696
1784.765,6,390,31794,218,91,8224,1189,15111,172,137,10437,1917,16683
291.554,1,4,326,4,53,97184,78,326,0,0,0,0,0
1740.612,17,30,31680,30,1028,60021,1028,31680,0,0,0,0,0
1769.831,1,8,848,8,78,252833,78,848,0,0,0,0,0
0.009,17,2,461,1,34,0,34,62,1,371,0,371,399
13.218,6,2243,2081578,1397,1410,9,1448,2032922,846,776,15,1448,48656
0.304,6,26,9041,13,261,25,683,1752,13,1100,24,2816,7289
1784.064,1,58,4872,58,56,31299,56,4872,0,0,0,0,0
0.39,6,10,968,5,256,93,256,460,5,304,92,304,508
280.479,6,30,7432,13,158,23373,267,1317,17,543,17526,1400,6115
659.105,2,6,192,6,8,131821,8,192,0,0,0,0,0
1.565,6,46,19090,27,888,60,1360,13554,19,476,75,2715,5536
8.646,6,36,8275,18,350,508,734,1802,18,441,498,1360,6473
5.588,17,4,1354,2,300,4587,300,656,2,321,4590,321,698
1772.627,6,180,15480,120,69,14896,69,8940,60,69,30040,69,6540
1771.455,6,102,9462,66,66,27253,66,5610,36,60,50610,60,3852
0.551,6,10,1669,6,551,110,947,1346,4,159,183,159,323
126.345,6,8,474,2,106,126337,106,194,6,0,25267,0,280
0.01,6,13,5740,7,135,1,135,507,6,1637,1,2017,5233
1773.6,6,182,15629,121,69,14780,69,8980,61,69,29552,69,6649
0.011,17,4,420,2,33,0,33,122,2,121,1,145,298
31.183,17,36,5292,18,48,1833,48,1368,18,190,1833,308,3924
0.119,6,9,527,5,43,29,43,311,4,0,37,0,216
12.003,17,2,150,2,47,12003,47,150,0,0,0,0,0
1.05,17,4,580,2,40,1017,40,136,2,194,963,194,444
180.447,2,2,64,2,8,180447,8,64,0,0,0,0,0
0.64,6,12,1653,6,288,124,288,548,6,426,69,434,1105
310.713,6,2883,1481297,1628,843,190,1152,1415639,1255,367,247,1179,65658
43.683,1,4,224,4,28,14561,28,224,0,0,0,0,0
1056.005,6,13,1140,13,47,88000,62,1140,0,0,0,0,0
0.415,6,22,7342,12,335,37,668,1974,10,1210,45,1906,5368
1766.175,17,55,18432,55,307,32706,308,18432,0,0,0,0,0
0.716,17,4,1344,4,308,238,308,1344,0,0,0,0,0
123.914,6,32,7717,12,155,28,267,1266,20,376,6521,3417,6451
0.03,17,2,180,1,30,0,30,58,1,94,0,94,122
248.209,17,6,2016,6,308,49641,308,2016,0,0,0,0,0
1.342,6,6,340,3,0,671,0,160,3,0,506,0,180
424.739,17,25,8396,25,307,17697,308,8396,0,0,0,0,0
1786.556,6,104,8376,68,65,26665,65,4930,36,59,51041,59,3446
280.523,6,30,7432,13,158,23376,267,1317,17,603,17530,2076,6115
1742.674,6,95,7203,63,38,28107,205,4476,32,33,56209,98,2727
33.014,6,105,35844,56,560,600,1360,25266,49,344,664,2720,10578
1774.207,17,142,11360,71,48,25345,48,5396,71,56,25345,56,5964
1786.406,6,106,8388,68,64,26662,64,4896,38,58,48278,58,3492
0.016,6,2,421,1,0,0,0,40,1,341,0,341,381
1769.477,6,146,9018,77,26,23282,26,4696,69,26,26021,26,4322
1.263,6,11,1727,7,100,210,100,384,4,589,336,1152,1343
1008.701,2,7,224,7,8,168116,8,224,0,0,0,0,0
280.045,6,28,7352,13,158,23337,267,1317,15,678,20000,2045,6035
4.34,17,2,1430,2,687,4340,687,1430,0,0,0,0,0
224.184,17,6,528,3,60,112091,60,264,3,60,112091,60,264
729.133,1,4,224,4,28,243044,28,224,0,0,0,0,0
0.94,6,7,295,4,0,313,0,164,3,7,119,7,131
10.617,6,30,7432,13,158,884,267,1317,17,543,661,1400,6115
1.439,6,37,8284,19,332,79,1234,2788,18,433,74,1360,5496
1779.346,17,324,66783,324,178,5508,422,66783,0,0,0,0,0
200.301,6,138,51065,68,688,2989,1360,37187,70,335,2892,1360,13878
296.368,6,6,364,4,31,98789,31,222,2,31,296179,31,142
128.733,6,43,10126,22,681,930,1360,4377,21,349,6428,2667,5749
1778.929,17,140,11200,70,48,25781,48,5320,70,56,25781,56,5880
1793.462,17,180,11520,180,36,10019,36,11520,0,0,0,0,0
11.426,6,27,7177,13,155,952,267,1306,14,530,878,3417,5871
280.213,6,27,7312,13,158,23351,267,1317,14,775,21551,4836,5995
3.995,17,4,268,4,39,1331,39,268,0,0,0,0,0
164.93,6,38,6176,17,177,10296,722,2490,21,260,8237,1408,3686
1744.698,2,20,640,20,8,91826,8,640,0,0,0,0,0
0.925,17,2,144,1,36,0,36,64,1,52,0,52,80
297.929,2,5,160,5,8,74482,8,160,0,0,0,0,0
1776.11,17,142,11360,71,48,25372,48,5396,71,56,25372,56,5964
0.84,6,10,1687,7,100,140,100,384,3,1179,299,1179,1303
1772.043,6,180,15480,120,69,14891,69,8940,60,69,30032,69,6540
6.073,17,6,1251,3,34,3030,34,186,3,327,3030,327,1065
1772.487,6,180,15480,120,69,14894,69,8940,60,69,30036,69,6540
0.932,17,2,312,2,128,932,128,312,0,0,0,0,0
1740.644,17,29,30624,29,1028,62165,1028,30624,0,0,0,0,0
11.095,17,16,17771,16,1082,739,1451,17771,0,0,0,0,0
1684.468,2,26,832,26,8,67378,8,832,0,0,0,0,0
280.24,6,30,7432,13,158,23353,267,1317,17,543,17513,1300,6115
1771.861,6,180,15480,120,69,14889,69,8940,60,69,30030,69,6540
0.371,6,31,17475,16,129,24,129,969,15,1309,26,1479,16506
280.229,6,29,7392,13,158,23352,267,1317,16,603,18679,2236,6075
280.58,6,30,7432,13,158,23381,267,1317,17,603,17531,2076,6115
8.344,17,3,1236,3,384,4172,394,1236,0,0,0,0,0
148.039,6,23,8150,12,420,59,958,1809,11,841,14790,2720,6341
1777.235,6,183,15738,121,69,14810,69,8980,62,69,29132,69,6758
1777.358,6,102,8228,68,64,26527,64,4896,34,58,53857,58,3332
240.497,6,61,24576,27,548,9249,1418,6350,34,783,7287,1418,18226
1786.438,6,102,8364,68,66,26663,66,4964,34,60,54131,60,3400
295.639,6,34,7034,16,262,19706,517,1628,18,744,17387,1418,5406
1798.064,6,367,25650,214,99,8441,469,15045,153,69,11827,69,10605
0.489,6,25,6055,13,108,40,147,959,12,768,44,1420,5096
202.451,6,29,7451,10,199,234,293,1602,19,391,11233,1179,5849
1790.174,17,142,11360,71,48,25573,48,5396,71,56,25573,56,5964
1790.084,6,330,21618,194,69,9275,69,12038,136,69,13259,69,9580
1.303,6,4,1182,3,92,651,92,248,1,882,0,882,934
240.139,6,46,9260,24,209,10440,834,2720,22,538,11434,2338,6540
0.291,17,2,152,1,48,0,48,76,1,48,0,48,76
61.329,6,35,15923,22,809,2920,1408,9249,13,855,5090,3847,6674
65.005,6,13,716,8,0,9286,0,432,5,0,15831,0,284
280.453,6,28,7352,12,158,25495,267,1277,16,603,18690,1400,6075
6.162,6,44,8385,23,227,280,314,4102,21,491,295,1179,4283
141.699,6,22,8584,11,556,102,1329,2140,11,998,14148,1791,6444
1772.089,6,180,15480,120,69,14891,69,8940,60,69,30032,69,6540
0.075,17,2,366,1,32,0,32,60,1,278,0,278,306
12.14,17,10,845,5,34,3033,34,310,5,79,3033,79,535
0.507,6,7,376,4,0,169,0,216,3,0,143,0,160
2.398,17,4,580,2,40,2065,40,136,2,194,2053,194,444
55.076,6,48,10415,22,533,784,910,3107,26,312,2197,1460,7308
0.026,17,4,368,2,32,8,32,120,2,96,13,96,248
24.461,6,27,7177,13,155,2038,267,1306,14,530,1880,3417,5871
141.609,6,25,12732,13,519,62,884,2629,12,1201,12862,3928,10103
3.111,6,12,3702,6,170,586,170,490,6,964,621,1448,3212
1.457,6,47,19570,27,920,56,1460,13994,20,433,58,1460,5576
25.499,6,3601,3427508,2318,1400,10,1440,3356104,1283,776,19,1440,71404
4.227,6,18,5176,10,150,469,174,708,8,828,93,1420,4468
0.016,17,2,417,1,34,0,34,62,1,327,0,327,355
1680.725,17,13,534,11,14,168053,14,462,2,8,1680537,8,72
115.905,6,34,14231,17,549,363,944,2970,17,879,7198,1460,11261
1.699,6,26,8069,16,288,113,598,1510,10,879,168,1452,6559
61.318,6,37,17274,23,783,2787,1402,9823,14,839,4696,2451,7451
0.005,17,2,416,1,58,0,58,86,1,302,0,302,330
0.458,6,24,5962,12,164,41,453,1442,12,648,40,1440,4520
1798.445,6,365,25032,213,94,8483,469,14536,152,69,11908,69,10496
11.063,6,36,14875,19,318,614,721,3310,17,1360,564,2535,11565
11.932,6,1741,1629071,1151,1365,10,1420,1601180,590,475,20,1883,27891
0.287,6,26,8913,13,242,23,610,1655,13,1095,23,2816,7258
99.534,1,6,336,6,28,19906,28,336,0,0,0,0,0
1682.705,17,14,1036,7,30,280441,30,406,7,62,280443,62,630
28.153,6,100,50101,47,1239,612,1360,42817,53,337,537,1360,7284
142.502,17,4,240,2,32,142501,32,120,2,32,142501,32,120
0.157,17,4,524,2,39,141,39,134,2,167,141,167,390
539.561,2,4,128,4,8,179853,8,128,0,0,0,0,0
0.045,17,4,588,2,48,40,48,152,2,190,38,308,436
280.069,6,30,7432,14,158,21543,267,1357,16,603,18666,2800,6075
60.193,17,28,2323,26,30,2406,37,1515,2,376,421,463,808
8.216,17,6,528,3,48,4101,48,228,3,72,4101,72,300
240.708,6,40,5920,19,222,13369,582,2775,21,254,12033,580,3145
0.482,6,12,1653,6,288,93,288,548,6,426,53,434,1105
301.04,6,41,13052,22,814,14326,1360,7428,19,404,16714,4027,5624
58.81,6,44,10601,22,773,469,1360,4826,22,348,2791,2667,5775
1750.664,17,12,498,11,14,175066,14,462,1,8,0,8,36
115.04,6,31,8912,14,158,8849,267,1357,17,687,7186,2800,7555
10.98,6,20,4442,11,275,1098,275,998,9,768,768,1440,3444
1.748,17,6,1844,3,64,861,64,276,3,494,465,504,1568
0.004,17,2,315,1,50,0,50,78,1,209,0,209,237
1660.119,1,8,448,8,28,237159,28,448,0,0,0,0,0
5.8,6,40,7309,20,218,305,314,3423,20,440,292,1152,3886
298.573,17,4,352,2,60,298571,60,176,2,60,298572,60,176
1786.438,6,104,8444,68,66,26663,66,4964,36,60,51038,60,3480
1.614,6,23,5529,12,140,146,267,1184,11,780,153,1460,4345
375.89,6,21,1422,15,180,26849,180,992,6,110,12236,110,430
240.568,2,4,128,4,8,80189,8,128,0,0,0,0,0
48.266,6,36,8455,17,410,542,882,1942,19,441,2673,1460,6513
62.269,6,36,15843,22,796,2965,1368,9117,14,748,4767,2736,6726
0.215,17,10,6308,5,606,53,1350,3171,5,599,31,1350,3137
1.272,6,30,6220,16,138,84,267,1755,14,650,87,1452,4465
116.454,6,119,88327,74,1276,1595,1448,77875,45,675,2398,1448,10452
721.936,2,10,320,10,8,80215,8,320,0,0,0,0,0
365.945,1,14,1176,14,56,28149,56,1176,0,0,0,0,0
1742.089,6,138,8761,76,49,23227,208,5382,62,31,28537,31,3379
5.007,17,4,288,2,36,5006,36,128,2,52,4962,52,160
1780.482,6,111,8898,72,65,25077,65,5155,39,59,46852,59,3743
1.981,17,2,672,2,308,1981,308,672,0,0,0,0,0
1786.673,6,104,8444,68,66,26666,66,4964,36,60,51045,60,3480
1772.542,6,203,22290,130,75,13740,267,10057,73,134,24617,1997,12233
2.22,6,58,14227,29,553,79,1429,5080,29,419,72,1986,9147
5.978,6,46,8465,23,227,271,314,4102,23,491,259,1179,4363
62.219,6,80,53809,48,1191,1323,1368,45409,32,747,1998,1368,8400
1799.606,6,137,9225,76,52,23994,208,5283,61,40,29988,224,3942
61.34,6,11,452,6,0,12268,0,244,5,0,15297,0,208
243.398,17,4,240,2,32,243397,32,120,2,32,243396,32,120
306.042,6,18,1265,11,31,30604,31,715,7,31,50979,31,550
280.524,6,29,7392,13,158,23377,267,1317,16,678,18698,2085,6075
1658.419,1,7,392,7,28,276403,28,392,0,0,0,0,0
1790.299,6,359,32709,171,108,10531,469,14580,188,74,9573,1460,18129
0.121,6,9,1339,5,145,30,145,349,4,826,37,826,990
0.016,6,20,12917,12,125,1,125,793,8,2340,2,3012,12124
1.002,17,2,176,2,60,1002,60,176,0,0,0,0,0
9.997,17,3,1008,3,308,4998,308,1008,0,0,0,0,0
1793.598,17,87,3648,86,14,21101,14,3612,1,8,0,8,36
240.218,6,57,20048,31,816,8006,1418,17133,26,194,9608,580,2915
123.268,17,4,240,2,32,123267,32,120,2,32,123267,32,120
372.147,6,22,2259,16,141,24809,141,813,6,398,4662,419,1446
1799.605,17,449,39928,404,35,4465,288,25708,45,288,40017,288,14220
11.645,17,21,5997,9,324,1451,1350,3170,12,207,1055,1350,2827
280.472,6,28,7352,12,158,25497,267,1277,16,678,18694,2085,6075
1710.227,1,8,448,8,28,244318,28,448,0,0,0,0,0
1.133,6,7,1567,4,100,377,100,264,3,1179,436,1179,1303
1798.76,6,100,7556,66,38,27673,205,4663,34,33,54495,98,2893
0.29,17,2,152,1,48,0,48,76,1,48,0,48,76
240.197,6,53,17421,28,767,8895,1402,14505,25,201,10007,580,2916
28.641,6,26,6348,15,117,2045,159,1389,11,873,2858,1709,4959
23.454,6,35,8258,17,175,1465,721,2085,18,681,1367,2840,6173
1645.413,1,7,392,7,28,274235,28,392,0,0,0,0,0
0.671,6,37,11361,21,622,33,1188,7314,16,356,38,1048,4047
1040.222,1,14,784,14,28,80017,28,784,0,0,0,0,0
0.198,6,48,22002,28,1054,7,1420,16972,20,421,10,1883,5030
40.538,6,661,672830,408,146,99,228,22615,253,2548,42,12672,650215
1793.501,17,178,11392,178,36,10132,36,11392,0,0,0,0,0
1777.496,17,140,11200,70,48,25760,48,5320,70,56,25760,56,5880
6.152,17,4,304,3,48,3049,48,228,1,48,0,48,76
1.922,17,2,312,2,128,1922,128,312,0,0,0,0,0
1737.114,17,218,45969,218,182,8005,377,45969,0,0,0,0,0
4.993,6,40,7309,22,218,237,314,3503,18,513,278,1179,3806
1789.956,6,379,26806,217,103,8286,469,15841,162,69,11117,69,10965
70.949,6,10,580,3,0,35474,0,160,7,0,5540,0,420
1798.88,17,449,39928,404,35,4463,288,25708,45,288,40018,288,14220
2.178,6,5,284,1,0,0,0,52,4,0,726,0,232
40.119,17,22,1936,11,48,4010,48,836,11,72,4010,72,1100
177.33,6,29,1944,12,46,16120,46,804,17,46,11074,46,1140
0.121,6,11,1535,5,507,30,507,727,6,556,24,556,808
1792.061,1,342,28728,342,56,5255,56,28728,0,0,0,0,0
26.007,6,38,9493,17,268,1625,721,3098,21,555,1290,1440,6395
1794.598,6,356,22520,208,69,8669,69,12460,148,69,12208,69,10060
1740.53,17,30,31680,30,1028,60018,1028,31680,0,0,0,0,0
0.499,17,2,152,1,48,0,48,76,1,48,0,48,76
1785.863,6,108,8604,68,66,26654,66,4964,40,60,45789,60,3640
0.044,17,4,352,2,37,1,37,130,2,83,1,89,222
4.184,6,8,559,7,31,603,31,519,1,0,0,0,40
1797.798,17,448,39896,403,35,4472,288,25676,45,288,40016,288,14220
126.346,6,23,11944,9,275,15793,275,639,14,895,9647,1420,11305
1.258,6,13,1211,7,182,209,182,724,6,77,164,134,487
317.036,6,88,19963,41,291,7925,1360,9550,47,274,6888,4649,10413
0.012,17,4,368,2,32,12,32,120,2,96,11,96,248
212.215,6,71,50191,46,1204,4715,1408,42159,25,960,2566,3847,8032
0.128,6,10,1569,5,627,31,627,895,5,406,32,406,674
1421.805,17,142,12077,131,30,10936,37,7640,11,375,136217,463,4437
0.039,17,2,588,1,39,0,39,67,1,493,0,493,521
15.378,17,21,9703,10,432,1705,1350,4608,11,435,1534,1350,5095
0.385,6,12,1653,6,288,71,288,548,6,426,43,434,1105
0.028,17,2,206,1,44,0,44,72,1,106,0,106,134
1781.167,17,142,11360,71,48,25445,48,5396,71,56,25445,56,5964
108.224,6,33,18709,18,702,54,1360,4967,15,1313,7719,2720,13742
240.316,6,55,17787,28,785,8900,1402,14815,27,195,9242,580,2972
0.004,6,3,151,1,0,0,0,40,2,31,0,31,111
0.59,6,50,20645,28,958,21,1380,15523,22,421,25,1923,5122
0.004,6,23,50432,1,0,0,0,40,22,2238,0,2736,50392
3.002,17,3,264,3,60,1501,60,264,0,0,0,0,0
1675.608,17,267,52369,267,168,6299,391,52369,0,0,0,0,0
1771.347,6,104,9648,68,65,26438,65,5758,36,59,50607,59,3890
0.074,17,2,168,1,48,0,48,76,1,64,0,64,92
86.876,17,29,30088,29,1009,3102,1450,30088,0,0,0,0,0
12.242,17,20,3900,10,32,1346,32,600,10,302,1358,308,3300
1787.494,6,102,8296,68,65,26679,65,4930,34,59,54162,59,3366
0.144,17,2,412,1,33,0,33,61,1,323,0,323,351
34.462,6,38,7542,18,154,2016,722,2063,20,443,1804,1408,5479
0.645,17,4,624,2,64,643,64,184,2,192,482,192,440
393.381,6,134,103450,86,1262,4628,1368,92827,48,738,2153,2519,10623
1740.686,17,30,7050,30,207,60023,207,7050,0,0,0,0,0
15.662,17,19,13193,11,981,1558,1350,11105,8,233,2227,1350,2088
1787.48,6,105,8475,68,65,26678,65,4930,37,59,49648,59,3545
0.003,17,3,996,3,304,1,333,996,0,0,0,0,0
633.094,2,8,320,8,16,90442,16,320,0,0,0,0,0
1743.122,6,99,7411,63,38,28114,205,4476,36,33,49798,98,2935
280.514,6,30,7432,14,158,21578,267,1357,16,678,18696,3456,6075
29.819,6,27,7177,13,155,2484,267,1306,14,530,2293,3417,5871
0.092,1,2,112,2,28,92,28,112,0,0,0,0,0
31.169,17,3,1008,3,308,15584,308,1008,0,0,0,0,0
12.482,6,1988,1718847,1213,1362,10,1380,1683614,775,467,16,1923,35233
120.262,2,3,96,3,8,60131,8,96,0,0,0,0,0
1772.569,6,180,15480,120,69,14895,69,8940,60,69,30039,69,6540
0.259,6,10,1186,5,357,64,357,561,5,421,55,421,625
1720.608,17,12,498,11,14,172060,14,462,1,8,0,8,36
1726.239,17,167,37192,167,194,10399,422,37192,0,0,0,0,0
376.262,6,25,1651,17,177,23516,177,1117,8,110,9291,110,534
172.841,1,5,280,5,28,43210,28,280,0,0,0,0,0
26.418,6,39,8348,20,188,1390,721,2127,19,681,1455,1420,6221
1769.719,6,101,9344,66,65,27226,65,5577,35,59,52046,59,3767
62.739,6,30,7297,14,155,4826,267,1346,16,441,4182,1420,5951
143.269,1,28,2912,0,0,0,0,0,28,76,5306,76,2912
11.839,6,25,8473,13,275,986,275,1078,12,986,852,1440,7395
167.476,6,32,14574,18,899,101,1360,6149,14,981,12870,3639,8425
0.473,17,3,451,2,39,226,39,134,1,289,0,289,317
1792.66,17,271,74354,271,246,6639,422,74354,0,0,0,0,0
2.888,6,60,22756,33,931,90,1440,13532,27,478,102,1440,9224
112.111,6,25,8812,13,654,73,1460,3171,12,858,10175,1547,5641
1.408,6,38,8252,19,320,78,1162,2716,19,433,68,1460,5536
1786.235,6,102,8364,68,66,26660,66,4964,34,60,54124,60,3400
1674.498,1,7,742,7,78,279083,78,742,0,0,0,0,0
0.966,17,4,352,2,60,965,60,176,2,60,962,60,176
6.334,6,45,8409,23,227,287,314,4102,22,489,290,1179,4307
1737.324,2,19,608,19,8,96518,8,608,0,0,0,0,0
158.564,6,18,1092,12,31,14398,31,759,6,31,31676,31,333
0.975,6,10,1687,7,100,162,100,384,3,1179,354,1179,1303
1453.798,1,88,4928,88,28,16710,28,4928,0,0,0,0,0
1739.998,1,57,4788,57,56,31071,56,4788,0,0,0,0,0
1787.156,6,103,8336,68,65,26673,65,4930,35,59,52559,59,3406
294.289,1,4,224,4,28,98096,28,224,0,0,0,0,0
2.351,17,3,1167,3,361,1175,361,1167,0,0,0,0,0
130.365,6,25,9841,12,457,69,1360,2342,13,995,10851,1360,7499
302.134,6,58,21841,30,1035,10418,1360,15753,28,407,368,4027,6088
1789.356,6,362,22898,210,69,8561,69,12678,152,69,11849,69,10220
1746.921,6,97,7307,63,38,28176,205,4476,34,33,52929,98,2831
0.231,17,2,214,1,47,0,47,75,1,111,0,111,139
1786.391,6,285,35571,121,144,14885,1360,18166,164,131,10958,2720,17405
0.062,17,2,214,1,39,0,39,67,1,119,0,119,147
1.278,6,47,20165,26,962,51,1460,14549,21,433,55,1460,5616
0.017,17,2,330,1,30,0,30,58,1,244,0,244,272
11.952,6,1076,932180,613,1436,18,1448,902276,463,776,25,1448,29904
1740.243,1,56,4704,56,56,31640,56,4704,0,0,0,0,0
5.135,17,95,125250,93,1317,36,1472,125170,2,12,5047,12,80
1755.696,17,15,4272,15,256,125406,1084,4272,0,0,0,0,0
80.344,6,77,52271,47,1221,1746,1448,43987,30,746,2125,1448,8284
0.214,6,3,453,2,241,214,241,321,1,92,0,92,132
300.751,6,35,16141,16,195,20050,431,1620,19,845,7069,2804,14521
4.072,17,8,1808,4,64,1334,64,368,4,332,1355,344,1440
1766.088,1,8,848,8,78,252298,78,848,0,0,0,0,0
10.974,6,18,2826,9,194,1346,194,642,9,362,1344,1360,2184
1.025,6,57,16074,28,553,37,1429,5076,29,517,35,1986,10998
11.746,6,2516,2350428,1614,1378,7,1408,2298860,902,931,12,2816,51568
1652.402,17,98,14216,98,117,17035,362,14216,0,0,0,0,0
1772.247,6,180,15480,120,69,14892,69,8940,60,69,30032,69,6540
650.447,17,155,22596,78,48,8446,48,5928,77,188,8557,308,16668
8.251,6,70,20766,36,559,235,1152,15979,34,427,242,1152,4787
1.16,17,3,215,2,33,1140,33,122,1,65,0,65,93
1777.049,17,73,3060,72,14,25028,14,3024,1,8,0,8,36
375.885,6,18,1242,14,180,28914,180,916,4,110,20058,110,326
154.944,17,4,240,2,32,154943,32,120,2,32,154943,32,120
1800.0,6,212,16318,79,68,23076,297,7724,133,48,13636,78,8594
375.041,6,21,1682,16,177,25002,177,1194,5,110,17904,110,488
1756.601,6,112,6751,63,27,28331,27,3732,49,27,36594,27,3019
9.707,6,84,26738,43,572,231,1152,20616,41,407,235,1152,6122
12.759,6,2424,2275579,1532,1406,8,1440,2224531,892,776,14,1440,51048
5.113,6,25,6104,12,108,464,147,919,13,665,425,1581,5185
66.035,17,4,288,2,36,66035,36,128,2,52,66034,52,160
504.548,2,4,128,4,8,168182,8,128,0,0,0,0,0
0.363,6,27,9047,14,252,27,647,1744,13,945,29,1438,7303
321.314,6,105,10617,52,148,6300,267,3127,53,114,6178,256,7490
36.836,1,41,4264,0,0,0,0,0,41,76,920,76,4264
0.073,6,10,1510,5,657,18,657,925,5,317,18,317,585
1.291,6,15,2638,8,288,173,288,640,7,568,185,853,1998
20.539,17,6,528,3,48,10265,48,228,3,72,10265,72,300
20.14,6,22,4550,12,205,1830,517,1879,10,428,2236,499,2671
0.176,6,9,1002,5,213,44,213,417,4,421,46,421,585
0.174,6,46,21878,27,1053,6,1420,16897,19,467,9,1883,4981
0.223,6,16,5867,8,290,31,517,1005,8,1109,29,1408,4862
1022.776,2,9,288,9,8,127847,8,288,0,0,0,0,0
0.249,17,3,451,2,39,176,39,134,1,289,0,289,317
1786.575,6,104,8308,68,64,26665,64,4896,36,58,51042,58,3412
1793.925,6,279,25537,167,75,10806,267,11675,112,133,16161,2828,13862
9.351,6,1642,1489662,1021,1380,8,1408,1452706,621,931,14,2801,36956
0.089,6,11,913,6,182,17,182,490,5,77,8,134,423
7.767,6,15,1362,8,275,1109,275,878,7,96,983,96,484
13.907,6,29,7533,11,155,1390,267,1226,18,398,817,2006,6307
76.923,6,34,19183,16,708,49,1460,4226,18,1094,4516,1460,14957
331.241,1,21,1764,21,56,16562,56,1764,0,0,0,0,0
72.627,6,40,8592,20,359,805,762,1945,20,416,3815,3488,6647
1.925,6,30,8955,18,283,113,583,1575,12,985,157,1420,7380
0.029,17,2,467,1,33,0,33,61,1,378,0,378,406
5.333,6,42,8305,21,227,266,314,4022,21,491,253,1179,4283
2.255,6,26,8521,15,175,161,362,1666,11,896,167,1408,6855
0.372,6,85,57786,52,1253,7,1420,52245,33,467,11,1883,5541
1798.748,17,455,41420,405,35,4452,288,25784,50,284,36201,308,15636
1783.602,6,207,23921,133,89,13512,981,11227,74,138,24421,1917,12694
61.477,6,26,8509,13,211,5123,362,1519,13,788,5108,1448,6990
11.242,6,1776,1553115,1076,1390,10,1420,1520894,700,467,16,1883,32221
1788.395,1,272,28832,272,78,6599,78,28832,0,0,0,0,0
481.369,2,5,160,5,8,120342,8,160,0,0,0,0,0
282.044,6,31,7563,14,147,21695,267,1448,17,543,17622,1400,6115
0.406,17,2,782,2,363,406,363,782,0,0,0,0,0
1778.252,1,136,7616,136,28,13172,28,7616,0,0,0,0,0
0.0,6,1,88,0,0,0,0,0,1,48,0,48,88
0.215,17,2,152,1,48,0,48,76,1,48,0,48,76
0.014,6,12,1845,7,139,2,139,511,5,533,3,904,1334
758.135,6,109,9980,41,76,18950,301,4080,68,90,11315,1062,5900
1767.76,6,30,4679,20,241,93040,241,3451,10,92,196397,92,1228
1793.725,17,180,11520,180,36,10020,36,11520,0,0,0,0,0
0.164,6,46,22543,27,1097,6,1420,17562,19,467,8,1883,4981
219.489,17,96,24864,96,231,2310,388,24864,0,0,0,0,0
1786.17,6,110,8936,70,66,25886,66,5176,40,60,45796,60,3760
0.017,6,2,450,1,0,0,0,40,1,370,0,370,410
300.813,6,50,10526,25,433,12533,910,3258,25,312,536,1460,7268
1401.383,17,12,888,6,30,280273,30,348,6,62,280273,62,540
1790.89,6,363,23007,210,69,8568,69,12678,153,69,11780,69,10329
11.131,6,18,5610,10,275,1236,275,958,8,1440,853,1440,4652
287.522,6,26,6310,10,267,80,501,1205,16,343,19162,1420,5105
12.328,6,93,28106,47,552,268,1152,21784,46,447,268,1179,6322
1794.465,6,363,23007,211,69,8545,69,12787,152,69,11882,69,10220
0.003,17,3,1540,3,485,1,513,1540,0,0,0,0,0
4.965,6,39,7269,20,218,261,314,3423,19,440,261,1152,3846
4.004,17,4,368,4,64,1334,64,368,0,0,0,0,0
240.42,6,69,24279,35,872,7070,1418,19329,34,262,7285,580,4950
5.024,17,4,288,2,36,5005,36,128,2,52,5004,52,160
296.557,6,31,9082,11,181,29655,267,1168,20,474,15543,1400,7914
0.151,17,4,368,2,32,1,32,120,2,96,0,96,248
756.217,2,5,160,5,8,189054,8,160,0,0,0,0,0
11.791,6,30,18187,9,169,1451,213,731,21,1106,579,1440,17456
8.995,6,17,5391,9,275,1124,275,643,8,1104,1246,1440,4748
0.063,17,2,118,1,31,0,31,59,1,31,0,31,59
63.239,6,54,12977,22,392,515,1189,5206,32,270,2039,1420,7771
97.133,6,79,55519,50,1207,1982,1368,47273,29,747,2208,1368,8246
0.075,17,2,136,1,32,0,32,60,1,48,0,48,76
110.942,17,3905,4606562,550,80,202,1350,59497,3355,1327,33,1350,4547065
41.902,17,5,207,4,12,13967,14,163,1,16,0,16,44
1793.57,1,130,7280,130,28,13903,28,7280,0,0,0,0,0
280.456,6,30,7432,14,158,21573,267,1357,16,678,18692,3456,6075
144.894,6,32,8952,14,158,11145,267,1357,18,624,8519,1400,7595
9.809,6,78,24757,39,563,258,1152,19040,39,461,251,1179,5717
0.181,6,2,1440,1,1360,0,1360,1400,1,0,0,0,40
0.257,17,3,234,2,39,59,39,134,1,72,0,72,100
2.296,17,18,10611,10,794,251,1350,8227,8,270,323,1350,2384
180.554,2,3,96,3,8,90277,8,96,0,0,0,0,0
1781.731,17,73,3060,72,14,25094,14,3024,1,8,0,8,36
233.762,6,26,7272,12,158,21251,267,1277,14,775,17978,3445,5995
26.317,6,44,12738,20,199,1385,721,2398,24,669,1134,1440,10340
1.271,6,12,3462,6,75,254,75,395,6,1373,254,1448,3067
1792.717,1,342,28728,342,56,5257,56,28728,0,0,0,0,0
257.471,6,27,8680,8,154,36781,267,792,19,547,14298,1460,7888
19.217,17,34,7096,14,190,1476,1350,3061,20,173,1009,1350,4035
4.891,6,22,4906,12,233,444,613,1785,10,518,522,1408,3121
27.474,17,8,608,8,48,3924,48,608,0,0,0,0,0
165.788,6,33,7291,14,169,12721,516,1578,19,291,9204,1452,5713
1.984,6,23,8365,14,175,152,362,1614,9,1255,166,2804,6751
0.55,17,4,560,2,64,405,64,184,2,160,426,160,376
0.878,6,10,1687,7,100,146,100,384,3,1179,313,1179,1303
236.513,17,4,352,2,60,236511,60,176,2,60,236512,60,176
1784.509,6,94,10216,46,203,39654,517,3214,48,748,37967,2409,7002
43.011,17,4,304,4,48,14337,48,304,0,0,0,0,0
1743.23,1,56,4704,56,56,31695,56,4704,0,0,0,0,0
3.328,6,39,14864,22,716,158,1408,12623,17,192,207,580,2241
1773.153,6,183,15738,121,69,14776,69,8980,62,69,29063,69,6758
0.064,6,10,583,5,43,16,43,311,5,0,15,0,272
4.762,6,39,7285,20,218,250,314,3423,19,516,250,1179,3862
0.014,6,2,196,2,92,14,92,196,0,0,0,0,0
1682.608,17,14,1036,7,30,280427,30,406,7,62,280428,62,630
7.268,6,5,240,1,0,0,0,48,4,0,2419,0,192
61.204,1,67,8196,67,94,927,336,8196,0,0,0,0,0
2.127,6,25,6059,12,108,193,147,919,13,768,175,1581,5140
917.664,6,124,16001,61,124,15291,721,7413,63,252,14798,1440,8588
33.556,6,30,5064,15,154,2396,721,1882,15,399,2383,2026,3182
1315.477,1,92,5152,92,28,14455,28,5152,0,0,0,0,0
131.258,6,168,132486,109,1314,1215,1408,118781,59,590,1683,2439,13705
66.515,6,68,41865,38,786,149,1258,5915,30,1432,2292,2939,35950
1795.322,17,448,39896,403,35,4465,288,25676,45,288,40022,288,14220
782.062,2,7,224,7,8,130343,8,224,0,0,0,0,0
701.087,1,8,1011,8,98,100155,103,1011,0,0,0,0,0
903.196,17,45,1884,44,14,21004,14,1848,1,8,0,8,36
299.571,6,6,364,4,31,99857,31,222,2,31,299529,31,142
12.963,6,36,11793,16,559,864,1360,4042,20,533,628,1360,7751
5.123,17,4,5484,4,1343,1707,1348,5484,0,0,0,0,0
136.419,6,12019,13350593,3609,760,37,1396,203976,8410,1514,16,6980,13146617
1.36,6,47,18526,27,844,52,1360,12950,20,476,62,2715,5576
95.518,17,141,10260,26,29,3820,288,1504,115,48,835,288,8756
1797.935,17,329,70554,329,186,5481,422,70554,0,0,0,0,0
0.115,17,2,383,1,33,0,33,61,1,294,0,294,322
2.526,6,13,2311,8,188,360,245,700,5,1407,569,1407,1611
718.839,6,7,10444,0,0,0,0,0,7,1452,119806,1452,10444
0.413,6,14,1733,7,288,68,288,588,7,284,37,434,1145
17.581,17,6,6233,6,1010,3516,1451,6233,0,0,0,0,0
15.111,17,11,4718,5,505,3769,1350,2666,6,314,3015,1350,2052
2.805,17,5,418,3,30,1379,30,174,2,94,1812,94,244
0.092,17,2,154,1,33,0,33,61,1,65,0,65,93
6.025,6,40,7309,20,218,317,314,3423,20,513,301,1179,3886
5.014,17,4,288,2,36,4997,36,128,2,52,4996,52,160
0.0,6,1,44,1,0,0,0,44,0,0,0,0,0
13.494,17,4,352,2,60,13493,60,176,2,60,13493,60,176
300.817,6,49,10486,24,433,13079,910,3218,25,312,536,1460,7268
0.032,17,2,116,1,30,0,30,58,1,30,0,30,58
7.59,6,1153,1012466,702,1363,10,1408,984350,451,931,16,2801,28116
258.731,6,31,8912,14,158,19902,267,1357,17,687,16166,1781,7555
233.759,2,2,64,2,8,233759,8,64,0,0,0,0,0
11.427,6,2046,1919940,1320,1376,8,1408,1877524,726,931,15,2816,42416
12.675,6,81,23442,41,507,316,1152,17376,40,446,318,1179,6066
15.292,17,19,10001,9,419,1907,1350,4026,10,569,1695,1350,5975
5.011,17,4,542,2,36,5006,36,128,2,179,5006,187,414
14.421,6,38,8574,14,378,62,787,1714,24,346,621,1360,6860
317.017,6,68,18511,37,311,8806,1360,9290,31,442,10562,4649,9221
1775.62,6,180,15480,120,69,14921,69,8940,60,69,30089,69,6540
1785.567,6,362,24774,211,94,8502,469,14387,151,69,11902,69,10387
1783.724,6,112,9755,72,77,25122,292,5655,40,69,45733,247,4100
0.012,17,2,615,1,44,0,44,72,1,515,0,515,543
1774.462,1,58,4872,58,56,31130,56,4872,0,0,0,0,0
1.662,6,14,2351,8,188,237,245,700,6,703,282,1152,1651
1778.849,17,140,11200,70,48,25780,48,5320,70,56,25780,56,5880
0.0,17,2,254,1,47,0,47,75,1,151,0,151,179
1773.118,6,180,15480,120,69,14900,69,8940,60,69,30048,69,6540
1781.168,1,342,28728,342,56,5223,56,28728,0,0,0,0,0
0.008,17,2,439,1,43,0,43,71,1,340,0,340,368
280.493,6,30,7432,14,158,21576,267,1357,16,678,18691,3536,6075
72.981,6,21,10149,11,433,80,990,1771,10,1327,8093,3928,8378
62.241,6,70,47281,43,1190,1481,1368,39143,27,840,2384,2519,8138
1328.838,6,81,6680,57,64,23729,64,4328,24,58,54139,58,2352
0.421,17,2,201,1,40,0,40,68,1,105,0,105,133
638.847,1,92,5152,92,28,7020,28,5152,0,0,0,0,0
0.045,17,2,904,1,300,0,300,328,1,548,0,548,576
251.59,6,33,8102,14,131,19352,267,1622,19,408,13976,4846,6480
0.001,6,2,1386,1,0,0,0,40,1,1294,0,1294,1346
0.059,6,14,5885,7,186,9,267,661,7,1234,8,3417,5224
280.247,6,29,7392,13,158,23353,267,1317,16,603,18681,1400,6075
1765.668,1,67,5628,67,56,26752,56,5628,0,0,0,0,0
1680.302,1,15,870,15,30,120021,30,870,0,0,0,0,0
0.065,17,4,352,2,60,64,60,176,2,60,64,60,176
1787.118,17,138,11040,69,48,26281,48,5244,69,56,26281,56,5796
31.21,17,18,1584,9,48,3899,48,684,9,72,3898,72,900
301.301,6,56,26538,32,804,9719,1408,9005,24,1085,1130,4133,17533
1767.56,6,196,12325,97,51,18412,208,7404,99,31,18033,31,4921
240.32,6,45,8499,23,449,10923,1418,5700,22,205,11443,580,2799
1740.61,1,56,4704,0,0,0,0,0,56,56,31647,56,4704
1.151,6,23,7952,11,164,97,267,1236,12,1014,88,2804,6716
296.965,17,4,352,2,60,296963,60,176,2,60,296964,60,176
337.975,1,8,448,8,28,48282,28,448,0,0,0,0,0
1.231,6,8,342,4,0,410,0,164,4,7,272,7,178
0.27,17,2,290,1,40,0,40,68,1,194,0,194,222
1791.088,6,356,22520,208,69,8652,69,12460,148,69,12184,69,10060
68.107,6,25,7097,12,155,6191,267,1266,13,589,5674,3426,5831
2.015,6,35,13084,19,525,111,1440,3430,16,818,114,1440,9654
9.427,6,29,7700,15,119,673,267,1610,14,1061,707,1368,6090
6.562,6,1356,1228207,808,1435,7,1448,1191911,548,776,11,1448,36296
0.437,6,53,21942,30,1031,15,1380,16723,23,426,17,3303,5219
90.313,6,18,4080,7,407,15052,722,1174,11,1165,9012,1408,2906
3.872,17,4,352,2,48,3862,48,152,2,72,3860,72,200
81.777,6,23,948,10,0,6271,0,408,13,0,6811,0,540
96.07,6,889,440642,493,828,195,1152,420011,396,398,242,1152,20631
6.613,6,770,603906,404,1405,15,1448,577782,366,776,17,1448,26124
63.192,6,7,420,7,0,0,0,420,0,0,0,0,0
280.24,6,27,7312,13,158,23353,267,1317,14,775,21554,4836,5995
0.185,6,46,33902,20,180,9,250,1590,26,1289,5,1440,32312
3.421,6,9,360,5,0,855,0,200,4,0,1121,0,160
17.251,17,22,12937,12,854,1565,1350,10595,10,206,1913,1350,2342
1.101,6,22,7900,11,164,93,267,1236,11,1216,93,3819,6664
253.993,6,64,15482,31,352,8466,1360,6954,33,378,7931,1360,8528
40.518,17,90,39033,46,684,900,1350,32789,44,113,935,1350,6244
1740.722,17,30,20190,30,645,60024,645,20190,0,0,0,0,0
1781.774,6,356,22520,208,69,8607,69,12460,148,69,12120,69,10060
1772.967,6,180,15480,120,69,14898,69,8940,60,69,30047,69,6540
1783.81,6,375,28522,218,126,8220,469,17481,157,69,11434,69,11041
599.588,6,9,546,6,31,119917,31,333,3,31,299712,31,213
24.57,6,7,328,2,0,24570,0,88,5,0,3822,0,240
280.56,6,30,7432,13,158,23380,267,1317,17,603,17526,2760,6115
1.344,6,38,8278,19,321,74,1164,2742,19,433,64,1360,5536
0.743,6,50,13661,24,533,32,1301,4712,26,493,29,3546,8949
10.308,6,6,328,4,0,3436,0,216,2,0,10084,0,112
1795.451,17,449,39928,404,35,4455,288,25708,45,288,40019,288,14220
0.226,6,22,5040,11,137,22,267,1132,11,577,22,1400,3908
3.917,17,4,288,2,36,3885,36,128,2,52,3884,52,160
291.973,6,41,9241,19,315,16218,517,2596,22,685,13901,1418,6645
243.453,6,40,9024,16,169,11022,516,1658,24,336,10580,1452,7366
0.26,6,9,1340,5,145,65,145,349,4,827,45,827,991
1796.478,6,281,21583,138,218,13105,516,8568,143,40,12649,304,13015
1788.817,6,356,22520,208,69,8641,69,12460,148,69,12168,69,10060
1798.238,17,142,11360,71,48,25688,48,5396,71,56,25688,56,5964
128.443,6,26,7292,10,154,14271,267,872,16,524,8540,1420,6420
3.266,6,77,43878,39,975,85,1360,12372,38,1198,84,1383,31506
0.005,6,3,128,2,0,5,0,84,1,0,0,0,44
1795.693,17,448,39896,403,35,4466,288,25676,45,288,40021,288,14220
280.241,6,30,7432,13,158,23353,267,1317,17,543,17513,1300,6115
25.372,6,36,8451,17,207,1585,721,2136,19,555,1397,1440,6315
0.393,6,10,967,5,256,93,256,460,5,303,92,303,507
0.507,6,23,4531,11,165,50,456,1394,12,498,40,888,3137
0.825,6,23,7420,13,337,68,674,2044,10,969,87,1483,5376
2.031,6,24,5755,13,158,168,370,1315,11,999,202,1731,4440
3.904,17,4,244,4,33,1301,33,244,0,0,0,0,0
18.082,6,16,3249,9,49,2260,92,563,7,463,45,1408,2686
1799.533,6,305,53452,192,304,9421,304,39516,113,83,16067,83,13936
1753.068,6,113,8190,70,31,25406,31,4797,43,31,41739,31,3393
0.088,1,10,840,10,56,9,56,840,0,0,0,0,0
119.133,17,4,1344,4,308,39711,308,1344,0,0,0,0,0
1709.461,6,200,22178,123,77,14011,267,9647,77,133,22454,1917,12531
1775.709,6,180,15480,120,69,14921,69,8940,60,69,30092,69,6540
19.933,17,33,12162,18,505,1169,1350,9606,15,142,1420,1350,2556
1.028,6,29,12011,15,525,73,1360,3258,14,909,62,1379,8753
89.943,6,45,66390,11,183,1771,230,1189,34,1982,2725,5632,65201
0.073,6,11,818,6,185,14,185,505,5,45,18,45,313
295.101,1,3,168,3,28,147550,28,168,0,0,0,0,0
0.002,6,2,111,1,0,0,0,40,1,31,0,31,71
1793.672,17,144,11520,72,48,25262,48,5472,72,56,25262,56,6048
1791.007,17,180,11520,180,36,10005,36,11520,0,0,0,0,0
116.601,2,2,64,2,8,116601,8,64,0,0,0,0,0
0.137,6,44,20942,26,1067,5,1420,16001,18,467,7,1883,4941
629.56,2,4,128,4,8,209853,8,128,0,0,0,0,0
1.792,6,25,8763,15,285,128,587,1459,10,985,179,1420,7304
1769.042,17,337,60472,337,151,5265,381,60472,0,0,0,0,0
7.247,6,38,7229,20,218,381,314,3423,18,513,410,1179,3806
315.982,6,89,20109,48,295,6723,1360,10304,41,326,7895,4649,9805
1786.859,6,107,8750,71,66,25526,66,5150,36,60,51047,60,3600
230.81,6,28,6460,10,216,9285,501,1270,18,343,13500,1420,5190
1.502,6,47,19258,27,896,57,1360,13682,20,476,68,2715,5576
378.005,2,3,96,3,8,189002,8,96,0,0,0,0,0
1744.923,6,96,7286,63,38,28143,205,4476,33,33,54521,98,2810
1744.941,6,96,7255,62,38,28605,205,4424,34,33,52867,98,2831
1743.128,6,95,7203,63,38,28114,205,4476,32,33,56220,98,2727
0.02,17,4,284,2,32,14,32,120,2,54,10,60,164
14.247,6,36,8365,16,268,949,722,1992,20,463,539,1380,6373
369.56,6,21,1422,15,180,26397,180,992,6,110,12254,110,430
782.092,2,7,224,7,8,130348,8,224,0,0,0,0,0
1784.832,6,104,8444,68,66,26639,66,4964,36,60,50992,60,3480
9.945,6,108,61983,55,507,184,1001,8289,53,1241,186,1546,53694
0.189,6,41,16620,23,976,8,1420,11679,18,420,10,1420,4941
1800.0,6,191,13390,66,46,27252,46,5492,125,46,14516,46,7898
263.158,17,4,352,2,60,263157,60,176,2,60,263157,60,176
1773.505,6,180,15480,120,69,14903,69,8940,60,69,30052,69,6540
1681.667,17,16,1265,8,30,240231,37,471,8,71,240232,136,794
1789.548,6,355,22480,207,69,8687,69,12420,148,69,12173,69,10060
0.55,6,4,220,2,0,550,0,100,2,0,303,0,120
158.091,2,6,240,6,16,31618,16,240,0,0,0,0,0
1742.759,6,95,7203,63,38,28109,205,4476,32,33,56205,98,2727
32.497,6,13,1515,4,599,10830,599,815,9,212,4061,212,700
18.168,17,26,11933,14,658,1394,1350,9613,12,165,1648,1350,2320
1770.523,6,99,9306,66,66,27238,66,5610,33,60,55326,60,3696
0.347,6,13,1693,7,288,56,288,588,6,426,38,434,1105
1770.434,1,67,5628,67,56,26824,56,5628,0,0,0,0,0
1797.658,17,448,39896,403,35,4471,288,25676,45,288,40017,288,14220
0.087,17,2,410,1,46,0,46,74,1,308,0,308,336
1783.902,6,115,13714,75,81,24106,500,5949,40,162,45738,1420,7765
240.264,6,43,9026,21,523,12012,1408,5811,22,229,11440,618,3215
2.346,17,2,329,1,45,0,45,73,1,228,0,228,256
1787.098,6,356,22520,208,69,8633,69,12460,148,69,12154,69,10060
957.881,1,16,896,16,28,63858,28,896,0,0,0,0,0
5.027,17,4,288,2,36,5026,36,128,2,52,5026,52,160
1799.963,1,16,896,16,28,119997,28,896,0,0,0,0,0
0.529,17,15,7052,7,605,87,1350,4436,8,299,71,1350,2616
205.307,6,32,8952,14,158,15792,267,1357,18,624,12073,1400,7595
532.389,17,26,1898,26,45,21295,45,1898,0,0,0,0,0
0.917,6,10,1687,7,100,152,100,384,3,1179,337,1179,1303
1738.758,1,57,4788,0,0,0,0,0,57,56,31049,56,4788
113.212,6,36,8287,14,159,3604,267,1682,22,357,5387,1926,6605
1.283,6,47,19267,27,898,49,1360,13691,20,433,58,1360,5576
11.569,17,4,352,2,60,11568,60,176,2,60,11569,60,176
1.407,6,243,184320,138,1351,10,1432,175820,105,389,12,1432,8500
1.371,6,19,3781,10,234,152,564,1452,9,463,149,1343,2329
1791.658,1,63,5292,0,0,0,0,0,63,56,28897,56,5292
14.114,17,2,152,2,48,14114,48,152,0,0,0,0,0
0.458,6,6,324,4,0,152,0,216,2,0,286,0,108
377.577,6,23,1535,16,177,25171,177,1053,7,110,10423,110,482
0.0,1,1,404,1,376,0,376,404,0,0,0,0,0
1.443,6,2,129,1,0,0,0,40,1,37,0,37,89
1739.37,6,138,9146,77,56,22886,208,5807,61,31,28984,31,3339
525.129,6,48,9274,23,326,23867,517,2521,25,777,21878,1418,6753
1740.486,17,30,7050,30,207,60016,207,7050,0,0,0,0,0
1744.724,2,22,704,22,8,83082,8,704,0,0,0,0,0
1781.479,1,58,4872,58,56,31254,56,4872,0,0,0,0,0
1742.048,1,58,4872,0,0,0,0,0,58,56,30562,56,4872
0.74,6,5,1523,1,1227,0,1227,1279,4,0,246,0,244
1772.001,6,204,22399,131,75,13630,267,10097,73,135,24610,2840,12302
33.152,6,6,340,5,0,8288,0,280,1,0,0,0,60
1.466,6,269,194332,144,1356,10,1432,184852,125,389,11,1432,9480
2.998,1,3,168,3,28,1499,28,168,0,0,0,0,0
0.015,17,2,206,1,44,0,44,72,1,106,0,106,134
5.614,6,40,7309,20,218,295,314,3423,20,513,279,1179,3886
57.061,17,20,1760,10,48,6339,48,760,10,72,6339,72,1000
1797.74,6,286,35246,117,133,15496,1460,16428,169,140,10700,1460,18818
62.484,6,42,18964,24,751,2716,1408,9579,18,936,3660,3847,9385
0.368,6,10,968,5,256,88,256,460,5,304,88,304,508
1773.276,6,182,15698,120,69,14901,69,8940,62,69,29063,69,6758
1769.876,6,99,9240,66,65,27228,65,5577,33,59,55305,59,3663
180.483,2,2,64,2,8,180483,8,64,0,0,0,0,0
1720.521,17,12,498,11,14,172052,14,462,1,8,0,8,36
8.014,6,687,613242,440,1326,17,1368,595734,247,776,31,2736,17508
0.374,6,22,5040,11,137,37,267,1132,11,692,35,1467,3908
143.841,17,4,240,2,32,143840,32,120,2,32,143840,32,120
0.065,17,2,210,1,53,0,53,81,1,101,0,101,129
301.735,17,6,360,3,32,150867,32,180,3,32,150867,32,180
9.575,6,1628,1485969,1000,1406,9,1448,1448649,628,776,14,1448,37320
103.793,6,25,8719,7,272,978,516,1100,18,459,6099,1452,7619
1785.456,6,111,11678,72,132,25147,1289,7632,39,69,46983,240,4046
0.017,6,2,80,1,0,0,0,40,1,0,0,0,40
1781.76,6,357,22629,208,69,8607,69,12460,149,69,12038,69,10169
90.114,17,4,332,2,31,90099,33,118,2,79,90100,93,214
4.538,6,38,7229,20,218,238,314,3423,18,513,251,1179,3806
0.015,17,2,411,1,48,0,48,76,1,307,0,307,335
1723.185,17,112,21361,112,162,15524,422,21361,0,0,0,0,0
74.04,6,40,19369,21,941,98,1440,6534,19,927,4105,1528,12835
7.818,6,626,543748,395,1308,19,1368,526974,231,792,33,1473,16774
2.332,17,19,9515,10,665,259,1350,6934,9,258,267,1350,2581
20.242,6,21,5418,12,107,1840,159,1074,9,773,2529,1418,4344
1792.586,17,176,11264,176,36,10243,36,11264,0,0,0,0,0
88.866,6,33,14400,16,488,329,1440,3125,17,962,5546,1440,11275
88.72,17,100,47584,54,754,1673,1350,42269,46,87,1970,1350,5315
0.508,17,3,451,2,39,502,39,134,1,289,0,289,317
1.441,6,41,10025,23,440,65,1360,4484,18,437,73,2715,5541
1786.6,6,105,8481,69,65,26273,65,5035,36,59,51042,59,3446
386.348,6,18,1242,14,180,29719,180,916,4,110,20107,110,326
1786.066,6,102,8364,68,66,26657,66,4964,34,60,54120,60,3400
70.201,6,24,9542,12,301,70,595,1428,12,952,6370,2720,8114
886.198,6,62,6991,34,76,24603,274,2658,28,123,32818,278,4333
1.604,6,10,1687,7,100,267,100,384,3,1179,680,1179,1303
0.076,17,4,820,2,36,63,36,128,2,318,47,318,692
5.028,17,3,228,3,48,2514,48,228,0,0,0,0,0
267.115,17,4,352,2,60,267114,60,176,2,60,267114,60,176
0.361,6,11,1686,6,131,72,131,451,5,967,90,967,1235
1.134,17,2,154,1,33,0,33,61,1,65,0,65,93
0.112,6,9,1867,5,902,27,902,1170,4,481,37,481,697
24.649,17,6,2016,6,308,4929,308,2016,0,0,0,0,0
378.536,6,21,1422,15,180,27038,180,992,6,110,12243,110,430
1207.654,17,302,27272,271,36,4472,288,17476,31,288,40024,288,9796
173.121,17,4,352,2,60,173120,60,176,2,60,173120,60,176
1795.069,6,122,7997,71,52,25643,208,5027,51,31,35892,31,2970
0.28,6,26,9062,13,262,23,690,1759,13,1103,22,2816,7303
1795.244,17,80,3354,79,14,23015,14,3318,1,8,0,8,36
100.088,6,46,16123,25,942,4163,1360,10481,21,399,4995,1360,5642
42.558,6,23,3944,14,179,3273,517,1824,9,411,5319,499,2120
0.01,6,2,205,1,125,0,125,165,1,0,0,0,40
0.05,17,2,144,1,36,0,36,64,1,52,0,52,80
3.077,6,42,14172,22,575,138,1440,6682,20,556,152,1440,7490
0.25,6,22,5040,11,137,25,267,1132,11,577,24,1400,3908
0.008,17,2,475,1,40,0,40,68,1,379,0,379,407
64.373,6,25,10089,12,531,55,1360,2637,13,988,5354,1360,7452
18.644,2,8,320,8,16,2663,16,320,0,0,0,0,0
1745.178,6,98,7421,65,38,27268,205,4611,33,33,54518,98,2810
5.019,17,4,558,2,36,5005,36,128,2,187,5005,187,430
88.697,6,594,270624,306,816,290,1152,253258,288,417,308,1179,17366
2.646,6,1384,1711976,613,217,4,230,34333,771,2134,3,12312,1677643
5.97,17,3,1008,3,308,2985,308,1008,0,0,0,0,0
1771.597,6,99,9306,66,66,27255,66,5610,33,60,55358,60,3696
0.925,6,23,6426,13,313,76,906,2092,10,982,102,1731,4334
476.097,6,57,11427,29,184,17003,1189,4299,28,352,4417,1460,7128
189.31,6,27,6522,17,168,11831,516,1695,10,552,18097,1452,4827
1.803,6,69,62293,48,198,38,250,3356,21,3044,88,9856,58937
7.153,6,5,220,1,0,0,0,44,4,0,2355,0,176
1772.845,6,180,15480,120,69,14897,69,8940,60,69,30039,69,6540
1790.088,1,210,11760,210,28,8565,28,11760,0,0,0,0,0
28.003,6,15,3846,3,92,14001,92,244,12,297,2515,1408,3602
8.667,6,22,2019,11,222,862,222,1332,11,231,862,231,687
280.862,6,32,7853,14,158,21604,267,1357,18,524,16502,1400,6496
92.144,6,226,117104,132,878,703,1460,94906,94,558,983,1638,22198
1786.429,17,87,3648,86,14,21016,14,3612,1,8,0,8,36
1740.644,17,30,31680,30,1028,60022,1028,31680,0,0,0,0,0
300.625,6,44,8786,22,278,14315,766,2060,22,364,631,1440,6726
1.316,6,59,39705,38,1214,35,1360,34363,21,498,55,1384,5342
11.919,6,6,328,4,0,3973,0,216,2,0,11906,0,112
0.676,6,24,14289,14,127,47,127,990,10,2126,64,5792,13299
1.115,17,2,244,2,94,1115,94,244,0,0,0,0,0
240.465,6,45,8499,23,449,10929,1418,5700,22,205,11450,580,2799
0.034,6,2,1175,1,0,0,0,40,1,1095,0,1095,1135
129.099,6,43,8885,14,132,9930,267,1756,29,297,4610,1460,7129
120.96,6,46,16243,26,700,4838,1360,6679,20,673,6359,2720,9564
83.882,6,37,9649,14,174,6452,267,1613,23,394,3804,1460,8036
17.809,6,26,6099,13,220,1484,517,1642,13,654,1483,1420,4457
15.882,17,24,16733,13,883,1320,1350,11848,11,416,1584,1350,4885
1798.802,17,448,39896,403,35,4474,288,25676,45,288,40018,288,14220
240.203,6,53,17664,28,786,8896,1402,14839,25,189,10008,580,2825
0.049,17,2,144,1,36,0,36,64,1,52,0,52,80
0.028,17,2,407,1,37,0,37,65,1,314,0,314,342
1740.502,17,29,19517,29,645,62160,645,19517,0,0,0,0,0
2.105,6,20,3833,11,234,210,564,1504,9,463,239,1343,2329
148.324,6,12,1767,4,100,228,100,264,8,1179,21155,1179,1503
1.272,6,50,18594,27,841,48,1360,12898,23,433,50,1360,5696
104.918,6,29,7392,12,158,9538,267,1277,17,543,6554,1400,6115
11.476,17,4,352,2,48,11466,48,152,2,72,11465,72,200
1682.13,6,171,14706,114,69,14886,69,8493,57,69,30036,69,6213
0.317,17,2,152,1,48,0,48,76,1,48,0,48,76
0.925,6,116,86987,51,131,18,232,2569,65,1363,12,1430,84418
0.068,17,2,136,1,32,0,32,60,1,48,0,48,76
11.711,6,1848,1627404,1149,1363,10,1380,1595211,699,467,16,1923,32193
0.179,6,46,20525,26,1031,7,1420,15504,20,467,9,1883,5021
0.414,17,2,194,1,61,0,61,89,1,77,0,77,105
1740.793,17,30,31680,30,1028,60027,1028,31680,0,0,0,0,0
1795.903,6,107,8550,70,64,26027,64,5040,37,58,49883,58,3510
1.336,6,39,9888,21,440,66,1360,4392,18,529,68,4075,5496
94.06,6,180,66738,81,893,1175,1440,48007,99,344,943,1440,18731
184.358,6,45,8932,20,119,9702,267,2000,25,311,7681,3417,6932
0.92,6,23,9242,14,290,70,804,1755,9,1423,92,3930,7487
1797.765,6,355,22480,207,69,8727,69,12420,148,69,12229,69,10060
1796.178,6,356,22520,208,69,8677,69,12460,148,69,12218,69,10060
1.33,6,42,12004,22,612,63,1360,6428,20,433,61,1360,5576
1795.031,17,449,39928,404,35,4454,288,25708,45,288,40017,288,14220
0.172,6,9,1340,5,145,43,145,349,4,827,54,827,991
300.991,6,38,20473,22,514,14332,1114,3723,16,1446,3568,4060,16750
240.777,6,58,18833,31,746,8025,1418,15797,27,202,9260,580,3036
240.522,6,45,8499,23,449,10932,1418,5700,22,205,11448,580,2799
0.014,17,2,465,1,40,0,40,68,1,369,0,369,397
1680.852,1,15,840,15,28,120060,28,840,0,0,0,0,0
21.232,17,43,7731,19,169,1177,1350,3744,24,138,921,1350,3987
5.979,6,83,26648,43,906,142,1101,15342,40,276,149,1440,11306
1779.364,1,338,28392,338,56,5280,56,28392,0,0,0,0,0
2.161,17,14,5083,14,335,166,361,5083,0,0,0,0,0
276.494,17,4,240,2,32,276493,32,120,2,32,276493,32,120
0.976,17,4,624,2,64,974,64,184,2,192,858,192,440
2.01,17,3,174,3,30,1005,30,174,0,0,0,0,0
0.207,17,2,157,1,31,0,31,59,1,70,0,70,98
1.396,17,20,6104,8,282,199,1350,2481,12,273,70,1350,3623
1791.733,6,456,128193,212,533,8491,1460,91713,244,242,7372,1460,36480
267.417,17,1113,744434,1074,663,249,1252,742866,39,12,4100,16,1568
130.117,6,20,3484,8,92,18588,92,504,12,261,11811,2026,2980
0.48,6,53,22551,29,1009,17,1380,17349,24,468,19,3303,5202
280.49,6,31,7813,14,158,21576,267,1357,17,577,17529,2236,6456
1772.29,6,180,15480,120,69,14893,69,8940,60,69,30031,69,6540
142.066,6,215,173616,134,1341,1068,1448,158520,81,604,1773,1448,15096
1.75,6,27,10171,16,283,116,583,1495,11,1029,157,1420,8676
0.004,17,2,493,1,33,0,33,61,1,404,0,404,432
11.002,6,22,4526,12,275,1000,275,1038,10,768,715,1440,3488
1089.141,17,209,15884,209,48,5236,48,15884,0,0,0,0,0
174.627,6,36,5705,16,152,5283,722,2060,20,289,9181,2328,3645
1798.988,17,83,3480,82,14,22209,14,3444,1,8,0,8,36
11.722,6,1854,1613607,1128,1375,10,1420,1580346,726,467,16,1883,33261
1736.976,1,56,4704,56,56,31581,56,4704,0,0,0,0,0
3.968,6,33,11865,17,257,248,669,1946,16,1007,248,1438,9919
240.212,6,56,19663,30,802,8282,1402,16822,26,185,9608,580,2841
72.726,17,20,1760,10,48,8079,48,760,10,72,8079,72,1000
1774.544,6,180,15480,120,69,14912,69,8940,60,69,30071,69,6540
0.359,17,4,1305,4,298,119,332,1305,0,0,0,0,0
1799.297,17,449,39928,404,35,4464,288,25708,45,288,40014,288,14220
1741.296,17,29,6815,29,207,62189,207,6815,0,0,0,0,0
318.42,6,9,522,3,106,159210,106,234,6,0,6297,0,288
240.25,6,59,18573,31,758,8007,1418,15346,28,220,8897,580,3227
2.561,17,4,694,3,32,871,32,180,1,486,0,486,514
10.757,6,18,5610,10,275,1195,275,958,8,1440,817,1440,4652
1753.68,1,56,4704,0,0,0,0,0,56,56,31885,56,4704
0.478,6,22,7255,13,318,39,600,1958,9,1205,55,1851,5297
1680.44,1,14,784,14,28,129264,28,784,0,0,0,0,0
1792.319,6,358,22876,205,69,8785,69,12409,153,69,11791,69,10467
280.359,6,30,7432,13,158,23363,267,1317,17,543,17514,1400,6115
0.096,17,8,2446,8,277,13,316,2446,0,0,0,0,0
1.082,6,23,6460,13,323,90,954,2140,10,979,119,1731,4320
5.965,6,5,220,5,0,0,0,220,0,0,0,0,0
0.152,17,2,167,1,39,0,39,67,1,72,0,72,100
86.525,6,721,349577,387,839,224,1152,331053,334,430,258,1179,18524
1726.221,1,8,448,8,28,246603,28,448,0,0,0,0,0
1.244,6,37,8214,19,321,69,1164,2718,18,433,63,1360,5496
300.271,6,35,28917,22,190,14298,444,1913,13,3290,20016,12189,27004
0.302,17,2,152,1,48,0,48,76,1,48,0,48,76
0.239,6,17,5343,8,290,34,517,1005,9,772,28,1408,4338
0.077,17,2,182,1,34,0,34,62,1,92,0,92,120
318.678,6,26,6293,11,139,31867,159,1150,15,873,22762,2816,5143
0.048,17,4,284,2,32,1,32,120,2,54,0,60,164
3.075,17,4,332,2,47,3066,47,150,2,63,3068,63,182
2.146,17,4,1568,4,364,715,364,1568,0,0,0,0,0
26.222,2,3,96,3,8,13111,8,96,0,0,0,0,0
1791.866,17,137,10940,71,48,25597,48,5396,66,56,27566,56,5544
1796.089,17,87,3648,86,14,21130,14,3612,1,8,0,8,36
0.856,17,2,144,1,36,0,36,64,1,52,0,52,80
1.42,6,42,10065,23,440,64,1360,4484,19,400,69,1360,5581
1794.829,17,144,11520,72,48,25279,48,5472,72,56,25279,56,6048
280.29,6,29,7392,13,158,23357,267,1317,16,603,18684,2036,6075
0.224,17,2,152,1,48,0,48,76,1,48,0,48,76
0.102,6,13,1749,7,253,17,500,878,6,275,20,500,871
302.456,1,8,448,8,28,43208,28,448,0,0,0,0,0
1653.433,1,14,784,14,28,127187,28,784,0,0,0,0,0
1786.656,6,102,8296,68,65,26666,65,4930,34,59,54138,59,3366
0.137,17,2,206,1,44,0,44,72,1,106,0,106,134
120.786,17,4,382,2,31,120651,34,119,2,103,120596,114,263
1797.531,1,345,28980,345,56,5225,56,28980,0,0,0,0,0
8.342,1,9,756,0,0,0,0,0,9,56,1042,56,756
10.737,6,20,4442,11,275,1073,275,998,9,768,745,1440,3444
36.573,6,15,660,5,0,1479,0,220,10,0,4035,0,440
1776.503,17,140,11200,70,48,25746,48,5320,70,56,25746,56,5880
1756.157,6,188,11673,94,50,18883,208,7014,94,31,18880,31,4659
0.178,6,46,21137,26,1075,7,1420,16116,20,467,8,1883,5021
0.241,6,12,1697,7,253,40,500,878,5,551,60,551,819
170.652,6,8288,7536904,5352,1326,31,1368,7367708,2936,776,58,2736,169196
1739.279,6,87,6322,58,31,30513,31,3915,29,31,62115,31,2407
0.19,17,2,152,1,48,0,48,76,1,48,0,48,76
0.492,6,21,7203,12,318,43,600,1906,9,964,60,1471,5297
0.499,17,2,420,1,39,0,39,67,1,325,0,325,353
0.499,17,3,451,2,39,369,39,134,1,289,0,289,317
1785.834,6,108,8844,70,66,25881,66,5044,38,60,48262,60,3800
17.341,17,29,21840,17,712,1081,1350,12590,12,742,1573,1350,9250
0.307,6,10,1669,6,551,61,947,1346,4,159,102,159,323
1.407,6,29,6041,13,156,117,267,1462,16,562,89,1420,4579
0.035,17,2,469,1,46,0,46,74,1,367,0,367,395
3.572,6,13,3096,4,92,1190,92,296,9,464,371,1408,2800
0.695,17,2,204,1,34,0,34,62,1,114,0,114,142
2.0,17,2,122,2,33,2000,33,122,0,0,0,0,0
1772.23,6,240,17880,120,69,14892,69,8940,120,34,14892,48,8940
0.309,6,22,7342,12,335,27,668,1974,10,1210,33,2816,5368
0.469,6,10,968,5,256,112,256,460,5,304,113,304,508
1745.842,6,90,6540,60,31,29590,31,4050,30,31,60192,31,2490
1772.389,6,182,15629,121,69,14769,69,8980,61,69,29535,69,6649
0.142,6,2,80,1,0,0,0,40,1,0,0,0,40
1780.526,17,140,11200,70,48,25804,48,5320,70,56,25804,56,5880
240.269,6,43,8939,21,519,12013,1402,5776,22,223,11441,618,3163
1783.393,17,83,3480,82,14,22017,14,3444,1,8,0,8,36
10.258,6,85,24621,43,533,244,1152,18800,42,459,243,1179,5821
67.379,17,4,240,2,32,67378,32,120,2,32,67378,32,120
1738.631,6,92,6668,60,31,29468,31,4062,32,31,56084,31,2606
10.274,6,30,7432,13,158,856,267,1317,17,543,639,1400,6115
240.18,6,54,17331,29,764,8577,1402,14514,25,188,10007,580,2817
14.651,6,24,6993,13,275,1220,275,1078,11,910,960,1440,5915
8.023,6,24,6902,6,156,1604,267,718,18,419,470,1460,6184
1008.044,2,5,160,5,8,252011,8,160,0,0,0,0,0
1742.055,6,87,6322,58,31,30562,31,3915,29,31,62216,31,2407
0.053,6,4,222,2,31,53,31,111,2,31,0,31,111
55.694,6,30,7297,14,155,4284,267,1346,16,441,3712,1420,5951
1796.45,17,448,39612,404,35,4457,288,25708,44,288,40951,288,13904
0.434,6,20,7196,12,325,38,626,1932,8,1210,61,1906,5264
0.0,6,2,135,2,31,0,31,135,0,0,0,0,0
2.749,6,14,1640,7,256,455,256,1052,7,304,455,304,588
1744.273,1,52,4368,52,56,34201,56,4368,0,0,0,0,0
1752.382,17,29,9708,29,306,62585,308,9708,0,0,0,0,0
0.108,6,9,1346,5,145,27,145,349,4,833,26,833,997
0.323,6,3,182,2,31,323,31,111,1,31,0,31,71
36.514,17,8,704,4,48,12168,48,304,4,72,12168,72,400
0.125,17,3,3140,3,1018,62,1438,3140,0,0,0,0,0
1682.811,17,16,1265,8,30,240395,37,471,8,71,240391,136,794
0.053,17,2,417,1,34,0,34,62,1,327,0,327,355
1763.34,2,13,416,13,8,146945,8,416,0,0,0,0,0
1786.711,6,102,8296,68,65,26667,65,4930,34,59,54140,59,3366
0.0,1,1,60,1,32,0,32,60,0,0,0,0,0
1780.446,17,134,10720,67,48,26976,48,5092,67,56,26976,56,5628
11.921,6,1783,1621479,1147,1363,10,1380,1591797,636,421,18,1923,29682
1772.053,6,180,15480,120,69,14891,69,8940,60,69,30032,69,6540
1772.906,6,181,15589,120,69,14898,69,8940,61,69,29547,69,6649
0.882,6,23,5715,13,158,72,370,1315,10,999,97,1791,4400
178.292,6,25,11358,12,433,77,990,1823,13,1000,14846,1360,9535
1794.873,6,358,33889,196,118,9204,1189,16369,162,123,11147,1933,17520
15.114,17,21,5666,9,282,1885,1350,2792,12,211,1371,1350,2874
0.086,6,2,100,1,0,0,0,60,1,0,0,0,40
125.682,2,2,64,2,8,125682,8,64,0,0,0,0,0
18.464,17,40,9317,18,237,1084,1350,4773,22,178,877,1350,4544
626.265,6,65,7698,34,89,18977,721,3213,31,130,18227,1448,4485
1794.357,6,359,28875,205,75,8795,267,13264,154,131,11727,1452,15611
862.996,6,91,7918,57,71,15410,138,4350,34,69,26151,69,3568
0.718,17,2,144,1,36,0,36,64,1,52,0,52,80
1700.482,17,12,498,11,14,170048,14,462,1,8,0,8,36
294.588,17,4,352,2,60,294587,60,176,2,60,294587,60,176
0.922,6,19,5912,10,282,102,548,1252,9,716,105,1420,4660
0.234,17,2,1922,2,933,234,933,1922,0,0,0,0,0
1740.511,17,24,5640,24,207,75674,207,5640,0,0,0,0,0
280.436,6,30,7432,13,158,23369,267,1317,17,603,17522,2760,6115
0.825,6,85,54227,48,1257,17,1432,48456,37,427,20,1432,5771
1737.177,1,56,4704,56,56,31585,56,4704,0,0,0,0,0
303.844,6,58,9039,33,304,9495,304,6296,25,83,12659,83,2743
4.281,6,39,7269,19,218,237,314,3383,20,440,211,1152,3886
1787.723,6,102,8228,68,64,26682,64,4896,34,58,54170,58,3332
0.397,6,52,22978,29,1045,14,1380,15893,23,511,16,1923,7085
28.002,17,16,1408,8,48,3999,48,608,8,72,3998,72,800
0.014,17,4,284,2,32,0,32,120,2,54,4,60,164
1796.161,17,449,39928,404,35,4456,288,25708,45,288,40020,288,14220
1.022,6,30,7609,15,154,73,267,1684,15,760,67,1420,5925
0.275,17,2,440,1,39,0,39,67,1,345,0,345,373
17.965,17,23,6741,9,275,2241,1350,2731,14,258,1379,1350,4010
1770.144,6,214,16788,79,72,22692,337,8057,135,49,13210,143,8731
191.534,1,2,232,2,88,191534,88,232,0,0,0,0,0
0.052,17,2,602,1,46,0,46,74,1,500,0,500,528
18.654,6,2771,2595384,1719,1424,10,1448,2528112,1052,776,17,1448,67272
7.727,6,24,4075,11,199,772,293,1641,13,318,622,1179,2434
22.733,6,20,3130,12,183,2066,517,1561,8,381,3243,499,1569
17.2,17,4,352,2,48,17187,48,152,2,72,17184,72,200
1.252,6,25,8056,12,164,96,267,1288,13,869,89,1448,6768
0.51,6,23,7437,14,274,39,668,2109,9,1210,58,1946,5328
0.484,17,2,384,1,39,0,39,67,1,289,0,289,317
1799.728,17,538,167612,538,283,3351,462,167612,0,0,0,0,0
0.134,6,2,743,1,663,0,663,703,1,0,0,0,40
1794.138,17,144,11520,72,48,25269,48,5472,72,56,25269,56,6048
1.764,17,20,5190,20,231,92,389,5190,0,0,0,0,0
5.442,6,13,3124,5,92,1360,92,348,8,1164,734,1448,2776
1792.75,6,429,32521,236,74,7628,267,15285,193,132,9336,1917,17236
0.07,6,9,1340,5,145,17,145,349,4,827,19,827,991
1787.12,1,58,4872,0,0,0,0,0,58,56,31352,56,4872
574.219,6,57,7264,28,100,16301,722,2872,29,151,20501,1408,4392
196.173,6,127,86283,75,1273,2650,1448,73964,52,599,3077,1448,12319
1.245,6,50,19794,27,927,47,1460,14098,23,433,48,1460,5696
18.556,17,34,7248,15,160,1323,1350,2823,19,204,1029,1350,4425
1.432,6,189,130304,102,1315,14,1432,122521,87,475,16,1871,7783
1790.479,1,222,12432,222,28,8101,28,12432,0,0,0,0,0
4.882,6,38,7229,19,218,271,314,3383,19,513,257,1179,3846
1787.905,6,367,25581,213,99,8433,469,15005,154,69,11685,69,10576
1741.171,1,15,840,15,28,124369,28,840,0,0,0,0,0
2.443,6,13,2311,8,188,349,245,700,5,1407,546,1407,1611
0.447,2,2,64,2,8,447,8,64,0,0,0,0,0
1797.184,6,368,25690,215,99,8398,469,15085,153,69,11821,69,10605
1795.39,17,448,39896,403,35,4466,288,25676,45,288,40023,288,14220
280.47,6,28,7352,12,158,25497,267,1277,16,678,18690,2760,6075
1.41,6,50,18814,27,857,54,1360,13118,23,433,55,1360,5696
120.28,2,2,64,2,8,120280,8,64,0,0,0,0,0
0.018,6,10,1544,5,505,4,505,773,5,503,4,503,771
1770.816,6,102,9396,66,65,27243,65,5577,36,59,50592,59,3819
240.171,6,53,17367,28,774,8895,1402,14624,25,179,10006,580,2743
1681.163,17,16,4257,8,30,240165,37,471,8,445,240165,463,3786
4.924,6,39,7285,20,218,259,314,3423,19,516,260,1179,3862
1.238,6,2,1235,1,0,0,0,40,1,1155,0,1155,1195
0.923,6,2,87,1,0,0,0,40,1,7,0,7,47
2.48,6,2,88,2,0,0,0,88,0,0,0,0,0
1.014,17,4,1116,2,32,980,32,120,2,470,0,470,996
12.434,6,1900,1715034,1163,1421,10,1432,1681333,737,420,16,1432,33701
1.115,17,33,23635,18,846,63,1350,15746,15,497,77,1350,7889
1.403,6,41,8431,21,321,70,1164,2810,20,400,64,1360,5621
0.105,17,2,136,1,32,0,32,60,1,48,0,48,76
280.815,6,30,7432,13,158,23401,267,1317,17,603,17548,2076,6115
220.537,6,31,8912,14,158,16964,267,1357,17,687,13778,2036,7555
1784.609,17,293,60032,293,176,6111,361,60032,0,0,0,0,0
0.173,6,45,21236,26,1085,6,1420,16255,19,467,9,2840,4981
1788.135,1,338,28392,338,56,5306,56,28392,0,0,0,0,0
1702.839,1,8,448,8,28,243262,28,448,0,0,0,0,0
31.919,6,335,323358,115,101,279,294,6387,220,1414,145,2836,316971
442.41,6,184,12752,96,32,4656,93,6821,88,31,4527,31,5931
175.61,6,24,6652,10,275,19512,275,679,14,491,13317,2840,5973
0.011,6,10,1510,5,657,2,657,925,5,317,2,317,585
0.078,6,2,239,1,147,0,147,199,1,0,0,0,40
1794.827,1,58,4872,0,0,0,0,0,58,56,31488,56,4872
6.932,6,995,909533,646,1362,10,1432,891282,349,475,19,1871,18251
1772.454,6,180,15480,120,69,14894,69,8940,60,69,30035,69,6540
0.33,6,26,9012,13,252,27,646,1694,13,947,26,1402,7318
24.07,6,3427,3204288,2219,1365,10,1408,3136808,1208,931,19,2801,67480
0.017,6,10,1677,6,555,3,951,1354,4,159,5,159,323
0.005,17,2,417,1,48,0,48,76,1,313,0,313,341
0.861,6,2,80,1,0,0,0,40,1,0,0,0,40
724.085,1,10,560,10,28,80453,28,560,0,0,0,0,0
2.02,17,2,148,2,46,2020,46,148,0,0,0,0,0
191.747,6,15,1135,9,66,23968,66,624,6,54,38331,60,511
0.254,17,2,144,1,36,0,36,64,1,52,0,52,80
93.197,6,21,860,9,0,6042,0,364,12,0,8471,0,496
372.086,6,23,1535,16,177,24805,177,1053,7,110,10393,110,482
0.024,6,5,666,2,304,13,304,408,3,102,7,102,258
1772.298,6,180,15480,120,69,14893,69,8940,60,69,30035,69,6540
12.042,17,4,814,2,34,12030,34,124,2,317,12030,325,690
1791.266,17,144,11520,72,48,25228,48,5472,72,56,25228,56,6048
1.232,6,51,19164,28,879,45,1360,13468,23,433,48,1360,5696
1797.174,6,204,12977,100,53,18153,208,7763,104,31,17446,31,5214
1.5,6,49,20110,27,953,57,1460,14454,22,476,60,2615,5656
36.737,17,11,836,11,48,3673,48,836,0,0,0,0,0
1783.46,17,291,68694,291,208,6149,422,68694,0,0,0,0,0
218.004,6,200,155287,121,1326,1816,1448,141613,79,682,1372,2359,13674
11.954,6,1771,1617073,1143,1364,10,1432,1587557,628,395,19,1432,29516
0.174,1,2,112,2,28,174,28,112,0,0,0,0,0
7.363,6,1144,1018103,723,1359,10,1420,996924,421,427,17,1420,21179
1.863,17,2,122,2,33,1863,33,122,0,0,0,0,0
112.785,6,1016,503156,559,835,202,1152,480085,457,435,246,1179,23071
50.714,6,24,5208,18,174,2983,174,898,6,1354,834,1420,4310
231.384,6,44,8776,18,123,9522,267,1713,26,273,9255,3417,7063
0.004,17,2,503,1,40,0,40,68,1,407,0,407,435
1786.062,6,106,8524,68,66,26657,66,4964,38,60,48269,60,3560
8.434,6,38,7229,19,218,468,314,3383,19,440,441,1152,3846
1779.787,1,342,28728,342,56,5219,56,28728,0,0,0,0,0
1793.997,17,144,11520,72,48,25267,48,5472,72,56,25267,56,6048
0.016,17,4,420,2,33,12,33,122,2,121,9,145,298
1795.581,1,273,15288,273,28,6601,28,15288,0,0,0,0,0
5.158,6,13,3116,8,49,736,92,523,5,2329,1242,2329,2593
242.433,6,36,4284,18,180,14260,595,2072,18,158,14260,580,2212
377.976,2,3,96,3,8,188988,8,96,0,0,0,0,0
1772.671,6,180,15480,120,69,14896,69,8940,60,69,30038,69,6540
1782.138,6,104,8376,68,65,26599,65,4930,36,59,50915,59,3446
1791.842,17,764,46076,764,32,2348,37,46076,0,0,0,0,0
0.459,6,42,20454,25,1035,19,1380,15534,17,469,25,1923,4920
0.002,6,3,120,1,0,0,0,40,2,0,0,0,80
657.123,2,7,224,7,8,109520,8,224,0,0,0,0,0
0.21,6,46,21563,27,1032,8,1420,16582,19,467,11,1883,4981
296.494,6,91,27195,46,906,6588,1101,15534,45,252,334,2720,11661
0.148,17,4,284,2,32,138,32,120,2,54,11,60,164
145.855,6,22,4739,9,267,407,501,1165,13,305,12147,1420,3574
0.063,17,2,188,1,34,0,34,62,1,98,0,98,126
22.237,6,6,1257,4,327,7412,414,815,2,181,22050,270,442
0.11,6,12,2024,7,329,18,500,1030,5,726,27,726,994
0.309,6,25,8859,13,237,25,590,1635,12,1098,27,2816,7224
151.978,6,29,7392,13,158,12664,267,1317,16,603,10129,2036,6075
1.378,6,10,1687,7,100,229,100,384,3,1179,556,1179,1303
16.627,6,22,9376,8,154,2375,267,792,14,801,1275,1917,8584
1797.566,6,378,26366,218,97,8283,469,15481,160,69,11303,69,10885
5.076,17,3,208,2,36,5002,36,128,1,52,0,52,80
0.066,6,14,4334,7,111,10,111,483,7,869,10,1448,3851
1791.584,6,356,22520,208,69,8654,69,12460,148,69,12187,69,10060
1.641,6,33,6578,17,149,102,267,2033,16,650,96,1380,4545
86.454,6,43,10663,21,269,4320,517,2528,22,537,4114,1418,8135
1795.78,1,287,16072,287,28,6278,28,16072,0,0,0,0,0
45.176,6,6034,5704706,3941,1369,11,1408,5591060,2093,950,21,2801,113646
1.689,6,54,13970,25,551,70,1429,4892,29,416,56,1460,9078
0.165,17,2,198,1,39,0,39,67,1,103,0,103,131
1741.063,6,87,6322,58,31,30544,31,3915,29,31,62180,31,2407
1789.103,17,86,3606,85,14,21298,14,3570,1,8,0,8,36
10.964,1,9,756,0,0,0,0,0,9,56,1370,56,756
916.182,6,148,25560,65,251,14315,1360,11821,83,176,11168,4649,13739
0.172,6,3,175,2,31,22,31,135,1,0,0,0,40
13.554,17,4,304,4,48,4518,48,304,0,0,0,0,0
312.836,6,23,2585,7,242,52138,517,1111,16,323,20855,499,1474
0.153,1,2,112,2,28,153,28,112,0,0,0,0,0
280.218,6,29,7392,13,158,23351,267,1317,16,603,18678,2800,6075
48.03,6,4,639,4,119,16010,256,639,0,0,0,0,0
1772.353,6,180,15480,120,69,14893,69,8940,60,69,30037,69,6540
2.281,17,21,7416,9,399,285,1350,3847,12,269,136,1350,3569
70.638,6,32,8952,14,158,5433,267,1357,18,624,4148,1400,7595
10.828,17,15,17718,15,1153,773,1452,17718,0,0,0,0,0
0.007,17,2,447,1,65,0,65,93,1,326,0,326,354
66.508,6,29,7392,13,158,5542,267,1317,16,603,4431,2076,6075
1797.948,6,368,25759,213,99,8480,469,15005,155,69,11674,69,10754
1.329,6,42,10077,23,440,60,1360,4496,19,400,63,1360,5581
0.849,6,2,111,1,0,0,0,40,1,31,0,31,71
1783.383,17,83,3480,82,14,22017,14,3444,1,8,0,8,36
14.639,17,3,984,3,300,7319,300,984,0,0,0,0,0
629.66,2,6,192,6,8,125932,8,192,0,0,0,0,0
1747.196,6,97,7307,63,38,28180,205,4476,34,33,52938,98,2831
22.111,6,9,527,5,43,5527,43,311,4,0,7336,0,216
4.629,6,39,7269,19,218,257,314,3383,20,440,229,1152,3886
1.117,6,29,11148,14,164,73,267,1460,15,988,67,1408,9688
0.87,17,17,9944,9,484,108,1350,4614,8,638,93,1350,5330
16.504,6,11,684,3,106,8245,106,234,8,90,2355,90,450
0.468,6,20,7151,12,318,41,600,1906,8,1205,65,1891,5245
240.194,6,53,19838,30,816,8282,1402,17081,23,221,10917,580,2757
0.05,17,4,352,2,37,0,37,130,2,83,0,89,222
0.669,6,21,7302,13,335,55,668,2038,8,968,90,1475,5264
293.627,1,4,224,4,28,97875,28,224,0,0,0,0,0
0.759,17,2,136,1,32,0,32,60,1,48,0,48,76
411.339,6,53,3730,18,46,24196,46,1410,35,46,12097,46,2320
290.309,1,3,180,3,32,145154,32,180,0,0,0,0,0
1794.024,17,66,2766,65,14,28031,14,2730,1,8,0,8,36
75.617,6,24,988,12,0,4537,0,488,12,0,6869,0,500
1.345,6,50,19049,28,937,49,1460,13348,22,400,55,1460,5701
6.147,6,1388,1282978,875,1389,6,1408,1251614,513,931,11,2816,31364
17.686,6,174,71355,93,722,192,1152,62935,81,431,217,1179,8420
451.963,6,9516,9351721,3373,400,134,420,194183,6143,1440,73,4314,9157538
281.61,6,30,7432,13,158,23467,267,1317,17,543,17594,1400,6115
1772.515,6,180,15480,120,69,14895,69,8940,60,69,30036,69,6540
140.631,17,4,240,2,32,140630,32,120,2,32,140630,32,120
1715.332,17,335,25460,335,48,5135,48,25460,0,0,0,0,0
1791.363,6,356,22520,208,69,8653,69,12460,148,69,12182,69,10060
12.078,6,9,376,5,0,3017,0,204,4,0,4021,0,172
1.609,6,3,120,2,0,1609,0,80,1,0,0,0,40
184.996,6,9,528,2,112,184990,112,200,7,0,30831,0,328
26.597,17,32,4704,16,48,1772,48,1216,16,190,1772,308,3488
41.789,6,16,6152,6,156,8357,267,718,10,837,4640,1452,5434
1797.342,6,357,32578,174,304,10389,842,12241,183,61,9875,1541,20337
18.904,17,2,152,2,48,18904,48,152,0,0,0,0,0
1770.208,6,135,8256,72,26,24931,26,4348,63,26,28551,26,3908
1785.96,6,104,8444,68,66,26656,66,4964,36,60,51024,60,3480
240.202,6,52,17480,27,775,9238,1418,14590,25,197,10007,580,2890
6.027,17,3,228,2,48,5958,48,152,1,48,0,48,76
1775.288,6,130,7942,70,26,25728,27,4217,60,26,30088,27,3725
15.845,17,15,5071,7,360,2632,1350,2718,8,266,2250,1350,2353
113.529,6,68,44114,42,1166,2769,1408,36027,26,961,2488,3847,8087
6.633,6,66,20126,33,562,207,1152,15379,33,489,199,1179,4747
1770.139,6,210,16254,78,70,22986,311,7746,132,48,13512,78,8508
12.392,6,10,628,4,106,4127,106,274,6,90,2476,90,354
62.595,6,50,10507,24,533,670,910,3199,26,329,2498,2720,7308
0.001,6,2,379,1,0,0,0,40,1,287,0,287,339
1.488,17,6,360,3,32,743,32,180,3,32,743,32,180
5.883,6,7,408,4,0,1879,0,216,3,0,2800,0,192
280.505,6,30,7432,13,158,23375,267,1317,17,603,17523,2076,6115
280.084,6,28,7352,13,158,23340,267,1317,15,678,20001,2800,6035
1.801,6,34,23315,20,209,94,517,2306,14,2252,137,8448,21009
62.694,6,83,58104,51,1204,1253,1368,49642,32,753,2014,2519,8462
0.009,17,2,198,1,63,0,63,91,1,79,0,79,107
1746.88,6,113,8190,70,31,25317,31,4797,43,31,41592,31,3393
1795.624,6,380,24239,218,69,8274,69,13274,162,69,11152,69,10965
1792.443,17,180,14040,180,50,10013,50,14040,0,0,0,0,0
0.048,17,2,362,1,46,0,46,74,1,260,0,260,288
20.578,6,3289,3076514,2125,1369,9,1408,3011322,1164,776,17,1408,65192
18.348,6,19,3430,7,49,3058,92,459,12,334,1644,1408,2971
481.317,2,7,224,7,8,80219,8,224,0,0,0,0,0
70.445,6,29,7395,13,155,5870,267,1306,16,453,4695,3417,6089
170.402,6,32,17682,18,708,34,1360,4318,14,1421,13098,4416,13364
280.415,6,29,7392,13,158,23367,267,1317,16,678,18691,2760,6075
101.535,6,936,463772,519,829,196,1152,442301,417,398,243,1152,21471
1.431,6,41,8431,21,321,71,1164,2810,20,400,65,1460,5621
1772.383,6,180,15480,120,69,14893,69,8940,60,69,30036,69,6540
1746.468,6,96,7497,63,40,28168,205,4539,33,37,54564,177,2958
1.371,6,47,19104,26,955,54,1460,13488,21,433,58,1460,5616
252.644,2,2,64,2,8,252644,8,64,0,0,0,0,0
1680.96,1,15,840,15,28,120068,28,840,0,0,0,0,0
29.288,6,47,9386,23,322,691,619,1967,24,379,1267,1460,7419
298.073,1,4,224,4,28,99357,28,224,0,0,0,0,0
0.222,6,12,3702,6,170,44,170,490,6,964,28,1448,3212
12.972,6,16,4730,6,92,2594,92,400,10,1259,1393,1448,4330
1679.98,1,15,840,15,28,119998,28,840,0,0,0,0,0
12.114,6,47,8782,24,231,526,314,4435,23,489,538,1179,4347
0.001,17,2,2728,2,1336,1,1336,2728,0,0,0,0,0
10.263,6,42,16223,23,637,466,1460,4838,19,816,559,1934,11385
1.516,17,6,936,3,64,599,64,276,3,192,617,192,660
318.405,6,8,564,5,106,79601,106,420,3,0,1520,0,144
377.947,2,3,96,3,8,188973,8,96,0,0,0,0,0
315.821,6,101,21080,54,259,5958,1360,10897,47,276,6863,2720,10183
1799.764,17,142,11360,71,48,25710,48,5396,71,56,25710,56,5964
0.004,17,2,299,1,46,0,46,74,1,197,0,197,225
0.01,6,4,160,3,0,1,0,120,1,0,0,0,40
1776.368,17,73,3060,72,14,25019,14,3024,1,8,0,8,36
0.202,6,2,92,1,0,0,0,40,1,0,0,0,52
1795.235,17,29,9512,29,300,64115,300,9512,0,0,0,0,0
280.41,6,29,7392,13,158,23367,267,1317,16,603,18692,2036,6075
126.009,2,2,64,2,8,126009,8,64,0,0,0,0,0
0.487,6,12,1653,6,288,95,288,548,6,426,55,434,1105
0.123,17,2,180,1,54,0,54,82,1,70,0,70,98
1770.363,6,101,9344,66,65,27236,65,5577,35,59,52066,59,3767
1703.101,6,175,15073,115,69,14939,69,8533,60,69,28864,69,6540
0.342,1,9,756,9,56,42,56,756,0,0,0,0,0
0.806,6,2,104,1,0,0,0,40,1,0,0,0,64
60.219,6,16,974,8,41,8576,46,485,8,42,8602,46,489
299.726,6,6,364,4,31,99908,31,222,2,31,299677,31,142
1796.471,17,87,3648,86,14,21134,14,3612,1,8,0,8,36
1739.852,6,87,6322,58,31,30523,31,3915,29,31,62137,31,2407
365.765,2,7,224,7,8,60960,8,224,0,0,0,0,0
1795.408,17,448,39896,403,35,4466,288,25676,45,288,40015,288,14220
1564.155,2,12,384,12,8,142195,8,384,0,0,0,0,0
3.315,17,4,1556,4,361,1105,361,1556,0,0,0,0,0
88.157,6,4303,3911609,2721,1354,32,1368,3814661,1582,776,55,1473,96948
26.657,17,16,1408,8,48,3806,48,608,8,72,3806,72,800
1786.484,6,106,8388,68,64,26663,64,4896,38,58,48280,58,3492
25.569,6,8,320,8,0,0,0,320,0,0,0,0,0
9.845,6,13,3773,5,171,2458,171,439,8,964,1405,1448,3334
1798.274,17,448,39896,403,35,4473,288,25676,45,288,40019,288,14220
0.113,6,13,4755,7,290,18,517,941,6,1164,19,1496,3814
8.17,2,2,104,2,28,8170,32,104,0,0,0,0,0
31.021,17,6,638,6,78,6204,84,638,0,0,0,0,0
241.126,6,34,7135,15,169,12097,516,1618,19,297,13390,1452,5517
207.785,17,12,5082,12,395,18889,421,5082,0,0,0,0,0
280.157,1,3,180,3,32,140078,32,180,0,0,0,0,0
0.154,6,9,1343,5,145,38,145,349,4,830,47,830,994
1.678,6,27,10083,16,285,111,587,1499,11,1017,150,1452,8584
1797.11,17,766,46178,766,32,2349,37,46178,0,0,0,0,0
286.151,17,4,558,2,36,286146,36,128,2,187,286146,187,430
1.323,6,38,9848,21,440,66,1360,4392,17,476,71,2720,5456
280.184,6,28,7352,13,158,23348,267,1317,15,678,20011,2045,6035
9.796,6,83,24877,43,544,233,1152,19136,40,413,244,1152,5741
1.284,6,51,20371,30,897,44,1360,14710,21,437,55,2715,5661
101.216,6,298,562908,203,808,9,1360,14623,95,6258,1075,35360,548285
1771.649,6,101,9344,66,65,27256,65,5577,35,59,52104,59,3767
1744.364,6,99,7473,65,38,27255,205,4580,34,33,52850,98,2893
300.251,6,42,10118,22,593,14289,1360,4485,20,370,15793,1360,5633
0.959,6,24,8963,14,264,73,700,1651,10,1380,86,3930,7312
360.946,2,4,128,4,8,120315,8,128,0,0,0,0,0
0.842,6,11,1727,7,100,140,100,384,4,589,191,1152,1343
1796.074,17,448,39612,404,35,4456,288,25708,44,288,40947,288,13904
1.312,6,50,18512,27,836,50,1360,12816,23,433,51,1360,5696
1797.745,1,58,4872,0,0,0,0,0,58,56,31539,56,4872
301.799,6,39,11226,22,561,14371,1408,3970,17,530,534,3534,7256
1738.379,1,53,4452,0,0,0,0,0,53,56,33430,56,4452
5.809,6,84,55322,51,1194,116,1368,46878,33,956,174,2736,8444
1785.859,6,456,27606,226,69,7937,69,13594,230,36,7798,69,14012
1722.374,17,12,498,11,14,172237,14,462,1,8,0,8,36
240.698,6,43,9083,22,607,11461,1402,6011,21,246,12034,620,3072
7.961,6,3,1272,2,564,7952,564,1232,1,0,0,0,40
2.31,6,25,7738,12,178,210,340,1345,13,950,190,1438,6393
1773.411,6,180,15480,120,69,14902,69,8940,60,69,30052,69,6540
0.012,6,13,5740,7,135,1,135,507,6,1637,2,2017,5233
0.039,6,6,897,3,483,13,483,639,3,102,7,102,258
1.574,6,30,10405,18,367,92,833,1825,12,1012,134,1420,8580
1773.432,6,180,15480,120,69,14902,69,8940,60,69,30050,69,6540
447.641,17,15,6210,15,386,31974,394,6210,0,0,0,0,0
1.021,6,31,12946,17,529,63,1440,3370,14,818,64,1440,9576
1799.975,1,271,15176,271,28,6666,28,15176,0,0,0,0,0
1739.278,6,87,6322,58,31,30513,31,3915,29,31,62116,31,2407
1780.346,17,142,11360,71,48,25433,48,5396,71,56,25433,56,5964
1773.07,6,181,15589,120,69,14899,69,8940,61,69,29548,69,6649
206.868,6,188,144988,113,1336,1847,1448,131517,75,637,1645,1448,13471
0.014,6,11,1971,6,451,2,500,1222,5,481,3,481,749
1.266,6,24,8004,12,164,97,267,1288,12,1014,97,2331,6716
5.806,6,16,3273,6,92,1161,92,400,10,465,614,1408,2873
1783.5,6,391,31696,222,91,8070,1189,15133,169,136,10616,1420,16563
146.219,6,21,9221,11,514,82,1236,2014,10,1132,16226,2720,7207
125.365,6,16,3971,8,407,17909,722,1226,8,465,17883,1448,2745
0.761,17,4,240,2,32,760,32,120,2,32,759,32,120
27.684,17,4,352,2,60,27683,60,176,2,60,27683,60,176
1153.299,6,293,21644,150,114,7740,469,12195,143,52,8070,69,9449
0.512,17,3,451,2,39,249,39,134,1,289,0,289,317
1784.459,6,418,25048,209,69,8579,69,12500,209,34,8579,48,12548
1788.652,6,4121,3599591,1778,130,1006,351,104972,2343,1485,763,4224,3494619
1.358,6,49,18877,28,927,50,1440,13216,21,400,59,1440,5661
11.411,17,8,704,4,48,3798,48,304,4,72,3799,72,400
143.12,1,16,1664,0,0,0,0,0,16,76,9541,76,1664
1221.524,6,254,17970,147,104,8366,469,10585,107,69,11523,69,7385
101.79,6,26,8372,13,201,63,290,1179,13,740,8470,1708,7193
1755.641,1,79,6636,0,0,0,0,0,79,56,22508,56,6636
1794.319,1,58,4872,58,56,31479,56,4872,0,0,0,0,0
1712.416,17,144,12642,132,30,13071,37,7698,12,384,149970,463,4944
0.02,6,10,1514,5,503,5,503,771,5,475,5,475,743
1773.219,6,180,15480,120,69,14901,69,8940,60,69,30047,69,6540
3.705,6,2,88,2,0,0,0,88,0,0,0,0,0
0.066,17,4,284,2,32,34,32,120,2,54,33,60,164
39.552,17,22,1936,11,48,3954,48,836,11,72,3953,72,1100
1796.978,1,345,28980,345,56,5223,56,28980,0,0,0,0,0
6.817,6,13,3212,7,92,1136,92,564,6,1162,1257,1408,2648
19.341,6,28,8792,13,158,1611,267,1317,15,858,1377,2045,7475
0.386,6,24,6021,12,181,35,537,1526,12,643,33,1448,4495
1795.54,6,356,22520,208,69,8674,69,12460,148,69,12214,69,10060
1.312,6,44,11555,24,547,57,1360,5934,20,400,59,1360,5621
1789.744,17,140,11200,70,48,25938,48,5320,70,56,25938,56,5880
1.786,6,10,924,5,283,402,283,551,5,105,403,105,373
167.889,6,29,6639,11,216,6681,501,1310,18,328,9870,1420,5329
0.475,6,21,7281,13,334,39,663,2021,8,967,63,1471,5260
279.383,6,30,7432,13,158,23281,267,1317,17,543,17458,1400,6115
71.088,6,28,7355,12,155,6462,267,1266,16,494,4738,2840,6089
1797.648,6,223,38823,107,934,16958,1402,28000,116,52,15631,65,10823
114.969,17,20,1520,20,48,6051,48,1520,0,0,0,0,0
1798.566,17,116,9280,58,48,31553,48,4408,58,56,31552,56,4872
5.004,17,4,288,2,36,5003,36,128,2,52,5003,52,160
1.273,1,30,840,30,0,0,0,840,0,0,0,0,0
132.46,6,31,14690,16,488,326,1360,3127,15,1216,9452,3928,11563
1.0,17,2,116,2,30,1000,30,116,0,0,0,0,0
1755.493,6,97,7575,47,33,38161,36,2688,50,379,35825,458,4887
1754.238,1,8,448,8,28,250605,28,448,0,0,0,0,0
213.32,6,30,7432,13,158,17776,267,1317,17,543,13327,1400,6115
62.641,17,6,8262,6,1349,12528,1349,8262,0,0,0,0,0
3.407,17,10,1450,5,40,849,40,340,5,194,849,194,1110
1799.589,17,448,39896,403,35,4476,288,25676,45,288,40014,288,14220
1523.982,1,48,5088,48,78,32425,78,5088,0,0,0,0,0
11.636,6,11,631,5,43,2909,43,311,6,0,2198,0,320
463.347,17,8,673,4,31,154438,37,239,4,80,154438,136,434
2.456,6,13,2311,8,188,350,245,700,5,1407,547,1407,1611
5.549,6,22,12560,6,186,1108,267,621,16,940,369,1420,11939
293.192,17,727,487159,684,681,429,1252,485439,43,12,4310,12,1720
1789.953,6,357,22698,207,69,8689,69,12420,150,69,12013,69,10278
1.881,17,2,1430,2,687,1881,687,1430,0,0,0,0,0
382.852,6,53,6858,23,116,11613,722,2487,30,140,13195,1408,4371
1797.914,1,243,13608,243,28,7429,28,13608,0,0,0,0,0
0.517,17,3,543,2,39,486,39,134,1,381,0,381,409
297.363,17,4,240,2,32,297362,32,120,2,32,297362,32,120
4.871,6,18,2069,9,222,608,222,1474,9,231,607,231,595
0.158,6,13,1997,7,329,26,500,1030,6,323,31,500,967
10.197,1,2,652,2,298,10197,334,652,0,0,0,0,0
63.114,6,35,5312,20,154,3321,722,2130,15,342,1112,1448,3182
1752.493,6,186,11385,93,47,19048,208,6766,93,31,19046,31,4619
10.682,6,16,4887,10,290,1186,517,1109,6,1152,2111,1460,3778
1143.017,2,12,384,12,8,103910,8,384,0,0,0,0,0
1785.863,6,426,25468,212,69,8463,69,12758,214,34,8384,64,12710
1745.534,6,97,7307,63,38,28153,205,4476,34,33,52884,98,2831
1786.045,6,102,8296,68,65,26657,65,4930,34,59,54119,59,3366
1741.734,6,87,6322,58,31,30556,31,3915,29,31,62204,31,2407
280.21,6,29,7392,13,158,23350,267,1317,16,603,18677,1400,6075
0.429,6,20,7168,12,319,38,602,1908,8,1209,60,1906,5260
1.084,6,28,8160,15,222,65,540,1964,13,944,74,1591,6196
0.014,17,2,405,1,35,0,35,63,1,314,0,314,342
1783.735,17,83,3480,82,14,22021,14,3444,1,8,0,8,36
5.513,6,572,470224,333,1340,16,1368,453120,239,776,22,1473,17104
1799.127,1,57,4788,0,0,0,0,0,57,56,32127,56,4788
1788.131,6,102,8228,68,64,26688,64,4896,34,58,54183,58,3332
1.774,17,6,552,3,32,870,32,180,3,96,870,96,372
360.898,2,5,160,5,8,90224,8,160,0,0,0,0,0
67.364,6,36,13245,11,155,709,267,1226,25,524,2806,1420,12019
147.276,6,6,339,2,0,3292,0,112,4,7,49031,7,227
5.685,6,42,7389,22,218,270,314,3503,20,513,284,1179,3886
194.735,6,6,1225,4,319,64911,398,799,2,173,194567,254,426
497.9,6,43,6493,16,132,15232,501,1835,27,178,19146,1420,4658
1795.685,17,140,11200,70,48,26024,48,5320,70,56,26024,56,5880
225.116,6,16,3249,8,92,32159,92,504,8,387,32130,1408,2745
1773.64,6,180,15480,120,69,14904,69,8940,60,69,30054,69,6540
0.666,17,4,304,2,37,0,37,130,2,59,1,65,174
1792.331,17,180,14040,180,50,10013,50,14040,0,0,0,0,0
288.935,6,180,28091,98,304,2978,304,19572,82,83,3566,83,8519
1787.905,6,366,25072,212,94,8473,469,14496,154,69,11685,69,10576
292.056,6,27,3197,11,324,29204,585,1241,16,141,19469,580,1956
1.149,6,61,27392,33,1037,35,1380,20095,28,511,41,1923,7297
0.398,6,21,7290,12,335,35,668,1974,9,968,49,1475,5316
4.97,6,44,8369,21,227,248,314,4022,23,427,213,1152,4347
1.668,6,13,2311,8,188,238,245,700,5,1407,352,1407,1611
57.953,17,751,265088,301,324,193,1350,106205,450,325,128,1350,158883
5.05,17,4,288,2,36,4983,36,128,2,52,5006,52,160
19.002,1,8,848,8,78,2714,78,848,0,0,0,0,0
84.033,6,12,492,5,0,21008,0,204,7,0,13993,0,288
4.791,6,40,7309,21,218,239,314,3463,19,513,252,1179,3846
1771.511,6,121,11041,75,65,23939,65,6312,46,59,39364,59,4729
1792.887,6,356,22520,208,69,8661,69,12460,148,69,12196,69,10060
1773.285,6,182,15629,121,69,14777,69,8980,61,69,29548,69,6649
0.209,6,10,1677,6,555,30,951,1354,4,159,55,159,323
1.551,6,24,6042,13,108,129,147,959,11,773,147,1608,5083
33.783,6,31,5093,15,154,2413,722,1859,16,342,2238,1408,3234
1786.626,6,104,8444,68,66,26666,66,4964,36,60,51043,60,3480
1799.721,1,228,24168,228,78,7928,78,24168,0,0,0,0,0
10.916,6,23,5271,12,351,992,1382,2242,11,430,1082,1460,3029
0.218,6,25,7216,12,155,19,267,1261,13,678,17,2045,5955
0.202,17,4,240,2,32,201,32,120,2,32,201,32,120
126.758,6,18,3365,8,92,18108,92,504,10,292,14064,1408,2861
1764.748,17,302,64602,302,185,5862,361,64602,0,0,0,0,0
4.495,6,38,7229,20,218,236,314,3423,18,513,248,1179,3806
1797.234,17,449,39928,404,35,4459,288,25708,45,288,40019,288,14220
10.189,6,10,436,4,0,3396,0,172,6,0,1709,0,264
0.032,6,3,120,1,0,0,0,40,2,0,32,0,80
93.793,17,4,240,2,32,93792,32,120,2,32,93792,32,120
3.048,17,4,324,2,34,3005,34,124,2,72,3038,72,200
2.443,17,3,451,2,39,919,39,134,1,289,0,289,317
11.667,6,1848,1611516,1121,1383,10,1420,1578215,727,420,16,1420,33301
298.451,1,6,336,6,28,59690,28,336,0,0,0,0,0
0.01,17,2,410,1,36,0,36,64,1,318,0,318,346
10.668,6,18,5610,10,275,1185,275,958,8,1440,805,1440,4652
640.182,6,65,5567,41,69,16004,69,3020,24,69,27787,69,2547
4.135,17,3,186,3,34,2067,34,186,0,0,0,0,0
1.82,6,2,96,2,0,0,0,96,0,0,0,0,0
10.768,6,20,4442,11,275,1076,275,998,9,768,749,1440,3444
8.506,6,25,8403,12,481,773,721,2410,13,683,668,1440,5993
0.904,2,2,64,2,8,904,8,64,0,0,0,0,0
0.081,17,2,193,1,46,0,46,74,1,91,0,91,119
1771.158,1,22,2908,22,104,84340,207,2908,0,0,0,0,0
1784.473,6,356,22520,208,69,8620,69,12460,148,69,12139,69,10060
1.195,6,3,258,2,138,1179,138,218,1,0,0,0,40
1.444,6,48,18327,26,891,57,1360,12671,22,433,59,1360,5656
1.508,6,50,19606,27,914,58,1460,13910,23,476,60,2615,5696
899.389,6,12,728,8,31,128484,31,444,4,31,299712,31,284
2.577,6,27,6095,14,338,198,1314,2254,13,414,213,1452,3841
4.956,17,2,628,2,286,4956,286,628,0,0,0,0,0
1792.484,1,139,7784,139,28,12989,28,7784,0,0,0,0,0
1796.812,17,448,39896,403,35,4469,288,25676,45,288,40022,288,14220
5.928,6,26,11440,13,357,494,721,1595,13,1165,384,2840,9845
57.094,17,19,7361,9,518,7124,1350,4916,10,216,6336,1350,2445
1741.26,6,90,6521,59,31,30021,31,3998,31,31,58033,31,2523
245.356,17,4,304,2,48,245355,64,152,2,48,245355,64,152
1.421,6,52,22861,29,998,50,1440,17165,23,433,56,1440,5696
240.354,6,46,9165,23,197,10924,751,2609,23,535,10923,2736,6556
33.732,6,34,5451,18,154,1984,721,2063,16,364,2235,2026,3388
0.443,17,2,677,1,300,0,300,328,1,321,0,321,349
20.178,6,17,2316,10,189,2242,517,1298,7,323,3360,499,1018
3.461,6,16,5973,6,186,690,267,621,10,822,383,1460,5352
372.084,6,23,2311,16,141,24805,141,825,7,398,3945,419,1486
10.769,6,19,4362,11,275,1076,275,998,8,758,868,1420,3364
667.352,1,12,672,12,28,60668,28,672,0,0,0,0,0
353.675,17,24,9552,24,370,15377,397,9552,0,0,0,0,0
0.011,17,2,439,1,43,0,43,71,1,340,0,340,368
240.167,6,4,196,2,0,239763,0,104,2,0,240167,0,92
0.515,6,23,7428,14,273,39,663,2104,9,1209,58,1946,5324
746.143,1,20,2120,20,78,39270,78,2120,0,0,0,0,0
1745.162,6,102,7970,66,45,26848,205,4902,36,35,49853,98,3068
13.337,17,3,984,3,300,6668,300,984,0,0,0,0,0
280.392,6,30,7432,13,158,23366,267,1317,17,543,17514,1400,6115
1770.246,6,99,9306,66,66,27234,66,5610,33,60,55316,60,3696
6.245,6,1138,1042247,704,1405,8,1440,1015015,434,776,14,1440,27232
158.033,6,38,8945,14,156,12155,267,1820,24,324,6870,1460,7125
0.33,17,16,8346,8,706,47,1350,5872,8,281,42,1350,2474
875.525,1,8,448,8,28,125075,28,448,0,0,0,0,0
60.458,6,28,11922,8,154,4471,267,792,20,645,3181,3417,11130
1789.867,17,140,11200,70,48,25939,48,5320,70,56,25939,56,5880
1778.151,1,298,16688,298,28,5987,28,16688,0,0,0,0,0
528.052,17,1170,56160,585,20,904,20,28080,585,20,904,20,28080
1.184,6,24,8004,12,164,91,267,1288,12,1014,91,2816,6716
374.298,17,9,3016,9,307,46787,308,3016,0,0,0,0,0
1771.965,6,180,15480,120,69,14890,69,8940,60,69,30030,69,6540
1798.741,1,180,19080,180,78,10048,78,19080,0,0,0,0,0
1780.065,1,336,28224,336,56,5313,56,28224,0,0,0,0,0
6.761,6,12,2271,7,188,1126,245,660,5,1407,1614,1407,1611
0.026,17,4,284,2,32,10,32,120,2,54,8,60,164
1.658,17,4,240,2,32,1657,32,120,2,32,1657,32,120
1786.627,6,102,8296,68,65,26666,65,4930,34,59,54137,59,3366
1.403,6,28,10995,16,334,93,663,2213,12,905,123,1368,8782
386.293,6,18,1242,14,180,29714,180,916,4,110,20063,110,326
1783.669,17,85,3569,83,14,21752,15,3487,2,13,269479,18,82
1781.772,6,365,23087,211,69,8484,69,12787,154,69,11645,69,10300
94.755,6,33,5211,20,180,4987,722,2132,13,399,1266,2026,3079
1767.486,17,168,13978,156,30,11403,37,9090,12,379,155242,463,4888
0.078,17,2,154,1,41,0,41,69,1,57,0,57,85
2.082,17,25,18326,12,701,189,1350,8754,13,708,165,1350,9572
1768.377,17,170,14599,157,30,11335,37,9148,13,391,142390,463,5451
1784.13,6,356,22520,208,69,8618,69,12460,148,69,12136,69,10060
324.182,6,589,474028,368,1320,883,1360,457278,221,207,145,1360,16750
5.031,17,4,288,2,36,5000,36,128,2,52,4995,52,160
1798.999,17,142,11360,71,48,25699,48,5396,71,56,25699,56,5964
1729.214,6,62,4504,40,33,44338,33,2740,22,31,82334,31,1764
0.126,17,2,586,1,46,0,46,74,1,484,0,484,512
5.026,6,39,7269,19,218,279,314,3383,20,513,248,1179,3886
1.03,6,23,6596,13,350,85,1089,2276,10,979,113,1731,4320
1751.166,1,8,448,8,28,250166,28,448,0,0,0,0,0
0.192,17,2,218,1,65,0,65,93,1,97,0,97,125
2.963,6,11,467,6,0,592,0,248,5,7,691,7,219
1799.416,17,764,46132,764,32,2358,37,46132,0,0,0,0,0
0.86,6,48,13745,24,551,37,1429,4876,24,464,36,1986,8869
1781.766,6,402,24525,212,69,8444,69,12620,190,42,9427,69,11905
1750.726,6,94,7151,62,38,28700,205,4424,32,33,56469,98,2727
27.545,17,4,352,2,60,27543,60,176,2,60,27544,60,176
1786.597,6,102,8296,68,65,26665,65,4930,34,59,54136,59,3366
86.92,6,39,25006,21,884,27,1360,6189,18,1644,5105,4416,18817
280.329,6,29,7392,13,158,23360,267,1317,16,603,18685,1400,6075
1680.591,17,12,498,11,14,168059,14,462,1,8,0,8,36
0.31,6,25,8987,13,266,25,705,1750,12,1100,27,2804,7237
300.645,6,35,8236,20,262,15823,671,1882,15,574,607,4848,6354
1786.434,6,102,8296,68,65,26663,65,4930,34,59,54131,59,3366
1787.327,6,124,12316,78,62,23212,721,6421,46,92,39713,2026,5895
0.766,6,12,1653,6,288,149,288,548,6,426,84,434,1105
242.367,17,4,240,2,32,242366,32,120,2,32,242366,32,120
266.154,6,49,5559,23,213,12097,672,3127,26,97,10646,457,2432
19.84,6,2,3000,0,0,0,0,0,2,1460,19840,1460,3000
0.014,17,2,322,1,36,0,36,64,1,230,0,230,258
3.862,6,54,19709,27,909,148,1440,13841,27,433,141,1440,5868
0.014,6,10,1514,5,503,3,503,771,5,475,3,475,743
5.263,6,40,7309,21,218,263,314,3463,19,513,278,1179,3846
1789.175,6,356,22520,208,69,8643,69,12460,148,69,12171,69,10060
1683.025,17,14,1036,7,30,280493,30,406,7,62,280499,62,630
1792.99,17,179,11456,179,36,10072,36,11456,0,0,0,0,0
1777.01,17,73,3060,72,14,25028,14,3024,1,8,0,8,36
0.438,17,8,2750,8,315,62,354,2750,0,0,0,0,0
1.653,6,24,8757,15,290,118,604,1476,9,1152,184,2840,7281
199.197,6,1666,826189,909,842,219,1152,787287,757,391,263,1179,38902
1.32,6,52,18742,29,841,47,1360,13001,23,437,52,2720,5741
121.921,6,23,8742,12,281,62,537,1357,11,1155,12179,3057,7385
1783.806,6,365,25363,212,100,8454,469,14896,153,69,11735,69,10467
1.202,17,4,368,2,32,990,32,120,2,96,997,96,248
0.593,6,20,6069,11,314,57,583,1837,9,751,72,1440,4232
1789.957,6,366,25541,213,99,8443,469,15005,153,69,11775,69,10536
146.204,6,50,10190,23,224,4160,1189,3171,27,370,5622,1420,7019
170.328,6,21,8744,11,325,65,634,1447,10,1147,18910,2568,7297
60.158,2,2,64,2,8,60158,8,64,0,0,0,0,0
5.966,6,40,7309,20,218,314,314,3423,20,513,297,1179,3886
13.094,6,59,20240,27,984,503,1440,13919,32,355,412,1440,6321
1756.294,6,105,6270,60,27,29766,27,3525,45,27,39914,27,2745
31.086,17,18,1584,9,48,3884,48,684,9,72,3884,72,900
0.279,6,27,9098,13,261,23,683,1728,14,947,21,2816,7370
1659.024,6,238,15730,137,73,12198,138,8723,101,69,11741,69,7007
280.203,6,27,7312,13,158,23350,267,1317,14,775,21550,2800,5995
132.215,6,30,8872,14,158,10170,267,1357,16,763,8806,3436,7515
13.786,6,21,6825,12,275,1253,275,1038,9,1353,1108,1440,5787
1783.134,17,83,3480,82,14,22014,14,3444,1,8,0,8,36
1787.233,6,104,8308,68,64,26675,64,4896,36,58,51061,58,3412
0.74,6,31,8042,17,345,46,720,1759,14,571,44,3488,6283
280.194,6,27,7312,12,158,25472,267,1277,15,678,20011,2800,6035
1779.321,17,140,11200,70,48,25787,48,5320,70,56,25787,56,5880
11.234,6,94,27074,48,537,239,1152,20752,46,447,243,1179,6322
1794.911,1,278,15568,278,28,6479,28,15568,0,0,0,0,0
1796.956,1,342,28728,342,56,5269,56,28728,0,0,0,0,0
1.15,6,24,8004,12,164,89,267,1288,12,1014,89,2411,6716
0.925,6,2,104,1,0,0,0,40,1,0,0,0,64
1790.42,6,364,25392,212,100,8485,469,14896,152,69,11854,69,10496
13.79,6,28,4921,13,154,1131,722,1768,15,338,972,1440,3153
0.118,17,2,588,1,39,0,39,67,1,493,0,493,521
1771.987,1,59,4956,59,56,30551,56,4956,0,0,0,0,0
1.335,6,49,20360,27,970,51,1460,14704,22,433,54,1460,5656
1792.688,1,342,28728,342,56,5257,56,28728,0,0,0,0,0
1726.311,17,12,498,11,14,172631,14,462,1,8,0,8,36
180.449,2,2,64,2,8,180449,8,64,0,0,0,0,0
0.054,17,2,472,1,60,0,60,88,1,356,0,356,384
1786.251,6,108,8536,68,65,26660,65,4930,40,59,45798,59,3606
1652.527,6,337,21553,189,70,8790,138,11769,148,69,11241,69,9784
1774.501,6,4961,4287314,2036,161,871,950,125650,2925,1403,606,1418,4161664
1243.621,17,14,3692,7,31,207269,37,413,7,440,207269,463,3279
0.122,6,12,1395,7,199,20,517,971,5,156,25,156,424
0.035,17,2,308,1,34,0,34,62,1,218,0,218,246
1774.465,1,59,4956,59,56,30594,56,4956,0,0,0,0,0
0.214,17,4,1327,4,303,71,354,1327,0,0,0,0,0
43.481,6,32,8252,13,158,3622,370,1315,19,514,2414,1420,6937
177.033,6,25,10376,13,203,103,299,1185,12,1087,16074,2573,9191
0.966,6,51,13845,24,553,42,1429,4856,27,464,36,1986,8989
1789.286,1,233,24698,233,78,7712,78,24698,0,0,0,0,0
10.789,6,20,4442,11,275,1078,275,998,9,768,753,1440,3444
484.4,6,94,7108,46,54,10755,69,2596,48,45,10306,125,4512
78.886,17,4,240,2,32,78885,32,120,2,32,78885,32,120
1681.456,17,14,1036,7,30,280237,30,406,7,62,280237,62,630
332.095,17,34,7922,34,205,10063,205,7922,0,0,0,0,0
0.508,6,10,924,5,283,85,283,551,5,105,85,105,373
0.101,17,2,2384,2,1164,101,1164,2384,0,0,0,0,0
5.905,6,13,2315,7,188,984,245,660,6,1407,1128,1407,1655
100.703,6,18,902,9,174,8286,174,538,9,0,12577,0,364
365.758,1,56,3136,0,0,0,0,0,56,28,6650,28,3136
34.156,6,23,3994,9,194,4269,293,1338,14,261,2606,1179,2656
89.31,6,35,5327,22,304,4252,304,3888,13,83,7384,83,1439
1657.214,1,7,392,7,28,276202,28,392,0,0,0,0,0
0.052,17,2,290,1,40,0,40,68,1,194,0,194,222
33.781,6,32,5156,16,154,2239,722,1922,16,399,2239,1402,3234
1629.327,1,8,448,8,28,232761,28,448,0,0,0,0,0
63.094,6,30,7297,14,155,4853,267,1346,16,441,4205,1420,5951
6.744,6,108,77266,68,1199,100,1408,69515,40,809,169,3964,7751
1798.13,1,58,4872,58,56,31546,56,4872,0,0,0,0,0
504.65,2,3,96,3,8,252325,8,96,0,0,0,0,0
1767.52,1,8,448,8,28,252502,28,448,0,0,0,0,0
0.081,17,2,376,1,39,0,39,67,1,281,0,281,309
0.017,17,2,410,1,63,0,63,91,1,291,0,291,319
1794.241,6,362,22898,210,69,8584,69,12678,152,69,11880,69,10220
135.952,6,28,8792,13,158,11329,267,1317,15,858,9705,2045,7475
1774.957,1,58,4872,58,56,31139,56,4872,0,0,0,0,0
217.994,6,198,166823,135,1310,1626,1408,151214,63,586,2655,1408,15609
1786.984,6,106,8456,68,65,26671,65,4930,38,59,48294,59,3526
240.639,6,45,9159,21,520,12028,1418,5787,24,235,10458,618,3372
0.136,6,10,1677,6,555,27,951,1354,4,159,27,159,323
280.178,6,28,7352,13,158,23348,267,1317,15,603,20012,2036,6035
1791.922,17,180,14040,180,50,10010,50,14040,0,0,0,0,0
23.636,17,4,352,2,60,23634,60,176,2,60,23634,60,176
240.256,6,56,18229,28,807,8897,1418,15194,28,196,8897,580,3035
3.841,1,5,420,5,56,960,56,420,0,0,0,0,0
10.18,6,11,2993,5,92,2545,92,348,6,1164,1927,1408,2645
106.351,6,30,7432,13,158,8862,267,1317,17,543,6644,1400,6115
1699.65,17,13,534,11,14,169948,14,462,2,8,1699481,8,72
1690.559,1,7,392,7,28,281759,28,392,0,0,0,0,0
171.353,6,56,13707,23,271,2863,469,4189,33,292,5354,1460,9518
0.857,6,22,5835,13,282,71,546,1370,9,683,93,1420,4465
6.311,6,520,454733,322,1346,19,1368,439641,198,776,30,2736,15092
1799.584,6,359,22709,209,69,8651,69,12569,150,69,12077,69,10140
466.315,6,45,7600,23,134,14762,516,2130,22,241,22201,1452,5470
0.376,6,10,968,5,256,92,256,460,5,304,92,304,508
126.612,6,22,8517,11,316,72,639,1420,11,949,12648,1440,7097
1797.698,6,190,11992,95,52,19122,208,7262,95,31,19122,31,4730
1787.907,6,430,26497,227,69,7911,69,13565,203,45,8851,69,12932
301.392,6,57,29438,29,915,10764,1408,10703,28,958,1162,1491,18735
0.444,6,10,1102,6,483,88,483,803,4,83,145,83,299
1772.342,6,180,15480,120,69,14893,69,8940,60,69,30032,69,6540
44.907,6,27,7177,13,155,3742,267,1306,14,530,3453,4260,5871
0.476,6,26,9017,13,257,39,669,1714,13,945,38,1438,7303
1722.884,17,145,16945,145,88,11964,371,16945,0,0,0,0,0
1.443,17,23,9492,10,531,160,1350,5593,13,271,74,1350,3899
110.001,6,23,10553,11,346,59,719,1510,12,1068,9987,1440,9043
294.525,2,2,64,2,8,294525,8,64,0,0,0,0,0
0.999,17,5,728,3,32,497,32,180,2,246,7,246,548
154.034,6,26,6460,15,169,11002,516,1618,11,549,15393,1452,4842
0.021,6,4,208,0,0,0,0,0,4,0,0,0,208
1795.416,17,448,39896,403,35,4466,288,25676,45,288,40016,288,14220
0.045,17,2,167,1,39,0,39,67,1,72,0,72,100
86.663,6,28,2039,14,66,6666,66,1088,14,65,6496,120,951
3.95,17,4,244,4,33,1316,33,244,0,0,0,0,0
1791.497,1,342,28728,342,56,5253,56,28728,0,0,0,0,0
12.126,6,1899,1658259,1151,1385,10,1420,1624118,748,467,16,1883,34141
0.056,17,4,344,2,47,53,47,150,2,69,53,75,194
1785.861,6,374,25999,216,98,8306,469,15263,158,69,11374,69,10736
373.593,6,27,1767,18,177,21976,177,1181,9,110,8662,110,586
9.018,6,22,9370,11,275,901,275,723,11,1170,800,1414,8647
1.205,6,24,8004,12,164,93,267,1288,12,1014,93,2804,6716
300.781,6,37,8526,19,315,16710,882,2053,18,441,502,1460,6473
1.763,17,16,6800,8,484,251,1350,4101,8,309,188,1350,2699
1.61,17,19,12210,9,568,201,1350,5365,10,656,94,1350,6845
1795.805,17,448,39896,403,35,4467,288,25676,45,288,40018,288,14220
127.163,17,4,240,2,32,127162,32,120,2,32,127162,32,120
0.127,6,13,1749,7,253,20,500,878,6,275,25,500,871
16.541,17,16,5414,8,373,2353,1350,3210,8,247,2351,1350,2204
111.408,1,16,896,16,28,7427,28,896,0,0,0,0,0
0.006,6,5,200,1,0,0,0,40,4,0,1,0,160
1785.825,6,356,22520,208,69,8627,69,12460,148,69,12146,69,10060
0.145,6,12,1938,7,209,24,209,581,5,544,35,891,1357
1799.641,17,449,39928,404,35,4465,288,25708,45,288,40015,288,14220
1188.071,17,210,15960,210,48,5684,48,15960,0,0,0,0,0
298.07,6,42,7801,16,143,14740,516,1790,26,225,11918,1452,6011
5.929,6,12,2271,7,188,988,245,660,5,1407,1415,1407,1611
98.824,1,4,224,4,28,32941,28,224,0,0,0,0,0
1792.812,17,178,11392,178,36,10128,36,11392,0,0,0,0,0
0.6,6,23,5482,13,125,49,212,1026,10,810,65,1731,4456
7.346,6,1644,1579450,1086,1380,6,1408,1545770,558,776,12,1408,33680
121.749,17,2,672,2,308,121749,308,672,0,0,0,0,0
1747.656,6,94,7151,62,38,28650,205,4424,32,33,56368,98,2727
1786.708,6,102,8296,68,65,26667,65,4930,34,59,54139,59,3366
1778.88,6,182,15629,121,69,14824,69,8980,61,69,29641,69,6649
30.226,6,1091,964502,671,1357,44,1368,934826,420,931,71,2736,29676
280.218,6,28,7352,13,158,23351,267,1317,15,678,20012,3436,6035
0.599,6,22,7300,13,325,49,626,1984,9,1210,68,1946,5316
265.508,17,4,352,2,60,265506,60,176,2,60,265507,60,176
0.883,6,10,1687,7,100,147,100,384,3,1179,315,1179,1303
0.626,6,29,13342,17,134,39,187,1855,12,1355,56,3643,11487
15.65,17,18,5426,9,334,1952,1350,3262,9,212,1952,1350,2164
1791.557,6,414,45457,200,509,9002,1418,21638,214,65,8398,1536,23819
283.618,6,482,402555,192,612,1484,1418,19448,290,1348,981,1418,383107
0.02,6,11,912,6,181,4,181,489,5,77,4,134,423
616.942,6,90,10261,46,177,13709,925,8067,44,31,14322,31,2194
36.122,6,25,7103,12,156,3283,267,1272,13,589,3008,3426,5831
372.491,6,23,1535,16,177,24832,177,1053,7,110,10395,110,482
1787.906,6,362,22898,210,69,8554,69,12678,152,69,11840,69,10220
52.784,6,113,60458,63,585,851,1408,10500,50,1246,1076,4224,49958
0.18,17,2,2750,2,1347,180,1347,2750,0,0,0,0,0
1654.241,1,7,392,7,28,275706,28,392,0,0,0,0,0
34.003,6,26,1867,13,332,2833,332,1036,13,83,2818,83,831
1765.543,17,168,14034,156,30,11390,37,9090,12,384,154891,463,4944
1650.098,1,8,448,8,28,235728,28,448,0,0,0,0,0
0.066,17,2,118,1,31,0,31,59,1,31,0,31,59
1783.884,6,356,22520,208,69,8617,69,12460,148,69,12134,69,10060
61.861,6,66,48188,44,1187,1438,1408,40308,22,961,2934,3847,7880
0.956,6,3,416,1,0,0,0,40,2,272,752,272,376
1795.106,6,354,22440,207,69,8714,69,12420,147,69,12292,69,10020
0.304,17,2,780,2,362,304,362,780,0,0,0,0,0
11.587,6,21,6825,12,275,1053,275,1038,9,1353,822,1420,5787
0.133,17,2,152,2,48,133,48,152,0,0,0,0,0
1764.273,2,14,448,14,8,135713,8,448,0,0,0,0,0
172.708,6,25,10089,12,531,64,1360,2637,13,988,14381,1360,7452
281.227,6,28,7693,13,158,23435,267,1317,15,721,20080,3445,6376
0.25,17,3,543,2,39,90,39,134,1,381,0,381,409
1740.718,17,30,31680,30,1028,60024,1028,31680,0,0,0,0,0
0.057,17,2,158,1,34,0,34,62,1,68,0,68,96
68.597,6,60,23506,31,668,2280,1360,11333,29,785,2443,1591,12173
0.046,17,2,456,1,46,0,46,74,1,354,0,354,382
1772.135,6,180,15480,120,69,14891,69,8940,60,69,30031,69,6540
87.925,17,14,1232,7,48,14653,48,532,7,72,14653,72,700
1761.771,6,183,18973,97,91,18351,722,9168,86,171,20723,1380,9805
280.187,6,27,7312,13,158,23348,267,1317,14,775,21551,2800,5995
300.894,6,38,9783,21,571,15044,1360,4301,17,435,542,2667,5482
0.703,6,130,103469,84,1324,8,1420,97408,46,467,15,1883,6061
1.373,6,51,20628,27,984,52,1460,14892,24,433,51,1460,5736
895.459,6,21,20882,3,174,2835,174,472,18,1405,52668,1420,20410
0.656,17,4,580,2,40,625,40,136,2,194,624,194,444
0.437,17,19,5572,8,316,62,1350,2752,11,228,38,1350,2820
9.576,6,85,24957,44,561,222,1152,19176,41,413,233,1152,5781
5.97,6,13,891,6,0,1,0,372,7,31,560,31,519
1790.615,6,359,22709,209,69,8608,69,12569,150,69,12017,69,10140
661.827,2,8,256,8,8,94546,8,256,0,0,0,0,0
1798.334,6,367,25650,214,99,8442,469,15045,153,69,11830,69,10605
175.188,17,2,72,1,8,0,8,36,1,8,0,8,36
280.453,6,29,7392,13,158,23371,267,1317,16,603,18692,2076,6075
61.92,6,73,49351,45,1176,1407,1448,41166,28,746,2284,1448,8185
2.827,17,25,6036,10,257,314,1350,2854,15,184,111,1350,3182
0.009,17,2,586,1,30,0,30,58,1,500,0,500,528
1794.137,17,80,3354,79,14,23001,14,3318,1,8,0,8,36
1724.493,1,8,448,8,28,246356,28,448,0,0,0,0,0
4.203,6,23,6460,11,262,415,517,1368,12,744,377,1418,5092
1737.172,1,56,4704,0,0,0,0,0,56,56,31584,56,4704
0.254,6,4,1037,2,0,220,0,104,2,853,41,853,933
87.75,6,4,362,0,0,0,0,0,4,67,29250,69,362
1781.322,1,342,28728,342,56,5223,56,28728,0,0,0,0,0
1787.901,6,354,22440,207,69,8679,69,12420,147,69,12245,69,10020
1.379,6,52,19258,29,879,49,1360,13517,23,437,54,2720,5741
5.056,6,38,7245,20,218,266,314,3423,18,516,281,1179,3822
5.362,6,38,7245,19,218,297,314,3383,19,442,283,1152,3862
1794.233,17,142,11360,71,48,25631,48,5396,71,56,25631,56,5964
15.276,6,16,2370,10,210,1695,210,972,6,545,3054,904,1398
0.128,17,2,472,1,60,0,60,88,1,356,0,356,384
7.945,6,46,8838,23,227,361,314,4102,23,476,349,1179,4736
0.03,6,2,123,1,0,0,0,40,1,31,0,31,83
22.756,6,13,2133,8,324,3250,585,1073,5,396,5686,580,1060
260.44,6,32,8952,14,158,20033,267,1357,18,687,15316,1781,7595
0.154,17,4,368,2,32,152,32,120,2,96,142,96,248
1532.742,6,93,7854,55,66,27644,66,4048,38,63,41422,91,3806
61.7,6,58,37106,36,1138,1762,1448,29208,22,749,2925,1448,7898
41.591,6,44,8864,21,378,569,786,2066,23,366,1883,2720,6798
175.556,6,21,8279,11,525,101,1237,2048,10,1163,19484,3151,6231
1772.517,6,202,22250,130,75,13740,267,10057,72,136,24960,2840,12193
5.504,6,41,7365,21,218,275,314,3463,20,516,276,1179,3902
373.77,6,29,1883,19,177,20765,177,1245,10,110,8727,110,638
504.069,2,3,96,3,8,252034,8,96,0,0,0,0,0
51.683,17,4,240,2,32,51681,32,120,2,32,51682,32,120
0.055,6,2,1500,1,0,0,0,40,1,1420,0,1420,1460
1783.31,17,83,3480,82,14,22016,14,3444,1,8,0,8,36
119.898,17,6,2081,1,308,0,308,336,5,321,29726,321,1745
1525.255,1,38,2128,38,28,41223,28,2128,0,0,0,0,0
1795.932,17,447,39580,403,35,4467,288,25676,44,288,40952,288,13904
1773.046,6,241,17968,120,69,14899,69,8940,121,34,14775,48,9028
240.206,6,53,17792,29,758,8578,1402,15174,24,194,10443,580,2618
0.094,17,2,588,1,39,0,39,67,1,493,0,493,521
240.244,6,53,18740,29,796,8579,1418,15858,24,232,10444,580,2882
1.284,6,49,18678,27,849,49,1360,13022,22,476,53,2715,5656
1772.51,6,204,22330,130,75,13740,267,10057,74,132,24279,1420,12273
1798.5,6,373,26028,216,98,8365,469,15263,157,69,11528,69,10765
280.263,6,31,7472,14,158,21558,267,1357,17,543,17513,1400,6115
1762.612,6,110,6623,61,27,29376,27,3589,49,27,36720,27,3034
1.014,6,23,6364,13,296,84,826,2007,10,988,110,1691,4357
1771.521,6,101,9344,66,65,27254,65,5577,35,59,52100,59,3767
6.027,6,1645,1541629,1053,1387,5,1408,1506181,592,931,9,2816,35448
0.381,6,23,7319,13,318,31,600,1970,10,803,41,1408,5349
35.258,6,41,8632,16,402,441,891,1878,25,441,1463,1440,6754
154.289,6,90,30322,41,639,3857,1360,14537,49,458,3194,1360,15785
2.443,17,4,240,2,32,2442,32,120,2,32,2441,32,120
1579.165,1,40,2240,40,28,40491,28,2240,0,0,0,0,0
52.93,6,42,8860,19,401,839,888,2031,23,346,2400,2720,6829
1791.183,17,87,3648,86,14,21072,14,3612,1,8,0,8,36
1790.662,6,363,23145,210,69,8567,69,12678,153,69,11780,69,10467
247.131,6,248,39589,137,304,1817,304,28008,111,83,2246,83,11581
1744.803,6,95,7234,62,38,28603,205,4424,33,33,54512,98,2810
0.005,17,2,294,1,36,0,36,64,1,202,0,202,230
5.301,6,56,20981,28,867,196,1440,15037,28,433,184,1440,5944
0.631,6,21,7203,13,318,52,600,1958,8,964,80,1471,5245
0.555,6,14,1745,7,288,64,288,600,7,426,64,434,1145
1.025,17,2,778,2,361,1025,361,778,0,0,0,0,0
1795.608,17,295,61237,295,179,6107,356,61237,0,0,0,0,0
0.0,1,1,112,1,84,0,84,112,0,0,0,0,0
6.259,17,25,7734,10,306,695,1350,3340,15,264,231,1350,4394
4.124,6,39,7269,20,218,217,314,3423,19,440,215,1152,3846
1799.414,17,171,10944,171,36,10584,36,10944,0,0,0,0,0
0.196,6,49,23504,28,1081,7,1420,18443,21,467,9,1883,5061
1785.858,6,369,25799,213,99,8423,469,15005,156,69,11521,69,10794
0.515,17,2,904,2,424,515,548,904,0,0,0,0,0
31.472,6,7,336,1,0,0,0,48,6,0,6293,0,288
1795.696,17,447,39864,402,35,4478,288,25644,45,288,40019,288,14220
5.111,6,14,2520,8,178,730,193,780,6,473,1011,891,1740
39.357,17,22,1936,11,48,3934,48,836,11,72,3934,72,1100
1796.288,17,142,11360,71,48,25661,48,5396,71,56,25661,56,5964
57.114,6,3,156,3,0,0,0,156,0,0,0,0,0
0.006,17,2,181,1,34,0,34,62,1,91,0,91,119
1.2,6,25,8056,12,164,92,267,1288,13,869,84,1402,6768
1742.929,6,95,7203,63,38,28111,205,4476,32,33,56214,98,2727
3.365,6,59,24407,30,905,116,1440,14001,29,576,112,1440,10406
0.302,17,2,204,1,34,0,34,62,1,114,0,114,142
280.541,6,28,7352,13,158,23378,267,1317,15,678,20033,2800,6035
189.163,6,46,9041,19,119,10509,267,1960,27,285,7273,1933,7081
1786.959,6,104,8354,68,63,26671,63,4862,36,57,51053,57,3492
0.075,17,2,572,1,39,0,39,67,1,477,0,477,505
1796.313,17,449,39928,404,35,4457,288,25708,45,288,40021,288,14220
0.879,17,3,305,2,32,466,32,120,1,157,0,157,185
30.721,6,37,8532,18,255,1807,722,2260,19,687,1648,1380,6272
1786.474,6,120,15100,76,193,23819,1290,10374,44,78,41543,240,4726
0.034,6,7,8860,1,0,0,0,40,6,1418,3,1418,8820
277.856,17,4,352,2,60,277855,60,176,2,60,277855,60,176
63.573,6,28,7217,13,155,5297,267,1306,15,482,4539,1997,5911
7.178,6,6,260,2,0,12,0,84,4,0,2389,0,176
9.029,6,16,1402,8,275,1289,275,878,8,96,1147,96,524
0.857,6,54,35950,30,1241,29,1360,28558,24,917,28,1360,7392
4.534,6,37,7205,19,218,251,314,3383,18,516,251,1179,3822
1772.441,6,180,15480,120,69,14894,69,8940,60,69,30033,69,6540
1786.675,6,102,8364,68,66,26666,66,4964,34,60,54139,60,3400
43.345,17,6,1236,3,48,21668,48,228,3,308,21668,308,1008
127.98,17,4,352,2,60,127979,60,176,2,60,127979,60,176
74.918,17,4,352,2,60,74916,60,176,2,60,74916,60,176
3.48,6,23,5715,13,158,271,370,1315,10,999,358,1691,4400
0.028,17,8,2454,8,278,4,317,2454,0,0,0,0,0
1783.814,17,142,11360,71,48,25482,48,5396,71,56,25482,56,5964
1786.462,6,190,11669,94,47,19209,208,6837,96,31,18802,31,4832
504.679,2,4,128,4,8,168226,8,128,0,0,0,0,0
10.31,6,9,527,5,43,2577,43,311,4,0,3403,0,216
90.664,6,76,54905,50,1194,1850,1368,46816,26,747,2475,1368,8089
42.303,17,44,6468,22,48,2013,48,1672,22,190,2013,308,4796
26.179,6,73,26011,36,854,747,1440,15216,37,543,722,1440,10795
0.225,6,18,4942,11,193,21,358,1218,7,860,36,1420,3724
0.093,17,2,180,1,30,0,30,58,1,94,0,94,122
1.786,6,19,4508,11,287,178,561,1305,8,575,213,1452,3203
3.658,17,3,1176,3,364,1829,364,1176,0,0,0,0,0
165.273,6,17,700,6,0,2440,0,244,11,0,16526,0,456
41.645,17,14,1064,14,48,3203,48,1064,0,0,0,0,0
1.723,6,49,19024,28,816,63,1360,13396,21,433,75,1360,5628
1776.098,17,140,11200,70,48,25740,48,5320,70,56,25740,56,5880
0.408,6,9,1346,5,145,102,145,349,4,833,117,833,997
216.036,17,3,222,3,46,108018,46,222,0,0,0,0,0
5.011,17,4,558,2,36,5007,36,128,2,187,5007,187,430
0.057,17,4,420,2,33,0,33,122,2,121,14,145,298
3.048,17,6,1046,3,30,1016,30,174,3,262,1518,272,872
5.035,17,4,288,2,36,5002,36,128,2,52,5003,52,160
133.91,6,113,84516,72,1259,1886,1408,74264,41,811,2193,3847,10252
240.6,2,4,128,4,8,80200,8,128,0,0,0,0,0
0.998,17,3,1005,2,300,354,300,656,1,321,0,321,349
312.54,6,9,596,7,106,52090,106,500,2,0,1012,0,96
0.792,17,4,934,2,40,780,40,136,2,371,779,379,798
1.484,6,46,18713,26,928,59,1460,13137,20,476,67,2615,5576
125.696,6,34,7866,13,155,10474,267,1306,21,357,6284,3417,6560
23.802,6,22,8789,13,326,1983,639,1532,9,1377,2958,3928,7257
280.58,6,29,7392,12,158,25507,267,1277,17,603,17533,1380,6115
0.014,6,2,104,2,0,0,0,104,0,0,0,0,0
12.102,6,92,26285,46,532,268,1152,19963,46,447,262,1179,6322
127.52,6,39,8417,15,131,4870,267,1530,24,295,5543,1917,6887
0.152,17,2,362,1,46,0,46,74,1,260,0,260,288
1786.705,17,87,3648,86,14,21020,14,3612,1,8,0,8,36
1735.122,6,219,18399,82,71,21419,301,8092,137,69,12757,1062,10307
5.257,17,4,352,2,60,5256,60,176,2,60,5256,60,176
0.365,6,9,527,5,43,91,43,311,4,0,116,0,216
0.177,6,9,1002,5,213,44,213,417,4,421,36,421,585
0.001,17,2,188,1,58,0,58,86,1,74,0,74,102
2.387,6,30,10427,18,367,140,833,1825,12,1014,208,1414,8602
1.794,6,27,10189,16,286,119,592,1504,11,1030,161,1420,8685
14.803,6,1951,1767832,1241,1371,11,1380,1733658,710,421,20,1923,34174
2.999,17,3,1005,2,300,481,300,656,1,321,0,321,349
1790.957,6,126,8927,73,68,24874,208,5846,53,31,34433,31,3081
280.295,6,29,7392,13,158,23357,267,1317,16,603,18681,1400,6075
1.325,6,49,18902,28,866,49,1360,13286,21,476,57,2715,5616
0.017,17,2,200,1,37,0,37,65,1,107,0,107,135
1782.963,6,356,22520,208,69,8613,69,12460,148,69,12128,69,10060
1775.52,6,204,16918,124,69,14435,69,9169,80,58,22474,69,7749
1783.173,6,108,8536,68,65,26614,65,4930,40,59,45718,59,3606
517.624,1,36,2016,36,28,14789,28,2016,0,0,0,0,0
5.347,17,3,208,2,36,5002,36,128,1,52,0,52,80
0.049,17,3,392,2,60,1,60,176,1,188,0,188,216
1698.103,17,20,1723,10,32,188671,37,601,10,84,188671,136,1122
0.243,6,22,7287,11,271,23,517,1666,11,1008,23,1691,5621
0.006,17,2,405,1,35,0,35,63,1,314,0,314,342
0.513,6,23,7397,13,334,42,663,2021,10,967,52,1471,5376
0.194,6,10,1327,5,299,44,299,567,5,246,44,459,760
34.962,6,15,4565,5,324,8740,585,917,10,518,3883,580,3648
1.837,6,27,10181,16,285,122,588,1500,11,1029,166,1420,8681
5.964,6,1331,1199816,800,1419,7,1448,1167540,531,776,10,1448,32276
1798.496,17,447,39580,403,35,4473,288,25676,44,288,40947,288,13904
629.866,2,6,192,6,8,125973,8,192,0,0,0,0,0
125.849,2,2,64,2,8,125849,8,64,0,0,0,0,0
1753.459,17,138,11040,69,48,25785,48,5244,69,56,25785,56,5796
1787.974,6,365,25501,212,100,8473,469,14896,153,69,11760,69,10605
240.269,6,44,8879,21,519,12013,1402,5790,23,188,10920,618,3089
599.515,6,11,657,7,31,99919,31,373,4,31,199797,31,284
0.343,17,2,204,1,34,0,34,62,1,114,0,114,142
0.31,6,20,4960,10,137,34,267,1092,10,692,33,1467,3868
0.005,17,2,255,1,43,0,43,71,1,156,0,156,184
0.864,1,2,112,2,28,864,28,112,0,0,0,0,0
0.922,6,28,8496,15,222,57,540,2000,13,994,62,2720,6496
1770.91,6,99,9306,66,66,27244,66,5610,33,60,55337,60,3696
0.006,17,2,396,1,39,0,39,67,1,301,0,301,329
17.116,6,14,2185,8,324,2445,585,1073,6,396,3420,580,1112
1798.089,6,443,28897,221,98,8173,469,15532,222,34,8136,64,13365
0.074,17,4,360,2,30,10,30,116,2,94,31,94,244
1746.96,6,97,7369,63,38,28176,205,4476,34,33,52925,98,2893
386.349,6,9538,9790602,3185,732,121,1448,202547,6353,1463,60,5792,9588055
1738.792,1,56,4704,56,56,31614,56,4704,0,0,0,0,0
2.222,17,6,471,3,31,1087,31,177,3,70,1013,70,294
1744.627,2,27,864,27,8,67101,8,864,0,0,0,0,0
1263.344,2,11,352,11,8,126334,8,352,0,0,0,0,0
69.062,6,14,572,7,0,11510,0,284,7,0,10740,0,288
1680.466,1,14,784,14,28,129266,28,784,0,0,0,0,0
36.568,17,11,836,11,48,3656,48,836,0,0,0,0,0
0.416,6,27,8984,13,234,34,575,1620,14,828,28,1448,7364
240.597,6,41,8853,20,607,12662,1418,5905,21,231,12029,580,2948
2.851,17,12,6474,6,615,570,1350,3859,6,407,320,1350,2615
1771.431,6,99,9306,66,66,27252,66,5610,33,60,55353,60,3696
1798.229,17,448,39896,403,35,4473,288,25676,45,288,40020,288,14220
1799.153,17,449,39928,404,35,4464,288,25708,45,288,40016,288,14220
1797.886,17,448,39896,403,35,4472,288,25676,45,288,40022,288,14220
6.061,6,1570,1455824,995,1386,5,1408,1421260,575,931,10,2801,34564
173.104,6,32,5436,14,169,9245,516,1578,18,260,10176,1452,3858
49.885,17,11,7469,11,651,4988,651,7469,0,0,0,0,0
280.429,6,29,7392,13,158,23369,267,1317,16,678,18693,3456,6075
240.206,6,55,19743,30,803,8282,1408,16836,25,199,10008,580,2907
0.225,17,2,157,1,31,0,31,59,1,70,0,70,98
586.093,6,519,436601,325,1373,1808,1448,407034,194,525,1952,1448,29567
1165.537,1,6,336,6,28,233107,28,336,0,0,0,0,0
1799.978,6,228,20029,85,81,21428,339,9233,143,70,12674,1062,10796
161.103,6,11,440,11,0,0,0,440,0,0,0,0,0
82.213,6,680,311731,350,825,235,1152,293026,330,423,249,1179,18705
175.671,6,10,636,3,106,72495,106,226,7,90,29244,90,410
1775.06,6,180,15480,120,69,14916,69,8940,60,69,30078,69,6540
0.021,17,3,618,2,32,1,32,120,1,470,0,470,498
71.357,6,11,1346,6,302,14271,302,912,5,83,17835,83,434
1785.927,6,278,34654,116,142,15528,1360,17242,162,131,11091,1942,17412
3.065,17,4,1560,4,362,1021,362,1560,0,0,0,0,0
153.705,17,4,352,2,60,153704,60,176,2,60,153703,60,176
279.956,17,4,240,2,32,279955,32,120,2,32,279955,32,120
0.505,17,2,384,1,39,0,39,67,1,289,0,289,317
1767.801,6,79,4160,40,26,45327,26,2106,39,26,46519,26,2054
92.576,6,19,6358,5,106,23144,106,314,14,456,7116,1460,6044
1748.661,6,97,7307,63,38,28204,205,4476,34,33,52982,98,2831
0.217,17,2,184,1,32,0,32,60,1,96,0,96,124
1729.757,6,77,13804,50,111,35301,1408,5186,27,300,66522,2816,8618
599.322,6,9,546,6,31,119864,31,333,3,31,299650,31,213
0.194,6,25,7216,12,155,17,267,1261,13,678,15,2800,5955
1799.898,1,16,896,16,28,119993,28,896,0,0,0,0,0
194.995,6,14,784,6,0,38994,0,312,8,56,27853,56,472
273.372,6,31,8912,14,158,21028,267,1357,17,763,17080,2076,7555
1792.273,17,142,11360,71,48,25603,48,5396,71,56,25603,56,5964
5.013,17,4,558,2,36,5005,36,128,2,187,5008,187,430
302.838,17,16,2384,16,121,20189,121,2384,0,0,0,0,0
71.556,6,26,7159,10,155,7950,267,1186,16,443,4768,1460,5973
1.995,17,3,660,2,46,1002,46,148,1,484,0,484,512
1746.03,6,90,6540,60,31,29593,31,4050,30,31,60193,31,2490
281.301,6,30,7570,13,158,23441,267,1317,17,556,17550,4200,6253
35.34,6,33,5200,16,154,2356,722,1912,17,300,2188,1448,3288
369.387,6,23,1535,16,177,24625,177,1053,7,110,10374,110,482
0.104,1,2,112,2,28,104,28,112,0,0,0,0,0
0.129,6,10,583,5,43,32,43,311,5,0,31,0,272
165.917,6,26,1068,10,0,6172,0,408,16,0,11060,0,660
2.31,17,26,6111,10,261,256,1350,2890,16,173,123,1350,3221
66.505,6,16,656,7,0,8210,0,284,9,0,8312,0,372
5.03,17,3,208,2,36,5006,36,128,1,52,0,52,80
154.061,17,4,352,2,60,154060,60,176,2,60,154060,60,176
1784.086,6,105,8550,69,66,26236,66,5070,36,60,50970,60,3480
0.978,17,4,724,2,32,973,32,120,2,274,973,274,604
15.872,6,20,1495,10,222,1762,222,848,10,231,1762,231,647
7.058,17,4,352,2,60,7057,60,176,2,60,7056,60,176
2.599,6,22,3505,12,167,236,293,1490,10,537,261,1179,2015
0.418,6,13,1693,6,288,80,288,548,7,426,38,434,1145
1792.003,6,366,23679,205,69,8784,69,12547,161,69,11200,69,11132
2.0,6,5,338,1,0,0,0,40,4,69,630,69,298
1751.031,6,127,7874,71,43,25014,208,4673,56,31,31678,31,3201
755.67,2,6,192,6,8,151134,8,192,0,0,0,0,0
6.301,6,38,7229,19,218,350,314,3383,19,513,336,1179,3846
1782.867,6,102,8296,68,65,26609,65,4930,34,59,54023,59,3366
1585.575,1,14,1641,14,89,121967,105,1641,0,0,0,0,0
37.672,6,44,8823,21,410,670,882,2150,23,478,1706,2128,6673
20.164,17,2,1084,2,514,20164,514,1084,0,0,0,0,0
1787.473,6,104,8504,69,66,26286,66,5004,35,60,52569,60,3500
881.864,1,8,448,8,28,125980,28,448,0,0,0,0,0
1786.619,6,102,8364,68,66,26665,66,4964,34,60,54136,60,3400
19.276,17,19,7023,9,477,2406,1350,4547,10,219,2138,1350,2476
1772.505,6,180,15480,120,69,14895,69,8940,60,69,30037,69,6540
1745.625,6,95,7203,63,38,28155,205,4476,32,33,56301,98,2727
0.003,6,3,128,2,0,3,0,88,1,0,0,0,40
3.214,6,2,88,2,0,0,0,88,0,0,0,0,0
1797.32,1,136,14416,136,78,13313,78,14416,0,0,0,0,0
0.071,17,4,284,2,32,0,32,120,2,54,1,60,164
0.313,6,20,7252,12,337,27,674,1980,8,1212,43,1906,5272
1.003,6,17,2730,9,288,122,288,692,8,568,116,853,2038
0.004,17,2,1152,1,548,0,548,576,1,548,0,548,576
5.089,17,4,288,2,36,5005,36,128,2,52,4979,52,160
18.09,6,17,2624,10,211,1995,211,1161,7,545,2984,904,1463
1793.999,1,92,9752,92,78,19714,78,9752,0,0,0,0,0
2.143,6,86,53094,50,1224,43,1432,47354,36,389,55,1432,5740
1786.666,6,102,8296,68,65,26666,65,4930,34,59,54138,59,3366
1775.945,17,73,3060,72,14,25013,14,3024,1,8,0,8,36
1741.463,17,29,30624,29,1028,62195,1028,30624,0,0,0,0,0
601.649,2,5,160,5,8,150412,8,160,0,0,0,0,0
1787.584,6,102,8228,68,64,26680,64,4896,34,58,54165,58,3332
170.477,17,4,352,2,60,170476,60,176,2,60,170475,60,176
277.501,6,25,7094,11,181,27750,267,1168,14,595,21344,1400,5926
1147.432,6,60,4360,40,31,29421,31,2700,20,31,60358,31,1660
0.254,17,3,543,2,39,46,39,134,1,381,0,381,409
1788.781,6,367,23374,212,69,8477,69,12758,155,69,11615,69,10616
8.785,6,17,1442,9,275,1098,275,918,8,96,1115,96,524
320.996,6,38,11497,14,310,24691,1189,2742,24,409,13955,1420,8755
1796.029,17,448,39896,403,35,4467,288,25676,45,288,40018,288,14220
1740.64,17,30,31680,30,1028,60022,1028,31680,0,0,0,0,0
16.21,17,58,19818,26,457,646,1350,12614,32,197,521,1350,7204
1787.353,6,118,14012,75,81,24153,501,5950,43,154,42553,1420,8062
599.225,6,9,546,6,31,119845,31,333,3,31,299569,31,213
0.874,6,11,1727,7,100,145,100,384,4,589,206,1152,1343
1.17,6,25,8056,12,164,91,267,1288,13,869,83,1448,6768
1741.129,6,87,6322,58,31,30546,31,3915,29,31,62182,31,2407
1776.304,1,69,5796,69,56,26122,56,5796,0,0,0,0,0
517.19,17,76,5776,76,48,6895,48,5776,0,0,0,0,0
0.842,6,28,5967,13,156,70,267,1462,15,650,55,1420,4505
2.21,6,51,19979,28,932,81,1460,14232,23,370,92,1460,5747
1.336,6,28,8263,15,225,83,561,1985,13,957,96,1631,6278
1.678,6,14,2351,8,188,239,245,700,6,703,284,1152,1651
0.056,6,5,303,2,0,1,0,116,3,31,22,31,187
43.289,6,34,8548,14,400,684,885,1817,20,422,2268,2720,6731
0.0,17,1,273,1,245,0,245,273,0,0,0,0,0
1793.783,17,66,2766,65,14,28027,14,2730,1,8,0,8,36
30.042,6,12,1317,7,174,5007,174,546,5,251,7508,476,771
11.261,17,3,1008,3,308,5630,308,1008,0,0,0,0,0
0.01,17,2,142,1,43,0,43,71,1,43,0,43,71
0.418,6,7,371,4,0,139,0,204,3,7,107,7,167
64.108,17,18,1584,9,48,8012,48,684,9,72,8012,72,900
280.187,6,27,7312,12,158,25471,267,1277,15,678,20010,2045,6035
1793.274,6,356,22520,208,69,8663,69,12460,148,69,12198,69,10060
0.493,6,27,9018,13,248,41,633,1678,14,941,34,1368,7340
33.802,6,92,68910,40,665,866,760,3614,52,1390,641,1418,65296
0.017,6,9,1547,5,515,4,515,783,4,548,5,548,764
243.748,6,20,7529,8,165,45,165,613,12,1256,22158,1408,6916
77.541,17,4,240,2,32,77539,32,120,2,32,77540,32,120
1743.275,6,95,7203,63,38,28117,205,4476,32,33,56223,98,2727
1740.597,17,30,7050,30,207,60020,207,7050,0,0,0,0,0
1682.623,17,14,1036,7,30,280428,30,406,7,62,280427,62,630
1763.223,17,150,25454,150,141,11833,373,25454,0,0,0,0,0
1787.659,17,142,11360,71,48,25537,48,5396,71,56,25537,56,5964
0.721,6,97,56903,51,1263,14,1432,48880,46,513,15,1871,8023
217.415,6,44,8754,22,114,10353,267,2149,22,336,7437,1917,6605
1.406,6,38,9848,21,440,70,1360,4392,17,476,75,2715,5456
11.834,17,4,352,2,60,11832,60,176,2,60,11833,60,176
1773.622,6,181,15589,120,69,14904,69,8940,61,69,29556,69,6649
1.285,6,24,8004,12,164,99,267,1288,12,1014,99,2804,6716
0.376,6,20,7576,10,366,41,517,1638,10,1079,39,1418,5938
1746.263,6,90,6540,60,31,29597,31,4050,30,31,60206,31,2490
34.505,6,31,5959,15,180,2464,721,1869,16,406,2286,2026,4090
0.017,17,4,624,2,64,14,64,184,2,192,1,192,440
31.817,17,4,352,2,48,31807,48,152,2,72,31805,72,200
3.772,17,5,295,5,31,943,31,295,0,0,0,0,0
6.302,1,4,224,4,28,2100,28,224,0,0,0,0,0
300.666,6,45,9002,22,318,14317,928,2235,23,364,389,1440,6767
1773.458,6,184,15778,122,69,14656,69,9020,62,69,29067,69,6758
0.157,17,2,190,1,59,0,59,87,1,75,0,75,103
0.221,17,2,204,1,34,0,34,62,1,114,0,114,142
109.483,6,35,9400,10,147,327,267,1292,25,394,4561,1452,8108
2.791,17,3,1167,3,361,1395,361,1167,0,0,0,0,0
145.996,6,65,41031,40,1144,3743,1408,32989,25,748,2561,1408,8042
31.133,17,51,15553,23,234,1413,1350,6044,28,311,1151,1350,9509
1792.817,17,180,11520,180,36,10015,36,11520,0,0,0,0,0
1788.976,17,142,11360,71,48,25556,48,5396,71,56,25556,56,5964
1787.506,17,87,3648,86,14,21029,14,3612,1,8,0,8,36
1798.563,17,447,39864,402,35,4485,288,25644,45,288,40015,288,14220
1224.093,6,130,11272,82,70,15112,138,6178,48,69,26044,69,5094
1123.96,17,220,16720,220,48,5132,48,16720,0,0,0,0,0
0.959,1,30,840,30,0,0,0,840,0,0,0,0,0
1795.73,17,448,39896,403,35,4466,288,25676,45,288,40020,288,14220
21.269,6,14,3153,5,92,5317,92,348,9,579,2601,1408,2805
0.558,6,23,7428,14,273,42,663,2104,9,1209,65,1946,5324
1783.815,6,356,22520,208,69,8617,69,12460,148,69,12134,69,10060
0.407,6,10,1992,5,288,95,288,508,5,424,57,434,1484
81.652,6,28,14284,15,887,77,1360,5957,13,1299,6790,3639,8327
0.14,17,2,245,1,32,0,32,60,1,157,0,157,185
1741.043,6,87,6322,58,31,30544,31,3915,29,31,62179,31,2407
1799.367,17,142,11360,71,48,25705,48,5396,71,56,25705,56,5964
0.135,17,4,420,2,33,0,33,122,2,121,122,145,298
1797.604,1,345,28980,345,56,5225,56,28980,0,0,0,0,0
1744.354,6,98,7390,63,38,28134,205,4476,35,33,51294,98,2914
1788.591,17,87,3648,86,14,21042,14,3612,1,8,0,8,36
0.268,17,2,180,1,30,0,30,58,1,94,0,94,122
1770.202,6,105,9694,68,65,26420,65,5705,37,59,49169,59,3989
150.917,17,18,1380,9,40,18862,41,618,9,56,18862,57,762
0.295,6,23,5080,10,137,32,267,1092,13,692,24,1467,3988
0.688,17,4,368,2,32,591,32,120,2,96,384,96,248
1799.053,6,376,26286,218,97,8290,469,15481,158,69,11456,69,10805
296.035,1,4,224,4,28,98678,28,224,0,0,0,0,0
62.154,6,43,15901,26,447,2486,1282,5038,17,830,3871,2816,10863
62.824,6,27,7177,13,155,5235,267,1306,14,530,4831,3417,5871
1795.867,17,449,39928,404,35,4456,288,25708,45,288,40024,288,14220
0.479,6,21,5000,10,137,53,267,1092,11,692,34,1467,3908
84.723,6,778,356499,401,822,211,1152,336628,377,435,224,1179,19871
172.001,1,2,120,2,32,172001,32,120,0,0,0,0,0
2.878,17,3,468,3,128,1439,128,468,0,0,0,0,0
0.123,17,2,411,1,33,0,33,61,1,322,0,322,350
9.791,6,1521,1351558,957,1361,10,1420,1324611,564,475,17,1883,26947
1.702,17,14,5083,14,335,130,361,5083,0,0,0,0,0
1.407,6,19,3781,10,234,156,564,1452,9,463,153,1343,2329
1771.704,6,99,9240,66,65,27256,65,5577,33,59,55362,59,3663
8.079,6,1583,1445690,995,1375,7,1408,1410450,588,776,13,1408,35240
1799.906,6,118,12016,76,62,23998,722,6350,42,96,42432,1408,5666
77.176,6,29,8832,13,158,6431,267,1317,16,763,5141,2045,7515
1.526,17,2,255,1,43,0,43,71,1,156,0,156,184
4.296,17,2,152,2,48,4296,48,152,0,0,0,0,0
5.572,17,4,558,2,36,5568,36,128,2,187,5566,187,430
1.297,17,15,1125,9,40,162,41,617,6,56,243,57,508
0.019,17,2,439,1,33,0,33,61,1,350,0,350,378
0.024,17,2,664,1,308,0,308,336,1,300,0,300,328
240.162,6,161,127545,64,288,3811,910,5076,97,1365,2501,4254,122469
6.773,6,38,8002,19,218,376,314,3383,19,550,361,1179,4619
0.093,17,2,410,1,46,0,46,74,1,308,0,308,336
64.06,6,7,388,4,0,21353,0,216,3,0,31892,0,172
1799.949,17,1933,146824,1054,40,1709,41,72373,879,56,2050,57,74451
33.924,1,5,140,5,0,0,0,140,0,0,0,0,0
1776.474,17,73,3060,72,14,25020,14,3024,1,8,0,8,36
11.384,17,15,17682,15,1150,813,1451,17682,0,0,0,0,0
57.676,6,37,10233,19,783,492,1360,4711,18,435,3382,2667,5522
15.011,17,5,380,5,48,3752,48,380,0,0,0,0,0
2.09,17,3,1170,3,362,1045,362,1170,0,0,0,0,0
0.013,17,2,554,2,249,13,249,554,0,0,0,0,0
272.83,17,4,352,2,60,272829,60,176,2,60,272829,60,176
0.423,6,14,1733,7,288,67,288,588,7,284,40,434,1145
68.654,6,592,271488,304,823,226,1152,253349,288,441,238,1179,18139
1799.748,17,450,39960,405,35,4454,288,25740,45,288,40022,288,14220
5.687,6,13,2311,8,188,812,245,700,5,1407,1354,1407,1611
0.127,17,2,152,1,48,0,48,76,1,48,0,48,76
0.005,6,12,19764,1,0,0,0,40,11,1741,0,2736,19724
1745.694,6,95,7203,63,38,28156,205,4476,32,33,56299,98,2727
161.083,17,4,352,2,60,161082,60,176,2,60,161082,60,176
1772.509,6,203,22290,130,75,13740,267,10057,73,134,24614,1997,12233
0.009,17,2,378,1,30,0,30,58,1,292,0,292,320
1781.765,6,420,25176,210,69,8525,69,12540,210,34,8525,48,12636
1.421,6,30,6427,15,164,101,267,1922,15,780,88,1460,4505
0.93,17,4,314,2,31,892,31,118,2,70,899,70,196
182.494,1,4,224,4,28,60831,28,224,0,0,0,0,0
1791.217,17,79,3312,78,14,23262,14,3276,1,8,0,8,36
0.882,6,140,113640,72,131,12,232,3409,68,1706,13,5680,110231
7.381,6,1479,1351136,931,1373,7,1408,1317976,548,931,13,2801,33160
23.282,6,58,13000,35,317,684,1368,6277,23,275,1055,1328,6723
33.051,6,32,7044,19,190,1836,517,2720,13,455,2753,499,4324
1718.404,1,140,7840,140,28,12362,28,7840,0,0,0,0,0
1772.303,6,180,15480,120,69,14893,69,8940,60,69,30035,69,6540
0.041,17,2,399,1,39,0,39,67,1,304,0,304,332
7.979,6,1895,1649516,1076,1438,7,1448,1595138,819,792,9,1448,54378
1738.506,6,87,6322,58,31,30500,31,3915,29,31,62089,31,2407
1681.656,17,16,1265,8,30,240234,37,471,8,71,240234,136,794
0.092,6,18,9468,11,517,9,517,1097,7,1999,12,2688,8371
1772.154,6,180,15480,120,69,14892,69,8940,60,69,30034,69,6540
1682.419,17,14,1036,7,30,280395,30,406,7,62,280395,62,630
1772.987,6,181,15589,120,69,14899,69,8940,61,69,29547,69,6649
1775.505,6,205,22439,130,75,13763,267,10057,75,132,23986,1460,12382
10.692,6,10,1699,4,100,3564,100,264,6,589,2086,1152,1435
8.093,6,484,409530,299,1304,26,1368,395246,185,931,42,2736,14284
1756.224,6,187,11456,93,47,19089,208,6766,94,31,18881,31,4690
2.065,17,28,18263,14,722,153,1350,10507,14,526,153,1350,7756
1.46,6,37,8218,19,321,81,1168,2722,18,476,74,2720,5496
5.784,6,30,8443,13,155,482,267,1306,17,496,360,1997,7137
36.425,17,4,352,2,60,36424,60,176,2,60,36424,60,176
1.197,6,22,7900,11,164,101,267,1236,11,1216,101,3819,6664
880.151,6,117,15045,68,86,13136,267,5566,49,174,18333,1997,9479
1771.512,6,82,4418,41,26,44286,26,2210,41,26,44286,26,2208
0.089,17,4,680,2,33,0,33,122,2,251,45,323,558
77.583,6,22,8039,11,512,88,1197,2008,11,797,7740,1440,6031
14.72,6,9,588,4,106,4906,106,274,5,90,3629,90,314
11.755,6,1886,1625502,1139,1372,10,1420,1591389,747,467,15,1883,34113
280.524,6,31,7472,13,158,23377,267,1317,18,603,16493,2076,6155
1772.107,6,180,15480,120,69,14891,69,8940,60,69,30034,69,6540
1747.444,6,101,7918,65,45,27303,205,4850,36,35,49917,98,3068
101.4,6,25,9040,12,704,74,1440,3331,13,739,8435,1440,5709
240.17,6,56,20284,30,836,8281,1408,17459,26,183,9606,580,2825
372.099,6,18,1242,14,180,28623,180,916,4,110,20063,110,326
9.33,6,91,28394,45,563,212,1152,22072,46,407,201,1152,6322
1786.615,6,106,8524,68,66,26665,66,4964,38,60,48284,60,3560
1771.321,6,104,9644,67,66,26838,66,5728,37,60,49200,60,3916
1785.858,6,365,25432,212,100,8463,469,14896,153,69,11749,69,10536
89.708,6,38,7922,21,116,4485,722,2418,17,461,977,2026,5504
0.173,6,44,21087,26,1077,6,1420,16146,18,467,8,1883,4941
0.302,17,4,644,2,36,296,36,128,2,230,296,230,516
312.334,6,13,756,5,106,78080,106,314,8,90,44617,90,442
0.027,6,16,3113,8,404,3,644,1636,8,351,2,870,1477
0.318,17,8,2774,8,318,45,357,2774,0,0,0,0,0
23.717,6,14,2716,6,841,4739,1460,1926,8,231,3386,231,790
1.54,6,25,6039,13,164,128,453,1494,12,652,137,1440,4545
8.349,6,69,20742,36,559,238,1152,15995,33,489,252,1179,4747
0.368,6,12,1653,6,288,70,288,548,6,426,38,434,1105
280.315,6,28,7352,13,158,23359,267,1317,15,603,20020,2036,6035
240.18,6,50,12064,24,191,10442,751,2839,26,604,9607,1408,9225
48.838,17,4,240,2,32,48837,32,120,2,32,48836,32,120
266.363,1,8,448,8,28,38051,28,448,0,0,0,0,0
1789.988,1,342,28728,342,56,5249,56,28728,0,0,0,0,0
45.824,6,34,10176,13,328,193,1189,2501,21,487,2290,1420,7675
0.023,17,4,608,2,60,21,60,176,2,188,9,188,432
0.11,17,2,304,1,60,0,60,88,1,188,0,188,216
109.914,6,25,10081,12,523,53,1360,2629,13,988,9149,1360,7452
0.071,6,17,3150,8,451,9,779,1778,9,224,8,694,1372
0.107,17,2,152,1,48,0,48,76,1,48,0,48,76
1686.628,17,15,1094,8,30,240945,30,464,7,62,281100,62,630
281.486,6,33,7556,14,158,21652,267,1357,19,543,15634,1380,6199
1263.346,2,11,352,11,8,126334,8,352,0,0,0,0,0
0.049,17,2,198,1,39,0,39,67,1,103,0,103,131
0.111,17,2,904,2,424,111,548,904,0,0,0,0,0
1782.208,17,86,3606,85,14,21216,14,3570,1,8,0,8,36
1772.419,6,180,15480,120,69,14894,69,8940,60,69,30032,69,6540
26.517,6,3853,3693365,2486,1407,10,1448,3617593,1367,776,19,1448,75772
0.1,17,2,322,1,33,0,33,61,1,233,0,233,261
252.03,2,3,96,3,8,126015,8,96,0,0,0,0,0
240.767,6,49,10214,25,524,10031,1418,6060,24,263,10467,990,4154
488.417,6,226,79747,105,775,4696,1460,62466,121,262,4065,1638,17281
0.55,17,3,543,2,39,392,39,134,1,381,0,381,409
37.445,6,30,7432,13,158,3120,267,1317,17,543,2338,1400,6115
240.221,6,57,18288,30,805,8283,1418,15278,27,199,9238,580,3010
1798.606,17,449,39416,404,34,4463,288,25444,45,282,40016,288,13972
1791.085,17,144,11520,72,48,25226,48,5472,72,56,25226,56,6048
134.082,6,20,9776,11,380,80,832,1613,9,1558,16742,3928,8163
10.166,6,16,5255,9,275,1270,275,643,7,1440,857,1440,4612
17.17,6,28,11777,9,226,2123,226,702,19,686,769,1360,11075
110.019,6,24,8082,12,378,61,801,1672,12,739,9989,2720,6410
1786.841,6,102,8228,68,64,26669,64,4896,34,58,54143,58,3332
1785.993,17,298,22648,298,48,6013,48,22648,0,0,0,0,0
0.146,1,2,112,2,28,146,28,112,0,0,0,0,0
211.086,17,6,2016,6,308,42217,308,2016,0,0,0,0,0
0.024,6,2,1520,1,0,0,0,40,1,1440,0,1440,1480
1787.219,6,102,8296,68,65,26674,65,4930,34,59,54155,59,3366
1783.291,17,83,3480,82,14,22015,14,3444,1,8,0,8,36
385.402,1,3,348,3,88,192701,88,348,0,0,0,0,0
13.429,6,2116,1854621,1285,1387,10,1420,1817148,831,467,16,1883,37473
1775.412,6,343,33743,171,134,10442,208,25933,172,31,10381,31,7810
0.147,6,9,1346,5,145,36,145,349,4,833,27,833,997
1680.529,1,15,840,15,28,120037,28,840,0,0,0,0,0
15.587,6,6,264,1,0,0,0,44,5,0,3852,0,220
32.124,6,13,5668,4,106,10708,106,274,9,718,4007,1452,5394
4.113,17,3,183,3,33,2056,33,183,0,0,0,0,0
280.492,6,30,7432,14,158,21576,267,1357,16,603,18696,2800,6075
1799.999,6,354,22440,206,69,8680,69,12380,148,69,12244,69,10060
1780.019,17,142,11360,71,48,25428,48,5396,71,56,25428,56,5964
128.237,6,60,39064,38,1168,3465,1408,31188,22,960,2924,3847,7876
7.705,6,1249,1071977,745,1388,10,1420,1047584,504,420,15,1420,24393
176.501,6,10,562,3,106,88245,106,234,7,0,29415,0,328
17.208,6,2785,2656070,1786,1408,9,1448,2599458,999,776,17,1448,56612
1.228,6,10,924,5,283,211,283,551,5,105,197,105,373
9.588,6,78,24341,39,550,252,1152,18640,39,459,244,1179,5701
2.215,17,3,174,3,30,1107,30,174,0,0,0,0,0
524.046,17,16,3060,8,48,74862,48,608,8,278,74862,308,2452
1786.33,6,108,8604,68,66,26661,66,4964,40,60,45800,60,3640
1800.0,6,211,16442,78,71,22986,328,7848,133,48,13636,78,8594
88.08,6,12,3780,12,286,8007,379,3780,0,0,0,0,0
1779.11,6,104,8376,68,65,26553,65,4930,36,59,50828,59,3446
1123.031,17,14,3541,7,32,187169,37,420,7,417,186912,463,3121
174.027,17,12,4032,12,308,15820,308,4032,0,0,0,0,0
0.953,6,10,1687,7,100,158,100,384,3,1179,348,1179,1303
1740.114,6,100,7860,66,45,26770,205,4896,34,35,52722,98,2964
94.729,6,22,8962,11,514,82,1237,2015,11,927,9455,1460,6947
28.187,17,8,1648,4,48,9294,48,304,4,308,9389,308,1344
1736.4,1,74,7844,74,78,23786,78,7844,0,0,0,0,0
1323.57,2,12,384,12,8,120324,8,384,0,0,0,0,0
263.474,6,22,6646,4,106,87824,106,274,18,375,15496,1420,6372
5.024,17,4,288,2,36,4976,36,128,2,52,4981,52,160
90.25,6,30,7432,13,158,7520,267,1317,17,603,5637,2076,6115
1782.224,17,81,3393,79,13,22846,14,3313,2,12,1782049,16,80
1770.354,6,99,9240,66,65,27236,65,5577,33,59,55320,59,3663
144.513,17,12,2000,6,48,28901,48,456,6,229,28901,308,1544
121.88,6,37,15819,17,1156,832,1360,14599,20,152,6405,152,1220
9.292,2,2,64,2,8,9292,8,64,0,0,0,0,0
3.733,17,2,656,2,300,3733,300,656,0,0,0,0,0
88.049,6,27,7312,13,158,7337,267,1317,14,775,6766,4836,5995
4.403,6,38,7229,19,218,244,314,3383,19,440,229,1152,3846
1795.748,6,356,22520,208,69,8675,69,12460,148,69,12215,69,10060
0.027,17,2,212,1,46,0,46,74,1,110,0,110,138
1134.057,2,9,288,9,8,141757,8,288,0,0,0,0,0
4.076,6,26,10474,11,268,403,517,1409,15,920,288,1418,9065
42.281,6,1034,810757,576,1356,73,1380,786511,458,383,92,1380,24246
72.308,6,90,65060,59,1187,1246,1368,54171,31,713,2400,1368,10889
1786.465,6,102,8364,68,66,26663,66,4964,34,60,54132,60,3400
1798.848,6,159,10973,84,67,21672,208,6950,75,31,24303,31,4023
2.062,17,4,3964,4,963,687,1451,3964,0,0,0,0,0
1.459,1,2,112,2,28,1459,28,112,0,0,0,0,0
4.366,6,39,7285,19,218,242,314,3383,20,442,216,1152,3902
27.51,6,51,13308,24,172,1196,722,2692,27,680,1018,2760,10616
1796.993,17,448,39896,403,35,4470,288,25676,45,288,40022,288,14220
0.393,6,12,1653,6,288,71,288,548,6,426,44,434,1105
1773.383,6,180,15480,120,69,14902,69,8940,60,69,30055,69,6540
1771.248,6,99,9240,66,65,27249,65,5577,33,59,55348,59,3663
67.79,17,4,240,2,32,67788,32,120,2,32,67789,32,120
16.003,1,3,168,3,28,8001,28,168,0,0,0,0,0
1.471,6,49,19312,27,896,56,1360,13656,22,433,59,1360,5656
1795.763,6,109,8818,70,65,26025,65,5075,39,59,47254,59,3743
0.291,6,26,9038,13,262,24,690,1735,13,1103,23,2816,7303
1773.423,6,180,15480,120,69,14902,69,8940,60,69,30052,69,6540
2.97,17,2,122,2,33,2970,33,122,0,0,0,0,0
59.15,6,36,8337,18,371,506,797,1865,18,478,3472,2720,6472
222.588,2,4,128,4,8,74196,8,128,0,0,0,0,0
0.41,17,5,1808,5,333,102,361,1808,0,0,0,0,0
1623.998,1,7,392,7,28,270666,28,392,0,0,0,0,0
1785.79,17,87,3648,86,14,21009,14,3612,1,8,0,8,36
0.332,6,27,9071,13,247,27,624,1672,14,832,24,1448,7399
1785.86,6,370,28474,215,117,8345,1189,15987,155,93,11596,485,12487
5.874,6,39,7269,19,218,326,314,3383,20,513,292,1179,3886
0.338,6,27,9059,13,252,28,647,1704,14,945,25,1408,7355
0.217,17,2,198,1,37,0,37,65,1,105,0,105,133
12.189,17,10,850,5,37,3045,37,325,5,77,3045,77,525
0.195,6,3,772,2,398,195,398,478,1,254,0,254,294
35.736,1,12,1248,0,0,0,0,0,12,76,3248,76,1248
0.693,6,15,1785,8,288,84,288,640,7,426,85,434,1145
1780.75,6,83,5276,41,36,44517,36,2180,42,456,43431,456,3096
1.658,6,7,295,4,0,552,0,164,3,7,354,7,131
48.346,6,38,9069,21,116,2417,332,1802,17,597,1715,1440,7267
1794.216,1,58,4872,58,56,31477,56,4872,0,0,0,0,0
339.899,6,1464,1304724,904,1427,376,1460,1272026,560,171,85,1460,32698
20.202,6,31,8912,14,158,1554,267,1357,17,687,1258,1781,7555
1.33,6,38,8258,19,321,73,1168,2722,19,433,63,1360,5536
10.868,6,1977,1791998,1177,1436,9,1448,1741598,800,776,13,1448,50400
5.029,6,29,16567,13,965,419,1448,3629,16,1209,334,2242,12938
1744.635,2,19,608,19,8,96924,8,608,0,0,0,0,0
223.218,6,31,6806,13,189,9093,516,1470,18,307,13125,1452,5336
192.008,6,4,1448,4,322,64002,436,1448,0,0,0,0,0
1.387,6,38,9848,21,440,69,1360,4392,17,476,75,2715,5456
1741.09,6,90,6521,59,31,30018,31,3979,31,31,57980,31,2542
198.66,17,4,352,2,60,198658,60,176,2,60,198659,60,176
1782.625,17,319,50685,319,130,5605,376,50685,0,0,0,0,0
0.031,17,2,222,1,36,0,36,64,1,130,0,130,158
1688.45,17,14,1036,7,30,281405,30,406,7,62,281405,62,630
10.942,6,20,4442,11,275,1094,275,998,9,768,771,1440,3444
1787.874,6,375,23694,214,69,8393,69,13114,161,69,11174,69,10580
3.582,6,24,6532,11,268,353,517,1385,13,744,294,1418,5147
0.007,17,2,382,1,37,0,37,65,1,289,0,289,317
1081.142,17,112,9404,104,30,10496,37,6060,8,390,145911,463,3344
281.366,6,31,7813,14,158,21643,267,1357,17,577,17580,2036,6456
0.58,6,52,21505,28,1009,21,1380,16291,24,383,23,1380,5214
1.223,6,11,1727,7,100,203,100,384,4,589,323,1152,1343
1776.425,17,140,11200,70,48,25745,48,5320,70,56,25745,56,5880
43.43,17,3,228,3,48,21715,48,228,0,0,0,0,0
160.646,6,14,4104,4,92,53548,92,296,10,1088,17826,1408,3808
1.241,6,236,172226,128,1376,9,1432,163442,108,389,11,1432,8784
299.146,6,6,364,4,31,99715,31,222,2,31,299138,31,142
61.749,6,37,15989,22,805,2940,1448,9211,15,665,4388,1448,6778
77.014,6,47,8974,22,360,687,734,2066,25,327,3202,1360,6908
1787.276,6,356,22520,208,69,8634,69,12460,148,69,12155,69,10060
1051.365,17,52,2178,51,14,21027,14,2142,1,8,0,8,36
1730.192,6,61,4485,41,33,43254,33,2825,20,31,91053,31,1660
142.976,6,16,3970,8,407,20425,722,1226,8,464,20396,1408,2744
0.854,6,4,160,1,0,0,0,40,3,0,424,0,120
3.635,6,2,88,2,0,0,0,88,0,0,0,0,0
1705.823,1,9,504,9,28,213227,28,504,0,0,0,0,0
1798.624,1,339,28476,339,56,5321,56,28476,0,0,0,0,0
0.168,17,3,2906,3,940,84,1451,2906,0,0,0,0,0
16.363,6,2786,2425321,1600,1424,10,1448,2351601,1186,776,13,1448,73720
225.237,6,1628,781064,853,843,264,1152,742152,775,395,290,1179,38912
22.914,6,25,7097,12,155,2083,267,1266,13,589,1909,3426,5831
0.78,17,2,672,2,308,780,308,672,0,0,0,0,0
0.557,17,23,15780,12,867,48,1350,10746,11,429,51,1350,5034
1795.916,17,448,39896,403,35,4467,288,25676,45,288,40017,288,14220
1786.606,6,104,8444,68,66,26665,66,4964,36,60,51043,60,3480
1794.049,6,381,27231,214,104,8422,469,15652,167,69,10807,69,11579
0.647,6,12,1653,6,288,123,288,548,6,426,71,434,1105
0.495,6,9,1346,5,145,123,145,349,4,833,138,833,997
0.992,6,10,1687,7,100,165,100,384,3,1179,360,1179,1303
4.463,6,38,7229,19,218,247,314,3383,19,513,233,1179,3846
10.04,17,2,142,2,43,10040,43,142,0,0,0,0,0
85.841,6,41,9485,18,290,1888,1189,2764,23,413,3901,1420,6721
0.003,6,2,1460,1,0,0,0,40,1,1380,0,1380,1420
0.015,17,2,420,1,39,0,39,67,1,325,0,325,353
0.025,17,2,672,2,308,25,308,672,0,0,0,0,0
38.181,17,44,6468,22,48,1817,48,1672,22,190,1817,308,4796
1564.269,2,16,512,16,8,104284,8,512,0,0,0,0,0
277.186,17,4,240,2,32,277185,32,120,2,32,277185,32,120
1746.912,6,95,7203,63,38,28176,205,4476,32,33,56340,98,2727
275.239,17,4,558,2,36,275224,36,128,2,187,275230,187,430
126.011,2,2,64,2,8,126011,8,64,0,0,0,0,0
300.561,6,22,1507,11,177,30038,177,829,11,110,30038,110,678
172.157,6,30,10630,13,727,95,1286,3475,17,646,10749,1631,7155
1782.798,6,102,8296,68,65,26608,65,4930,34,59,54021,59,3366
1799.691,17,448,39612,404,35,4465,288,25708,44,288,40952,288,13904
59.061,2,2,64,2,8,59061,8,64,0,0,0,0,0
0.012,17,2,407,1,59,0,59,87,1,292,0,292,320
30.822,6,6,360,0,0,0,0,0,6,0,0,0,360
0.02,17,2,904,1,300,0,300,328,1,548,0,548,576
1761.082,6,131,8605,71,52,25154,208,4996,60,31,29845,31,3609
1783.17,17,83,3480,82,14,22014,14,3444,1,8,0,8,36
559.295,17,6,528,3,60,279647,60,264,3,60,279647,60,264
0.192,6,25,7216,13,155,16,267,1301,12,678,15,3436,5915
1762.518,1,67,5628,67,56,26704,56,5628,0,0,0,0,0
92.874,17,3531,4194981,484,60,192,1350,42893,3047,1334,30,1350,4152088
1745.424,6,97,7307,63,38,28152,205,4476,34,33,52882,98,2831
173.094,6,21,8417,11,468,86,1067,1878,10,1021,19212,1591,6539
2.453,6,60,21495,32,955,79,1460,13801,28,386,77,1460,7694
285.384,6,17,1315,9,332,35671,332,820,8,83,40767,83,495
1790.97,6,189,21190,101,113,17909,721,11056,88,150,20582,2840,10134
1788.533,6,100,6484,64,47,28389,208,4114,36,31,51086,31,2370
1783.493,6,125,12368,77,62,23467,722,6371,48,87,37940,1408,5997
0.428,6,538,544710,346,194,1,230,22407,192,2696,1,12618,522303
0.071,17,2,152,1,48,0,48,76,1,48,0,48,76
20.19,6,21,13597,8,275,2884,275,599,13,1134,1617,2840,12998
352.037,6,22,6693,3,106,13,106,234,19,334,19556,1460,6459
370.921,6,18,1242,14,180,28532,180,916,4,110,20064,110,326
0.584,6,15,1785,8,288,58,288,640,7,426,68,434,1145
0.072,6,11,1864,7,262,12,517,896,4,752,22,752,968
1790.835,17,83,3480,82,14,22109,14,3444,1,8,0,8,36
240.143,6,39,4904,20,181,12638,517,2139,19,221,13341,851,2765
29.205,6,36,8337,18,371,506,797,1865,18,478,1710,2128,6472
1773.653,6,182,15629,121,69,14780,69,8980,61,69,29559,69,6649
1787.424,17,87,3648,86,14,21028,14,3612,1,8,0,8,36
160.377,1,8,448,8,28,22911,28,448,0,0,0,0,0
0.077,6,9,1339,5,145,19,145,349,4,826,22,826,990
1680.407,1,15,870,15,30,120029,30,870,0,0,0,0,0
0.012,6,5,678,2,316,7,316,420,3,102,4,102,258
1771.14,6,100,9358,66,66,27248,66,5610,34,60,53668,60,3748
1682.656,17,14,1036,7,30,280437,30,406,7,62,280435,62,630
1760.064,1,114,12084,114,78,15575,78,12084,0,0,0,0,0
1791.755,6,107,8305,69,42,26349,205,4984,38,37,48418,108,3321
5.09,17,3,257,2,37,5004,37,130,1,99,0,99,127
141.984,6,25,10447,13,721,102,1309,3437,12,814,12891,1460,7010
0.625,17,4,240,2,32,624,32,120,2,32,624,32,120
1797.413,1,56,4704,56,56,32680,56,4704,0,0,0,0,0
1.02,17,3,201,3,39,510,39,201,0,0,0,0,0
466.628,1,6,336,6,28,93325,28,336,0,0,0,0,0
125.931,2,2,64,2,8,125931,8,64,0,0,0,0,0
327.608,17,5,680,5,108,81902,348,680,0,0,0,0,0
1784.873,6,359,22709,209,69,8581,69,12569,150,69,11978,69,10140
8.713,6,18,2477,10,211,963,211,974,8,545,1241,904,1503
280.418,6,30,7432,13,158,23368,267,1317,17,543,17523,1400,6115
0.302,6,21,7302,12,335,26,668,1986,9,968,37,1475,5316
1799.339,17,349,90583,349,231,5170,422,90583,0,0,0,0,0
1772.012,6,205,22508,130,75,13736,267,10057,75,133,23945,1997,12451
1781.329,6,353,22400,206,69,8689,69,12380,147,69,12200,69,10020
0.232,17,2,144,1,36,0,36,64,1,52,0,52,80
1797.944,1,345,28980,345,56,5226,56,28980,0,0,0,0,0
666.22,6,28,3448,18,195,39185,1448,2711,10,31,74003,31,737
1795.897,17,449,39928,404,35,4456,288,25708,45,288,40017,288,14220
0.188,17,4,420,2,33,184,33,122,2,121,183,145,298
1772.423,6,180,15480,120,69,14894,69,8940,60,69,30038,69,6540
1.275,6,50,19058,28,937,47,1460,13357,22,400,52,1460,5701
0.036,17,3,244,2,32,20,32,120,1,96,0,96,124
0.318,17,2,144,1,36,0,36,64,1,52,0,52,80
8.338,6,44,8469,23,218,379,314,4202,21,489,388,1179,4267
1798.571,6,367,25650,214,99,8443,469,15045,153,69,11829,69,10605
1770.5,6,99,9306,66,66,27238,66,5610,33,60,55325,60,3696
0.005,17,2,672,2,308,5,308,672,0,0,0,0,0
1.3,6,45,17343,25,894,54,1460,11767,20,433,59,1460,5576
1772.296,6,180,15480,120,69,14893,69,8940,60,69,30034,69,6540
13.587,6,14,1025,7,222,2263,222,506,7,231,2263,231,519
9.052,6,3,239,1,0,0,0,40,2,83,8067,83,199
0.22,6,34,24607,16,180,14,250,1382,18,1392,9,2880,23225
1.229,6,40,9928,21,440,61,1360,4392,19,433,58,1360,5536
1.408,6,25,8056,12,164,108,267,1288,13,869,100,1368,6768
125.488,6,25,6287,9,272,95,518,1182,16,343,8360,1420,5105
1786.311,6,105,8416,68,65,26661,65,4930,37,59,49617,59,3486
576.017,17,390,28115,306,40,1888,41,21008,84,56,440,57,7107
1786.706,6,102,8228,68,64,26667,64,4896,34,58,54140,58,3332
1788.743,1,222,12432,222,28,8093,28,12432,0,0,0,0,0
1202.933,2,17,544,17,8,75183,8,544,0,0,0,0,0
230.945,17,4,352,2,60,230944,60,176,2,60,230944,60,176
0.019,17,2,128,1,36,0,36,64,1,36,0,36,64
3.032,17,30,15229,15,743,216,1350,11569,15,216,112,1350,3660
7.356,6,1695,1564327,1070,1384,6,1408,1527163,625,931,11,2801,37164
369.703,6,23,6694,5,106,92425,106,322,18,375,21744,1460,6372
1772.579,6,180,15480,120,69,14895,69,8940,60,69,30037,69,6540
229.266,17,4,304,2,48,229265,64,152,2,48,229264,64,152
9.384,6,26,7229,7,134,1564,267,1093,19,447,519,1460,6136
1792.598,6,357,22629,208,69,8657,69,12460,149,69,12111,69,10169
0.274,6,26,8870,13,232,22,567,1612,13,1095,22,2816,7258
301.211,6,50,13802,22,724,14335,1360,7434,28,261,11149,2667,6368
64.85,6,15,1370,6,177,121,177,674,9,110,8083,110,696
0.061,17,2,323,1,33,0,33,61,1,234,0,234,262
1796.048,1,82,4592,82,28,22173,28,4592,0,0,0,0,0
0.681,6,4,220,2,0,681,0,100,2,0,304,0,120
186.124,17,3,1022,3,312,93062,322,1022,0,0,0,0,0
0.533,6,10,968,5,256,129,256,460,5,304,129,304,508
284.633,1,4,224,4,28,94877,28,224,0,0,0,0,0
1791.349,6,359,22709,209,69,8612,69,12569,150,69,12022,69,10140
1782.143,6,104,8376,68,65,26599,65,4930,36,59,50914,59,3446
125.322,6,32,7717,12,155,28,267,1266,20,376,6595,3417,6451
1789.609,6,4095,3928473,1393,129,1285,344,80929,2702,1411,662,2836,3847544
369.701,6,18,1242,14,180,28438,180,916,4,110,20062,110,326
4.788,17,4,424,2,46,4742,46,148,2,110,4756,110,276
1020.482,6,66,9690,38,102,20509,516,3264,28,212,37792,1452,6426
4.171,6,35,6209,19,206,231,314,2824,16,548,260,1179,3385
148.785,6,36,8511,12,155,180,267,1266,24,330,6468,1420,7245
124.453,17,3,1008,3,308,62226,308,1008,0,0,0,0,0
1.129,6,11,1727,7,100,188,100,384,4,589,292,1152,1343
240.303,6,61,20488,31,786,8009,1418,17358,30,195,8285,580,3130
2.928,6,13,2311,8,188,418,245,700,5,1407,670,1407,1611
0.415,17,4,624,2,64,412,64,184,2,192,297,192,440
3.006,17,2,1430,2,687,3006,687,1430,0,0,0,0,0
0.053,6,14,1421,8,17,7,32,458,6,321,10,642,963
290.826,1,4,224,4,28,96942,28,224,0,0,0,0,0
0.092,17,3,451,2,39,87,39,134,1,289,0,289,317
5.428,17,4,240,2,32,5427,32,120,2,32,5427,32,120
1786.237,6,103,8395,68,65,26660,65,4930,35,59,52533,59,3465
1782.863,17,140,11200,70,48,25838,48,5320,70,56,25838,56,5880
0.077,17,2,317,1,43,0,43,71,1,218,0,218,246
1794.424,17,29,9512,29,300,64086,300,9512,0,0,0,0,0
8.253,6,3,213,2,62,1,62,142,1,31,0,31,71
638.831,6,1337,1206120,555,129,1153,338,36472,782,1479,817,5632,1169648
1.013,6,19,7099,12,318,92,600,1906,7,1205,144,1851,5193
0.98,17,3,1164,3,360,490,360,1164,0,0,0,0,0
1794.382,17,351,45418,172,174,10493,1350,34846,179,31,10080,60,10572
19.181,17,4,352,2,48,19172,48,152,2,72,19171,72,200
54.069,6,31,8912,14,158,4159,267,1357,17,687,3375,1781,7555
71.352,6,37,9234,14,155,5488,267,1346,23,386,3234,1420,7888
1.144,6,31,6044,16,111,76,267,1539,15,650,72,1420,4505
28.414,6,9,527,5,43,7103,43,311,4,0,9469,0,216
81.473,6,22,900,10,0,6183,0,404,12,0,7405,0,496
1786.837,6,102,8228,68,64,26669,64,4896,34,58,54142,58,3332
372.416,6,27,1767,18,177,21906,177,1181,9,110,8891,110,586
1.351,6,48,18651,26,917,54,1460,12995,22,433,55,1460,5656
0.013,2,2,64,2,8,13,8,64,0,0,0,0,0
159.853,6,23,1969,11,119,15985,208,1396,12,31,14399,31,573
39.975,17,12,912,12,48,3634,48,912,0,0,0,0,0
77.328,1,9,504,9,28,9666,28,504,0,0,0,0,0
33.885,6,51,17673,27,880,1296,1360,11682,24,358,1465,1360,5991
1794.976,17,448,39896,403,35,4465,288,25676,45,288,40020,288,14220
0.001,17,2,360,1,40,0,40,68,1,264,0,264,292
0.513,6,22,5040,10,137,57,267,1092,12,692,40,1487,3948
352.501,17,12,2472,6,48,70498,48,456,6,308,70497,308,2016
1721.104,1,8,448,8,28,245872,28,448,0,0,0,0,0
6.168,6,1519,1467824,1006,1385,5,1408,1436484,513,931,11,2801,31340
137.27,6,1133,580226,640,845,214,1152,553978,493,383,278,1152,26248
53.691,6,25,7097,12,155,4881,267,1266,13,589,4473,3426,5831
240.263,6,44,8621,22,461,11440,1402,4880,22,258,11440,580,3741
1771.61,6,103,9448,66,65,27255,65,5577,37,59,49209,59,3871
1761.495,6,118,11988,75,63,23803,722,6268,43,99,41934,2330,5720
38.77,6,4874,4626127,3118,1404,12,1448,4530127,1756,776,21,1448,96000
8.145,6,79,24930,40,568,208,1152,19229,39,413,207,1152,5701
11.844,6,1743,1619866,1143,1365,10,1432,1591575,600,427,19,1432,28291
280.237,6,30,7432,14,158,21556,267,1357,16,603,18677,2800,6075
0.112,17,2,168,1,48,0,48,76,1,64,0,64,92
58.7,6,18,8311,8,275,8385,275,603,10,1216,6093,1440,7708
1776.655,1,112,6272,112,28,16005,28,6272,0,0,0,0,0
6.068,17,6,498,3,47,3031,47,225,3,63,3030,63,273
1.63,6,52,22474,29,974,58,1440,16778,23,433,64,1440,5696
721.902,2,5,160,5,8,180475,8,160,0,0,0,0,0
240.346,6,46,9073,24,517,10449,1418,5910,22,223,11443,639,3163
1794.152,6,447,26160,239,69,7538,69,13700,208,34,8667,64,12460
0.218,6,10,1669,6,551,43,947,1346,4,159,72,159,323
1776.433,17,73,3060,72,14,25020,14,3024,1,8,0,8,36
90.241,6,49,10405,24,533,429,910,3199,25,364,3754,2128,7206
843.266,6,170,11106,86,69,9204,69,5234,84,59,10159,69,5872
1745.386,6,95,7203,63,38,28151,205,4476,32,33,56292,98,2727
1705.047,1,65,5460,65,56,26641,56,5460,0,0,0,0,0
11.583,6,1746,1599252,1086,1420,10,1432,1568619,660,420,17,1432,30633
221.875,17,15,6210,15,386,15848,394,6210,0,0,0,0,0
1773.013,1,59,4956,59,56,30569,56,4956,0,0,0,0,0
890.474,6,188,14281,108,126,8322,469,8735,80,69,11271,69,5546
7.538,6,23,4478,13,213,628,597,1741,10,441,815,1402,2737
0.402,6,10,968,5,256,98,256,460,5,304,97,304,508
1786.432,6,106,8644,70,66,25890,66,5044,36,60,51037,60,3600
1677.745,1,15,870,15,30,119838,30,870,0,0,0,0,0
0.759,6,28,5967,13,156,63,267,1462,15,650,49,1420,4505
23.518,6,47,10282,22,533,599,910,3107,25,385,974,2128,7175
1785.59,17,138,11040,69,48,26258,48,5244,69,56,26258,56,5796
10.734,6,35,23067,21,202,536,202,1302,14,1911,782,2816,21765
11.916,6,1880,1760843,1186,1407,10,1448,1720091,694,776,16,1448,40752
91.587,6,32,7172,15,217,6538,517,1704,17,458,5721,2417,5468
240.24,6,58,17268,30,715,8283,1418,14455,28,168,8897,580,2813
143.456,17,8,2624,8,300,20493,300,2624,0,0,0,0,0
0.238,6,25,6032,12,164,21,453,1442,13,651,18,1448,4590
1777.267,17,140,11200,70,48,25757,48,5320,70,56,25757,56,5880
1789.214,17,142,11360,71,48,25560,48,5396,71,56,25560,56,5964
1797.256,6,369,25799,215,99,8398,469,15085,154,69,11743,69,10714
64.004,6,38,9296,16,327,135,1189,2615,22,413,3047,1420,6681
5.085,6,16,3253,9,49,635,92,563,7,579,266,1408,2690
1791.503,1,81,6804,81,56,22393,56,6804,0,0,0,0,0
1772.206,6,180,15480,120,69,14892,69,8940,60,69,30033,69,6540
1780.443,6,103,8464,68,66,26573,66,4964,35,60,52362,60,3500
3.769,6,13,6940,5,92,942,92,452,8,1213,492,1408,6488
0.363,6,9,1338,5,549,90,549,753,4,421,92,421,585
0.181,6,18,3068,9,282,22,531,1606,9,493,21,828,1462
49.385,6,47,10344,22,533,662,910,3107,25,345,2051,2720,7237
11.599,6,25,8473,13,275,966,275,1078,12,986,767,1440,7395
0.876,6,10,1687,7,100,146,100,384,3,1179,313,1179,1303
1750.687,17,12,498,11,14,175068,14,462,1,8,0,8,36
58.462,6,34,8423,17,410,552,882,1990,17,521,3642,3488,6433
4.861,17,6,432,3,36,2372,36,192,3,52,2380,52,240
0.005,17,4,376,2,44,1,44,144,2,88,1,100,232
0.004,17,2,492,1,31,0,31,59,1,405,0,405,433
1797.619,6,358,22669,209,69,8642,69,12500,149,69,12144,69,10169
0.112,17,2,166,1,39,0,39,67,1,71,0,71,99
12.896,6,24,6993,13,275,1074,275,1078,11,910,789,1440,5915
94.914,17,16,3700,10,40,10546,41,686,6,474,18781,505,3014
299.309,17,4,240,2,32,299308,32,120,2,32,299308,32,120
725.12,1,14,784,14,28,55778,28,784,0,0,0,0,0
0.297,6,5,260,2,0,251,0,104,3,0,141,0,156
4.599,17,53,37560,22,342,219,1350,8152,31,920,117,1350,29408
6.221,6,43,8329,21,227,311,314,4022,22,489,284,1179,4307
4.225,6,41,7349,20,218,222,314,3423,21,440,199,1152,3926
11.251,17,557,481085,372,1137,30,1350,433717,185,228,53,1350,47368
11.14,6,1732,1521022,1053,1390,10,1420,1489641,679,467,16,1883,31381
280.278,6,28,7352,13,158,23356,267,1317,15,678,20017,2800,6035
0.203,6,39,14508,22,870,9,1420,9607,17,467,12,1883,4901
0.253,17,2,558,1,32,0,32,60,1,470,0,470,498
1780.13,17,208,45990,208,193,8599,356,45990,0,0,0,0,0
62.1,6,75,55581,49,1213,1293,1368,47468,26,844,2473,2519,8113
317.029,6,60,12801,31,143,10567,658,3719,29,416,11317,4649,9082
35.47,6,37,8507,18,410,521,882,1982,19,478,1960,2128,6525
0.393,6,10,887,5,248,95,248,452,5,231,96,231,435
14.666,6,27,9428,10,273,1629,421,1027,17,642,866,1440,8401
65.228,6,27,7177,13,155,5435,267,1306,14,530,5016,3417,5871
10.714,6,1719,1483191,1041,1371,10,1420,1451850,678,467,15,2840,31341
5.302,6,39,7269,19,218,294,314,3383,20,513,263,1179,3886
280.173,6,30,7432,13,158,23347,267,1317,17,543,17510,1400,6115
1787.863,17,358,88726,358,219,5008,422,88726,0,0,0,0,0
280.032,6,32,7512,15,158,20002,267,1397,17,543,17500,1400,6115
0.99,17,2,134,2,39,990,39,134,0,0,0,0,0
245.304,6,32,8952,14,158,18869,267,1357,18,624,14424,1400,7595
14.788,6,17,5885,10,290,1643,517,1109,7,1101,2427,1418,4776
202.865,6,65,45634,43,1183,4830,1448,37759,22,747,2935,1448,7875
1782.373,17,83,3480,82,14,22004,14,3444,1,8,0,8,36
280.496,6,28,7352,12,158,25499,267,1277,16,678,18693,2085,6075
324.014,6,41,8357,19,172,17995,517,1856,22,669,15425,1368,6501
1772.67,6,181,15589,120,69,14896,69,8940,61,69,29543,69,6649
0.486,17,4,304,2,37,479,37,130,2,59,478,65,174
0.513,6,12,1304,6,256,93,256,756,6,304,92,304,548
1799.718,1,56,4704,0,0,0,0,0,56,56,32722,56,4704
1144.738,17,41,13760,41,307,28618,308,13760,0,0,0,0,0
10.987,6,20,7130,11,275,1098,275,998,9,1440,748,1440,6132
156.726,1,6,336,6,28,31345,28,336,0,0,0,0,0
0.181,6,3,316,2,196,0,196,276,1,0,0,0,40
1.433,17,2,244,2,94,1433,94,244,0,0,0,0,0
3.289,17,5,868,4,64,1090,64,368,1,472,0,472,500
1770.854,6,101,9344,66,65,27243,65,5577,35,59,52081,59,3767
5.943,6,44,8369,22,227,283,314,4062,22,427,270,1152,4307
1759.559,6,201,26243,109,304,16292,304,17920,92,83,19335,83,8323
1783.342,17,83,3480,82,14,22016,14,3444,1,8,0,8,36
0.086,6,9,3905,5,517,21,517,773,4,1458,22,1498,3132
1797.245,17,448,39896,403,35,4470,288,25676,45,288,40015,288,14220
1.839,6,20,3833,11,234,183,564,1504,9,463,207,1343,2329
0.07,17,2,418,1,37,0,37,65,1,325,0,325,353
0.025,17,2,554,1,30,0,30,58,1,468,0,468,496
1791.424,1,342,28728,342,56,5253,56,28728,0,0,0,0,0
282.634,1,4,224,4,28,94211,28,224,0,0,0,0,0
240.205,6,55,18863,30,797,8282,1418,15921,25,204,10008,580,2942
823.149,17,10,3388,10,310,91461,376,3388,0,0,0,0,0
240.235,6,55,18523,30,784,8283,1418,15693,25,190,10009,580,2830
1791.263,17,144,11520,72,48,25228,48,5472,72,56,25228,56,6048
139.419,17,8,2688,8,308,19917,308,2688,0,0,0,0,0
29.525,17,21,4296,10,62,3280,288,908,11,280,1807,308,3388
188.97,1,3,348,3,88,94485,88,348,0,0,0,0,0
300.92,6,45,14200,25,831,12538,1360,8536,20,373,458,2720,5664
1770.242,6,103,9590,68,65,26421,65,5705,35,59,52063,59,3885
375.091,6,25,1651,17,177,23443,177,1117,8,110,9251,110,534
5.264,17,6,432,3,36,2473,36,192,3,52,2482,52,240
1765.845,1,58,4872,0,0,0,0,0,58,56,30979,56,4872
1789.836,17,87,3648,86,14,21056,14,3612,1,8,0,8,36
1699.478,17,12,498,11,14,169947,14,462,1,8,0,8,36
1740.358,6,87,6322,58,31,30532,31,3915,29,31,62154,31,2407
9.098,17,6,528,3,48,4540,48,228,3,72,4541,72,300
288.98,17,6,360,3,32,144489,32,180,3,32,144489,32,180
7.981,6,12,945,6,222,1594,222,466,6,231,1594,231,479
36.022,17,20,1760,10,48,4001,48,760,10,72,4001,72,1000
0.283,17,2,198,1,39,0,39,67,1,103,0,103,131
3.587,17,10,2351,5,40,893,40,340,5,374,885,391,2011
16.81,17,4,240,2,32,16809,32,120,2,32,16809,32,120
240.445,6,56,18298,29,810,8586,1418,15300,27,198,9247,580,2998
0.934,6,29,12578,15,529,66,1360,3278,14,872,58,1360,9300
1771.968,6,99,9306,66,66,27261,66,5610,33,60,55370,60,3696
240.462,6,31,3826,15,181,17175,595,1878,16,220,16030,580,1948
1199.41,17,224,17024,224,48,5378,48,17024,0,0,0,0,0
0.551,6,10,968,5,256,121,256,460,5,304,127,304,508
1792.551,17,180,14040,180,50,10014,50,14040,0,0,0,0,0
2.388,6,13,2311,8,188,341,245,700,5,1407,531,1407,1611
5.159,6,6,272,3,0,2579,0,128,3,0,1511,0,144
0.29,6,27,8920,13,227,24,547,1592,14,941,21,1408,7328
4.928,6,39,7285,21,218,246,314,3463,18,516,274,1179,3822
0.007,17,4,350,2,34,3,34,124,2,85,2,91,226
1.366,6,48,19013,26,945,54,1460,13357,22,433,55,1460,5656
10.095,6,83,25074,42,550,246,1152,19293,41,459,246,1179,5781
0.478,6,188,234258,88,222,5,256,6144,100,2274,4,8448,228114
1662.467,1,7,392,7,28,277077,28,392,0,0,0,0,0
120.413,2,3,96,3,8,60206,8,96,0,0,0,0,0
1786.558,6,102,8364,68,66,26665,66,4964,34,60,54135,60,3400
15.646,6,48,10649,23,619,711,1460,3502,25,340,644,1460,7147
30.563,6,11,684,4,106,10183,106,282,7,90,5091,90,402
9.696,6,19,9034,8,75,1385,75,511,11,1323,969,1448,8523
151.493,6,23,9629,11,351,66,746,1527,12,1087,13760,1360,8102
1784.838,6,106,8524,68,66,26639,66,4964,38,60,48236,60,3560
1799.996,17,448,39896,403,35,4477,288,25676,45,288,40015,288,14220
1.307,6,49,20224,27,961,50,1460,14568,22,433,54,1460,5656
300.842,6,49,10486,24,433,13080,910,3218,25,312,541,1460,7268
1799.319,6,370,25770,215,99,8408,469,15085,155,69,11682,69,10685
25.543,17,4,352,2,60,25542,60,176,2,60,25542,60,176
149.384,6,81,57744,52,1199,2929,1368,49500,29,841,2205,2519,8244
1741.655,6,87,6322,58,31,30555,31,3915,29,31,62201,31,2407
0.143,17,2,154,1,33,0,33,61,1,65,0,65,93
6.489,6,10,657,5,245,1622,245,449,5,0,1452,0,208
7.134,6,20,3985,10,126,792,126,678,10,1373,792,1448,3307
0.023,17,4,368,2,32,11,32,120,2,96,15,96,248
1.678,6,25,8765,15,285,119,588,1460,10,985,166,1420,7305
300.722,6,38,8348,20,257,15827,685,1875,18,441,502,1360,6473
1781.759,6,362,22898,210,69,8525,69,12678,152,69,11799,69,10220
0.171,17,2,152,1,48,0,48,76,1,48,0,48,76
0.657,17,4,284,2,32,316,32,120,2,54,344,60,164
0.32,6,28,9128,13,252,26,647,1692,15,831,22,1408,7436
21.223,6,14,1247,7,222,3534,222,728,7,231,3534,231,519
0.363,6,4,191,1,0,0,0,40,3,31,133,31,151
0.389,17,15,8346,8,705,55,1350,5871,7,325,54,1350,2475
839.951,6,56,4616,32,66,27095,66,2336,24,60,32890,60,2280
0.113,6,13,4527,8,290,16,517,993,5,1088,23,1418,3534
1.352,6,38,9848,20,502,71,1440,4352,18,433,68,1440,5496
1770.876,6,101,9410,66,66,27244,66,5610,35,60,52081,60,3800
12.177,6,1858,1657422,1153,1384,10,1420,1624989,705,526,17,3303,32433
3.16,17,18,6770,9,482,391,1350,4591,9,214,390,1350,2179
280.465,6,28,7352,13,158,23372,267,1317,15,678,20030,3456,6035
0.597,17,4,560,2,64,596,64,184,2,160,481,160,376
0.276,17,2,136,1,32,0,32,60,1,48,0,48,76
128.461,6,24,6813,7,140,21410,267,849,17,479,8026,1460,5964
128.55,6,14,5980,4,96,42850,106,456,10,730,675,1420,5524
368.908,6,23,1535,16,177,24593,177,1053,7,110,10376,110,482
5.041,17,4,288,2,36,5009,36,128,2,52,5010,52,160
280.463,6,27,7312,12,158,25496,267,1277,15,678,20029,2085,6035
1797.648,1,276,15456,276,28,6536,28,15456,0,0,0,0,0
1787.829,6,102,8228,68,64,26684,64,4896,34,58,54174,58,3332
1786.587,6,102,8364,68,66,26665,66,4964,34,60,54136,60,3400
7.144,6,1621,1488308,1020,1381,6,1408,1452392,601,931,11,2816,35916
70.869,17,4,352,2,60,70868,60,176,2,60,70868,60,176
144.988,17,4,352,2,60,144986,60,176,2,60,144987,60,176
32.35,6,43,8504,20,153,1702,267,2342,23,523,1451,1917,6162
0.454,6,21,7281,13,334,37,663,2021,8,967,60,1471,5260
164.469,17,4,240,2,32,164468,32,120,2,32,164468,32,120
3.962,17,4,240,2,32,3961,32,120,2,32,3961,32,120
0.172,17,2,152,1,48,0,48,76,1,48,0,48,76
281.643,6,36,8972,16,158,18776,267,1437,20,611,14822,1300,7535
3.432,6,2,88,2,0,0,0,88,0,0,0,0,0
1779.665,6,104,8308,68,64,26562,64,4896,36,58,50845,58,3412
1795.744,1,274,15344,274,28,6577,28,15344,0,0,0,0,0
6.346,17,20,7654,10,507,701,1350,5356,10,201,700,1350,2298
4.317,6,67,38821,38,807,116,1360,12068,29,1346,149,3585,26753
3.053,17,3,468,3,128,1526,128,468,0,0,0,0,0
0.366,6,19,7099,11,318,35,600,1854,8,1205,50,1891,5245
290.499,17,2,136,2,40,290499,47,136,0,0,0,0,0
0.336,6,22,7342,12,335,30,668,1974,10,1210,36,1906,5368
280.219,6,28,7352,13,158,23351,267,1317,15,678,20013,4200,6035
1680.415,1,15,840,15,28,120029,28,840,0,0,0,0,0
277.409,17,4,240,2,32,277408,32,120,2,32,277408,32,120
3.504,17,5,295,5,31,876,31,295,0,0,0,0,0
1.534,6,38,8252,19,320,85,1162,2716,19,433,75,1440,5536
0.211,6,26,7256,13,155,17,267,1301,13,678,16,3436,5955
4.52,6,12,5718,3,106,2260,106,234,9,730,534,1452,5484
1789.947,6,355,22549,206,69,8731,69,12380,149,69,12094,69,10169
0.274,6,27,9086,13,257,22,667,1715,14,947,20,1408,7371
233.212,17,4,272,2,40,233211,47,136,2,40,233211,47,136
42.087,17,4,240,2,32,42086,32,120,2,32,42086,32,120
55.025,6,32,8952,15,158,3930,267,1397,17,687,3438,2036,7555
1772.473,6,180,15480,120,69,14894,69,8940,60,69,30037,69,6540
15.714,6,27,4867,13,154,1265,722,1767,14,394,1169,1448,3100
1786.863,6,102,8364,68,66,26669,66,4964,34,60,54143,60,3400
1771.085,6,99,9240,66,65,27247,65,5577,33,59,55342,59,3663
145.215,6,28,6389,10,266,101,500,1204,18,343,8536,1420,5185
0.382,17,2,204,1,34,0,34,62,1,114,0,114,142
4.076,17,5,290,5,30,1019,30,290,0,0,0,0,0
14.907,6,85,29599,41,899,372,1460,17972,44,447,330,2615,11627
1.656,6,14,2351,8,188,236,245,700,6,703,279,1152,1651
41.602,17,3,228,3,48,20801,48,228,0,0,0,0,0
0.831,6,24,6469,13,314,65,909,2095,11,786,79,1460,4374
5.588,17,5,320,5,36,1397,36,320,0,0,0,0,0
1755.514,1,57,4788,0,0,0,0,0,57,56,31348,56,4788
1800.0,6,223,17815,84,75,21325,337,8566,139,52,13043,234,9249
0.273,17,2,148,1,32,0,32,60,1,60,0,60,88
1773.193,6,180,15480,120,69,14900,69,8940,60,69,30052,69,6540
3.998,17,3,201,3,39,1999,39,201,0,0,0,0,0
1774.865,6,180,15480,120,69,14914,69,8940,60,69,30076,69,6540
2.217,6,50,19360,29,889,79,1360,13699,21,400,101,1360,5661
1740.973,6,87,6322,58,31,30543,31,3915,29,31,62177,31,2407
0.285,6,2,80,1,0,0,0,40,1,0,0,0,40
4.961,6,10,1102,6,483,992,483,803,4,83,1629,83,299
0.012,17,2,582,1,30,0,30,58,1,496,0,496,524
688.338,17,6,246,5,14,172084,14,210,1,8,0,8,36
1770.531,6,192,20922,125,110,14278,965,11939,67,94,26822,917,8983
1791.781,6,356,22520,208,69,8655,69,12460,148,69,12186,69,10060
0.259,6,21,5000,11,137,25,267,1132,10,692,27,2800,3868
6.622,6,45,8409,23,227,301,314,4102,22,489,303,1179,4307
0.224,17,2,632,1,288,0,288,316,1,288,0,288,316
1774.877,6,180,15480,120,69,14914,69,8940,60,69,30079,69,6540
693.584,6,87,5896,34,46,21017,46,2580,53,46,13335,46,3316
377.403,6,27,1767,18,177,22200,177,1181,9,110,8912,110,586
1799.992,17,450,39960,405,35,4455,288,25740,45,288,40020,288,14220
1744.607,2,29,928,29,8,62307,8,928,0,0,0,0,0
1048.851,17,57,19152,57,308,18729,308,19152,0,0,0,0,0
0.324,6,21,7281,13,334,27,663,2021,8,967,42,1912,5260
5.002,17,4,502,2,36,4998,36,128,2,159,4997,159,374
0.106,17,2,417,1,34,0,34,62,1,327,0,327,355
0.047,17,2,280,1,64,0,64,92,1,160,0,160,188
0.209,6,43,17230,24,939,9,1420,12249,19,467,11,1883,4981
7.623,6,1236,1060296,737,1388,10,1420,1036103,499,420,15,1420,24193
78.706,17,4,1344,4,308,26235,308,1344,0,0,0,0,0
169.862,6,21,2557,12,324,15442,585,1281,9,396,21220,580,1276
0.959,6,27,8506,15,229,56,583,2007,12,1201,72,3151,6499
1780.98,6,354,22440,207,69,8645,69,12420,147,69,12198,69,10020
4.396,6,32,6089,17,206,274,314,2744,15,548,293,1179,3345
300.171,6,44,13736,24,889,13042,1360,8134,20,399,15788,1360,5602
8.397,6,692,583434,422,1311,19,1368,564730,270,776,30,2736,18704
14.158,6,30,7573,12,155,1287,267,1266,18,398,832,3417,6307
143.458,6,23,11398,12,397,81,884,1717,11,1318,14330,3928,9681
1791.715,1,58,4872,58,56,31433,56,4872,0,0,0,0,0
0.335,6,27,8920,13,227,27,547,1592,14,941,25,1408,7328
3.078,6,53,13930,25,551,128,1429,4892,28,416,100,1460,9038
721.893,2,9,288,9,8,90236,8,288,0,0,0,0,0
1788.739,17,87,3648,86,14,21043,14,3612,1,8,0,8,36
1770.328,6,228,16359,91,56,19668,457,7709,137,47,13017,142,8650
87.195,6,10,632,3,92,43523,92,256,7,0,14504,0,376
481.289,2,5,160,5,8,120322,8,160,0,0,0,0,0
66.756,17,4,352,2,60,66755,60,176,2,60,66755,60,176
1798.026,17,449,39928,404,35,4461,288,25708,45,288,40018,288,14220
0.8,6,21,5999,12,274,72,523,1307,9,721,90,1452,4692
1775.306,17,140,11200,70,48,25728,48,5320,70,56,25728,56,5880
33.71,6,32,5147,16,154,2247,722,1911,16,342,2233,1408,3236
1007.327,2,6,192,6,8,201465,8,192,0,0,0,0,0
1770.39,6,101,9410,66,66,27236,66,5610,35,60,52067,60,3800
1797.152,1,345,28980,345,56,5224,56,28980,0,0,0,0,0
80.969,6,19,780,8,0,6949,0,324,11,0,8095,0,456
1.014,6,10,1687,7,100,169,100,384,3,1179,375,1179,1303
2.456,17,3,1480,1,300,0,300,328,2,548,110,548,1152
336.388,17,7065,4141789,7032,560,47,1252,4140425,33,13,4829,56,1364
1791.815,17,140,11200,70,48,25968,48,5320,70,56,25968,56,5880
1745.722,6,96,7353,63,38,28156,205,4476,33,35,54542,98,2877
1.1,6,24,8004,12,164,85,267,1288,12,1014,84,2816,6716
5.68,6,41,7349,21,218,284,314,3463,20,513,283,1179,3886
1.536,6,51,22069,28,951,56,1440,16373,23,433,61,1440,5696
0.57,17,2,144,1,36,0,36,64,1,52,0,52,80
0.624,6,7,371,4,0,208,0,204,3,7,163,7,167
1777.602,17,73,3060,72,14,25036,14,3024,1,8,0,8,36
280.316,6,28,7352,12,158,25483,267,1277,16,603,18680,1400,6075
0.015,17,8,2438,8,276,2,315,2438,0,0,0,0,0
1795.589,17,447,39864,402,35,4477,288,25644,45,288,40016,288,14220
1797.758,6,284,35005,116,144,15631,1360,17397,168,131,10764,1360,17608
54.121,6,10,648,10,31,6013,31,648,0,0,0,0,0
1786.728,6,106,8524,68,66,26667,66,4964,38,60,48279,60,3560
0.455,17,2,780,2,362,455,362,780,0,0,0,0,0
5.924,6,44,8385,22,227,282,314,4062,22,491,269,1179,4323
11.652,6,1852,1609791,1126,1374,10,1420,1576530,726,467,16,1883,33261
1771.87,6,180,15480,120,69,14889,69,8940,60,69,30031,69,6540
9.586,6,1716,1557167,1070,1376,8,1408,1518911,646,931,14,2816,38256
0.278,17,2,476,1,39,0,39,67,1,381,0,381,409
0.365,1,2,112,2,28,365,28,112,0,0,0,0,0
61.633,6,51,30317,32,1045,1988,1448,22576,19,843,3411,2359,7741
1351.682,1,158,8848,158,28,8609,28,8848,0,0,0,0,0
1.026,17,22,6495,9,329,128,1350,3216,13,224,63,1350,3279
0.133,17,2,672,2,308,133,308,672,0,0,0,0,0
1795.904,6,390,27660,221,101,8163,469,16415,169,69,10686,69,11245
1796.745,1,58,4872,58,56,31521,56,4872,0,0,0,0,0
0.096,17,2,159,1,33,0,33,61,1,70,0,70,98
3.483,1,2,433,2,188,3483,238,433,0,0,0,0,0
0.168,1,2,112,2,28,168,28,112,0,0,0,0,0
0.343,17,2,195,1,44,0,44,72,1,95,0,95,123
1789.07,1,342,28728,342,56,5246,56,28728,0,0,0,0,0
0.375,6,7,376,4,0,125,0,216,3,0,103,0,160
1772.512,6,202,22250,130,75,13740,267,10057,72,136,24963,2840,12193
11.728,6,1852,1621901,1126,1386,10,1420,1588604,726,467,16,1883,33297
2.874,17,6,594,3,39,1436,39,201,3,103,1435,103,393
1.306,6,40,9928,21,440,65,1360,4392,19,476,63,2720,5536
23.014,17,14,1232,7,48,3833,48,532,7,72,3832,72,700
200.337,17,4,352,2,60,200336,60,176,2,60,200336,60,176
0.356,17,8,2766,8,317,50,356,2766,0,0,0,0,0
78.549,6,23,10009,13,531,47,1360,2677,10,1384,8713,3934,7332
350.622,17,68,5168,68,48,5233,48,5168,0,0,0,0,0
1750.543,17,12,498,11,14,175054,14,462,1,8,0,8,36
280.602,6,29,7392,13,158,23383,267,1317,16,603,18701,2036,6075
2.283,17,4,610,3,39,553,39,201,1,381,0,381,409
1795.91,17,449,39928,404,35,4456,288,25708,45,288,40024,288,14220
28.731,17,4,1344,4,308,9577,308,1344,0,0,0,0,0
1.675,6,11,1727,7,100,279,100,384,4,589,477,1152,1343
1788.595,17,372,56861,184,205,9773,1350,42886,188,46,9556,1350,13975
12.094,17,3,984,3,300,6047,300,984,0,0,0,0,0
1792.03,6,356,22520,208,69,8657,69,12460,148,69,12190,69,10060
1777.625,17,79,3312,78,14,23086,14,3276,1,8,0,8,36
598.686,1,5,812,5,134,149671,320,812,0,0,0,0,0
504.485,2,4,128,4,8,168161,8,128,0,0,0,0,0
0.0,17,1,1471,1,1443,0,1443,1471,0,0,0,0,0
1773.001,1,230,12880,230,28,7742,28,12880,0,0,0,0,0
0.49,17,2,784,2,364,490,364,784,0,0,0,0,0
0.912,6,11,1727,7,100,152,100,384,4,589,215,1152,1343
1772.56,6,116,10580,72,65,24965,65,6226,44,59,41219,59,4354
1738.972,2,28,896,28,8,64406,8,896,0,0,0,0,0
280.666,6,29,7733,13,158,23388,267,1317,16,641,18697,3436,6416
182.097,17,4,352,2,60,182095,60,176,2,60,182096,60,176
100.084,6,51,10571,27,593,3842,1460,4733,24,347,4343,1460,5838
1763.787,2,15,480,15,8,125984,8,480,0,0,0,0,0
1776.712,17,73,3060,72,14,25024,14,3024,1,8,0,8,36
0.466,6,17,6337,9,141,58,275,646,8,894,28,1440,5691
302.462,6,26,5452,14,298,23266,1382,2353,12,435,27495,2432,3099
756.512,2,5,160,5,8,189128,8,160,0,0,0,0,0
0.135,6,14,6093,7,128,22,128,500,7,1305,22,1448,5593
0.04,6,2,92,0,0,0,0,0,2,0,0,0,92
1.348,6,28,9447,14,392,103,1408,2698,14,859,93,1408,6749
42.456,6,37,8270,18,334,512,688,1756,19,441,2351,1460,6514
444.003,6,91,16075,44,99,10325,721,4440,47,423,8363,1414,11635
1793.36,17,765,46134,765,32,2347,37,46134,0,0,0,0,0
31.974,6,9,396,2,0,3484,0,88,7,0,5314,0,308
0.006,1,2,112,2,28,6,28,112,0,0,0,0,0
1786.145,6,104,8376,68,65,26658,65,4930,36,59,51030,59,3446
0.029,17,2,524,1,59,0,59,87,1,409,0,409,437
1741.137,6,87,6322,58,31,30546,31,3915,29,31,62183,31,2407
600.394,6,97,13173,48,87,12774,267,3948,49,164,12507,1460,9225
1.829,6,19,5244,9,150,228,174,664,10,835,191,1452,4580
4.816,17,5,4754,5,922,1204,1451,4754,0,0,0,0,0
98.291,6,787,364663,409,824,240,1152,343697,378,417,259,1179,20966
1789.262,17,87,3648,86,14,21050,14,3612,1,8,0,8,36
0.872,6,37,8289,21,241,43,619,1850,16,526,49,4848,6439
1799.426,6,202,18474,103,59,17639,721,8013,99,158,18359,1414,10461
0.956,6,31,13362,17,511,59,1360,3279,14,1056,60,2561,10083
0.264,17,2,376,1,41,0,41,69,1,279,0,279,307
1614.333,1,7,742,7,78,269055,78,742,0,0,0,0,0
1797.968,1,345,28980,345,56,5226,56,28980,0,0,0,0,0
0.074,17,6,912,3,60,4,60,264,3,188,3,188,648
2.691,17,4,1568,4,364,897,364,1568,0,0,0,0,0
16.636,6,2879,2723977,1870,1379,8,1408,2666845,1009,931,16,2801,57132
296.85,1,4,224,4,28,98950,28,224,0,0,0,0,0
0.818,6,26,5649,12,140,74,267,1184,14,650,58,1420,4465
0.168,17,2,2380,2,1162,168,1162,2380,0,0,0,0,0
1781.021,1,58,4872,0,0,0,0,0,58,56,31245,56,4872
3.837,17,10,900,5,30,944,30,290,5,94,951,94,610
1.319,6,45,19019,26,954,52,1460,13483,19,433,63,1460,5536
1769.959,1,56,4704,0,0,0,0,0,56,56,32181,56,4704
247.222,6,14,1428,5,190,118,190,458,9,247,30901,462,970
0.038,6,2,162,1,0,0,0,40,1,82,0,82,122
13.238,6,23,6002,12,275,1203,275,1038,11,902,1222,1440,4964
0.905,6,10,1687,7,100,150,100,384,3,1179,319,1179,1303
1795.635,17,449,39928,404,35,4455,288,25708,45,288,40018,288,14220
1745.574,6,97,7307,63,38,28154,205,4476,34,33,52883,98,2831
89.458,6,34,8423,17,410,548,882,1990,17,521,5581,3488,6433
1773.22,1,58,4872,58,56,31109,56,4872,0,0,0,0,0
1782.478,17,83,3480,82,14,22005,14,3444,1,8,0,8,36
63.165,6,27,17412,16,708,42,1360,4214,11,2124,6303,4416,13198
1.274,6,50,20613,27,986,49,1460,14917,23,433,50,1460,5696
1681.53,17,14,1036,7,30,280249,30,406,7,62,280249,62,630
0.141,17,4,420,2,33,2,33,122,2,121,121,145,298
1799.613,17,4044,194112,2023,20,890,20,97104,2021,20,890,20,97008
0.631,6,13,7038,5,106,157,106,314,8,1066,43,1460,6724
1789.956,6,419,30681,216,126,8325,469,17401,203,43,8861,69,13280
5.693,17,9,618,9,40,711,41,618,0,0,0,0,0
17.05,17,21,10806,10,663,1891,1350,6910,11,326,1702,1350,3896
93.4,6,22,8961,11,514,80,1236,2014,11,927,9322,1460,6947
1795.312,6,363,23007,211,69,8549,69,12718,152,69,11889,69,10289
145.222,17,4,240,2,32,145221,32,120,2,32,145220,32,120
881.96,2,7,224,7,8,146993,8,224,0,0,0,0,0
152.384,6,44,26129,19,741,43,1360,3769,25,1123,6343,1360,22360
1.922,17,3,1170,3,362,961,362,1170,0,0,0,0,0
290.119,17,4,352,2,60,290118,60,176,2,60,290118,60,176
180.753,17,4,352,2,60,180752,60,176,2,60,180752,60,176
1784.798,17,142,11360,71,48,25496,48,5396,71,56,25496,56,5964
1120.782,17,10,2745,5,30,280194,30,290,5,463,280194,463,2455
299.936,1,2,112,2,28,299936,28,112,0,0,0,0,0
0.64,6,279,234347,163,261,3,517,10917,116,1940,5,11264,223430
240.193,6,53,17145,28,763,8895,1408,14445,25,174,10007,580,2700
124.14,6,35,7975,13,155,10345,267,1306,22,340,5910,3417,6669
1798.36,17,449,39928,404,35,4462,288,25708,45,288,40019,288,14220
280.439,6,28,7352,13,158,23369,267,1317,15,678,20027,3456,6035
17.477,6,39,24043,21,840,873,1360,5915,18,1338,1016,2720,18128
31.437,1,2,120,2,32,31437,32,120,0,0,0,0,0
9.07,1,9,756,0,0,0,0,0,9,56,1133,56,756
7.482,17,12,1764,6,48,1494,48,456,6,190,1494,308,1308
3.919,17,4,352,2,48,3911,48,152,2,72,3910,72,200
240.121,6,48,29285,20,183,12637,517,2146,28,1426,8893,2804,27139
280.324,6,31,7472,14,158,21563,267,1357,17,543,17515,1300,6115
1784.151,6,358,22669,209,69,8577,69,12500,149,69,12055,69,10169
372.153,6,25,1651,17,177,23259,177,1117,8,110,9241,110,534
1785.863,6,368,25621,214,99,8384,469,15045,154,69,11672,69,10576
0.541,6,21,5000,10,137,60,267,1092,11,866,46,2867,3908
1797.994,2,23,736,23,8,81727,8,736,0,0,0,0,0
0.236,17,2,213,1,44,0,44,72,1,113,0,113,141
0.499,6,57,23896,33,956,15,1380,16726,24,515,19,1923,7170
1764.249,2,10,320,10,8,196027,8,320,0,0,0,0,0
0.397,2,2,64,2,8,397,8,64,0,0,0,0,0
0.011,17,2,146,1,37,0,37,65,1,53,0,53,81
0.193,6,9,1339,5,145,48,145,349,4,826,51,826,990
0.181,6,27,7296,13,155,15,267,1301,14,603,13,2036,5995
192.723,6,26,7088,5,154,48180,267,672,21,348,9621,1460,6416
49.377,6,4477,4227825,2768,1442,17,1448,4125445,1709,776,28,1448,102380
13.828,6,2439,2357433,1625,1375,8,1408,2310441,814,776,16,1408,46992
40.21,6,45,18354,26,233,1608,1448,5158,19,1109,751,2896,13196
1795.887,17,449,39928,404,35,4456,288,25708,45,288,40022,288,14220
0.079,6,2,116,1,0,0,0,64,1,0,0,0,52
0.021,17,2,912,1,308,0,308,336,1,548,0,548,576
61.281,6,36,15829,22,795,2918,1448,9103,14,748,4694,2359,6726
1798.695,17,450,39960,405,35,4452,288,25740,45,288,40016,288,14220
0.054,17,4,368,2,32,0,32,120,2,96,0,96,248
53.753,17,4,240,2,32,53752,32,120,2,32,53752,32,120
1642.851,1,7,392,7,28,273808,28,392,0,0,0,0,0
523.375,6,99,18521,57,309,4867,1286,8470,42,278,12763,1420,10051
1.625,6,29,10365,17,367,101,833,1785,12,1012,139,1420,8580
32.52,6,24,6812,7,156,5420,267,758,17,447,2005,1420,6054
1681.682,17,18,1413,9,30,210208,37,529,9,70,210208,136,884
0.859,6,27,5927,13,156,71,267,1462,14,650,59,1414,4465
0.45,6,52,22958,29,1037,16,1380,17796,23,421,19,1923,5162
11.906,6,1886,1645228,1139,1390,10,1420,1611115,747,467,15,1883,34113
20.541,17,6,528,3,48,10265,48,228,3,72,10265,72,300
1.014,17,2,116,2,30,1014,30,116,0,0,0,0,0
0.057,17,3,244,2,32,0,32,120,1,96,0,96,124
26.938,6,41,9868,21,188,1346,721,2167,20,765,1406,1440,7701
0.541,6,4,311,1,91,0,91,143,3,0,270,0,168
7.073,6,835,662665,463,1350,14,1402,638645,372,665,18,1402,24020
5.733,6,21,3905,11,234,573,564,1516,10,463,564,1343,2389
0.008,17,2,222,1,33,0,33,61,1,133,0,133,161
689.971,6,104,14685,49,152,14374,1189,5177,55,214,6281,1917,9508
0.252,17,2,144,1,36,0,36,64,1,52,0,52,80
0.286,6,25,8961,13,252,23,646,1694,12,1105,25,2804,7267
1246.254,1,44,2464,44,28,28982,28,2464,0,0,0,0,0
1796.522,17,449,39928,404,35,4457,288,25708,45,288,40023,288,14220
124.365,6,8,474,2,106,124358,106,194,6,0,24872,0,280
240.41,6,43,8667,22,519,11447,1402,5829,21,217,12020,617,2838
280.04,6,31,7472,14,158,21541,267,1357,17,543,17498,1400,6115
247.419,6,51,7256,24,331,10757,1056,3627,27,170,9515,580,3629
1799.562,17,410,35272,371,33,4863,288,22948,39,288,46338,288,12324
180.493,6,23,11050,12,753,61,1360,3526,11,1414,18036,3940,7524
0.524,17,3,451,2,39,426,39,134,1,289,0,289,317
7.959,6,39,12280,18,215,468,721,2014,21,673,329,1414,10266
56.499,1,4,224,4,28,18833,28,224,0,0,0,0,0
1.309,6,49,18532,27,840,50,1360,12876,22,476,53,2715,5656
317.106,6,97,18530,46,226,7046,1360,8004,51,273,6338,4658,10526
2.499,17,3,1164,3,360,1249,360,1164,0,0,0,0,0
172.563,6,8,447,2,0,7455,0,112,6,7,34476,7,335
0.018,6,20,10009,12,125,1,125,781,8,2201,2,4344,9228
11.024,6,20,4402,11,275,1102,275,998,9,758,779,1420,3404
2.796,17,6,753,3,31,1391,31,177,3,164,889,164,576
70.46,17,3,494,2,179,70460,202,414,1,52,0,52,80
296.325,17,4,240,2,32,296324,32,120,2,32,296324,32,120
1780.965,6,361,22927,209,69,8562,69,12638,152,69,11794,69,10289
125.971,6,21,7979,11,525,87,1237,2048,10,919,13976,1591,5931
0.033,6,9,1340,5,145,8,145,349,4,827,9,827,991
0.009,17,2,410,1,37,0,37,65,1,317,0,317,345
1787.882,17,232,48908,232,182,7739,377,48908,0,0,0,0,0
63.354,6,34,5260,20,154,3334,721,2130,14,399,1209,2026,3130
68.55,6,23,6816,8,154,9792,267,792,15,541,4881,1917,6024
284.599,6,35,8996,14,158,21892,267,1357,21,485,14229,1400,7639
0.142,1,5,420,5,56,35,56,420,0,0,0,0,0
36.66,17,35,16534,15,894,2618,1350,13832,20,107,1652,1350,2702
9.929,6,89,28140,44,559,230,1152,21890,45,444,219,1179,6250
1743.584,6,95,7203,63,38,28122,205,4476,32,33,56232,98,2727
1.756,17,20,5180,20,231,92,388,5180,0,0,0,0,0
181.692,17,4,240,2,32,181691,32,120,2,32,181691,32,120
421.108,2,7,224,7,8,70184,8,224,0,0,0,0,0
117.924,6,20,9457,11,548,79,1306,2116,9,1393,14719,3639,7341
0.434,6,14,1733,7,288,68,288,588,7,284,39,434,1145
1793.901,1,58,4872,58,56,31471,56,4872,0,0,0,0,0
0.502,17,4,791,2,32,497,32,120,2,307,495,319,671
33.66,6,26,3658,12,226,3060,226,2202,14,110,2571,110,1456
216.171,6,31,8235,12,220,5112,516,1365,19,381,12004,1452,6870
4.976,6,40,7309,21,218,248,314,3463,19,513,262,1179,3846
0.053,17,2,363,1,29,0,29,57,1,278,0,278,306
1775.909,17,140,11200,70,48,25737,48,5320,70,56,25737,56,5880
1680.458,1,14,784,14,28,129266,28,784,0,0,0,0,0
1786.952,6,104,8376,68,65,26670,65,4930,36,59,51050,59,3446
0.199,17,6,360,3,32,99,32,180,3,32,99,32,180
1377.077,1,20,1120,20,28,72477,28,1120,0,0,0,0,0
1679.909,1,15,840,15,28,119993,28,840,0,0,0,0,0
0.384,17,2,140,1,34,0,34,62,1,50,0,50,78
1796.652,6,356,22520,208,69,8679,69,12460,148,69,12222,69,10060
0.027,17,2,558,1,32,0,32,60,1,470,0,470,498
300.733,6,37,8355,20,272,15828,743,1921,17,478,535,2128,6434
1.264,6,2,80,1,0,0,0,40,1,0,0,0,40
1699.595,17,13,534,11,14,169941,14,462,2,8,1699416,8,72
6.256,6,40,7309,22,218,297,314,3503,18,513,352,1179,3806
0.358,6,28,6278,15,181,25,537,1706,13,555,27,1542,4572
0.008,17,2,152,1,48,0,48,76,1,48,0,48,76
1786.458,17,87,3648,86,14,21017,14,3612,1,8,0,8,36
7.452,6,962,840343,582,1366,12,1408,815919,380,776,19,1408,24424
1787.766,17,762,45960,762,32,2349,37,45960,0,0,0,0,0
169.203,6,28,12978,15,519,69,884,2721,13,1080,14087,2568,10257
1796.466,6,114,9234,74,66,24609,66,5534,40,60,46060,60,3700
1786.118,6,148,19246,89,302,20296,302,13688,59,83,30795,83,5558
1783.009,17,73,3060,72,14,25112,14,3024,1,8,0,8,36
1779.966,6,432,37541,201,66,8898,615,14428,231,88,7738,4649,23113
22.6,6,34,8375,18,410,512,882,1982,16,574,1496,4848,6393
27.791,17,4,352,2,60,27790,60,176,2,60,27790,60,176
1740.496,17,29,30624,29,1028,62160,1028,30624,0,0,0,0,0
1701.533,17,15,3844,15,228,121538,1072,3844,0,0,0,0,0
1786.578,6,104,8444,68,66,26665,66,4964,36,60,51039,60,3480
1786.878,6,102,8296,68,65,26669,65,4930,34,59,54144,59,3366
41.172,17,4,240,2,32,41172,32,120,2,32,41172,32,120
0.014,6,4,222,2,31,14,31,111,2,31,3,31,111
1.837,17,4,332,2,39,1836,39,134,2,71,1716,71,198
280.382,6,30,7432,13,158,23365,267,1317,17,543,17521,1400,6115
1781.761,6,365,23156,211,69,8484,69,12718,154,69,11645,69,10438
0.0,6,1,83,0,0,0,0,0,1,31,0,31,83
1.294,6,29,9202,15,257,92,669,1818,14,831,97,1438,7384
125.124,6,30,7643,11,156,31,267,1232,19,403,6951,3426,6411
369.606,6,18,1242,14,180,28431,180,916,4,110,20060,110,326
1720.499,17,12,498,11,14,172049,14,462,1,8,0,8,36
1688.216,1,8,448,8,28,241173,28,448,0,0,0,0,0
1790.369,6,212,25340,135,103,13360,469,12671,77,133,23555,1942,12669
172.068,6,39,9964,12,139,5777,267,1601,27,346,6617,1420,8363
41.353,17,4,352,2,60,41351,60,176,2,60,41352,60,176
6.946,6,66,20206,33,565,217,1152,15459,33,489,209,1179,4747
1789.769,6,368,25690,215,99,8363,469,15085,153,69,11774,69,10605
1776.548,6,180,15480,120,69,14928,69,8940,60,69,30103,69,6540
316.994,6,85,20316,40,317,8128,1360,10213,45,285,7201,1360,10103
0.795,17,14,7027,7,606,132,1350,4438,7,341,123,1350,2589
0.593,17,15,9135,8,822,84,1350,6803,7,305,63,1350,2332
17.28,17,16,11613,8,802,2464,1350,6642,8,593,2464,1350,4971
55.543,17,620,556783,220,56,253,1350,18599,400,1317,139,1350,538184
1771.928,6,180,15480,120,69,14890,69,8940,60,69,30032,69,6540
120.266,17,2,148,2,46,120266,46,148,0,0,0,0,0
280.454,6,31,7472,13,158,23371,267,1317,18,543,16495,1300,6155
140.118,17,4,240,2,32,140117,32,120,2,32,140117,32,120
1638.862,1,8,448,8,28,234123,28,448,0,0,0,0,0
63.228,2,3,96,3,8,31614,8,96,0,0,0,0,0
134.536,6,124,94331,79,1305,1724,1448,82419,45,637,2219,1448,11912
3.998,6,11,467,6,0,799,0,248,5,7,743,7,219
513.72,1,8,448,8,28,73388,28,448,0,0,0,0,0
3.889,17,2,690,2,317,3889,317,690,0,0,0,0,0
7.946,17,43,14479,15,478,567,1350,7596,28,217,293,1350,6883
0.169,6,45,21209,25,1083,7,1420,16188,20,467,8,1883,5021
5.052,17,2,2200,2,1072,5052,1072,2200,0,0,0,0,0
23.147,17,4,352,2,60,23146,60,176,2,60,23146,60,176
1.296,6,41,12067,22,624,61,1460,6531,19,433,62,1460,5536
1784.221,6,107,8421,70,45,25858,205,5179,37,35,49555,98,3242
0.603,6,28,15243,15,648,43,1360,3224,13,1435,36,4416,12019
977.919,6,198,12543,114,69,8653,69,6837,84,69,11782,69,5706
131.142,6,21,8544,11,556,108,1329,2140,10,998,14547,1791,6404
20.14,6,22,5981,13,107,1678,159,1138,9,873,2516,1675,4843
1738.466,1,15,840,15,28,124176,28,840,0,0,0,0,0
279.283,1,4,224,4,28,93094,28,224,0,0,0,0,0
3.829,17,4,268,4,39,1276,39,268,0,0,0,0,0
1740.43,17,30,7050,30,207,60014,207,7050,0,0,0,0,0
0.016,17,2,400,1,37,0,37,65,1,307,0,307,335
1798.713,6,381,24141,217,69,8327,69,13441,164,69,11033,69,10700
0.154,17,2,157,1,31,0,31,59,1,70,0,70,98
1739.498,1,57,4788,0,0,0,0,0,57,56,31062,56,4788
1.228,6,27,8945,14,288,94,796,1747,13,952,86,1460,7198
7.88,6,16,3265,9,211,984,211,910,7,665,1312,904,2355
0.007,17,4,344,2,47,4,47,150,2,69,2,75,194
1784.03,6,362,24774,211,94,8495,469,14387,151,69,11893,69,10387
34.502,17,18,1584,9,48,4311,48,684,9,72,4311,72,900
3.068,6,10,923,6,304,613,304,624,4,83,980,83,299
5.898,17,35,17472,14,384,453,1350,5781,21,528,253,1350,11691
1786.742,6,107,8624,68,66,26667,66,4964,39,60,47017,60,3660
1.132,6,14,3017,6,288,209,288,560,8,531,136,853,2457
0.748,6,27,15398,15,664,53,1360,3289,12,1659,50,5440,12109
1764.843,6,175,13131,91,85,19609,208,8624,84,31,21259,31,4507
10.277,6,85,24957,44,561,239,1152,19176,41,413,250,1152,5781
1786.995,6,102,8296,68,65,26671,65,4930,34,59,54148,59,3366
13.336,6,16,3265,9,211,1666,211,910,7,665,2220,904,2355
0.575,6,15,1785,8,288,62,288,640,7,426,66,434,1145
1786.739,6,104,8376,68,65,26667,65,4930,36,59,51047,59,3446
11.04,6,39,13527,17,401,690,721,3094,22,636,476,1414,10433
1740.436,6,87,6322,58,31,30533,31,3915,29,31,62157,31,2407
0.27,6,26,8868,13,227,22,547,1592,13,941,22,1408,7276
1781.245,6,106,8524,68,66,26585,66,4964,38,60,48139,60,3560
1792.925,17,144,11520,72,48,25252,48,5472,72,56,25252,56,6048
4.35,6,39,7269,19,218,241,314,3383,20,440,215,1152,3886
5.038,17,3,413,2,41,5034,41,138,1,247,0,247,275
0.054,17,4,284,2,32,0,32,120,2,54,38,60,164
1792.88,6,343,29780,195,93,9241,469,14064,148,132,12196,3426,15716
1739.173,6,149,18261,87,81,20222,877,8240,62,149,28510,1448,10021
1799.765,17,443,37748,405,35,4454,288,25740,38,288,47593,288,12008
1.001,6,8,404,4,0,260,0,196,4,0,313,0,208
2.172,6,13,2311,8,188,310,245,700,5,1407,479,1407,1611
0.014,17,2,206,1,44,0,44,72,1,106,0,106,134
1744.692,2,28,896,28,8,64618,8,896,0,0,0,0,0
10.023,6,13,616,6,0,2004,0,280,7,0,1510,0,336
15.029,6,2349,2216718,1499,1400,9,1440,2167854,850,776,17,1440,48864
1.678,17,4,490,2,32,1586,32,120,2,157,1661,157,370
82.572,6,10194,9848186,6868,1357,12,1408,9670570,3326,776,24,1408,177616
1798.052,6,191,18610,126,99,14384,469,11525,65,69,28089,69,7085
6.215,6,41,7349,21,218,310,314,3463,20,513,312,1179,3886
22.362,17,4,240,2,32,22360,32,120,2,32,22360,32,120
86.28,6,33,15029,16,579,5752,1440,4349,17,1084,5339,1440,10680
0.037,6,7,380,4,0,12,0,216,3,0,12,0,164
0.076,17,2,180,1,30,0,30,58,1,94,0,94,122
0.031,17,2,146,1,37,0,37,65,1,53,0,53,81
1767.27,17,167,13964,155,30,11475,37,9032,12,383,155227,463,4932
280.215,6,27,7312,13,158,23351,267,1317,14,775,21552,2800,5995
1.995,6,14,1687,8,222,272,222,1212,6,231,356,231,475
0.398,17,2,162,1,45,0,45,73,1,61,0,61,89
1786.625,6,102,8364,68,66,26666,66,4964,34,60,54137,60,3400
0.259,6,21,7281,13,334,21,663,2021,8,1209,36,2816,5260
1320.0,17,17,714,17,14,82500,14,714,0,0,0,0,0
0.244,17,8,2750,8,315,34,354,2750,0,0,0,0,0
7.927,6,40,8156,19,239,426,314,3873,21,491,384,1179,4283
1790.959,1,332,27888,332,56,5410,56,27888,0,0,0,0,0
0.899,17,2,144,1,36,0,36,64,1,52,0,52,80
1798.188,1,342,28728,342,56,5273,56,28728,0,0,0,0,0
280.273,6,29,7392,13,158,23356,267,1317,16,603,18682,1400,6075
1772.519,6,180,15480,120,69,14895,69,8940,60,69,30038,69,6540
1771.669,1,58,4872,58,56,31081,56,4872,0,0,0,0,0
364.558,6,25,1654,17,180,22784,180,1120,8,110,9303,110,534
0.258,6,23,5928,12,164,23,453,1442,11,781,25,2224,4486
0.294,6,3,144,2,0,294,0,92,1,0,0,0,52
1799.17,1,56,4704,56,56,32712,56,4704,0,0,0,0,0
1772.924,6,181,15589,120,69,14898,69,8940,61,69,29547,69,6649
8.294,6,1677,1539781,1030,1415,7,1448,1501473,647,776,12,1448,38308
9.21,6,1781,1660795,1110,1417,8,1448,1621141,671,792,13,1448,39654
5.083,6,44,8369,22,227,242,314,4062,22,489,229,1179,4307
0.849,6,23,6426,13,313,70,906,2092,10,982,93,1731,4334
0.224,17,2,290,1,40,0,40,68,1,194,0,194,222
1788.296,17,344,26144,344,48,5213,48,26144,0,0,0,0,0
0.87,6,2,202,1,0,0,0,40,1,110,0,110,162
11.83,6,1751,1620494,1143,1365,10,1432,1591871,608,427,19,1432,28623
9.201,17,15,13642,5,977,1038,1350,5027,10,833,1016,1350,8615
35.837,17,4,304,4,48,11945,48,304,0,0,0,0,0
422.295,17,138,9475,138,40,3082,41,9475,0,0,0,0,0
0.418,17,2,152,1,48,0,48,76,1,48,0,48,76
2.046,6,6,805,1,91,0,91,131,5,118,496,160,674
95.205,6,11606,11192397,7791,1359,12,1408,10989317,3815,776,24,1408,203080
8.022,6,600,498126,332,1419,23,1448,478578,268,776,28,1448,19548
1764.74,6,194,34600,124,304,14347,304,25612,70,83,25575,83,8988
378.816,2,4,128,4,8,126272,8,128,0,0,0,0,0
126.542,2,2,64,2,8,126542,8,64,0,0,0,0,0
1750.734,17,13,534,11,14,175054,14,462,2,8,1750542,8,72
8.587,6,756,674456,472,1354,17,1368,653180,284,776,29,2736,21276
1.032,6,328,318785,113,201,9,486,6689,215,1426,3,1438,312096
42.595,6,24,4750,14,232,3276,722,1897,10,463,1635,1448,2853
8.377,6,79,25298,41,579,209,1152,19621,38,461,219,1179,5677
0.596,6,14,1745,7,288,71,288,600,7,426,70,434,1145
0.967,6,28,8160,15,222,57,540,1964,13,944,66,1591,6196
2.444,6,114,87684,50,131,49,232,2529,64,1399,34,2860,85155
90.217,17,4,352,2,60,90216,60,176,2,60,90215,60,176
1.317,6,11,1727,7,100,219,100,384,4,589,352,1152,1343
1798.417,6,356,22520,208,69,8688,69,12460,148,69,12233,69,10060
1.902,6,44,11177,25,165,79,658,3361,19,640,41,1360,7816
118.098,6,85,40239,47,735,588,1440,14425,38,867,3188,1797,25814
220.278,17,4,352,2,60,220277,60,176,2,60,220277,60,176
1799.641,17,446,38980,404,35,4465,288,25708,42,288,42944,288,13272
7.092,6,185,199358,128,133,55,201,5687,57,3752,123,22624,193671
1617.005,2,19,608,19,8,89833,8,608,0,0,0,0,0
251.563,6,22,5772,7,150,106,174,584,15,352,17961,1452,5188
21.925,1,4,224,4,28,7308,28,224,0,0,0,0,0
0.02,6,2,111,1,0,0,0,40,1,31,0,31,71
1.331,17,4,352,2,60,1330,60,176,2,60,1330,60,176
84.827,6,8,320,8,0,0,0,320,0,0,0,0,0
1785.175,6,102,8296,68,65,26644,65,4930,34,59,54093,59,3366
3.557,17,2,178,1,29,0,29,57,1,93,0,93,121
1.311,6,47,18601,27,850,50,1360,13025,20,476,59,2715,5576
1.433,6,49,19957,28,879,53,1360,14341,21,433,61,1360,5616
1683.462,17,16,1265,8,30,240490,37,471,8,71,240490,136,794
7.696,6,77,24834,39,568,202,1152,19173,38,459,201,1179,5661
0.025,17,2,383,1,33,0,33,61,1,294,0,294,322
2.448,6,26,7495,16,302,163,693,2761,10,721,245,1460,4734
1082.146,17,212,16112,212,48,5128,48,16112,0,0,0,0,0
2.86,17,3,468,3,128,1430,128,468,0,0,0,0,0
0.255,17,2,152,1,48,0,48,76,1,48,0,48,76
1786.602,6,167,21927,96,316,18806,316,15452,71,83,25522,83,6475
0.782,17,2,214,1,39,0,39,67,1,119,0,119,147
0.006,17,3,388,2,30,0,30,116,1,244,0,244,272
0.178,1,2,112,2,28,178,28,112,0,0,0,0,0
69.394,6,27,8752,13,158,5782,267,1317,14,981,5334,2800,7435
1745.449,6,95,7203,63,38,28152,205,4476,32,33,56293,98,2727
885.907,1,8,652,8,53,126558,78,652,0,0,0,0,0
68.682,6,23,10236,11,397,77,884,1665,12,1009,6230,1360,8571
227.665,6,31,8912,14,158,17512,267,1357,17,687,14227,2036,7555
9.477,6,48,34135,33,1139,296,1368,27927,15,1072,662,2519,6208
53.852,17,10,1352,5,48,13460,48,380,5,166,13460,308,972
8.675,6,14,2245,8,211,1230,211,846,6,545,1725,904,1399
1717.14,6,136,10631,86,66,20201,66,6080,50,62,35041,151,4551
1754.094,1,70,5880,0,0,0,0,0,70,56,25421,56,5880
1.46,17,23,12248,11,500,142,1350,5816,12,508,129,1350,6432
0.266,17,2,384,1,39,0,39,67,1,289,0,289,317
1779.947,6,104,8376,68,65,26566,65,4930,36,59,50853,59,3446
0.008,6,3,327,2,103,1,138,287,1,0,0,0,40
1761.431,6,79,4160,40,26,45163,26,2106,39,26,46352,26,2054
0.113,6,26,29747,17,183,7,230,1441,9,3975,11,13597,28306
1740.628,17,30,20190,30,645,60021,645,20190,0,0,0,0,0
1795.159,17,448,39896,403,35,4465,288,25676,45,288,40016,288,14220
36.617,17,22,1936,11,48,3656,48,836,11,72,3654,72,1100
0.035,6,2,116,1,0,0,0,52,1,0,0,0,64
1783.311,1,74,6216,74,56,24428,56,6216,0,0,0,0,0
2.095,17,4,1564,4,363,698,363,1564,0,0,0,0,0
240.332,6,43,9238,21,523,12016,1408,5812,22,252,11444,618,3426
88.057,17,40,10360,40,231,2257,388,10360,0,0,0,0,0
1777.49,1,64,5376,64,56,28214,56,5376,0,0,0,0,0
585.441,1,6,336,6,28,117088,28,336,0,0,0,0,0
1744.729,2,25,800,25,8,72697,8,800,0,0,0,0,0
19.691,17,6,456,6,48,3938,48,456,0,0,0,0,0
0.132,6,13,1175,7,146,20,146,430,6,250,24,499,745
13.189,6,24,6993,13,275,1099,275,1078,11,910,847,1440,5915
0.915,6,52,13869,24,551,39,1429,4840,28,438,33,1460,9029
317.135,6,53,11408,24,149,13788,267,1866,29,492,11313,1400,9542
3.079,6,32,16428,18,697,181,1360,5634,14,1460,224,2574,10794
1799.095,1,16,896,16,28,119939,28,896,0,0,0,0,0
0.833,6,36,13874,21,872,41,1360,8772,15,498,46,2720,5102
240.948,6,144,99702,56,137,4380,380,4976,88,1202,2769,1438,94726
1781.76,6,356,22520,208,69,8607,69,12460,148,69,12120,69,10060
335.605,6,82,12845,37,170,9322,1189,4214,45,235,7627,1420,8631
0.01,17,2,512,1,40,0,40,68,1,416,0,416,444
1784.849,17,142,11360,71,48,25497,48,5396,71,56,25497,56,5964
60.11,2,2,64,2,8,60110,8,64,0,0,0,0,0
9.934,6,89,26773,45,550,225,1152,20531,44,447,224,1179,6242
13.523,1,9,756,0,0,0,0,0,9,56,1690,56,756
6.287,17,26,10261,11,332,628,1350,3962,15,391,251,1350,6299
1784.635,17,142,11360,71,48,25494,48,5396,71,56,25494,56,5964
1792.506,17,180,11520,180,36,10014,36,11520,0,0,0,0,0
1767.273,6,103,8115,67,45,26776,205,4985,36,34,50485,98,3130
1772.637,6,180,15480,120,69,14896,69,8940,60,69,30037,69,6540
10.662,6,11,616,5,0,2665,0,280,6,0,1750,0,336
1770.426,17,362,61496,362,141,4904,404,61496,0,0,0,0,0
1.434,6,42,10065,23,440,65,1360,4484,19,480,69,4075,5581
1700.433,17,12,498,11,14,170043,14,462,1,8,0,8,36
369.393,6,23,1535,16,177,24626,177,1053,7,110,10371,110,482
0.223,6,9,1002,5,213,55,213,417,4,421,57,421,585
0.846,6,23,5715,13,158,70,370,1315,10,999,93,1791,4400
0.362,17,4,284,2,32,198,32,120,2,54,165,60,164
0.191,6,4,258,3,31,93,31,218,1,0,0,0,40
13.759,6,31,5277,16,154,902,722,1970,15,360,970,2026,3307
1657.403,1,8,448,8,28,236771,28,448,0,0,0,0,0
1792.808,6,355,23377,191,69,9368,69,12056,164,69,10998,69,11321
336.529,6,46,9031,20,133,12438,502,2002,26,315,13457,1420,7029
1780.11,17,326,98964,326,275,5477,422,98964,0,0,0,0,0
230.28,17,6,1496,3,32,115138,37,181,3,410,115137,463,1315
5.035,17,4,558,2,36,5026,36,128,2,187,5023,187,430
0.649,6,15,1785,8,288,85,288,640,7,426,79,434,1145
252.574,17,2,837,2,390,252574,687,837,0,0,0,0,0
120.104,6,51,26197,29,997,4288,1448,19464,22,466,5712,1559,6733
11.721,6,93,28218,46,555,260,1152,21840,47,449,249,1179,6378
1795.972,1,345,28980,345,56,5220,56,28980,0,0,0,0,0
0.279,17,3,234,2,39,25,39,134,1,72,0,72,100
1796.0,6,363,23007,210,69,8593,69,12747,153,69,11813,69,10260
6.286,6,42,7932,20,213,330,314,3577,22,495,285,1179,4355
444.289,6,43,6996,23,234,20194,1314,2805,20,337,23383,2840,4191
1.442,6,48,18104,26,875,57,1360,12448,22,433,59,1360,5656
1799.999,6,403,26484,197,46,9041,46,11804,206,46,8779,46,14680
190.055,6,15,3864,5,92,294,92,384,10,369,21096,2026,3480
360.963,2,4,128,4,8,120321,8,128,0,0,0,0,0
1755.08,6,99,7473,65,38,27423,205,4580,34,33,53175,98,2893
203.338,17,4,304,2,48,203336,64,152,2,48,203337,64,152
0.097,17,2,334,1,39,0,39,67,1,239,0,239,267
280.221,6,30,7432,13,158,23351,267,1317,17,543,17512,1300,6115
1789.984,17,140,11200,70,48,25941,48,5320,70,56,25941,56,5880
1793.083,17,344,26144,344,48,5227,48,26144,0,0,0,0,0
0.816,6,19,9141,11,514,81,1236,2014,8,1359,84,3639,7127
10.97,6,20,4442,11,275,1097,275,998,9,768,800,1440,3444
0.489,17,15,5091,6,347,97,1350,2255,9,287,46,1350,2836
1791.633,17,180,14040,180,50,10009,50,14040,0,0,0,0,0
0.215,6,22,5876,12,164,19,453,1442,10,558,22,1402,4434
1784.786,6,356,22520,208,69,8622,69,12460,148,69,12138,69,10060
0.09,17,4,2876,2,689,90,1350,1434,2,693,44,1350,1442
1794.74,17,142,11360,71,48,25639,48,5396,71,56,25639,56,5964
369.487,6,27,1767,18,177,21734,177,1181,9,110,8616,110,586
0.019,6,2,336,1,0,0,0,40,1,256,0,256,296
10.487,17,4,824,2,48,10465,48,152,2,308,10468,308,672
0.019,17,2,218,1,34,0,34,62,1,128,0,128,156
1776.091,6,181,15589,120,69,14925,69,8940,61,69,29591,69,6649
241.851,6,51,12921,24,474,10515,1402,5570,27,494,9301,1513,7351
1771.222,6,103,9514,66,66,27249,66,5610,37,60,49198,60,3904
993.86,1,79,9254,79,89,12741,107,9254,0,0,0,0,0
240.628,2,3,96,3,8,120314,8,96,0,0,0,0,0
366.376,6,19,1303,14,177,28182,177,925,5,110,15155,110,378
1779.876,17,140,11200,70,48,25795,48,5320,70,56,25795,56,5880
1780.797,6,354,22440,207,69,8644,69,12420,147,69,12197,69,10020
126.172,6,25,11358,12,433,65,990,1823,13,1000,10504,1360,9535
1740.444,17,30,7050,30,207,60015,207,7050,0,0,0,0,0
11.471,6,1791,1580909,1118,1363,10,1380,1547824,673,558,17,1923,33085
1790.534,6,356,22520,208,69,8649,69,12460,148,69,12180,69,10060
1787.302,6,356,22520,208,69,8634,69,12460,148,69,12157,69,10060
42.741,17,3,222,3,46,21370,46,222,0,0,0,0,0
0.081,17,4,336,2,34,0,34,124,2,78,33,84,212
8.152,6,56,9765,29,233,291,314,4901,27,420,303,1152,4864
1770.811,6,104,9644,67,66,26830,66,5728,37,60,49186,60,3916
1741.325,17,30,31680,30,1028,60045,1028,31680,0,0,0,0,0
1789.954,6,355,22618,205,69,8774,69,12340,150,69,12013,69,10278
1776.503,17,73,3060,72,14,25021,14,3024,1,8,0,8,36
1781.554,6,102,8296,68,65,26590,65,4930,34,59,53983,59,3366
626.182,6,61,7522,32,91,20193,722,3142,29,160,22357,2328,4380
300.565,6,13,979,7,177,50066,177,561,6,110,60079,110,418
7.52,6,5,232,3,0,3760,0,136,2,0,2860,0,96
154.838,6,37,9774,16,141,2219,267,1495,21,437,7741,1460,8279
0.107,6,11,1703,6,314,21,500,948,5,487,26,487,755
2.287,6,642,546956,377,1411,6,1432,531609,265,475,8,1871,15347
1795.935,17,87,3648,86,14,21128,14,3612,1,8,0,8,36
190.726,17,7,2832,7,376,31787,548,2832,0,0,0,0,0
0.612,6,20,7229,13,334,51,663,2021,7,1209,91,1946,5208
1791.188,17,179,13962,179,50,10062,50,13962,0,0,0,0,0
1797.939,6,373,26097,216,98,8362,469,15332,157,69,11524,69,10765
1.224,17,8,1618,4,37,403,37,260,4,311,383,331,1358
23.637,6,37,8309,18,347,508,728,1795,19,441,1305,1460,6514
57.576,6,6,328,4,0,19192,0,216,2,0,57511,0,112
1.346,17,12,6448,6,649,269,1350,4067,6,368,238,1350,2381
296.582,1,2,112,2,28,296582,28,112,0,0,0,0,0
16.73,6,6,328,4,0,5576,0,216,2,0,16710,0,112
0.067,17,2,188,1,58,0,58,86,1,74,0,74,102
1800.0,6,371,25564,159,46,11208,46,10322,212,46,8530,46,15242
0.119,17,2,376,1,39,0,39,67,1,281,0,281,309
0.767,6,64,29250,36,1066,21,1380,21812,28,475,27,1923,7438
15.336,6,42,8602,22,269,730,636,2001,20,445,490,2128,6601
1744.695,2,23,736,23,8,79304,8,736,0,0,0,0,0
78.024,17,4,304,2,48,78012,48,152,2,48,78012,48,152
0.28,6,25,8816,13,227,23,547,1592,12,1098,25,2816,7224
1797.696,17,449,39928,404,35,4460,288,25708,45,288,40017,288,14220
1799.408,1,65,5460,65,56,28115,56,5460,0,0,0,0,0
1.205,6,25,8056,12,164,92,267,1288,13,869,85,1408,6768
54.543,6,494,219342,249,815,219,1152,204037,245,423,222,1179,15305
122.586,17,8,2688,8,308,17512,308,2688,0,0,0,0,0
21.51,6,3356,3023905,2005,1420,10,1448,2942205,1351,776,15,1448,81700
0.061,6,2,80,1,0,0,0,40,1,0,0,0,40
24.427,6,14,5625,4,106,8139,106,274,10,706,2712,1420,5351
1776.294,17,73,3060,72,14,25018,14,3024,1,8,0,8,36
294.898,1,2,120,2,32,294898,32,120,0,0,0,0,0
7.814,2,2,64,2,8,7814,8,64,0,0,0,0,0
1741.337,17,30,31680,30,1028,60046,1028,31680,0,0,0,0,0
634.88,6,118,7480,66,69,8925,69,4020,52,69,12448,69,3460
7.173,6,5,240,1,0,0,0,48,4,0,2386,0,192
0.233,6,20,4960,10,137,25,267,1092,10,692,24,1467,3868
32.837,6,10,564,3,0,16331,0,164,7,0,5443,0,400
4.83,17,4,288,2,36,4829,36,128,2,52,4829,52,160
1791.277,17,142,11352,72,48,25229,48,5472,70,56,25960,56,5880
365.273,1,4,240,4,32,121757,32,240,0,0,0,0,0
0.957,17,25,18229,11,556,92,1350,6428,14,814,71,1350,11801
4.007,17,2,144,1,36,0,36,64,1,52,0,52,80
0.022,17,2,132,1,30,0,30,58,1,46,0,46,74
1747.841,6,94,7151,62,38,28653,205,4424,32,33,56368,98,2727
136.777,6,25,6318,9,272,94,516,1180,16,345,9112,1452,5138
1799.782,6,3307,3708934,1111,149,1621,892,68276,2196,1661,819,9814,3640658
5.081,6,37,7189,19,218,282,314,3383,18,513,283,1179,3806
443.307,6,47,4019,30,69,15286,69,2304,17,69,27706,69,1715
1794.107,17,144,11520,72,48,25269,48,5472,72,56,25269,56,6048
0.545,17,2,167,1,39,0,39,67,1,72,0,72,100
0.32,6,28,9150,14,262,24,690,1787,14,1102,24,2816,7363
10.994,6,19,4402,11,275,1099,275,998,8,768,889,1440,3404
0.54,6,12,1304,6,256,105,256,756,6,304,105,304,548
0.297,6,27,9071,13,252,24,647,1716,14,945,22,1408,7355
1785.599,1,126,7056,126,28,14284,28,7056,0,0,0,0,0
0.275,6,29,6342,15,181,19,537,1718,14,555,20,1542,4624
280.039,6,26,7272,13,158,23336,267,1317,13,905,23333,4845,5955
1793.508,6,169,10758,89,51,20378,208,6659,80,31,22700,31,4099
0.015,17,2,419,1,44,0,44,72,1,319,0,319,347
1.317,6,23,10165,12,125,119,125,765,11,1467,131,1564,9400
277.068,1,4,479,4,91,92356,117,479,0,0,0,0,0
0.1,17,2,152,1,48,0,48,76,1,48,0,48,76
0.05,17,4,368,2,32,32,32,120,2,96,36,96,248
1785.97,1,58,3248,58,28,31332,28,3248,0,0,0,0,0
145.991,6,16,2442,7,331,137,721,1294,9,382,18228,612,1148
0.022,17,2,251,1,31,0,31,59,1,164,0,164,192
1788.862,17,87,3648,86,14,21045,14,3612,1,8,0,8,36
143.349,6,29,8832,13,158,11945,267,1317,16,763,9552,1781,7515
11.771,6,1882,1612559,1137,1363,10,1380,1578517,745,421,15,1923,34042
217.608,17,4,352,2,60,217607,60,176,2,60,217607,60,176
0.046,17,2,184,1,32,0,32,60,1,96,0,96,124
0.225,17,4,624,2,64,126,64,184,2,192,124,192,440
1160.402,6,119,7390,59,49,20004,208,4277,60,31,19664,31,3113
0.135,6,9,1348,5,145,33,145,349,4,835,42,835,999
1740.956,17,57,19148,57,307,31088,312,19148,0,0,0,0,0
0.012,17,3,386,2,36,8,36,128,1,230,0,230,258
10.774,6,24,2099,12,222,974,222,1372,12,231,975,231,727
180.477,2,3,96,3,8,90238,8,96,0,0,0,0,0
1770.36,6,99,9240,66,65,27236,65,5577,33,59,55320,59,3663
1796.377,17,449,134245,449,270,4009,425,134245,0,0,0,0,0
1.856,17,2,778,2,361,1856,361,778,0,0,0,0,0
95.141,6,29,13574,16,488,321,1360,3127,13,1416,7917,2875,10447
1778.793,6,227,21473,115,134,15603,208,15877,112,31,16021,31,5596
0.014,6,12,3705,6,171,2,171,491,6,964,2,1448,3214
1773.204,6,183,15738,121,69,14776,69,8980,62,69,29063,69,6758
1787.487,17,87,3648,86,14,21029,14,3612,1,8,0,8,36
2.782,6,23,5271,12,351,252,1382,2242,11,430,276,1452,3029
5.949,1,9,936,0,0,0,0,0,9,76,743,76,936
61.166,6,7,292,4,0,20388,0,164,3,0,30548,0,128
28.91,17,4,352,2,60,28909,60,176,2,60,28909,60,176
300.685,6,37,8388,21,280,15034,775,1994,16,522,568,4080,6394
1751.907,6,105,8670,69,66,25763,66,5070,36,60,50052,60,3600
620.5,1,21,1176,21,28,31025,28,1176,0,0,0,0,0
0.577,6,10,924,5,283,99,283,551,5,105,98,105,373
1770.094,1,58,4872,58,56,31054,56,4872,0,0,0,0,0
0.891,6,24,14150,13,127,72,127,811,11,1594,73,2896,13339
15.166,1,20,2080,0,0,0,0,0,20,76,798,76,2080
0.223,6,21,5831,12,164,20,453,1442,9,652,26,2201,4389
0.104,17,2,2752,2,1348,104,1348,2752,0,0,0,0,0
0.065,6,111,140864,34,128,1,307,2153,77,1796,0,4206,138711
366.794,6,23,1535,16,177,24452,177,1053,7,110,10374,110,482
125.858,6,181,141748,113,1292,1123,1368,128694,68,679,1874,2519,13054
7.726,6,24,12188,8,124,1103,124,960,16,1322,440,1638,11228
3.473,6,15,2395,9,188,434,245,744,6,703,331,1152,1651
1798.618,17,87,3648,86,14,21160,14,3612,1,8,0,8,36
1773.015,6,204,22399,130,75,13744,267,10057,74,133,24281,1452,12342
1783.466,17,83,3480,82,14,22018,14,3444,1,8,0,8,36
1771.888,6,180,15480,120,69,14889,69,8940,60,69,30030,69,6540
1.583,6,27,10175,16,284,105,585,1497,11,1029,141,1420,8678
280.193,6,27,7312,13,158,23349,267,1317,14,678,21552,3436,5995
1780.111,17,73,3060,72,14,25071,14,3024,1,8,0,8,36
1.113,6,26,9564,13,164,78,267,1388,13,1070,78,2816,8176
1790.994,17,179,13962,179,50,10061,50,13962,0,0,0,0,0
115.059,6,124,96535,80,1260,1456,1368,86124,44,737,2669,2519,10411
12.684,6,6,328,4,0,4228,0,216,2,0,12461,0,112
0.85,6,20,5948,11,281,85,544,1288,9,716,95,1420,4660
90.679,17,18,1584,9,48,11333,48,684,9,72,11333,72,900
10.456,6,16,3911,9,275,1307,275,643,7,992,916,1440,3268
1764.722,1,56,4704,0,0,0,0,0,56,56,32085,56,4704
121.567,6,25,10837,12,740,62,1440,3473,13,976,10118,1440,7364
0.11,17,4,420,2,33,0,33,122,2,121,35,145,298
11.722,6,1933,1778435,1198,1404,9,1448,1735539,735,776,15,1448,42896
0.158,6,44,18157,24,1011,6,1420,13136,20,420,7,1420,5021
67.134,6,25,7097,12,155,6103,267,1266,13,589,5593,3426,5831
81.184,6,25,10716,13,746,58,1360,3536,12,1114,7367,2720,7180
2.328,6,29,10389,17,373,145,851,1803,12,1012,203,1420,8586
0.002,17,2,264,1,40,0,40,68,1,168,0,168,196
5.023,17,3,208,2,36,5004,36,128,1,52,0,52,80
2.955,17,2,312,2,128,2955,128,312,0,0,0,0,0
1792.726,1,174,9744,174,28,10362,28,9744,0,0,0,0,0
0.314,6,10,1634,5,131,78,131,399,5,967,78,967,1235
61.081,17,28,2339,26,30,2443,37,1515,2,384,345,463,824
166.725,6,24,8079,12,377,72,798,1669,12,739,15141,2720,6410
1.68,6,4,172,3,0,840,0,132,1,0,0,0,40
0.544,17,4,560,2,64,411,64,184,2,160,429,160,376
1.383,6,24,8004,12,164,107,267,1288,12,1014,107,2736,6716
242.911,6,50,12909,26,623,9714,1368,10082,24,195,10559,580,2827
280.39,6,30,7432,13,158,23365,267,1317,17,543,17519,1400,6115
1786.311,17,87,3648,86,14,21015,14,3612,1,8,0,8,36
1536.128,6,192,14888,72,71,21633,337,7172,120,49,12907,143,7716
1787.574,6,104,8444,68,66,26680,66,4964,36,60,51070,60,3480
0.412,17,4,300,2,39,411,39,134,2,55,410,55,166
0.301,17,2,157,1,31,0,31,59,1,70,0,70,98
1791.99,17,201,58769,201,264,8959,422,58769,0,0,0,0,0
50.086,6,16,664,7,0,8346,0,284,9,0,6259,0,380
0.127,17,2,572,1,39,0,39,67,1,477,0,477,505
3.64,17,5,340,5,40,910,40,340,0,0,0,0,0
1741.498,6,87,6322,58,31,30552,31,3915,29,31,62195,31,2407
0.019,17,2,182,1,44,0,44,72,1,82,0,82,110
23.67,17,10,850,5,37,3029,37,325,5,77,1308,77,525
5.18,6,5,232,2,0,5180,0,88,3,0,1523,0,144
280.311,6,30,7432,13,158,23359,267,1317,17,603,17516,2036,6115
120.29,17,4,240,2,32,120289,32,120,2,32,120289,32,120
0.592,6,27,8996,13,243,49,611,1656,14,941,42,1368,7340
300.927,6,39,9679,21,547,15046,1360,4157,18,435,509,2667,5522
280.26,6,29,7392,13,158,23355,267,1317,16,603,18679,2036,6075
945.413,6,95,10488,53,87,18177,722,4959,42,111,23054,2118,5529
1793.165,17,89,3737,87,14,20850,15,3655,2,13,785909,18,82
61.284,6,6,523,2,191,61102,191,303,4,0,20365,0,220
0.111,17,2,602,1,46,0,46,74,1,500,0,500,528
39.732,17,3,1000,3,305,19866,308,1000,0,0,0,0,0
240.193,6,52,17693,27,790,9237,1402,14850,25,191,10007,580,2843
0.365,17,2,198,1,39,0,39,67,1,103,0,103,131
3.16,6,5,232,2,0,3160,0,88,3,0,1511,0,144
1.397,6,49,19269,27,892,53,1440,13613,22,433,57,1440,5656
1789.495,1,279,15624,279,28,6437,28,15624,0,0,0,0,0
1170.786,6,137,19532,79,304,11541,304,13848,58,83,20540,83,5684
3.716,2,2,64,2,8,3716,8,64,0,0,0,0,0
1.363,6,50,19420,27,900,52,1360,13724,23,433,53,1360,5696
3.276,6,10,427,5,0,819,0,208,5,7,743,7,219
60.544,6,17,2304,8,189,8649,517,1194,9,323,7567,499,1110
1792.441,17,373,94652,373,225,4818,394,94652,0,0,0,0,0
6.81,6,269,196266,143,1054,47,1460,22629,126,1478,52,7300,173637
1279.27,6,153,18088,92,78,13214,267,7232,61,150,21320,1917,10856
1.888,17,21,6643,8,329,269,1350,2859,13,263,134,1350,3784
0.118,6,31,7961,17,289,7,517,1857,14,553,8,1883,6104
46.065,6,36,8386,18,371,520,797,1913,18,521,2700,3488,6473
1699.454,17,12,498,11,14,169945,14,462,1,8,0,8,36
1772.177,6,180,15480,120,69,14892,69,8940,60,69,30033,69,6540
1787.195,6,354,22440,207,69,8675,69,12420,147,69,12240,69,10020
1658.148,1,7,392,7,28,276358,28,392,0,0,0,0,0
0.814,6,27,5927,13,156,67,267,1462,14,650,57,1420,4465
300.625,6,37,8526,19,315,16701,882,2053,18,441,498,1460,6473
1196.093,6,245,17302,143,94,8423,437,9706,102,79,11841,549,7596
1.538,6,50,20155,28,889,56,1360,14499,22,476,64,2715,5656
1765.436,2,15,480,15,8,126102,8,480,0,0,0,0,0
1798.734,6,367,25650,214,99,8444,469,15045,153,69,11831,69,10605
1749.669,17,12,498,11,14,174966,14,462,1,8,0,8,36
836.579,1,48,5088,48,78,17799,78,5088,0,0,0,0,0
0.032,17,4,624,2,64,13,64,184,2,192,14,192,440
123.097,6,129,49978,67,722,1865,1360,36701,62,359,2015,1938,13277
11.728,6,6,328,4,0,3909,0,216,2,0,11703,0,112
1741.162,6,87,6322,58,31,30546,31,3915,29,31,62182,31,2407
0.949,6,10,1687,7,100,158,100,384,3,1179,348,1179,1303
31.514,6,8,348,2,0,19,0,84,6,0,6299,0,264
93.013,6,33,14450,16,488,337,1440,3127,17,966,5805,1440,11323
165.855,6,30,6749,12,220,6036,516,1365,18,310,9751,1452,5384
61.809,6,78,54845,48,1216,1315,1408,45143,30,1016,2124,2816,9702
193.546,17,4,352,2,60,193544,60,176,2,60,193545,60,176
0.294,17,8,2750,8,315,42,354,2750,0,0,0,0,0
1682.612,17,14,1036,7,30,280428,30,406,7,62,280430,62,630
463.77,17,6,360,3,32,231884,32,180,3,32,231884,32,180
0.811,17,22,8574,10,433,90,1350,4617,12,301,71,1350,3957
1.625,6,31,5884,16,121,108,267,1379,15,650,94,1420,4505
94.122,6,111,59082,64,823,161,1360,20801,47,1070,2043,2737,38281
144.9,6,23,3654,8,92,20700,92,504,15,197,10336,1408,3150
1785.916,6,104,8376,68,65,26655,65,4930,36,59,51023,59,3446
1683.895,17,14,1036,7,30,280640,30,406,7,62,280640,62,630
0.428,6,12,1653,6,288,81,288,548,6,426,49,434,1105
301.193,6,43,8740,19,308,16732,889,2027,24,441,1021,1460,6713
1795.725,6,356,22520,208,69,8675,69,12460,148,69,12215,69,10060
37.85,6,36,8192,19,657,2102,1418,5647,17,165,2364,580,2545
1.86,6,20,3833,11,234,186,564,1504,9,463,208,1343,2329
0.0,6,2,1270,0,0,0,0,0,2,1190,0,1190,1270
12.066,6,1839,1680759,1182,1368,10,1432,1649608,657,427,18,1432,31151
165.132,6,27,7312,13,158,13761,267,1317,14,775,12699,3445,5995
1785.854,6,375,26108,216,98,8306,469,15332,159,69,11302,69,10776
159.802,6,22,10167,11,397,59,884,1665,11,1150,15968,2568,8502
1771.918,6,180,15480,120,69,14890,69,8940,60,69,30030,69,6540
0.69,6,7,295,4,0,230,0,164,3,7,100,7,131
4.925,17,4,288,2,36,4916,36,128,2,52,4909,52,160
1672.754,6,124,16674,69,114,24599,721,8511,55,259,12097,1440,8163
240.281,6,43,9004,21,519,12013,1402,5775,22,230,11441,618,3229
504.011,2,5,160,5,8,126002,8,160,0,0,0,0,0
0.014,17,2,574,1,32,0,32,60,1,486,0,486,514
10.752,6,18,5610,10,275,1194,275,958,8,1440,820,1440,4652
159.151,1,8,832,0,0,0,0,0,8,76,22735,76,832
0.505,6,22,7376,13,273,42,663,2052,9,1209,58,1946,5324
5.012,17,35,18296,15,723,358,1350,11273,20,323,172,1350,7023
1786.85,6,102,8296,68,65,26669,65,4930,34,59,54142,59,3366
1788.898,6,359,22709,209,69,8600,69,12569,150,69,12005,69,10140
101.634,6,74,50404,46,1206,2258,1408,42217,28,960,2281,3847,8187
9.172,6,16,3911,9,275,1146,275,643,7,992,736,1440,3268
11.144,6,104,36607,54,635,210,1152,30109,50,449,222,1179,6498
15.441,17,8,608,8,48,2205,48,608,0,0,0,0,0
1787.6,6,106,8456,68,65,26680,65,4930,38,59,48311,59,3526
6.568,6,15,3231,9,49,821,92,575,6,2328,1275,2328,2656
421.037,2,4,128,4,8,140345,8,128,0,0,0,0,0
3.361,17,2,166,1,47,0,47,75,1,63,0,63,91
41.021,6,44,10169,21,533,768,910,3043,23,364,1858,2720,7126
354.554,6,34,8861,10,189,12620,516,1350,24,311,15411,1452,7511
0.199,17,6,2117,6,324,39,354,2117,0,0,0,0,0
1740.434,17,30,31680,30,1028,60014,1028,31680,0,0,0,0,0
1789.829,6,242,24923,97,67,18642,594,9161,145,136,12428,4080,15762
1775.861,6,180,15480,120,69,14923,69,8940,60,69,30094,69,6540
6.54,6,12,5545,4,106,2173,106,274,8,988,932,3377,5271
1118.58,17,220,16720,220,48,5107,48,16720,0,0,0,0,0
1.397,6,25,8056,12,164,109,267,1288,13,869,99,1448,6768
64.015,6,45,7222,26,304,2560,304,5348,19,83,3502,83,1874
1783.639,6,102,8296,68,65,26621,65,4930,34,59,54046,59,3366
0.169,6,2,1500,1,1408,0,1408,1460,1,0,0,0,40
3.744,17,4,304,4,48,1248,48,304,0,0,0,0,0
61.985,6,13,3100,7,92,10330,92,452,6,1164,12357,1408,2648
1790.036,6,356,22520,208,69,8647,69,12460,148,69,12177,69,10060
1796.696,6,377,29457,215,75,8395,267,13595,162,133,11159,1414,15862
386.65,6,22,1459,14,177,29742,177,925,8,110,10954,110,534
1799.187,6,367,23236,212,69,8526,69,12896,155,69,11682,69,10340
1763.706,2,14,448,14,8,135669,8,448,0,0,0,0,0
721.98,2,6,192,6,8,144396,8,192,0,0,0,0,0
14.526,6,1854,1671480,1169,1373,12,1380,1635026,685,421,21,1923,36454
1.435,6,40,9928,21,440,71,1360,4392,19,476,68,2715,5536
0.0,17,1,1073,1,1045,0,1045,1073,0,0,0,0,0
0.008,17,2,456,1,40,0,40,68,1,360,0,360,388
1784.702,1,58,3248,58,28,31310,28,3248,0,0,0,0,0
280.252,6,29,7392,13,158,23354,267,1317,16,603,18682,2036,6075
1787.058,17,140,11200,70,48,25899,48,5320,70,56,25899,56,5880
0.578,17,20,7707,10,461,63,1350,4891,10,253,60,1350,2816
30.581,6,6,360,0,0,0,0,0,6,0,0,0,360
1.023,17,2,176,2,60,1023,60,176,0,0,0,0,0
205.759,1,4,224,4,28,68586,28,224,0,0,0,0,0
1780.645,6,993,193773,459,323,3887,1368,88448,534,239,3340,2380,105325
0.518,6,14,3448,8,106,74,106,530,6,866,98,1448,2918
1795.493,6,172,17363,103,73,17602,722,8667,69,89,26399,1408,8696
1786.728,6,104,8444,68,66,26667,66,4964,36,60,51046,60,3480
0.272,6,12,3705,6,171,54,171,491,6,964,54,1448,3214
88.495,17,4,352,2,60,88493,60,176,2,60,88494,60,176
0.753,17,2,162,1,36,0,36,64,1,70,0,70,98
4.371,6,34,6169,18,206,257,314,2784,16,548,273,1179,3385
0.015,17,2,162,1,36,0,36,64,1,70,0,70,98
1798.223,17,448,39896,403,35,4473,288,25676,45,288,40020,288,14220
5.007,17,4,288,2,36,5006,36,128,2,52,5006,52,160
61.646,6,48,27653,30,1023,2125,1402,19994,18,839,3612,2804,7659
1.883,6,27,8851,16,286,125,591,1503,11,863,166,1380,7348
0.035,17,2,152,1,34,0,34,62,1,62,0,62,90
0.006,17,2,487,1,40,0,40,68,1,391,0,391,419
296.557,17,30,4770,15,40,21181,40,1020,15,222,21181,249,3750
2.704,6,2,88,2,0,0,0,88,0,0,0,0,0
280.355,6,29,7392,13,158,23362,267,1317,16,603,18686,2036,6075
15.248,17,25,13516,13,801,1268,1350,10782,12,199,1383,1350,2734
137.081,6,43133,44259486,16070,161,8,291,884100,27063,1551,5,8412,43375386
0.355,17,2,167,1,39,0,39,67,1,72,0,72,100
1.276,6,42,11442,22,547,60,1360,5866,20,433,58,1360,5576
1744.727,2,28,896,28,8,64619,8,896,0,0,0,0,0
1789.208,17,87,3648,86,14,21049,14,3612,1,8,0,8,36
412.476,1,8,448,8,28,58925,28,448,0,0,0,0,0
3.015,6,2,88,2,0,0,0,88,0,0,0,0,0
18.998,17,30,6219,15,209,1354,1350,3569,15,148,1354,1350,2650
914.141,1,64,3584,64,28,14510,28,3584,0,0,0,0,0
208.92,6,53,11417,24,110,9083,267,2298,29,378,7461,4260,9119
1.502,6,38,9904,20,510,79,1440,4408,18,433,77,1440,5496
1.844,6,44,18043,23,479,83,1460,3875,21,951,76,1460,14168
0.049,17,2,396,1,39,0,39,67,1,301,0,301,329
1700.522,17,20,1723,10,32,188943,37,601,10,84,188939,136,1122
0.012,17,2,387,1,65,0,65,93,1,266,0,266,294
0.076,17,2,672,2,308,76,308,672,0,0,0,0,0
13.668,6,1842,1685727,1147,1391,11,1448,1644923,695,776,19,1448,40804
764.687,6,47,3374,31,31,25489,31,2108,16,31,50978,31,1266
721.959,2,8,256,8,8,103137,8,256,0,0,0,0,0
1793.715,17,142,11360,71,48,25624,48,5396,71,56,25624,56,5964
0.186,17,2,154,1,33,0,33,61,1,65,0,65,93
1795.393,1,67,5628,67,56,27202,56,5628,0,0,0,0,0
1797.952,1,58,4872,0,0,0,0,0,58,56,31543,56,4872
1747.333,1,56,4704,0,0,0,0,0,56,56,31769,56,4704
315.979,6,82,14279,40,123,8102,615,4292,42,276,7703,4649,9987
1797.729,17,142,11360,71,48,25681,48,5396,71,56,25681,56,5964
1774.749,17,140,11200,70,48,25720,48,5320,70,56,25720,56,5880
15.284,17,4,352,2,60,15282,60,176,2,60,15283,60,176
1680.355,1,15,840,15,28,120025,28,840,0,0,0,0,0
7.713,6,39,7269,20,218,405,314,3423,19,513,404,1179,3846
31.837,1,5,280,5,28,7959,28,280,0,0,0,0,0
0.085,17,2,572,1,39,0,39,67,1,477,0,477,505
1141.377,6,166,14976,68,74,17034,314,6239,98,88,11765,1062,8737
0.254,6,20,7229,12,334,22,663,1969,8,1209,35,1906,5260
1.258,6,39,9888,20,502,66,1460,4352,19,433,60,1460,5536
1786.518,6,104,8504,69,66,26272,66,5004,35,60,52541,60,3500
15.903,17,27,9860,13,309,1322,1350,4381,14,363,1220,1350,5479
0.538,6,27,9141,13,268,44,710,1758,14,947,36,1368,7383
1797.512,6,356,22520,208,69,8683,69,12460,148,69,12227,69,10060
70.868,6,30,8982,12,328,6442,1189,2461,18,413,4160,1420,6521
7.232,17,5,5192,5,1010,1808,1452,5192,0,0,0,0,0
207.323,6,1947,981854,1075,846,193,1152,936663,872,368,237,1152,45191
1790.728,6,268,33823,109,147,16579,1360,16756,159,135,11332,3302,17067
1783.714,17,142,11360,71,48,25481,48,5396,71,56,25480,56,5964
0.496,6,108,75536,63,1286,8,1432,69445,45,475,10,1871,6091
593.504,6,9,546,6,31,118700,31,333,3,31,296742,31,213
374.64,6,18,1242,14,180,28818,180,916,4,110,20063,110,326
0.713,17,4,240,2,32,712,32,120,2,32,712,32,120
1.46,6,48,18200,26,882,58,1360,12544,22,433,60,1360,5656
2.914,1,3,168,3,28,1457,28,168,0,0,0,0,0
317.011,6,73,19220,38,325,8567,1360,9701,35,386,9320,4649,9519
0.129,17,2,339,1,33,0,33,61,1,250,0,250,278
10.757,6,19,4362,11,275,1075,275,998,8,1010,856,2840,3364
1750.58,17,12,498,11,14,175058,14,462,1,8,0,8,36
1.563,6,59,14796,28,549,57,1429,5020,31,405,48,1460,9776
2.16,17,19,7403,9,476,265,1350,4540,10,258,236,1350,2863
1789.952,6,376,23803,214,69,8403,69,13183,162,69,11117,69,10620
240.252,6,53,15631,28,671,8898,1402,12885,25,179,10010,580,2746
1771.084,6,99,9240,66,65,27247,65,5577,33,59,55343,59,3663
342.763,6,16505,16193521,5840,335,58,338,331556,10665,1435,32,4314,15861965
1.147,6,28,9314,16,149,76,159,2058,12,662,103,1669,7256
280.315,6,29,7392,13,158,23359,267,1317,16,603,18682,2036,6075
19.764,6,8,537,0,0,0,0,0,8,31,2823,31,537
0.063,17,2,448,2,196,63,346,448,0,0,0,0,0
3.003,1,3,168,3,28,1501,28,168,0,0,0,0,0
0.019,17,4,304,2,48,1,48,152,2,48,1,48,152
262.344,17,4,240,2,32,262343,32,120,2,32,262343,32,120
0.019,17,4,284,2,32,10,32,120,2,54,13,60,164
36.378,6,30,13636,12,330,3307,517,1943,18,825,2118,1408,11693
1773.81,6,182,15698,120,69,14905,69,8940,62,69,29075,69,6758
0.386,6,20,4960,10,137,42,267,1092,10,692,41,1467,3868
1.973,17,22,5709,22,231,93,389,5709,0,0,0,0,0
14.87,6,13,2143,8,329,2124,595,1083,5,396,3664,580,1060
3.612,6,20,6828,11,185,361,275,1001,9,780,406,1440,5827
300.578,6,38,8448,20,286,15819,797,1976,18,441,497,1360,6472
300.573,6,38,8404,20,274,15819,753,1931,18,441,496,1460,6473
2.244,6,12,2271,7,188,374,245,660,5,1407,495,1407,1611
0.234,17,2,152,1,48,0,48,76,1,48,0,48,76
0.001,1,6,726,6,93,0,107,726,0,0,0,0,0
1776.426,1,60,5040,60,56,30108,56,5040,0,0,0,0,0
0.017,17,8,1670,8,180,2,219,1670,0,0,0,0,0
1784.531,6,359,22985,207,69,8662,69,12420,152,69,11817,69,10565
0.223,6,10,1514,5,503,55,503,771,5,475,55,475,743
0.123,1,2,112,2,28,123,28,112,0,0,0,0,0
1786.746,6,104,8444,68,66,26667,66,4964,36,60,51047,60,3480
66.082,6,40,8701,19,410,489,882,2046,21,414,3296,2720,6655
55.58,17,4,352,2,48,55569,48,152,2,72,55571,72,200
84.187,17,4,352,2,60,84185,60,176,2,60,84186,60,176
12.546,17,4,1328,4,304,4182,308,1328,0,0,0,0,0
5.323,17,3,208,2,36,5006,36,128,1,52,0,52,80
0.07,6,3,144,1,0,0,0,40,2,0,0,0,104
1772.844,6,186,15927,122,69,14651,69,9089,64,69,28140,69,6838
1778.845,17,140,11200,70,48,25780,48,5320,70,56,25780,56,5880
134.181,6,893,418634,470,829,286,1152,396923,423,398,317,1152,21711
276.774,17,4,352,2,60,276773,60,176,2,60,276773,60,176
5.052,17,4,288,2,36,5004,36,128,2,52,4994,52,160
0.038,17,3,1537,3,484,19,512,1537,0,0,0,0,0
1789.936,6,356,22520,208,69,8647,69,12460,148,69,12176,69,10060
481.247,2,6,192,6,8,96249,8,192,0,0,0,0,0
27.274,6,13,876,5,92,6818,92,348,8,92,3866,92,528
240.232,6,52,17343,28,777,8897,1402,14679,24,201,10444,580,2664
1796.836,1,58,4872,58,56,31523,56,4872,0,0,0,0,0
9.861,6,22,2713,12,211,896,211,1098,10,545,899,904,1615
2.892,17,3,468,3,128,1446,128,468,0,0,0,0,0
133.468,17,4,352,2,60,133466,60,176,2,60,133467,60,176
1008.367,2,9,288,9,8,126045,8,288,0,0,0,0,0
1432.187,6,3165,3020060,1080,156,1327,917,64731,2085,1407,687,5672,2955329
0.05,17,2,211,1,45,0,45,73,1,110,0,110,138
0.355,17,2,290,1,40,0,40,68,1,194,0,194,222
1.193,6,30,6220,16,138,79,267,1755,14,650,80,1452,4465
6.795,6,72,26639,40,874,174,1360,15757,32,478,205,1360,10882
0.429,6,17,8429,11,290,42,517,1173,6,1734,72,2736,7256
25.97,6,43,13659,21,299,1298,722,3243,22,794,1226,2760,10416
0.481,17,8,2750,8,315,68,354,2750,0,0,0,0,0
1748.091,6,155,9627,82,48,21581,208,5777,73,31,24275,31,3850
1.528,17,19,10086,9,484,191,1350,4608,10,519,109,1350,5478
1.988,17,6,460,3,40,986,41,206,3,56,986,57,254
0.545,6,21,7281,13,334,45,663,2021,8,1209,71,1946,5260
1795.03,17,447,39864,402,35,4476,288,25644,45,288,40021,288,14220
14.9,6,2229,2080378,1439,1368,10,1408,2034634,790,931,18,2816,45744
184.336,17,10,2060,5,48,46082,48,380,5,308,46081,308,1680
0.124,6,10,1378,5,145,31,145,349,5,825,26,825,1029
0.453,6,127,88960,59,131,7,232,2889,68,1322,6,1430,86071
1776.307,17,73,3060,72,14,25018,14,3024,1,8,0,8,36
86.283,6,807,386389,437,818,197,1152,366798,370,435,233,1179,19591
192.191,6,71,18822,37,315,3838,1360,9711,34,407,5819,4649,9111
0.104,17,2,213,1,54,0,54,82,1,103,0,103,131
240.158,6,54,15928,29,689,8576,1402,13233,25,173,10006,580,2695
240.187,6,54,17304,29,770,8577,1402,14620,25,172,10007,580,2684
0.224,17,8,2758,8,316,32,355,2758,0,0,0,0,0
52.658,6,37,8495,18,410,505,882,1982,19,441,2918,1460,6513
1797.269,17,449,39928,404,35,4459,288,25708,45,288,40016,288,14220
1751.325,6,95,7203,63,38,28247,205,4476,32,33,56480,98,2727
1794.153,6,165,12837,87,92,20860,208,8818,78,31,23298,31,4019
1797.61,1,345,28980,345,56,5225,56,28980,0,0,0,0,0
1797.275,17,447,39580,403,35,4470,288,25676,44,288,40951,288,13904
0.154,1,2,112,2,28,154,28,112,0,0,0,0,0
1786.716,6,104,8376,68,65,26667,65,4930,36,59,51046,59,3446
1796.914,6,354,22440,206,69,8765,69,12380,148,69,12223,69,10060
316.941,6,91,33881,48,625,6743,1360,23224,43,371,7542,4649,10657
1796.811,17,448,39896,403,35,4469,288,25676,45,288,40018,288,14220
7.562,17,40,8999,13,242,629,1350,3514,27,175,289,1350,5485
0.343,17,2,152,1,48,0,48,76,1,48,0,48,76
0.092,6,32,19073,16,127,5,127,967,16,1328,6,1448,18106
0.164,6,25,7216,12,155,14,267,1261,13,678,13,2800,5955
0.058,6,10,2047,6,740,11,1323,1724,4,159,18,159,323
172.141,17,8,2688,8,308,24591,308,2688,0,0,0,0,0
0.338,6,7,423,4,43,63,43,259,3,0,79,0,164
2.27,17,28,21698,18,1053,131,1350,19475,10,194,248,1350,2223
1754.811,6,78,4108,39,26,46178,26,2054,39,26,46178,26,2054
1767.055,1,57,4788,0,0,0,0,0,57,56,31554,56,4788
1745.422,6,100,7860,66,45,26852,205,4896,34,35,52881,98,2964
2.32,6,71,28281,36,1005,66,1440,17638,35,543,63,1440,10643
1776.508,17,73,3060,72,14,25021,14,3024,1,8,0,8,36
1.486,6,47,19269,27,898,57,1360,13693,20,476,66,2715,5576
61.839,6,73,48562,44,1179,1438,1408,38913,29,903,2200,2816,9649
6.647,17,41,26498,21,726,330,1350,15851,20,504,348,1350,10647
2.96,17,4,296,4,46,986,46,296,0,0,0,0,0
9.49,6,14,3706,4,92,3163,92,296,10,360,1031,2026,3410
0.098,17,5,1692,5,310,24,355,1692,0,0,0,0,0
0.022,17,2,212,1,46,0,46,74,1,110,0,110,138
0.011,17,2,237,1,72,0,72,100,1,109,0,109,137
0.49,17,3,451,2,39,357,39,134,1,289,0,289,317
21.776,6,17,6184,4,190,5049,190,370,13,880,1804,1460,5814
2.119,17,3,174,3,30,1059,30,174,0,0,0,0,0
1787.901,6,370,25301,214,93,8393,469,14645,156,69,11534,69,10656
6.888,6,42,7389,22,201,328,314,3503,20,513,348,1179,3886
1757.968,6,100,7866,66,45,27045,205,4902,34,35,53261,98,2964
1798.065,17,448,39896,403,35,4472,288,25676,45,288,40020,288,14220
1784.382,17,83,3480,82,14,22029,14,3444,1,8,0,8,36
1769.568,6,99,9240,66,65,27224,65,5577,33,59,55295,59,3663
1781.587,1,125,13250,125,78,14367,78,13250,0,0,0,0,0
280.736,6,30,7773,13,158,23394,267,1317,17,577,17539,1400,6456
0.196,17,2,574,1,32,0,32,60,1,486,0,486,514
54.098,1,4,224,4,28,18032,28,224,0,0,0,0,0
1.578,6,29,10388,17,373,98,851,1803,12,1012,135,1420,8585
1790.954,17,179,13962,179,50,10061,50,13962,0,0,0,0,0
13.182,6,2,80,1,0,0,0,40,1,0,0,0,40
1670.064,1,8,448,8,28,238580,28,448,0,0,0,0,0
57.979,6,25,8808,7,155,493,267,1066,18,501,3407,3457,7742
0.186,6,45,21638,27,1039,7,1420,16697,18,467,10,1883,4941
1797.96,1,345,28980,345,56,5226,56,28980,0,0,0,0,0
300.86,6,54,17238,29,916,10745,1360,11325,25,326,361,1360,5913
4.094,17,4,296,4,46,1364,46,296,0,0,0,0,0
1795.325,17,448,39896,403,35,4465,288,25676,45,288,40028,288,14220
3.994,17,4,368,4,64,1331,64,368,0,0,0,0,0
3.529,17,5,588,4,64,1170,64,368,1,192,0,192,220
240.325,6,42,8806,20,523,12648,1408,5757,22,210,11443,618,3049
1797.015,17,446,39264,403,35,4470,288,25676,43,288,41926,288,13588
1784.932,6,108,8790,71,66,25499,66,5150,37,60,49572,60,3640
0.168,6,10,1379,5,145,42,145,349,5,826,29,826,1030
10.506,1,4,224,4,28,3502,28,224,0,0,0,0,0
0.23,6,4,1037,2,0,220,0,104,2,853,12,853,933
370.909,6,18,1242,14,180,28531,180,916,4,110,20059,110,326
1.227,6,25,8056,12,164,94,267,1288,13,869,87,1408,6768
1771.229,6,99,9306,66,66,27249,66,5610,33,60,55348,60,3696
49.287,6,30,9017,17,233,3080,517,2083,13,694,4099,1408,6934
4.256,6,53,17215,24,791,185,1440,9722,29,480,133,1440,7493
1783.688,6,113,8931,71,65,25481,65,5245,42,59,43495,59,3686
0.024,6,19,4192,10,101,2,101,629,9,441,2,500,3563
0.75,6,141,94930,77,1287,9,1420,88079,64,475,11,1883,6851
10.059,2,3,96,3,8,5029,8,96,0,0,0,0,0
2.971,17,3,1176,3,364,1485,364,1176,0,0,0,0,0
61.155,6,24,9651,12,372,74,802,1630,12,1075,5547,2720,8021
6.996,6,1589,1498309,1027,1383,6,1408,1464421,562,931,12,2816,33888
1780.614,6,354,22440,207,69,8643,69,12420,147,69,12195,69,10020
1771.503,6,99,9306,66,66,27253,66,5610,33,60,55356,60,3696
1.828,17,4,580,2,40,1796,40,136,2,194,1784,194,444
19.113,6,14,3176,6,92,3822,92,400,8,1164,2700,1408,2776
1681.544,17,14,1036,7,30,280255,30,406,7,62,280254,62,630
186.984,6,6243,5543053,3814,1366,49,1368,5398531,2429,899,76,1473,144522
363.919,2,3,96,3,8,181959,8,96,0,0,0,0,0
96.65,6,144,103207,84,1269,1164,1368,91960,60,738,1634,2736,11247
0.005,17,2,339,1,33,0,33,61,1,250,0,250,278
3.613,17,5,295,5,31,903,31,295,0,0,0,0,0
421.098,2,3,96,3,8,210549,8,96,0,0,0,0,0
0.072,6,2,116,2,0,0,0,116,0,0,0,0,0
0.627,17,4,820,2,36,606,36,128,2,318,623,318,692
0.688,17,4,1344,4,308,229,308,1344,0,0,0,0,0
17.231,17,30,13655,14,671,1323,1350,9793,16,213,1146,1350,3862
8.015,6,35,7970,14,156,616,267,1819,21,441,400,1420,6151
1796.383,6,104,8500,69,65,26417,65,5035,35,59,52832,59,3465
1772.369,6,180,15480,120,69,14893,69,8940,60,69,30032,69,6540
41.219,6,40,8769,22,456,1962,1418,5752,18,207,2423,580,3017
61.11,17,4,352,2,60,61109,60,176,2,60,61109,60,176
1.127,17,4,534,2,31,1115,31,118,2,180,1117,196,416
0.0,6,2,80,0,0,0,0,0,2,0,0,0,80
300.293,6,66,82648,39,162,7902,230,2858,27,3265,11549,9814,79790
75.727,6,30,7573,12,155,6884,267,1266,18,429,4454,3426,6307
1791.969,17,142,11352,72,48,25235,48,5472,70,56,25970,56,5880
0.088,6,10,1495,5,507,22,507,727,5,556,21,556,768
1.781,17,6,552,3,32,890,32,180,3,96,884,96,372
10.99,6,18,4266,10,275,1221,275,958,8,992,887,1440,3308
0.053,6,2,1288,1,1208,0,1208,1248,1,0,0,0,40
1797.672,6,365,25032,213,94,8479,469,14536,152,69,11903,69,10496
30.343,17,8,704,4,48,10111,48,304,4,72,10111,72,400
19.463,1,9,756,9,56,2432,56,756,0,0,0,0,0
0.182,17,2,2752,2,1348,182,1348,2752,0,0,0,0,0
11.855,6,1880,1625608,1149,1363,10,1380,1592081,731,387,16,1923,33527
11.637,6,1837,1625042,1147,1363,10,1380,1593000,690,421,16,1923,32042
300.677,6,36,8494,20,308,15825,885,2100,16,522,568,2720,6394
27.523,6,111057,104612338,57938,154,0,298,3122657,53119,1858,0,11264,101489681
0.647,6,10,1840,6,901,129,901,1221,4,403,215,403,619
0.033,17,2,180,1,30,0,30,58,1,94,0,94,122
31.639,6,7,308,1,0,0,0,44,6,0,6289,0,264
1787.728,17,75,3141,73,13,24829,14,3061,2,12,335532,16,80
1789.226,17,142,11360,71,48,25560,48,5396,71,56,25560,56,5964
335.321,6,73,17351,43,652,7983,721,11366,30,152,11562,269,5985
1.138,6,25,8056,12,164,88,267,1288,13,869,80,1448,6768
32.023,6,25,6673,11,268,3202,517,1374,14,456,2415,1402,5299
1550.732,6,76,6121,50,64,26531,64,3600,26,56,62025,58,2521
240.57,6,46,8958,24,516,10459,1402,5900,22,211,11455,638,3058
560.918,17,6,444,3,30,280437,30,174,3,62,280430,62,270
1799.377,17,448,39612,404,35,4464,288,25708,44,288,40945,288,13904
1161.426,6,232,14731,134,69,8732,69,8120,98,69,11964,69,6611
1789.307,17,83,3480,82,14,22090,14,3444,1,8,0,8,36
11.65,6,1790,1626090,1150,1363,10,1380,1596248,640,383,18,1380,29842
1794.407,17,248,49988,248,173,7264,377,49988,0,0,0,0,0
282.346,6,31,7679,12,158,25491,267,1277,19,512,15683,3456,6402
1798.348,17,448,39896,403,35,4473,288,25676,45,288,40019,288,14220
125.122,17,2,656,2,300,125122,300,656,0,0,0,0,0
0.006,6,3,189,1,0,0,0,40,2,69,0,69,149
1727.63,1,8,848,8,78,246804,78,848,0,0,0,0,0
1784.36,6,362,22898,210,69,8537,69,12678,152,69,11816,69,10220
1.389,6,44,10169,23,440,63,1360,4508,21,400,59,1360,5661
1681.32,17,14,3815,7,30,280218,30,406,7,459,280218,463,3409
0.377,6,26,9068,13,266,31,705,1750,13,947,30,2804,7318
240.197,6,53,17357,28,771,8895,1418,14572,25,184,10007,580,2785
1795.005,6,244,46664,152,483,11887,483,36892,92,83,19725,83,9772
1774.394,6,200,18271,128,83,13971,965,10363,72,73,24989,405,7908
0.808,6,27,5927,13,156,67,267,1462,14,650,57,1420,4465
19.213,6,43,14599,22,1005,420,1360,8957,21,399,951,1360,5642
240.388,6,55,18476,29,813,8584,1418,15346,26,221,9615,580,3130
0.88,17,3,244,2,32,709,32,120,1,96,0,96,124
0.996,6,28,8484,14,266,65,540,1948,14,852,62,1360,6536
33.249,6,21,5995,11,267,3324,501,1245,10,620,3684,1420,4750
11.712,6,19,2921,9,137,1464,267,913,10,400,1272,1179,2008
5.355,17,4,240,2,32,5354,32,120,2,32,5354,32,120
371.058,6,21,1419,15,177,26504,177,989,6,110,12242,110,430
2.439,6,13,2311,8,188,348,245,700,5,1407,548,1407,1611
195.364,17,4,352,2,60,195363,60,176,2,60,195363,60,176
1.993,6,9,527,5,43,498,43,311,4,0,663,0,216
0.042,17,4,284,2,32,14,32,120,2,54,30,60,164
10.859,17,17,18142,17,1039,678,1451,18142,0,0,0,0,0
14.482,6,113,38662,57,630,258,1152,31940,56,407,258,1152,6722
1786.804,6,104,8444,68,66,26668,66,4964,36,60,51048,60,3480
11.128,6,1755,1537224,1064,1390,10,1420,1505363,691,467,16,1883,31861
34.739,6,33,6067,16,154,2315,721,1923,17,407,2157,2026,4144
61.319,6,35,15821,22,799,2919,1408,9147,13,855,5089,3847,6674
1798.388,6,364,24523,212,87,8523,469,14096,152,69,11908,69,10427
240.594,6,40,8785,20,598,12662,1418,5836,20,237,12662,580,2949
0.024,6,2,92,1,0,0,0,40,1,0,0,0,52
1785.73,6,358,22738,208,69,8626,69,12460,150,69,11982,69,10278
57.982,6,30,7432,13,158,4831,267,1317,17,543,3621,1400,6115
0.576,17,4,708,2,36,562,36,128,2,262,551,262,580
3.866,17,4,352,2,48,3853,48,152,2,72,3853,72,200
746.166,6,123,18337,64,151,11843,469,7885,59,158,12864,1452,10452
0.522,6,24,7480,14,273,40,663,2104,10,967,53,1471,5376
4.748,17,2,656,2,300,4748,300,656,0,0,0,0,0
1795.07,17,80,3354,79,14,23013,14,3318,1,8,0,8,36
2.368,17,4,574,3,39,925,39,201,1,345,0,345,373
1797.001,17,449,39928,404,35,4459,288,25708,45,288,40022,288,14220
1726.868,1,8,448,8,28,246695,28,448,0,0,0,0,0
1682.623,17,14,1036,7,30,280431,30,406,7,62,280431,62,630
64.011,1,2,112,2,28,64011,28,112,0,0,0,0,0
5.008,17,4,558,2,36,5002,36,128,2,187,5003,187,430
23.357,6,65,37787,31,599,778,1440,4995,34,1208,696,1491,32792
1792.746,17,404,45900,186,149,9690,1350,33045,218,30,8261,60,12855
300.582,6,40,8732,20,315,15820,882,2117,20,386,444,1460,6615
1796.488,17,450,39960,405,35,4446,288,25740,45,288,40331,288,14220
3.716,6,36,6249,18,206,218,314,2784,18,456,203,1152,3465
1.314,6,40,9928,21,440,65,1360,4392,19,476,63,2715,5536
301.091,6,19,2992,10,195,33435,195,651,9,492,37614,775,2341
5.585,6,40,7325,22,218,265,314,3503,18,516,313,1179,3822
0.507,6,27,6154,14,164,39,453,1570,13,648,39,2176,4584
1789.91,1,342,28728,342,56,5249,56,28728,0,0,0,0,0
0.337,6,29,9071,14,234,25,575,1672,15,942,23,1408,7399
39.773,17,5,380,5,48,9943,48,380,0,0,0,0,0
1.533,6,29,10365,17,367,95,833,1785,12,1012,132,1420,8580
1788.287,17,87,3648,86,14,21038,14,3612,1,8,0,8,36
1628.104,1,8,448,8,28,232586,28,448,0,0,0,0,0
1799.274,1,58,4872,0,0,0,0,0,58,56,31566,56,4872
384.001,6,6,861,6,103,76800,138,861,0,0,0,0,0
11.971,6,1748,1628684,1151,1365,10,1432,1600504,597,428,20,2864,28180
1799.754,17,439,37620,398,33,4533,288,24664,41,288,44022,288,12956
5.541,6,40,7309,20,218,291,314,3423,20,513,276,1179,3886
118.485,6,41,8305,18,131,6969,267,1790,23,348,5383,1452,6515
15.267,6,2592,2380057,1564,1435,9,1448,2317117,1028,776,14,1448,62940
0.014,17,4,352,2,37,8,37,130,2,83,7,89,222
291.22,6,36,7397,17,248,18198,517,1899,19,643,16176,1418,5498
4.301,6,37,7205,19,218,238,314,3383,18,516,238,1179,3822
1749.485,1,222,12432,222,28,7916,28,12432,0,0,0,0,0
170.015,6,24,12066,13,505,78,1201,2067,11,1591,16983,4429,9999
3.238,17,4,240,4,32,1079,32,240,0,0,0,0,0
0.134,17,4,1116,2,32,120,32,120,2,470,110,470,996
64.204,1,6,336,6,28,12840,28,336,0,0,0,0,0
890.958,6,77,8699,43,78,21213,721,3804,34,129,26992,1448,4895
1785.756,6,106,8456,68,65,26653,65,4930,38,59,48261,59,3526
8.5,6,25,7103,12,156,772,267,1272,13,589,707,3426,5831
77.564,6,9678,9389483,6530,1361,11,1408,9221099,3148,931,24,2801,168384
61.371,6,10,754,10,26,6819,26,754,0,0,0,0,0
0.589,6,10,1380,5,145,147,145,349,5,827,64,827,1031
1.389,6,49,18758,26,922,55,1440,13062,23,433,55,1440,5696
367.076,6,20,1358,15,180,26219,180,980,5,110,15167,110,378
1783.773,17,142,11360,71,48,25482,48,5396,71,56,25482,56,5964
331.389,6,108,66733,55,590,6136,986,6481,53,1223,1292,1491,60252
159.8,1,4,1481,4,342,53266,353,1481,0,0,0,0,0
1769.047,6,98,7421,65,38,27641,205,4611,33,33,55269,98,2810
56.215,6,19,5867,9,267,7026,502,1166,10,613,6236,1420,4701
0.007,17,2,432,1,60,0,60,88,1,316,0,316,344
1796.838,17,448,39896,403,35,4469,288,25676,45,288,40017,288,14220
190.683,6,69,49448,46,1185,4237,1408,41520,23,960,2801,3847,7928
89.946,6,778,393244,440,836,204,1152,374933,338,435,266,1179,18311
1785.512,6,115,9058,72,65,25148,65,5155,43,59,42510,59,3903
9.496,6,89,28863,46,577,211,1152,22645,43,449,220,1179,6218
745.932,1,44,4664,44,78,17347,78,4664,0,0,0,0,0
1.533,6,46,19128,27,891,58,1360,13592,19,476,73,2715,5536
1787.251,6,102,8276,68,64,26675,65,4920,34,58,54156,59,3356
1772.361,6,180,15480,120,69,14893,69,8940,60,69,30036,69,6540
301.353,6,12,930,8,180,43050,180,604,4,110,20059,110,326
0.012,6,3,327,2,103,0,138,287,1,0,0,0,40
1774.822,6,180,15480,120,69,14914,69,8940,60,69,30077,69,6540
1792.841,17,163,10432,163,36,11066,36,10432,0,0,0,0,0
0.095,17,2,212,1,46,0,46,74,1,110,0,110,138
1647.549,1,7,392,7,28,274591,28,392,0,0,0,0,0
0.08,17,2,204,1,34,0,34,62,1,114,0,114,142
0.034,17,2,116,1,30,0,30,58,1,30,0,30,58
0.029,17,2,280,1,64,0,64,92,1,160,0,160,188
0.141,6,5,279,4,31,8,31,239,1,0,0,0,40
0.267,6,10,1090,5,261,66,261,465,5,421,55,421,625
1772.378,6,180,15480,120,69,14893,69,8940,60,69,30038,69,6540
1796.846,17,449,39928,404,35,4458,288,25708,45,288,40025,288,14220
0.029,17,6,912,3,60,5,60,264,3,188,6,188,648
284.933,6,33,7561,15,158,20352,267,1397,18,544,16757,1300,6164
0.29,6,24,5980,12,164,26,453,1442,12,651,25,1448,4538
2.051,17,3,310,2,31,2030,31,118,1,164,0,164,192
66.433,6,580,268414,300,833,222,1152,252050,280,396,237,1152,16364
299.52,6,40,9987,21,590,14966,1360,4425,19,399,16629,1360,5562
1786.44,6,386,24092,212,69,8466,69,12896,174,50,10326,69,11196
10.997,6,17,4226,9,275,1374,275,918,8,992,839,1440,3308
1771.154,6,106,9898,69,66,26046,66,5910,37,60,49192,60,3988
0.173,6,35,18372,16,173,11,319,1532,19,1320,9,1588,16840
150.725,17,4,352,2,60,150724,60,176,2,60,150724,60,176
2.787,17,4,275,3,31,1361,31,177,1,70,0,70,98
0.261,17,2,2754,2,1349,261,1349,2754,0,0,0,0,0
1.428,6,48,21000,28,951,52,1360,15424,20,476,65,2715,5576
212.131,17,4,352,2,60,212129,60,176,2,60,212130,60,176
1493.019,17,120,7680,120,36,12546,36,7680,0,0,0,0,0
1783.811,6,357,22629,208,69,8617,69,12529,149,69,12052,69,10100
4.57,6,30,7432,13,158,380,267,1317,17,543,285,1400,6115
1792.71,17,172,13416,172,50,10483,50,13416,0,0,0,0,0
962.538,2,11,352,11,8,96253,8,352,0,0,0,0,0
5.001,17,2,128,2,36,5001,36,128,0,0,0,0,0
5.013,17,3,434,2,34,5008,34,124,1,282,0,282,310
0.423,6,10,968,5,256,101,256,460,5,304,101,304,508
29.117,17,18,1584,9,48,3631,48,684,9,72,3631,72,900
0.995,17,2,685,1,308,0,308,336,1,321,0,321,349
504.268,2,5,160,5,8,126067,8,160,0,0,0,0,0
1787.532,6,102,8296,68,65,26679,65,4930,34,59,54164,59,3366
1260.829,1,6,336,6,28,252165,28,336,0,0,0,0,0
1759.69,6,78,3588,39,0,46307,0,2028,39,0,46307,0,1560
0.593,6,15,1785,8,288,63,288,640,7,426,69,434,1145
1742.666,6,95,7203,63,38,28107,205,4476,32,33,56207,98,2727
1740.489,17,30,20190,30,645,60016,645,20190,0,0,0,0,0
140.507,6,22,8174,11,520,105,1223,2034,11,948,14032,1631,6140
1786.464,6,102,8364,68,66,26663,66,4964,34,60,54132,60,3400
294.361,17,4,352,2,60,294360,60,176,2,60,294360,60,176
296.247,17,4,240,2,32,296246,32,120,2,32,296246,32,120
1798.836,17,449,39416,404,34,4463,288,25444,45,282,40022,288,13972
11.485,6,22,2709,12,211,1042,211,1102,10,545,1271,904,1607
1771.913,6,99,9306,66,66,27260,66,5610,33,60,55369,60,3696
21.237,6,17,3348,9,49,2654,92,575,8,1164,3000,1408,2773
0.418,6,8,335,4,0,139,0,164,4,7,70,7,171
0.104,6,9,1002,5,213,26,213,417,4,421,23,421,585
11.015,6,20,4442,11,275,1101,275,998,9,768,787,1440,3444
1773.291,6,180,15480,120,69,14901,69,8940,60,69,30049,69,6540
0.084,6,10,1495,5,507,20,507,727,5,556,21,556,768
1783.811,6,362,24774,211,94,8494,469,14387,151,69,11892,69,10387
1755.69,6,97,7369,64,38,27868,205,4559,33,33,54858,98,2810
280.503,6,30,7432,13,158,23375,267,1317,17,603,17527,2076,6115
300.841,6,31,8312,13,204,25070,467,1500,18,391,7411,1448,6812
0.641,6,12,2032,7,329,106,500,1022,5,375,159,500,1010
1297.867,6,116,13676,63,124,20933,722,7754,53,105,24949,1448,5922
1794.463,6,374,23654,214,69,8424,69,13114,160,69,11284,69,10540
128.792,6,65,49008,27,564,4952,1448,3669,38,1445,3480,2896,45339
7.876,17,21,10686,7,758,1310,1350,5502,14,342,602,1350,5184
504.564,2,4,128,4,8,168188,8,128,0,0,0,0,0
1769.73,6,104,9883,68,70,26413,234,5948,36,60,50561,83,3935
1770.249,6,225,16962,93,70,19239,313,8454,132,48,13513,78,8508
250.559,17,4,304,2,48,250547,48,152,2,48,250547,48,152
0.397,6,27,9078,13,263,33,691,1736,14,943,29,1438,7342
1792.926,6,418,25021,209,69,8619,69,12500,209,34,8619,48,12521
3.617,6,2,88,2,0,0,0,88,0,0,0,0,0
1777.635,6,95,7647,59,65,26138,65,4310,36,54,50784,59,3337
1786.602,6,103,8395,68,65,26665,65,4930,35,59,52543,59,3465
280.249,6,29,7392,13,158,23354,267,1317,16,603,18679,1400,6075
1764.032,2,14,448,14,8,135694,8,448,0,0,0,0,0
1740.08,1,56,4704,56,56,31637,56,4704,0,0,0,0,0
504.163,17,18,1656,9,33,63018,37,550,9,94,63018,136,1106
1799.204,1,238,13328,238,28,7591,28,13328,0,0,0,0,0
1746.338,6,95,7203,63,38,28166,205,4476,32,33,56325,98,2727
481.343,2,5,160,5,8,120335,8,160,0,0,0,0,0
1796.861,17,448,39896,403,35,4469,288,25676,45,288,40019,288,14220
1077.93,17,344,23636,343,40,3151,41,23552,1,56,0,56,84
1740.48,17,29,30624,29,1028,62160,1028,30624,0,0,0,0,0
118.826,6,23,8169,12,211,66,290,1147,11,1095,11868,2720,7022
4.009,6,26,9155,11,231,399,669,1736,15,945,285,1438,7419
0.01,17,4,859,2,37,0,37,130,2,336,1,348,729
1786.406,6,105,8534,69,65,26270,65,4970,36,59,51037,59,3564
1786.843,6,102,8296,68,65,26669,65,4930,34,59,54144,59,3366
127.54,6,33,7837,11,171,12754,267,1306,22,352,6065,1460,6531
2.542,17,2,154,1,33,0,33,61,1,65,0,65,93
6.07,17,59,11920,22,216,289,1350,5381,37,148,164,1350,6539
1740.572,17,29,30624,29,1028,62163,1028,30624,0,0,0,0,0
1784.316,6,102,8364,68,66,26631,66,4964,34,60,54067,60,3400
2.107,6,24,6064,12,181,191,537,1526,12,651,161,1448,4538
1783.551,17,77,3228,76,14,23780,14,3192,1,8,0,8,36
201.883,6,26,8197,14,576,15529,1178,2477,12,636,5564,1491,5720
3.21,6,5,232,2,0,3210,0,88,3,0,1516,0,144
1718.555,1,8,448,8,28,245507,28,448,0,0,0,0,0
0.174,17,2,2754,2,1349,174,1349,2754,0,0,0,0,0
0.153,17,2,194,1,61,0,61,89,1,77,0,77,105
1786.649,6,102,8364,68,66,26666,66,4964,34,60,54137,60,3400
74.3,6,31,8749,17,434,4643,659,2254,14,959,5662,2688,6495
481.258,2,6,192,6,8,96251,8,192,0,0,0,0,0
33.607,6,30,5243,15,180,2400,721,1859,15,371,2384,2026,3384
0.681,17,2,144,1,36,0,36,64,1,52,0,52,80
1.433,6,51,21552,29,919,51,1360,15896,22,476,59,2720,5656
1744.635,2,30,960,30,8,60159,8,960,0,0,0,0,0
0.039,6,2,364,1,0,0,0,40,1,272,0,272,324
0.037,6,4,239,2,0,14,0,104,2,31,0,31,135
289.92,17,4,352,2,60,289919,60,176,2,60,289919,60,176
33.659,6,31,5130,16,154,2243,722,1947,15,399,2390,2026,3183
1762.604,6,114,8065,65,26,27540,26,3860,49,96,36712,427,4205
2.271,17,3,238,2,30,2177,30,116,1,94,0,94,122
54.545,6,20,820,11,0,5454,0,444,9,0,6066,0,376
300.754,6,51,25691,29,997,10741,1402,15514,22,752,2042,1503,10177
280.212,6,28,7352,13,158,23351,267,1317,15,678,20012,2600,6035
1773.229,6,183,15738,121,69,14776,69,8980,62,69,29067,69,6758
1781.765,6,367,25581,213,99,8404,469,15005,154,69,11645,69,10576
1681.25,17,14,3843,7,30,280207,30,406,7,463,280207,463,3437
10.961,6,20,7130,11,275,1096,275,998,9,1440,779,1440,6132
1799.982,17,31,1767,31,29,59999,29,1767,0,0,0,0,0
20.279,6,20,3142,10,229,2253,517,1457,10,381,2247,499,1685
0.406,6,10,968,5,256,97,256,460,5,304,97,304,508
1799.132,17,142,11360,71,48,25701,48,5396,71,56,25699,56,5964
0.525,17,2,384,1,39,0,39,67,1,289,0,289,317
36.87,6,522,484825,194,126,191,300,10466,328,1411,112,1418,474359
1741.165,6,87,6322,58,31,30546,31,3915,29,31,62184,31,2407
10.529,6,86,65345,51,174,210,228,3267,35,1882,307,5012,62078
62.41,6,60,38315,37,1137,1733,1448,30365,23,749,2822,1448,7950
5.987,6,1305,1170470,800,1382,7,1408,1139546,505,931,11,2816,30924
0.176,6,26,7776,13,176,14,334,1391,13,1137,14,1648,6385
103.084,17,4,240,2,32,103083,32,120,2,32,103083,32,120
0.654,6,9,492,5,0,163,0,268,4,0,208,0,224
166.376,1,4,224,4,28,55458,28,224,0,0,0,0,0
47.974,6,33,5427,15,145,3426,721,1942,18,281,2792,1448,3485
57.432,17,4,352,2,60,57430,60,176,2,60,57431,60,176
1744.392,6,95,7203,63,38,28135,205,4476,32,33,56261,98,2727
120.29,2,3,96,3,8,60145,8,96,0,0,0,0,0
1794.104,17,80,3354,79,14,23001,14,3318,1,8,0,8,36
1789.298,17,142,11360,71,48,25561,48,5396,71,56,25561,56,5964
0.05,17,2,2750,2,1347,50,1347,2750,0,0,0,0,0
225.587,17,4,240,2,32,225586,32,120,2,32,225586,32,120
0.191,17,2,2754,2,1349,191,1349,2754,0,0,0,0,0
12.341,6,47,10026,25,450,514,766,2857,22,369,519,1440,7169
504.728,2,4,128,4,8,168242,8,128,0,0,0,0,0
21.081,6,42,9784,21,642,446,1360,4097,21,371,1045,1360,5687
1772.993,6,181,15589,120,69,14899,69,8940,61,69,29549,69,6649
3.068,6,2,88,2,0,0,0,88,0,0,0,0,0
0.48,17,3,451,2,39,203,39,134,1,289,0,289,317
73.569,6,26,4221,12,234,6672,564,1600,14,463,5645,1343,2621
1752.623,1,56,4704,0,0,0,0,0,56,56,31865,56,4704
1794.161,17,80,3354,79,14,23002,14,3318,1,8,0,8,36
0.005,17,4,1379,4,316,1,355,1379,0,0,0,0,0
192.021,6,26,7226,6,154,38404,267,712,20,356,10104,1917,6514
12.946,6,9,492,5,0,3236,0,268,4,0,4309,0,224
8.305,6,1608,1485053,1025,1372,7,1408,1450073,583,931,13,2816,34980
19.45,6,28,7099,9,142,2431,267,938,19,449,1072,1452,6161
280.201,6,28,7352,12,158,25472,267,1277,16,603,18679,1400,6075
1790.541,17,87,3648,86,14,21065,14,3612,1,8,0,8,36
2.747,17,4,1556,4,361,915,361,1556,0,0,0,0,0
1773.196,6,180,15480,120,69,14900,69,8940,60,69,30049,69,6540
154.892,6,64,11340,27,195,5951,1189,3637,37,326,4299,1917,7703
10.765,6,18,5550,10,275,1196,275,958,8,1420,857,1420,4592
0.22,17,8,2758,8,316,31,355,2758,0,0,0,0,0
16.039,6,27,9339,10,138,1782,267,963,17,640,997,1420,8376
81.183,6,22,900,10,0,6110,0,404,12,0,7379,0,496
0.999,17,2,925,1,548,0,548,576,1,321,0,321,349
1743.005,6,123,11278,69,93,25632,205,7233,54,31,32880,33,4045
1786.002,6,102,8364,68,66,26656,66,4964,34,60,54118,60,3400
1775.751,17,142,11360,71,48,25367,48,5396,71,56,25367,56,5964
24.51,6,12,724,3,106,12250,106,234,9,90,3061,90,490
1795.31,6,356,22520,208,69,8672,69,12460,148,69,12212,69,10060
1799.343,17,448,39896,403,35,4475,288,25676,45,288,40021,288,14220
1789.968,17,87,3648,86,14,21058,14,3612,1,8,0,8,36
2.52,17,3,1170,3,362,1260,362,1170,0,0,0,0,0
67.894,6,19,1822,7,226,658,226,832,12,110,6156,110,990
1679.676,17,12,498,11,14,167967,14,462,1,8,0,8,36
13.129,17,4,824,2,48,13110,48,152,2,308,13111,308,672
1783.269,17,83,3480,82,14,22015,14,3444,1,8,0,8,36
2.7,6,14,2351,8,188,385,245,700,6,1407,487,1407,1651
21.381,17,27,10079,13,240,1779,1350,3486,14,442,1642,1350,6593
1684.361,17,16,1265,8,30,240621,37,471,8,71,240621,136,794
243.866,1,3,168,3,28,121933,28,168,0,0,0,0,0
63.252,6,29,8832,14,158,4865,267,1357,15,858,4516,3436,7475
0.374,6,22,4442,11,165,37,456,1394,11,493,36,888,3048
3.019,17,7,1782,4,32,991,32,240,3,486,1488,486,1542
45.087,6,44,9950,23,642,403,1360,4201,21,349,2246,2667,5749
11.036,6,20,4442,11,275,1103,275,998,9,768,782,1440,3444
280.539,6,29,7392,13,158,23378,267,1317,16,775,18694,4836,6075
5.478,6,40,7309,21,218,273,314,3463,19,513,289,1179,3846
97.832,17,4,240,2,32,97831,32,120,2,32,97831,32,120
0.332,17,23,13460,13,804,27,1350,10822,10,235,33,1350,2638
219.809,17,2,386,2,165,219809,165,386,0,0,0,0,0
367.389,6,17,1190,13,180,30615,180,864,4,110,20059,110,326
1.572,6,50,18337,28,882,58,1360,12636,22,437,64,2715,5701
1744.706,2,30,960,30,8,60162,8,960,0,0,0,0,0
1.288,6,45,15423,24,801,56,1360,9807,21,476,55,2715,5616
217.926,17,6,528,3,48,108957,48,228,3,72,108957,72,300
258.845,6,74,8159,34,146,7843,630,3708,40,128,6636,580,4451
13.098,6,21,6825,12,275,1190,275,1038,9,1353,1008,1440,5787
0.087,17,2,142,1,35,0,35,63,1,51,0,51,79
20.866,6,24,7132,7,156,768,267,1072,17,413,1303,1452,6060
0.054,17,2,1152,1,548,0,548,576,1,548,0,548,576
1776.373,17,82,3438,81,14,22204,14,3402,1,8,0,8,36
0.25,6,21,5000,10,137,27,267,1092,11,692,24,1467,3908
249.852,6,55,6204,25,246,10410,667,2858,30,157,8615,580,3346
280.007,6,27,7312,13,158,23333,267,1317,14,775,21538,3445,5995
0.084,17,4,240,2,32,0,32,120,2,32,43,32,120
1798.959,6,356,22520,208,69,8690,69,12460,148,69,12237,69,10060
0.792,6,17,5164,9,150,99,174,664,8,835,98,1452,4500
79.479,6,38,8682,18,447,509,1025,2129,20,441,4175,1360,6553
282.107,6,67,8388,30,205,9727,698,3909,37,148,7836,580,4479
240.199,6,53,17947,30,757,8282,1402,15218,23,190,10917,580,2729
1782.841,6,356,22520,208,69,8612,69,12460,148,69,12128,69,10060
0.044,17,4,284,2,32,40,32,120,2,54,41,60,164
1.481,6,40,9928,21,440,74,1360,4392,19,476,70,2715,5536
0.048,17,2,271,1,39,0,39,67,1,176,0,176,204
10.777,6,18,4266,10,275,1197,275,958,8,992,859,1440,3308
0.193,6,79,73875,26,169,7,313,2038,53,1409,3,1438,71837
1740.172,1,72,6048,0,0,0,0,0,72,56,24509,56,6048
1781.753,6,362,22898,210,69,8525,69,12678,152,69,11799,69,10220
1796.758,6,357,28143,174,366,10366,515,11762,183,39,9869,76,16381
12.604,6,1927,1719803,1210,1367,10,1380,1685433,717,421,17,1923,34370
1754.431,1,8,448,8,28,250633,28,448,0,0,0,0,0
15.852,6,33,5255,16,154,1056,722,1922,17,271,978,1402,3333
1789.152,1,284,15904,284,28,6322,28,15904,0,0,0,0,0
0.001,6,3,2880,1,0,0,0,40,2,1368,0,1368,2840
1763.467,2,15,480,15,8,125961,8,480,0,0,0,0,0
15.468,6,16,3262,9,210,1928,210,908,7,664,2515,904,2354
66.557,6,20,8238,11,525,90,1236,2047,9,1163,8295,3151,6191
111.801,6,40,8793,19,412,705,889,2076,21,391,5583,3488,6717
14.817,6,16,1327,8,222,2115,222,768,8,231,2115,231,559
0.054,17,4,420,2,33,0,33,122,2,121,39,145,298
1797.516,6,367,25650,214,99,8439,469,15045,153,69,11823,69,10605
5.608,6,17,6095,6,186,1120,267,621,11,718,559,1420,5474
1738.99,6,91,6604,59,31,29982,31,3998,32,31,56095,31,2606
7.423,17,3,228,3,48,3711,48,228,0,0,0,0,0
0.371,6,26,9017,13,261,30,683,1728,13,943,30,1408,7289
11.377,6,27,11433,13,275,948,275,1078,14,1087,844,1440,10355
299.69,6,6,364,4,31,99896,31,222,2,31,299559,31,142
0.552,17,2,136,1,32,0,32,60,1,48,0,48,76
1785.035,6,356,22520,208,69,8623,69,12460,148,69,12143,69,10060
0.885,6,11,1727,7,100,147,100,384,4,589,209,1152,1343
60.547,6,140,12264,124,134,492,174,5768,16,585,3815,1452,6496
280.358,6,30,7432,13,158,23363,267,1317,17,543,17514,1400,6115
0.079,17,2,408,1,39,0,39,67,1,313,0,313,341
1786.615,6,103,8404,68,66,26665,66,4964,35,60,52544,60,3440
3.149,17,3,228,2,48,3032,48,152,1,48,0,48,76
217.07,17,4,240,2,32,217069,32,120,2,32,217069,32,120
9.973,17,4,766,2,47,9962,47,150,2,280,9940,280,616
1.03,6,28,8263,14,270,65,561,1945,14,820,64,1440,6318
1788.847,6,373,23614,214,69,8398,69,13114,159,69,11318,69,10500
1.273,6,47,16542,25,821,53,1360,10886,22,433,52,1360,5656
655.235,6,84,11229,43,92,15600,721,3759,41,291,16375,2840,7470
1792.696,17,156,9984,156,36,11565,36,9984,0,0,0,0,0
263.673,6,258,40667,141,304,1883,304,28276,117,83,2261,83,12391
48.345,6,8,432,5,0,12086,0,268,3,0,23973,0,164
995.334,17,10,1040,10,76,110592,346,1040,0,0,0,0,0
223.046,6,31,7483,14,140,17156,267,1553,17,475,13939,1460,5930
57.537,17,12,1056,6,48,11506,48,456,6,72,11504,72,600
0.03,17,4,352,2,60,29,60,176,2,60,28,60,176
0.102,17,2,389,1,34,0,34,62,1,299,0,299,327
0.13,6,11,913,6,182,26,182,490,5,77,22,134,423
1756.191,6,108,6426,60,27,29765,27,3525,48,27,37364,27,2901
1771.426,6,105,9828,68,66,26439,66,5792,37,60,49203,60,4036
246.532,6,31,8912,14,158,18964,267,1357,17,687,15397,2036,7555
65.384,6,18,6682,5,156,2341,267,678,13,607,5448,2840,6004
21.56,1,5,639,5,99,5390,117,639,0,0,0,0,0
1658.53,1,7,392,7,28,276421,28,392,0,0,0,0,0
1.724,6,26,10575,13,164,129,267,1396,13,1213,128,3819,9179
1793.801,17,66,2766,65,14,28028,14,2730,1,8,0,8,36
316.028,6,19,1628,3,112,158014,112,240,16,77,21067,90,1388
1.962,6,18,3257,10,99,198,182,924,8,477,254,1343,2333
61.329,6,37,15941,22,801,2920,1448,9163,15,665,4361,1448,6778
0.48,6,23,7307,12,318,42,600,1906,11,964,46,1471,5401
1.914,6,27,10185,16,286,127,590,1502,11,1029,171,1420,8683
1756.056,6,105,6258,60,26,29762,27,3519,45,26,39909,27,2739
0.082,17,2,702,2,323,82,329,702,0,0,0,0,0
280.752,6,29,7392,13,158,23396,267,1317,16,603,18701,2076,6075
0.015,17,2,439,1,33,0,33,61,1,350,0,350,378
22.906,1,4,224,4,28,7635,28,224,0,0,0,0,0
0.17,6,2,1288,1,1208,0,1208,1248,1,0,0,0,40
5.007,6,39,7269,20,218,263,314,3423,19,513,264,1179,3846
0.44,6,5,284,1,0,0,0,52,4,0,146,0,232
31.887,6,9,396,2,0,3390,0,88,7,0,5300,0,308
0.845,6,11,1727,7,100,140,100,384,4,589,200,1152,1343
1776.28,17,73,3060,72,14,25018,14,3024,1,8,0,8,36
1.974,6,46,15241,23,781,89,1440,9545,23,433,81,1440,5696
0.862,6,10,1687,7,100,143,100,384,3,1179,305,1179,1303
1796.647,6,418,25064,209,69,8637,69,12500,209,34,8637,64,12564
270.283,17,4,670,2,31,270272,33,118,2,248,270268,262,552
3.966,17,10,900,5,30,980,30,290,5,94,983,94,610
1.836,17,2,1430,2,687,1836,687,1430,0,0,0,0,0
138.125,6,24,8742,12,666,80,1460,3176,12,845,12541,1547,5566
10.156,6,1587,1391009,985,1359,10,1420,1362518,602,427,16,1420,28491
272.716,6,28,7352,13,158,22726,267,1317,15,603,19474,2076,6035
5.311,6,44,8369,23,227,241,314,4102,21,489,252,1179,4267
0.108,6,10,1495,5,507,27,507,727,5,556,27,556,768
1740.717,17,30,7050,30,207,60024,207,7050,0,0,0,0,0
1741.106,6,87,6322,58,31,30545,31,3915,29,31,62182,31,2407
4.413,17,33,21419,20,899,231,1350,18541,13,193,364,1350,2878
4.998,17,4,530,2,36,4993,36,128,2,173,4992,187,402
0.02,6,12,3644,6,99,3,99,419,6,968,3,1448,3225
39.16,6,11,2997,5,92,9790,92,348,6,1162,7792,1408,2649
15.399,6,27,4852,12,256,1399,722,1645,15,342,1076,1448,3207
92.355,1,21,588,21,0,0,0,588,0,0,0,0,0
11.948,6,1889,1653579,1147,1387,10,1420,1619678,742,467,16,1883,33901
280.297,6,29,7392,14,158,21561,267,1357,15,678,20018,3436,6035
10.196,6,82,24565,41,552,254,1152,18784,41,459,248,1179,5781
2.361,6,14,2309,8,288,333,288,1204,6,426,433,434,1105
56.253,6,17,3632,5,256,14063,256,716,12,304,5102,304,2916
312.447,6,23,2585,7,242,52073,517,1111,16,323,20829,499,1474
4.998,17,4,558,2,36,4992,36,128,2,187,4993,187,430
0.398,6,29,7088,17,244,24,656,2394,12,701,35,1728,4694
1797.0,1,345,28980,345,56,5223,56,28980,0,0,0,0,0
356.083,6,17,1190,13,180,29673,180,864,4,110,20083,110,326
1791.303,6,356,22520,208,69,8653,69,12460,148,69,12185,69,10060
27.021,6,2276,2113765,1388,1438,19,1448,2058933,888,776,30,1448,54832
3.127,6,10,1102,6,483,625,483,803,4,83,1040,83,299
0.239,6,19,4920,10,137,26,267,1092,9,866,28,2867,3828
19.26,6,38,8678,18,410,505,882,1994,20,419,1007,1360,6684
2.508,6,2,88,2,0,0,0,88,0,0,0,0,0
0.107,6,10,1514,5,503,26,503,771,5,475,26,475,743
0.116,6,9,1346,5,145,29,145,349,4,833,33,833,997
1772.746,6,285,34355,117,134,15281,1360,16645,168,130,10614,2720,17710
1.352,6,50,19195,27,884,52,1360,13499,23,433,53,1360,5696
0.839,17,2,784,2,364,839,364,784,0,0,0,0,0
1.326,6,41,11964,22,612,63,1360,6428,19,433,64,1360,5536
1772.926,6,180,15480,120,69,14898,69,8940,60,69,30047,69,6540
128.76,6,20,6963,8,147,18394,267,1359,12,730,781,1917,5604
110.153,6,21,1346,9,46,13768,46,590,12,46,10013,46,756
1.119,6,25,8056,12,164,86,267,1288,13,869,79,1402,6768
1636.709,1,7,742,7,78,272784,78,742,0,0,0,0,0
2.044,17,4,580,2,40,2012,40,136,2,194,2012,194,444
1.475,6,38,8252,19,320,81,1162,2716,19,433,72,1360,5536
221.866,17,4,304,2,48,221865,64,152,2,48,221865,64,152
5.942,2,2,64,2,8,5942,8,64,0,0,0,0,0
285.88,6,27,2905,14,324,21987,585,1385,13,282,23819,580,1520
280.166,6,26,7272,12,158,25469,267,1277,14,775,21550,2800,5995
120.302,2,2,64,2,8,120302,8,64,0,0,0,0,0
1773.509,1,67,5628,67,56,26871,56,5628,0,0,0,0,0
1747.247,6,111,8756,71,48,24960,205,5354,40,34,44788,98,3402
0.075,6,9,1346,5,145,18,145,349,4,833,20,833,997
0.174,6,9,1002,5,213,43,213,417,4,421,40,421,585
836.748,2,6,192,6,8,167349,8,192,0,0,0,0,0
1785.811,6,102,8296,68,65,26653,65,4930,34,59,54112,59,3366
8.136,6,79,24914,41,568,203,1152,19253,38,459,213,1179,5661
1794.621,17,80,3354,79,14,23007,14,3318,1,8,0,8,36
55.159,6,27,7177,13,155,4596,267,1306,14,530,4242,3417,5871
0.144,17,2,198,1,37,0,37,65,1,105,0,105,133
60.082,17,28,2323,26,30,2403,37,1515,2,376,352,463,808
102.651,6,36,23951,19,840,34,1360,5835,17,1742,6407,5438,18116
12.427,6,13,2133,8,324,1775,585,1073,5,396,3052,580,1060
0.023,17,4,352,2,37,13,37,130,2,83,12,89,222
1.467,6,46,18580,26,917,58,1460,13004,20,476,66,2615,5576
13.529,6,26,4213,14,234,1040,564,1704,12,463,1110,1343,2509
0.129,6,11,3653,6,171,25,171,491,5,1447,31,2676,3162
0.02,6,14,5639,8,134,2,134,474,6,2456,4,3453,5165
1743.275,6,95,7203,63,38,28117,205,4476,32,33,56224,98,2727
1.981,6,27,10214,16,286,132,592,1504,11,1033,179,1412,8710
0.455,6,9,1346,5,145,113,145,349,4,833,91,833,997
15.195,17,18,12315,11,892,1516,1350,10127,7,284,2527,1350,2188
2.972,17,4,424,2,46,2970,46,148,2,110,2970,110,276
0.095,6,10,1495,5,507,23,507,727,5,556,23,556,768
1.05,17,2,134,2,39,1050,39,134,0,0,0,0,0
937.857,6,19,2485,14,103,70153,138,2009,5,69,2944,69,476
1.954,17,22,5709,22,231,93,389,5709,0,0,0,0,0
0.027,17,2,118,1,31,0,31,59,1,31,0,31,59
0.348,6,23,7268,11,257,33,748,1611,12,837,30,1418,5657
235.426,17,4,352,2,60,235425,60,176,2,60,235425,60,176
1795.19,17,449,39928,404,35,4454,288,25708,45,288,40017,288,14220
38.521,17,22,1936,11,48,3851,48,836,11,72,3850,72,1100
1771.396,6,110,10179,71,65,25305,65,6003,39,59,46612,59,4176
1.367,6,46,18124,26,882,54,1460,12548,20,476,62,2615,5576
1.358,6,48,18915,27,870,52,1360,13299,21,476,59,2715,5616
1740.536,17,30,20190,30,645,60018,645,20190,0,0,0,0,0
1791.683,6,329,25039,161,195,11196,515,10075,168,39,10725,76,14964
0.57,6,24,7503,14,275,43,674,2115,10,1212,58,1946,5388
1750.565,6,100,7539,63,38,28234,205,4488,37,33,48615,98,3051
1781.143,17,142,11360,71,48,25444,48,5396,71,56,25444,56,5964
1.474,6,25,8056,12,164,113,267,1288,13,869,103,1448,6768
0.146,6,2,1193,2,1113,146,1113,1193,0,0,0,0,0
1743.655,6,95,7203,63,38,28123,205,4476,32,33,56237,98,2727
280.454,6,31,7813,13,158,23371,267,1317,18,524,16496,1400,6496
57.937,2,4,128,4,8,19312,8,128,0,0,0,0,0
245.399,17,4,352,2,60,245398,60,176,2,60,245398,60,176
1791.03,6,356,22520,208,69,8652,69,12460,148,69,12181,69,10060
92.902,6,9,597,4,31,30967,31,239,5,31,23154,31,358
0.151,17,2,241,1,36,0,36,64,1,149,0,149,177
1787.906,6,364,23047,210,69,8554,69,12747,154,69,11685,69,10300
33.734,6,30,5066,15,154,2409,721,1882,15,400,2394,2026,3184
0.06,6,14,4334,7,111,9,111,483,7,869,10,1448,3851
300.926,6,38,8434,21,271,15046,739,1970,17,481,547,3388,6464
20.463,6,6,328,4,0,6821,0,216,2,0,20442,0,112
1755.837,6,96,7255,62,38,28784,205,4424,34,33,53198,98,2831
591.629,17,171,21458,82,151,7303,1350,14713,89,47,6722,1350,6745
240.156,6,54,17321,29,721,8576,1408,14508,25,188,10006,580,2813
1798.248,17,449,39928,404,35,4462,288,25708,45,288,40021,288,14220
1787.098,6,108,8536,68,65,26673,65,4930,40,59,45818,59,3606
169.45,17,4,352,2,60,169449,60,176,2,60,169449,60,176
240.32,6,60,18495,29,757,8582,1418,15145,31,216,8010,580,3350
1081.426,6,111,9546,74,69,14814,69,5513,37,69,30032,69,4033
0.778,17,4,947,2,33,765,37,123,2,384,768,463,824
1792.844,17,87,3648,86,14,21092,14,3612,1,8,0,8,36
158.001,1,2,112,2,28,158001,28,112,0,0,0,0,0
1787.588,6,357,22629,208,69,8635,69,12460,149,69,12076,69,10169
1771.144,6,99,9306,66,66,27248,66,5610,33,60,55345,60,3696
5.785,6,56,19829,28,847,214,1440,13861,28,433,206,1440,5968
0.036,6,4,239,2,0,3,0,104,2,31,0,31,135
1.151,17,28,10182,12,360,102,1350,4660,16,317,74,1350,5522
85.52,6,12,3906,12,298,7774,393,3906,0,0,0,0,0
426.702,1,9,504,9,28,53337,28,504,0,0,0,0,0
1.512,6,47,20046,27,954,58,1460,14470,20,476,69,2615,5576
1754.207,6,184,11097,92,45,19277,208,6518,92,31,19274,31,4579
0.032,17,2,456,1,60,0,60,88,1,340,0,340,368
1797.914,17,449,39928,404,35,4461,288,25708,45,288,40020,288,14220
0.858,6,20,5984,11,282,85,548,1292,9,721,95,1452,4692
4.409,6,12,568,6,0,881,0,280,6,0,600,0,288
0.027,6,12,3462,6,75,5,75,395,6,1373,5,1448,3067
188.253,6,32,8952,14,158,14481,267,1357,18,624,11063,1400,7595
240.201,6,54,17930,29,788,8578,1402,14924,25,212,10008,580,3006
6.859,17,4,240,2,32,6858,32,120,2,32,6858,32,120
31.546,6,7,308,1,0,0,0,44,6,0,6292,0,264
1790.739,17,144,11520,72,48,25221,48,5472,72,56,25221,56,6048
47.017,6,13,760,5,0,11754,0,280,8,0,6714,0,480
1790.519,6,356,22520,208,69,8649,69,12460,148,69,12180,69,10060
1794.727,17,140,11200,70,48,26010,48,5320,70,56,26010,56,5880
1647.708,1,8,448,8,28,235386,28,448,0,0,0,0,0
1.119,6,24,8004,12,164,87,267,1288,12,1014,86,2423,6716
1799.695,1,192,10752,192,28,9422,28,10752,0,0,0,0,0
0.397,17,4,624,2,64,395,64,184,2,192,275,192,440
1266.481,1,42,3528,0,0,0,0,0,42,56,30889,56,3528
1792.098,17,142,11360,71,48,25600,48,5396,71,56,25600,56,5964
1773.411,6,180,15480,120,69,14902,69,8940,60,69,30050,69,6540
150.922,6,24,10761,13,746,57,1460,3537,11,1128,15077,2380,7224
1771.096,6,103,9514,66,66,27247,66,5610,37,60,49193,60,3904
0.086,17,2,323,1,33,0,33,61,1,234,0,234,262
29.751,17,27,17670,11,588,2967,1350,6783,16,652,1978,1350,10887
0.204,17,2,152,1,48,0,48,76,1,48,0,48,76
1.337,6,40,10403,21,499,66,1360,4867,19,476,64,2715,5536
11.461,6,2342,2252114,1541,1385,7,1408,2205798,801,931,14,2801,46316
49.938,6,45,12388,19,390,451,1173,5064,26,330,1997,2006,7324
67.836,1,4,224,4,28,22612,28,224,0,0,0,0,0
31.629,6,7,308,1,0,0,0,44,6,0,6277,0,264
108.024,17,4,1344,4,308,36008,308,1344,0,0,0,0,0
0.867,6,31,13360,17,511,54,1360,3279,14,1056,54,2561,10081
1673.366,2,11,352,11,8,167336,8,352,0,0,0,0,0
130.467,6,22,8764,11,314,77,634,1427,11,983,13031,1360,7337
1776.187,17,73,3060,72,14,25016,14,3024,1,8,0,8,36
235.267,1,4,224,4,28,78422,28,224,0,0,0,0,0
5.283,6,39,17919,21,934,264,1460,11167,18,752,297,1460,6752
1794.653,6,251,37065,155,302,11653,302,26820,96,83,18891,83,10245
10.303,17,2,152,2,48,10303,48,152,0,0,0,0,0
5.017,17,4,288,2,36,5002,36,128,2,52,4994,52,160
1786.739,6,106,8524,68,66,26667,66,4964,38,60,48287,60,3560
1.063,6,6,328,4,0,354,0,216,2,0,1024,0,112
0.002,6,3,128,2,0,1,0,88,1,0,0,0,40
0.036,17,4,1148,2,32,22,32,120,2,486,22,486,1028
26.087,6,56,19737,26,347,1036,1194,3301,30,843,893,1440,16436
0.542,6,21,7334,9,278,67,813,1600,12,850,48,2372,5734
259.046,17,6,2000,6,305,51809,308,2000,0,0,0,0,0
18.43,17,4,352,2,60,18429,60,176,2,60,18429,60,176
1.084,6,39,14191,24,681,47,1188,10102,15,550,70,1048,4089
4.798,6,39,7269,19,218,266,314,3383,20,513,237,1179,3886
368.884,6,23,1535,16,177,24592,177,1053,7,110,10378,110,482
109.5,6,29,7830,8,141,6068,267,1175,21,341,5474,3417,6655
1770.718,1,67,5628,67,56,26829,56,5628,0,0,0,0,0
1773.234,6,180,15480,120,69,14901,69,8940,60,69,30050,69,6540
280.602,6,30,7432,13,158,23383,267,1317,17,543,17530,1400,6115
1740.113,6,87,6322,58,31,30528,31,3915,29,31,62146,31,2407
0.025,17,2,227,1,44,0,44,72,1,127,0,127,155
1798.596,6,367,25719,213,99,8483,469,15005,154,69,11752,69,10714
4.272,6,23,6464,11,262,422,517,1368,12,744,384,1418,5096
1795.024,1,240,25440,240,78,7510,78,25440,0,0,0,0,0
756.552,2,5,160,5,8,189138,8,160,0,0,0,0,0
5.022,17,4,824,2,33,5004,33,122,2,323,5000,323,702
1786.266,17,87,3648,86,14,21014,14,3612,1,8,0,8,36
125.169,17,4,352,2,60,125168,60,176,2,60,125168,60,176
468.854,6,79,20104,40,354,12021,1360,10149,39,335,12334,1360,9955
1797.1,17,435,36356,401,35,4492,288,25612,34,288,53362,288,10744
1745.564,6,95,7203,63,38,28154,205,4476,32,33,56296,98,2727
2.264,6,24,6466,13,313,167,906,2092,11,786,205,1460,4374
16.073,17,21,13720,12,814,1457,1350,10104,9,373,2004,1350,3616
0.062,1,2,112,2,28,62,28,112,0,0,0,0,0
1679.555,17,12,498,11,14,167955,14,462,1,8,0,8,36
280.423,6,28,7352,13,158,23368,267,1317,15,775,20026,3465,6035
0.139,17,2,152,1,48,0,48,76,1,48,0,48,76
1.684,6,14,2351,8,188,240,245,700,6,703,286,1152,1651
240.31,6,43,8812,21,524,12014,1418,5817,22,204,11442,618,2995
1.278,6,10,1687,7,100,213,100,384,3,1179,514,1179,1303
4.004,17,3,201,3,39,2002,39,201,0,0,0,0,0
612.604,6,159,31707,85,363,7292,815,19374,74,197,8390,1448,12333
0.054,17,4,857,2,45,0,45,146,2,327,8,339,711
1787.688,17,87,3648,86,14,21031,14,3612,1,8,0,8,36
1.175,6,23,7952,12,164,91,267,1288,11,1216,100,3819,6664
0.967,6,22,5489,12,140,87,267,1184,10,780,97,1460,4305
1.865,17,2,134,2,39,1865,39,134,0,0,0,0,0
1777.234,1,192,10752,192,28,9304,28,10752,0,0,0,0,0
1.037,6,29,8925,15,514,74,1445,2703,14,627,64,1460,6222
1791.273,17,144,11520,72,48,25228,48,5472,72,56,25229,56,6048
280.202,6,28,7352,13,158,23350,267,1317,15,678,20005,2045,6035
154.568,6,61,12371,23,260,7025,961,3856,38,323,4173,896,8515
1.706,6,24,6636,13,350,141,1089,2276,11,783,169,1420,4360
1709.697,17,12,498,11,14,170969,14,462,1,8,0,8,36
1760.598,1,56,4704,0,0,0,0,0,56,56,32010,56,4704
53.66,6,52,15925,22,951,51,1440,9477,30,249,1844,1440,6448
1792.316,1,57,4788,57,56,32005,56,4788,0,0,0,0,0
2.487,6,7,380,4,0,829,0,216,3,0,1237,0,164
0.767,6,9,1002,5,213,191,213,417,4,421,172,421,585
1.98,6,26,7775,14,268,151,679,1905,12,897,179,1731,5870
0.189,6,36,26466,19,185,10,524,1912,17,1690,11,4206,24554
1786.536,6,104,8444,68,66,26664,66,4964,36,60,51041,60,3480
12.15,17,4,352,2,60,12149,60,176,2,60,12148,60,176
369.663,6,18,1242,14,180,28435,180,916,4,110,20060,110,326
32.139,6,9,396,2,0,3552,0,88,7,0,5344,0,308
612.506,17,32,4912,16,40,40832,43,1094,16,210,40832,249,3818
1740.46,17,30,7050,30,207,60015,207,7050,0,0,0,0,0
5.005,17,4,288,2,36,5004,36,128,2,52,5003,52,160
1787.924,6,372,24057,209,69,8595,69,12638,163,69,11036,69,11419
1634.881,1,14,784,14,28,125760,28,784,0,0,0,0,0
1739.352,6,87,6322,58,31,30514,31,3915,29,31,62118,31,2407
10.989,6,18,6775,10,275,1221,275,683,8,1440,854,1440,6092
0.908,6,30,8540,15,222,54,540,1964,15,852,53,1360,6576
3.362,17,10,2463,5,40,838,40,340,5,396,838,407,2123
0.193,17,2,2754,2,1349,193,1349,2754,0,0,0,0,0
25.186,6,45,10243,23,539,456,921,3157,22,412,1193,4848,7086
0.825,6,10,923,6,304,165,304,624,4,83,271,83,299
61.827,6,73,49190,45,1171,1405,1408,41003,28,960,2281,2816,8187
1799.286,17,142,11360,71,48,25703,48,5396,71,56,25703,56,5964
15.653,6,8,460,3,0,7826,0,160,5,0,2038,0,300
701.685,1,20,1120,20,28,36930,28,1120,0,0,0,0,0
1789.772,6,361,22858,210,69,8563,69,12678,151,69,11931,69,10180
280.413,6,28,7352,12,158,25492,267,1277,16,678,18691,2085,6075
0.154,17,2,279,1,36,0,36,64,1,187,0,187,215
1786.794,6,102,8296,68,65,26668,65,4930,34,59,54142,59,3366
1773.496,6,180,15480,120,69,14903,69,8940,60,69,30051,69,6540
0.3,6,10,1671,6,552,59,948,1348,4,159,99,159,323
13.679,6,27,4866,13,154,1121,722,1766,14,394,1038,1402,3100
0.966,17,4,368,2,32,820,32,120,2,96,769,96,248
1716.364,6,345,23018,197,83,8756,469,12820,148,69,11675,69,10198
1757.997,1,9,964,9,79,219749,88,964,0,0,0,0,0
1.325,6,24,8004,12,164,102,267,1288,12,1014,103,2491,6716
1783.554,6,356,22520,208,69,8616,69,12460,148,69,12131,69,10060
1796.781,1,345,28980,345,56,5223,56,28980,0,0,0,0,0
4.532,6,40,7309,19,218,251,314,3383,21,440,213,1152,3926
0.849,6,11,1727,7,100,141,100,384,4,589,201,1152,1343
0.154,17,2,166,1,39,0,39,67,1,71,0,71,99
0.106,17,2,152,1,48,0,48,76,1,48,0,48,76
0.082,6,10,1671,6,552,16,948,1348,4,159,26,159,323
367.14,6,26,1691,16,177,24476,177,1053,10,110,8512,110,638
5.602,6,31,5935,16,111,373,267,1430,15,780,369,1531,4505
38.104,6,36,8432,20,402,2005,891,2038,16,522,571,3488,6394
3.458,17,10,1415,5,31,861,31,295,5,196,858,196,1120
672.176,6,58,12959,26,153,26881,457,1991,32,691,21678,1702,10968
1790.214,17,87,3648,86,14,21061,14,3612,1,8,0,8,36
31.251,17,18,1368,18,48,1838,48,1368,0,0,0,0,0
0.283,17,2,167,1,39,0,39,67,1,72,0,72,100
0.631,6,23,7418,13,335,52,668,2038,10,968,64,1475,5380
109.691,17,4,352,2,60,109690,60,176,2,60,109690,60,176
11.605,6,43,12968,20,241,610,721,2495,23,636,480,1414,10473
11.519,6,1854,1586225,1119,1364,10,1380,1552427,735,421,15,1923,33798
218.156,6,30,7432,13,158,18179,267,1317,17,543,13630,1400,6115
0.016,17,2,427,1,47,0,47,75,1,324,0,324,352
0.433,6,26,8868,13,227,36,547,1592,13,941,35,1408,7276
240.24,6,62,18524,32,697,7749,1402,14915,30,170,8283,580,3609
1796.192,17,448,39896,403,35,4468,288,25676,45,288,40020,288,14220
0.825,6,23,6168,13,264,68,662,1848,10,979,90,1731,4320
311.993,6,23,5479,9,133,38998,159,887,14,967,23999,2816,4592
10.608,6,1540,1435235,992,1371,10,1408,1402075,548,776,19,1408,33160
60.53,6,42,8670,21,371,453,797,2033,21,413,3019,1360,6637
4.763,6,41,7349,21,218,238,314,3463,20,440,237,1152,3886
4.919,6,41,7365,21,218,245,314,3463,20,442,244,1152,3902
1786.515,6,104,8266,68,63,26664,64,4875,36,57,51040,58,3391
131.87,6,23,6676,6,154,26374,267,712,17,479,8217,1460,5964
1795.364,1,58,4872,0,0,0,0,0,58,56,31497,56,4872
241.614,17,776,145370,538,157,449,172,99966,238,162,268,172,45404
375.915,6,18,1242,14,180,28916,180,916,4,110,20061,110,326
0.088,17,4,284,2,32,29,32,120,2,54,60,60,164
1759.597,1,44,5239,44,91,40920,125,5239,0,0,0,0,0
208.937,6,31,8912,14,158,16072,267,1357,17,687,13056,2036,7555
1.582,6,52,19491,29,896,56,1360,13750,23,400,63,1360,5741
3.71,6,14,2351,8,188,530,245,700,6,703,690,1152,1651
0.038,17,2,235,1,36,0,36,64,1,143,0,143,171
0.001,17,2,188,1,58,0,58,86,1,74,0,74,102
1772.573,6,180,15480,120,69,14895,69,8940,60,69,30042,69,6540
240.174,6,55,18003,28,803,8895,1402,15118,27,184,9237,580,2885
1798.056,6,21,1274,14,31,138312,31,777,7,31,299672,31,497
6.009,17,4,724,2,41,6000,41,138,2,265,6000,265,586
1770.741,6,116,10712,73,66,24593,66,6220,43,60,42158,60,4492
1774.242,6,209,24139,133,89,13441,981,11227,76,138,23654,1926,12912
0.304,6,26,8890,13,232,25,569,1614,13,1098,24,2804,7276
20.979,17,8,1864,8,205,2997,205,1864,0,0,0,0,0
217.235,17,4,352,2,60,217234,60,176,2,60,217234,60,176
1629.119,1,8,448,8,28,232731,28,448,0,0,0,0,0
1798.202,1,345,28980,345,56,5227,56,28980,0,0,0,0,0
300.271,6,33,11958,18,588,17663,1438,4500,15,833,17179,1488,7458
0.013,17,2,376,1,36,0,36,64,1,284,0,284,312
0.873,17,2,122,2,33,873,33,122,0,0,0,0,0
1740.629,1,8,448,8,28,248661,28,448,0,0,0,0,0
1795.783,6,465,26880,257,69,7014,69,14420,208,34,8675,64,12460
1785.88,6,104,8376,68,65,26654,65,4930,36,59,51021,59,3446
1.4,6,53,19535,29,896,50,1440,13754,24,400,53,1440,5781
0.206,17,2,154,1,33,0,33,61,1,65,0,65,93
132.409,17,2,152,2,48,132409,48,152,0,0,0,0,0
1789.962,6,428,26012,228,69,7884,69,13467,200,42,8994,69,12545
0.004,17,2,912,1,308,0,308,336,1,548,0,548,576
3.366,6,2,88,2,0,0,0,88,0,0,0,0,0
2.932,6,13,2311,8,188,418,245,700,5,1407,672,1407,1611
21.015,17,2,84,2,14,21015,14,84,0,0,0,0,0
1799.344,17,448,39896,403,35,4475,288,25676,45,288,40020,288,14220
88.228,6,21,4835,7,352,14704,722,1417,14,298,6772,1408,3418
1.775,17,3,1480,1,300,0,300,328,2,548,100,548,1152
1786.095,6,106,8584,69,66,26266,66,5004,37,60,49611,60,3580
581.114,1,20,1120,20,28,30584,28,1120,0,0,0,0,0
0.397,6,7,295,4,0,132,0,164,3,7,93,7,131
0.258,17,2,193,1,43,0,43,71,1,94,0,94,122
280.644,6,32,7853,14,158,21588,267,1357,18,524,16507,1400,6496
1.713,6,39,11816,23,597,77,1188,7769,16,356,39,758,4047
1774.372,6,180,15480,120,69,14910,69,8940,60,69,30069,69,6540
164.661,1,20,1680,20,56,8666,56,1680,0,0,0,0,0
1.632,6,12,2271,7,188,272,245,660,5,1407,346,1407,1611
329.909,1,8,725,8,62,47129,85,725,0,0,0,0,0
13.717,6,13,3316,3,92,6858,92,244,10,318,1501,1408,3072
0.595,6,14,1745,7,288,68,288,600,7,426,68,434,1145
1.573,6,13,2311,8,188,224,245,700,5,1407,327,1407,1611
219.437,6,35,7123,19,143,12190,516,1910,16,415,14622,1452,5213
132.074,17,4,558,2,36,132068,36,128,2,187,132069,187,430
178.101,6,30,8019,12,217,5101,502,1352,18,396,10470,1420,6667
0.233,6,25,4623,12,165,21,456,1446,13,415,18,888,3177
499.432,17,18,7032,18,362,29378,648,7032,0,0,0,0,0
0.456,6,22,7368,13,337,38,674,2032,9,1212,52,1946,5336
1771.835,6,180,15480,120,69,14889,69,8940,60,69,30030,69,6540
1.042,6,108,87477,49,131,21,232,2489,59,1558,17,5440,84988
35.538,6,29,14286,9,333,4423,514,1726,20,902,1862,1696,12560
1795.656,17,447,39864,402,35,4477,288,25644,45,288,40017,288,14220
1.221,6,25,8056,12,164,94,267,1288,13,869,86,1440,6768
1750.252,17,12,498,11,14,175025,14,462,1,8,0,8,36
43.03,17,4,352,2,60,43029,60,176,2,60,43028,60,176
1770.408,6,99,9240,66,65,27237,65,5577,33,59,55322,59,3663
2.087,6,11,1727,7,100,347,100,384,4,1179,497,1179,1343
0.0,17,1,362,1,334,0,334,362,0,0,0,0,0
15.107,17,16,9889,8,388,2152,1350,3335,8,791,2152,1350,6554
9.094,17,8,664,4,47,3029,47,300,4,63,3029,63,364
1.147,6,25,8080,12,164,89,267,1312,13,869,81,1408,6768
0.312,6,26,8890,13,232,26,569,1614,13,1098,25,2804,7276
266.791,6,46,20896,25,744,11116,1408,7253,21,1140,13339,1655,13643
1777.598,17,285,83630,285,265,6259,422,83630,0,0,0,0,0
1795.946,17,449,39928,404,35,4456,288,25708,45,288,40017,288,14220
9.711,6,14,3898,3,106,4850,106,234,11,533,970,1420,3664
3.621,6,55,22560,29,958,129,1440,16538,26,355,120,1440,6022
1776.396,17,138,11040,69,48,26123,48,5244,69,56,26123,56,5796
2.318,6,4,220,2,0,2318,0,100,2,0,1033,0,120
1745.092,6,99,7442,64,38,27699,205,4528,35,33,51318,98,2914
0.207,6,46,20454,26,1026,8,1420,15433,20,467,10,1883,5021
228.021,6,16,3582,4,92,1772,92,308,12,264,20712,1408,3274
69.414,6,64,44567,43,1149,1652,1408,36742,21,960,3078,3847,7825
1794.908,17,142,11360,71,48,25641,48,5396,71,56,25641,56,5964
0.784,6,44,25061,21,689,39,1440,5700,23,1084,29,1440,19361
1799.727,6,356,22520,208,69,8694,69,12460,148,69,12242,69,10060
12.099,6,25,7103,12,156,1099,267,1272,13,589,1007,3426,5831
1771.279,6,106,9604,66,65,27250,65,5577,40,59,45415,59,4027
17.722,17,28,10745,14,361,1360,1350,5453,14,350,1360,1350,5292
3.937,17,2,152,2,48,3937,48,152,0,0,0,0,0
1624.321,2,17,544,17,8,101520,8,544,0,0,0,0,0
0.135,6,10,1380,6,145,27,145,389,4,827,41,827,991
1788.411,6,360,22818,210,69,8556,69,12678,150,69,12002,69,10140
0.254,17,2,572,1,39,0,39,67,1,477,0,477,505
39.201,17,22,1936,11,48,3919,48,836,11,72,3919,72,1100
1794.652,17,768,46308,768,32,2339,37,46308,0,0,0,0,0
1.044,17,8,1360,4,33,335,33,244,4,251,345,323,1116
1787.238,6,125,14099,80,82,22623,516,6330,45,156,40616,1452,7769
0.552,6,58,24137,33,968,17,1380,16915,25,515,20,1923,7222
0.014,17,2,354,1,36,0,36,64,1,262,0,262,290
1797.269,17,87,3648,86,14,21144,14,3612,1,8,0,8,36
1.165,6,24,8004,12,164,89,267,1288,12,1014,89,2411,6716
527.003,6,65,4645,24,58,21608,295,2068,41,46,13175,78,2577
0.142,17,2,144,1,36,0,36,64,1,52,0,52,80
159.519,6,25,9908,12,549,61,1460,2709,13,952,13282,1460,7199
0.208,17,8,2758,8,316,29,355,2758,0,0,0,0,0
1785.857,6,370,25839,214,99,8384,469,15114,156,69,11521,69,10725
17.576,6,80,24485,39,552,462,1152,18704,41,459,433,1179,5781
300.121,6,33,24085,19,220,16673,392,2087,14,1932,23085,5218,21998
1781.507,6,184,15847,123,69,14602,69,9198,61,69,29685,69,6649
5.803,6,15,2399,7,188,967,245,660,8,703,789,1152,1739
1799.796,17,449,39928,404,35,4465,288,25708,45,288,40020,288,14220
1.475,6,49,19099,27,880,56,1360,13443,22,476,60,2715,5656
5.265,17,3,208,2,36,5004,36,128,1,52,0,52,80
0.004,17,2,335,1,37,0,37,65,1,242,0,242,270
624.157,6,122,7709,70,72,9045,138,4249,52,69,12238,69,3460
187.287,6,378,371548,224,1090,313,1360,42803,154,2371,1223,11462,328745
11.243,17,17,17997,17,1030,702,1451,17997,0,0,0,0,0
1776.684,6,81,4264,41,26,44415,26,2158,40,26,45554,26,2106
0.088,17,2,194,1,48,0,48,76,1,90,0,90,118
1797.96,17,449,39928,404,35,4461,288,25708,45,288,40017,288,14220
3.01,6,59,22876,33,952,94,1460,13811,26,500,104,2615,9065
2.077,6,3,120,1,0,0,0,40,2,0,1945,0,80
3.988,6,33,6129,17,206,249,314,2744,16,548,247,1179,3385
1743.498,6,95,6910,62,31,28581,31,4247,33,31,54483,31,2663
1773.114,6,180,15480,120,69,14900,69,8940,60,69,30048,69,6540
282.887,6,31,10272,12,158,25717,267,1277,19,685,15713,1400,8995
0.143,17,2,196,1,62,0,62,90,1,78,0,78,106
17.64,17,5,4401,5,852,4410,1451,4401,0,0,0,0,0
0.011,6,2,205,1,125,0,125,165,1,0,0,0,40
142.795,17,4,352,2,60,142794,60,176,2,60,142794,60,176
158.271,6,29,7392,13,158,13189,267,1317,16,603,10549,2036,6075
1788.119,17,142,11360,71,48,25544,48,5396,71,56,25544,56,5964
1772.045,6,180,15480,120,69,14891,69,8940,60,69,30031,69,6540
1782.265,17,83,3480,82,14,22003,14,3444,1,8,0,8,36
24.556,6,18,788,8,0,3508,0,348,10,0,2459,0,440
280.024,6,30,7432,13,158,23335,267,1317,17,543,17499,1400,6115
3.462,17,31,14469,14,637,266,1350,9318,17,275,212,1350,5151
1790.689,1,339,28476,339,56,5297,56,28476,0,0,0,0,0
1787.614,6,181,15589,121,69,14896,69,9049,60,69,30292,69,6540
2.008,17,6,1804,3,40,997,41,206,3,504,998,505,1598
1785.207,6,104,8444,68,66,26644,66,4964,36,60,51003,60,3480
1783.808,6,369,26130,214,105,8374,469,15445,155,69,11583,69,10685
285.082,1,4,326,4,53,95027,78,326,0,0,0,0,0
0.376,17,2,152,1,48,0,48,76,1,48,0,48,76
1668.359,1,7,392,7,28,278059,28,392,0,0,0,0,0
6.569,6,66,20622,34,559,199,1152,15915,32,427,203,1152,4707
0.993,1,5,420,5,56,248,56,420,0,0,0,0,0
1772.021,6,180,15480,120,69,14890,69,8940,60,69,30030,69,6540
0.435,6,13,1693,7,288,66,288,588,6,426,48,434,1105
0.548,1,6,2022,6,309,109,310,2022,0,0,0,0,0
31.401,6,15,5673,5,106,7847,106,314,10,823,3487,1420,5359
1798.277,17,448,39896,403,35,4473,288,25676,45,288,40019,288,14220
1740.448,1,15,840,15,28,124317,28,840,0,0,0,0,0
0.4,17,6,2075,6,317,80,355,2075,0,0,0,0,0
292.025,1,4,224,4,28,97341,28,224,0,0,0,0,0
0.325,17,2,180,1,30,0,30,58,1,94,0,94,122
1776.049,6,100,7525,65,38,27750,205,4611,35,33,52227,98,2914
1794.046,17,140,11200,70,48,26000,48,5320,70,56,26000,56,5880
3.44,6,24,6175,14,232,245,501,1725,10,809,353,1691,4450
300.784,6,38,8530,21,286,15039,797,2052,17,482,539,3488,6478
282.004,6,29,7392,13,158,23500,267,1317,16,603,18775,2036,6075
1022.786,2,10,320,10,8,113642,8,320,0,0,0,0,0
110.701,17,3460,4136697,456,62,243,1350,41485,3004,1335,36,1350,4095212
1793.345,1,69,5796,69,56,26372,56,5796,0,0,0,0,0
22.762,6,33,5563,14,180,1750,722,1806,19,230,1253,2026,3757
0.469,17,4,314,2,31,450,31,118,2,70,446,70,196
0.008,6,6,312,0,0,0,0,0,6,0,0,0,312
0.061,6,10,767,5,186,14,186,454,5,45,11,45,313
0.158,17,4,284,2,32,78,32,120,2,54,81,60,164
1743.765,6,147,9391,79,52,22355,208,5772,68,31,26021,31,3619
1740.469,1,15,840,15,28,124319,28,840,0,0,0,0,0
13.28,6,433,304501,243,1317,54,1360,286683,190,364,68,2720,17818
0.699,1,30,840,30,0,0,0,840,0,0,0,0,0
292.524,6,45,7850,21,129,14623,517,2021,24,456,12716,1418,5829
300.663,6,38,8566,20,315,15824,882,2093,18,441,499,1440,6473
1773.632,6,180,15480,120,69,14904,69,8940,60,69,30055,69,6540
1.706,6,13,2311,8,188,243,245,700,5,1407,361,1407,1611
188.52,6,7,614,6,106,37704,106,566,1,0,0,0,48
0.316,6,27,8920,13,227,26,547,1592,14,941,23,1448,7328
30.213,17,17,7540,8,606,4311,1350,5073,9,246,3772,1350,2467
1798.385,17,448,39896,403,35,4473,288,25676,45,288,40018,288,14220
1789.143,6,4012,3873578,1354,127,1322,334,78598,2658,1414,673,2836,3794980
294.512,1,4,224,4,28,98170,28,224,0,0,0,0,0
0.088,17,2,198,1,39,0,39,67,1,103,0,103,131
0.177,1,2,112,2,28,177,28,112,0,0,0,0,0
219.16,6,1190,1013536,777,1305,282,1360,985344,413,166,531,4027,28192
63.153,17,4,352,2,60,63152,60,176,2,60,63152,60,176
61.913,17,4,5504,4,1348,20637,1348,5504,0,0,0,0,0
0.053,6,12,3705,6,171,10,171,491,6,964,3,1448,3214
12.702,6,14,2245,8,211,1814,211,846,6,545,2533,904,1399
0.812,17,2,116,2,30,812,30,116,0,0,0,0,0
144.025,17,13,5072,13,362,12002,548,5072,0,0,0,0,0
0.175,1,2,112,2,28,175,28,112,0,0,0,0,0
225.835,6,25,6318,9,272,100,516,1180,16,345,15049,1452,5138
0.011,17,4,352,2,37,0,37,130,2,83,4,89,222
786.296,6,1245,1108640,464,139,1608,769,29094,781,1376,1008,2816,1079546
61.639,6,54,31060,33,1059,1926,1408,23969,21,665,3070,1408,7091
3.365,17,8,1660,4,32,1120,32,240,4,327,1120,486,1420
365.942,6,23,1535,16,177,24396,177,1053,7,110,10363,110,482
2.867,17,32,10220,15,296,202,1350,4862,17,287,177,1350,5358
1767.346,1,57,4788,57,56,31559,56,4788,0,0,0,0,0
120.849,17,6,528,3,60,60424,60,264,3,60,60424,60,264
1.648,6,25,8763,15,285,117,587,1459,10,985,164,1420,7304
0.533,6,28,9228,14,227,41,747,1875,14,943,37,1368,7353
15.142,17,20,7754,9,483,1889,1350,4603,11,258,1511,1350,3151
4.576,6,37,7189,19,218,254,314,3383,18,513,253,1179,3806
1.378,6,46,19207,27,897,53,1360,13671,19,476,64,2720,5536
208.155,6,32,8952,14,158,16011,267,1357,18,624,12240,1400,7595
3.142,6,2,88,2,0,0,0,88,0,0,0,0,0
2.237,6,9,527,5,43,559,43,311,4,0,744,0,216
1741.229,6,92,6668,60,31,29512,31,4081,32,31,56167,31,2587
206.419,17,4,240,2,32,206418,32,120,2,32,206418,32,120
1.32,6,50,16593,27,810,50,1440,10852,23,400,52,1440,5741
298.017,17,6,1990,6,303,59603,329,1990,0,0,0,0,0
290.998,6,58,15118,26,116,11638,517,2355,32,651,9385,1418,12763
351.511,6,91,11346,42,95,7412,267,3316,49,263,7322,1460,8030
2.544,6,10,1102,6,483,508,483,803,4,83,846,83,299
95.582,6,1684,1577756,1182,1339,80,1360,1547595,502,176,190,2667,30161
1.451,6,49,19839,29,926,51,1460,14218,20,480,66,4075,5621
1750.471,6,95,7203,63,38,28233,205,4476,32,33,56458,98,2727
0.262,17,2,362,1,46,0,46,74,1,260,0,260,288
0.083,17,4,352,2,37,0,37,130,2,83,0,89,222
1742.944,17,277,55864,277,173,6315,422,55864,0,0,0,0,0
3.99,17,26,6984,11,277,396,1350,3359,15,213,282,1350,3625
1776.449,6,103,8395,68,65,26514,65,4930,35,59,52245,59,3465
1679.558,17,12,498,11,14,167955,14,462,1,8,0,8,36
125.372,6,15,3197,7,92,20895,92,452,8,387,17883,1408,2745
0.178,6,2,173,1,93,0,93,133,1,0,0,0,40
0.702,6,14,2152,7,288,113,288,588,7,424,87,434,1564
240.198,6,53,19035,29,816,8578,1408,16205,24,224,10443,580,2830
1788.514,17,87,3648,86,14,21041,14,3612,1,8,0,8,36
0.214,17,4,284,2,32,1,32,120,2,54,0,60,164
1407.398,6,109,11257,62,70,21283,721,5341,47,91,30591,1448,5916
5.032,17,4,288,2,36,5005,36,128,2,52,5016,52,160
295.667,1,40,3360,40,56,7581,56,3360,0,0,0,0,0
13.725,6,27,4868,13,154,1125,722,1767,14,394,1042,1440,3101
1.646,6,48,19274,27,896,63,1360,13658,21,433,72,1360,5616
1795.587,17,448,39896,403,35,4466,288,25676,45,288,40019,288,14220
192.21,6,139,102769,86,1283,2261,1408,90476,53,680,2552,2439,12293
1793.175,17,144,11520,72,48,25251,48,5472,72,56,25255,56,6048
300.456,6,40,29177,21,190,15022,444,1861,19,1754,13577,4206,27316
300.798,6,39,9638,21,540,15039,1360,4116,18,399,507,1360,5522
15.642,6,2518,2336156,1616,1367,9,1408,2284588,902,776,17,1408,51568
0.382,6,27,9098,13,261,31,683,1728,14,829,28,1438,7370
0.171,6,12,1754,6,90,34,174,425,6,1085,34,1085,1329
134.523,6,15,2060,7,312,112,673,1238,8,245,19197,338,822
0.842,6,51,13829,24,551,36,1429,4840,27,464,31,1986,8989
1411.95,1,50,2800,50,28,28815,28,2800,0,0,0,0,0
60.071,2,2,64,2,8,60071,8,64,0,0,0,0,0
373.413,6,18,1242,14,180,28724,180,916,4,110,20066,110,326
373.981,6,21,1419,15,177,26712,177,989,6,110,12250,110,430
10.916,6,20,4402,11,275,1091,275,998,9,758,768,1420,3404
1134.253,2,9,288,9,8,141781,8,288,0,0,0,0,0
2.992,17,2,120,2,32,2992,32,120,0,0,0,0,0
369.393,6,21,1419,15,177,26385,177,989,6,110,12242,110,430
1794.871,17,420,141280,420,308,4283,548,141280,0,0,0,0,0
365.975,6,27,1767,18,177,21527,177,1181,9,110,8607,110,586
0.252,17,3,451,2,39,80,39,134,1,289,0,289,317
0.012,1,2,673,2,308,12,311,673,0,0,0,0,0
1772.071,6,180,15480,120,69,14891,69,8940,60,69,30031,69,6540
0.032,17,2,206,1,44,0,44,72,1,106,0,106,134
1792.926,17,87,3648,86,14,21093,14,3612,1,8,0,8,36
2.117,17,2,925,1,548,0,548,576,1,321,0,321,349
0.138,17,2,157,1,31,0,31,59,1,70,0,70,98
91.769,6,40,25787,19,840,39,1460,5847,21,1193,4581,1460,19940
0.156,17,6,1246,6,179,31,219,1246,0,0,0,0,0
1797.128,6,752,50952,376,31,4792,31,25628,376,31,4791,31,25324
0.413,6,13,1693,7,288,63,288,588,6,426,48,434,1105
1795.023,17,144,11520,72,48,25281,48,5472,72,56,25281,56,6048
0.057,6,11,819,6,186,11,186,506,5,45,13,45,313
1787.354,17,87,3648,86,14,21027,14,3612,1,8,0,8,36
1789.482,6,360,22887,209,69,8603,69,12500,151,69,11926,69,10387
0.176,17,4,284,2,32,96,32,120,2,54,85,60,164
1798.763,6,362,24512,209,88,8647,469,13907,153,69,11832,69,10605
353.799,6,381,123696,176,891,2021,1418,101912,205,106,1734,1418,21784
1799.183,1,16,896,16,28,119945,28,896,0,0,0,0,0
11.543,6,100,29285,49,529,240,1152,22081,51,430,225,1179,7204
8.978,6,1661,1538945,1057,1378,8,1408,1502873,604,931,14,2816,36072
1734.811,1,8,448,8,28,247830,28,448,0,0,0,0,0
11.507,17,3,984,3,300,5753,300,984,0,0,0,0,0
0.184,17,4,1104,4,248,61,353,1104,0,0,0,0,0
1790.989,17,179,13962,179,50,10061,50,13962,0,0,0,0,0
1684.46,2,14,448,14,8,129573,8,448,0,0,0,0,0
61.719,17,6,528,3,48,30853,48,228,3,72,30853,72,300
3.808,6,34,6169,18,206,224,314,2784,16,548,236,1179,3385
0.214,17,4,664,2,33,207,33,122,2,243,207,307,542
74.394,6,20,4353,10,243,8247,722,1501,10,579,8247,1408,2852
1.63,6,14,2351,8,188,232,245,700,6,703,276,1152,1651
0.29,17,3,234,2,39,99,39,134,1,72,0,72,100
1744.604,2,28,896,28,8,64614,8,896,0,0,0,0,0
11.726,17,2,152,2,48,11726,48,152,0,0,0,0,0
1762.013,1,123,6888,123,28,14442,28,6888,0,0,0,0,0
1.344,17,4,908,2,32,1340,32,120,2,366,4,486,788
4.382,6,22,4426,12,213,398,597,1689,10,552,465,1767,2737
22.136,17,28,7054,13,304,1842,1350,4325,15,153,1578,1350,2729
1781.761,6,416,24920,208,69,8607,69,12460,208,34,8607,48,12460
1740.723,6,87,6322,58,31,30539,31,3915,29,31,62168,31,2407
1.321,6,52,21605,30,977,45,1440,15904,22,400,54,1440,5701
1.848,6,27,8849,16,286,123,590,1502,11,862,163,1380,7347
8.833,6,1629,1325861,864,1432,9,1448,1272765,765,776,11,1448,53096
1772.231,6,180,15480,120,69,14892,69,8940,60,69,30036,69,6540
1796.918,17,448,39896,403,35,4469,288,25676,45,288,40019,288,14220
2.717,6,2,80,1,0,0,0,40,1,0,0,0,40
5.474,6,44,8369,21,227,273,314,4022,23,489,235,1179,4347
1681.575,17,14,1036,7,30,280255,30,406,7,62,280257,62,630
4.776,6,34,6169,18,206,280,314,2784,16,548,301,1179,3385
18.154,17,4,352,2,60,18153,60,176,2,60,18153,60,176
3.709,17,4,240,4,32,1236,32,240,0,0,0,0,0
52.552,2,7,312,7,20,8758,32,312,0,0,0,0,0
1776.9,17,142,11360,71,48,25383,48,5396,71,56,25383,56,5964
2.813,17,15,8360,8,706,401,1350,5872,7,327,460,1350,2488
1787.908,6,369,25730,214,99,8393,469,15045,155,69,11609,69,10685
283.689,17,4,352,2,60,283688,60,176,2,60,283688,60,176
88.532,6,26,7548,9,272,142,516,1180,17,406,5528,1452,6368
0.026,6,13,2100,7,329,4,500,1030,6,375,5,500,1070
1797.742,17,449,39928,404,35,4460,288,25708,45,288,40023,288,14220
0.999,17,2,134,2,39,999,39,134,0,0,0,0,0
32.405,6,17,1020,6,0,6479,0,360,11,0,3239,0,660
15.639,6,6,288,5,0,3909,0,248,1,0,0,0,40
1786.683,6,102,8296,68,65,26666,65,4930,34,59,54138,59,3366
1773.035,6,181,15589,120,69,14899,69,8940,61,69,29543,69,6649
1790.812,6,382,25188,219,80,8214,469,14321,163,69,11054,69,10867
5.239,6,44,8369,21,227,261,314,4022,23,427,225,1152,4347
259.261,17,4,352,2,60,259260,60,176,2,60,259260,60,176
1019.906,17,20,17229,20,833,53679,1449,17229,0,0,0,0,0
1798.884,17,450,39960,405,35,4452,288,25740,45,288,40022,288,14220
136.038,6,10,524,6,0,27207,0,308,4,0,45129,0,216
0.053,17,2,245,1,32,0,32,60,1,157,0,157,185
1082.82,2,8,256,8,8,154688,8,256,0,0,0,0,0
0.024,17,2,656,1,300,0,300,328,1,300,0,300,328
280.288,6,28,7352,13,158,23357,267,1317,15,678,20016,2045,6035
294.217,17,6,528,3,60,147108,60,264,3,60,147108,60,264
1070.937,17,212,16112,212,48,5075,48,16112,0,0,0,0,0
240.273,6,52,15684,28,667,8898,1402,12813,24,230,10446,580,2871
6.507,6,39,7269,19,218,361,314,3383,20,513,328,1179,3886
1774.458,6,184,15916,120,69,14911,69,8940,64,69,28161,69,6976
10.092,6,81,24765,40,542,258,1152,18968,41,461,245,1179,5797
504.298,2,4,128,4,8,168099,8,128,0,0,0,0,0
1.462,6,10,1687,7,100,243,100,384,3,1179,598,1179,1303
377.311,6,27,1767,18,177,22194,177,1181,9,110,8900,110,586
283.98,1,6,336,6,28,56796,28,336,0,0,0,0,0
4.172,17,6,950,3,33,2054,33,183,3,227,2081,233,767
11.77,17,4,304,4,48,3923,48,304,0,0,0,0,0
280.858,6,25,7094,11,181,28085,267,1168,14,595,21600,1400,5926
1783.144,6,102,8296,68,65,26614,65,4930,34,59,54031,59,3366
3.537,2,2,64,2,8,3537,8,64,0,0,0,0,0
1760.835,6,104,8136,67,45,26679,205,4985,37,35,48901,98,3151
1.981,6,30,10405,18,367,116,833,1825,12,1012,173,1420,8580
0.27,17,2,167,1,39,0,39,67,1,72,0,72,100
3.659,6,124,88992,58,131,64,232,2849,66,1368,50,1430,86143
0.067,6,11,913,6,182,13,182,490,5,77,7,134,423
3.047,6,42,22649,21,752,152,1460,6906,21,1063,145,1460,15743
374.909,6,25,1651,17,177,23431,177,1117,8,110,9260,110,534
1775.0,6,180,15480,120,69,14915,69,8940,60,69,30080,69,6540
1786.281,6,102,8296,68,65,26660,65,4930,34,59,54127,59,3366
1780.665,17,142,11360,71,48,25437,48,5396,71,56,25437,56,5964
0.095,17,2,588,1,39,0,39,67,1,493,0,493,521
1116.606,6,113,9764,74,70,15295,138,5582,39,69,29383,69,4182
4.484,6,22,6429,10,268,493,517,1333,12,744,403,1418,5096
0.341,17,2,180,1,30,0,30,58,1,94,0,94,122
33.535,6,31,5118,15,154,2395,721,1883,16,342,2223,1408,3235
25.999,6,40,12378,19,199,1444,721,2158,21,781,1290,1440,10220
1785.592,17,73,3060,72,14,25149,14,3024,1,8,0,8,36
125.355,6,36,17861,20,708,28,1360,4434,16,1161,8348,2720,13427
615.722,6,175,40881,82,442,7601,1360,26476,93,172,6627,4649,14405
0.128,6,11,3653,6,171,22,171,491,5,1447,29,2676,3162
2.779,6,2,88,2,0,0,0,88,0,0,0,0,0
1787.911,6,356,22520,208,69,8637,69,12460,148,69,12162,69,10060
2.102,6,13,2311,8,188,300,245,700,5,1407,460,1407,1611
136.121,6,465,116293,221,576,618,1440,89049,244,166,558,1702,27244
166.818,6,26,12869,15,519,59,884,2721,11,1385,16668,3928,10148
1.47,17,4,296,3,30,727,30,174,1,94,0,94,122
1.338,6,37,8212,19,320,74,1162,2716,18,529,68,4075,5496
0.307,6,22,7333,12,334,27,663,1969,10,1209,33,1906,5364
82.275,6,15,612,6,0,5970,0,244,9,0,10281,0,368
2.556,17,3,984,3,300,1278,300,984,0,0,0,0,0
232.348,17,10,590,10,31,25816,31,590,0,0,0,0,0
92.564,6,41,8678,17,345,3117,720,1747,24,331,4019,3488,6931
0.01,17,2,394,1,36,0,36,64,1,302,0,302,330
1659.223,6,36,8753,22,341,79010,1247,4308,14,353,127618,1597,4445
1782.28,17,83,3480,82,14,22003,14,3444,1,8,0,8,36
1647.211,1,7,392,7,28,274535,28,392,0,0,0,0,0
0.568,6,2,111,1,0,0,0,40,1,31,0,31,71
1785.307,17,87,3648,86,14,21003,14,3612,1,8,0,8,36
0.104,6,10,1669,6,551,20,947,1346,4,159,34,159,323
1787.903,6,355,22480,207,69,8679,69,12420,148,69,12162,69,10060
1.349,6,50,19471,27,904,51,1360,13775,23,433,52,1360,5696
1771.796,6,320,49384,134,194,13320,1440,24664,186,183,9576,1702,24720
15.302,6,3,120,1,0,0,0,40,2,0,9,0,80
378.265,2,3,96,3,8,189132,8,96,0,0,0,0,0
1743.976,6,95,7203,63,38,28128,205,4476,32,33,56248,98,2727
0.03,17,8,1670,8,180,4,219,1670,0,0,0,0,0
212.35,6,30,7432,13,158,17695,267,1317,17,543,13267,1400,6115
301.046,6,44,12552,25,733,12543,1360,6945,19,402,491,2667,5607
1.204,6,28,10016,15,624,71,1460,3752,13,716,86,1460,6264
23.796,6,17,2573,8,821,3398,1420,1966,9,231,2973,231,607
5.445,6,40,7309,20,218,286,314,3423,20,440,273,1152,3886
2.067,6,27,6166,14,108,159,147,999,13,773,142,1608,5167
0.447,6,14,4329,7,127,74,127,499,7,864,70,1448,3830
5.967,6,44,8748,21,209,298,314,3563,23,532,259,1179,5185
1.294,6,3,168,1,0,0,0,52,2,0,1294,0,116
19.821,6,2850,2669486,1842,1371,10,1408,2612406,1008,931,19,2801,57080
1798.927,17,142,11360,71,48,25698,48,5396,71,56,25698,56,5964
1797.878,17,450,39960,405,35,4450,288,25740,45,288,40022,288,14220
1684.738,17,18,1494,9,31,210586,37,536,9,78,210586,136,958
11.605,6,21,6825,12,275,1055,275,1038,9,1353,824,1440,5787
240.265,6,54,19523,29,843,8580,1418,16692,25,190,10010,580,2831
5.822,6,477,372195,226,209,25,253,14136,251,1402,23,2816,358059
371.909,6,23,1499,14,177,28608,177,913,9,110,10536,110,586
99.026,17,3,1008,3,308,49513,308,1008,0,0,0,0,0
0.02,6,16,6016,9,88,2,88,504,7,1740,3,1880,5512
1740.689,17,29,19517,29,645,62167,645,19517,0,0,0,0,0
1787.724,17,87,3648,86,14,21032,14,3612,1,8,0,8,36
87.266,17,4,352,2,60,87265,60,176,2,60,87265,60,176
0.312,6,23,7394,13,335,25,668,2026,10,1210,33,1906,5368
317.024,6,48,11881,29,141,11322,615,3596,19,834,17605,4649,8285
1.972,6,13,2311,8,188,281,245,700,5,1407,430,1407,1611
0.651,6,104,76922,64,1315,10,1432,71022,40,428,15,1871,5900
1785.518,1,58,4872,0,0,0,0,0,58,56,31324,56,4872
382.447,6,23,1538,16,180,25496,180,1056,7,110,10422,110,482
1798.125,1,345,28980,345,56,5227,56,28980,0,0,0,0,0
1735.38,17,195,48488,195,220,8945,422,48488,0,0,0,0,0
56.697,17,4,352,2,48,56688,48,152,2,72,56688,72,200
0.022,17,2,157,1,31,0,31,59,1,70,0,70,98
0.375,6,10,1669,6,551,74,947,1346,4,159,124,159,323
79.855,6,24,10657,13,741,54,1360,3517,11,1337,7971,4428,7140
1790.731,6,383,25815,218,85,8252,1189,14601,165,74,10918,405,11214
1775.15,6,180,15480,120,69,14917,69,8940,60,69,30084,69,6540
5.03,17,4,288,2,36,5005,36,128,2,52,5009,52,160
12.119,17,20,1720,10,47,1346,47,750,10,69,1346,75,970
0.536,6,14,1745,7,288,62,288,600,7,426,61,434,1145
1796.33,17,132,10560,66,48,27635,48,5016,66,56,27635,56,5544
0.041,17,2,912,1,308,0,308,336,1,548,0,548,576
0.149,6,9,1340,5,145,37,145,349,4,827,35,827,991
0.247,6,23,5928,12,164,22,453,1442,11,781,23,2224,4486
181.035,6,88,59905,53,1214,3481,1368,51348,35,841,1823,2519,8557
2.018,6,49,19887,27,933,77,1460,14186,22,400,88,1460,5701
0.067,6,9,1002,5,213,16,213,417,4,421,19,421,585
1797.09,17,142,11360,71,48,25672,48,5396,71,56,25672,56,5964
0.012,6,13,4256,7,85,2,85,457,6,1159,2,1863,3799
0.272,17,2,180,1,30,0,30,58,1,94,0,94,122
65.935,17,4,304,4,48,21978,48,304,0,0,0,0,0
241.312,6,111,80677,43,211,5745,646,3736,68,1310,3599,1654,76941
41.562,2,4,128,4,8,13854,8,128,0,0,0,0,0
19.628,17,33,14729,16,661,1306,1350,11029,17,189,1224,1350,3700
0.11,6,13,2012,7,329,18,500,1030,6,331,21,500,982
1788.792,6,359,22709,209,69,8599,69,12569,150,69,12003,69,10140
1790.952,1,342,28728,342,56,5252,56,28728,0,0,0,0,0
5.259,6,41,7349,22,218,250,314,3503,19,513,278,1179,3846
1798.238,17,87,3648,86,14,21155,14,3612,1,8,0,8,36
1786.984,6,104,8376,68,65,26671,65,4930,36,59,51053,59,3446
1787.375,6,104,8376,68,65,26677,65,4930,36,59,51064,59,3446
399.344,17,56,4678,52,30,7830,37,3030,4,384,113186,463,1648
0.026,6,3,2880,1,0,0,0,40,2,1368,18,1368,2840
51.29,6,5,284,3,0,25554,0,164,2,0,51110,0,120
1770.189,6,99,9306,66,66,27233,66,5610,33,60,55315,60,3696
60.143,2,2,64,2,8,60143,8,64,0,0,0,0,0
11.828,6,25,8473,13,275,985,275,1078,12,986,850,1440,7395
0.065,17,4,284,2,32,0,32,120,2,54,1,60,164
0.014,17,2,904,2,424,14,548,904,0,0,0,0,0
1796.352,17,176,13728,176,50,10264,50,13728,0,0,0,0,0
5.148,17,3,228,3,48,2574,48,228,0,0,0,0,0
149.687,6,24,4832,10,221,7244,519,1288,14,331,11507,2642,3544
1743.632,6,95,7203,63,38,28123,205,4476,32,33,56234,98,2727
11.239,17,14,16226,14,1131,864,1448,16226,0,0,0,0,0
0.151,6,41,16330,23,949,6,1420,11389,18,420,8,1420,4941
0.378,6,12,1653,6,288,69,288,548,6,426,40,434,1105
0.006,6,3,175,1,0,0,0,40,2,31,1,31,135
4.263,17,5,4754,5,922,1065,1451,4754,0,0,0,0,0
0.675,6,118,88177,52,131,13,232,2609,66,1359,9,1430,85568
1794.651,17,144,11520,72,48,25276,48,5472,72,56,25276,56,6048
11.629,6,1713,1593470,1125,1365,10,1432,1565647,588,427,19,1432,27823
510.883,1,17,952,17,28,31930,28,952,0,0,0,0,0
20.744,17,8,1648,4,48,6908,48,304,4,308,6906,308,1344
26.146,6,4158,3978348,2674,1408,9,1448,3896516,1484,776,17,1448,81832
33.02,17,84,37501,46,684,733,1350,32774,38,96,891,1350,4727
101.918,6,45,13774,21,891,708,1360,8012,24,399,4423,1360,5762
1.422,6,41,8431,21,321,71,1164,2810,20,400,65,1360,5621
1529.671,6,77,5573,51,31,30593,31,3415,26,31,61186,31,2158
1795.238,1,210,22260,210,78,8589,78,22260,0,0,0,0,0
1.847,6,28,8891,17,286,115,591,1543,11,863,165,1380,7348
2.039,17,6,552,3,32,850,32,180,3,96,0,96,372
11.854,6,18,4595,8,266,1693,498,1122,10,383,1306,1420,3473
13.285,6,2395,2249166,1500,1419,8,1448,2197938,895,776,14,1448,51228
0.87,6,9,1647,6,100,174,100,344,3,1179,310,1179,1303
0.03,6,10,1594,5,503,7,503,771,5,555,7,555,823
55.956,6,28,7217,13,155,4663,267,1306,15,482,3996,1420,5911
0.078,17,2,290,1,40,0,40,68,1,194,0,194,222
1790.208,6,356,22520,208,69,8648,69,12460,148,69,12178,69,10060
281.877,6,33,7621,15,143,20134,267,1466,18,603,16577,2076,6155
0.379,6,26,8990,13,247,31,624,1672,13,947,30,1448,7318
65.095,6,16,660,8,0,5244,0,328,8,0,9297,0,332
0.92,6,26,5916,13,161,76,267,1491,13,650,70,1420,4425
0.97,17,5,980,3,32,482,32,180,2,372,6,470,800
8.209,17,4,834,2,44,8187,44,144,2,317,8187,317,690
68.978,6,47,14099,18,373,4057,1189,4091,29,491,2455,1420,10008
899.482,6,12,728,8,31,128497,31,444,4,31,299716,31,284
0.467,6,10,1669,6,551,93,947,1346,4,159,155,159,323
0.112,6,13,1749,8,253,15,500,930,5,551,28,551,819
61.339,6,35,16014,22,818,2920,1408,9339,13,855,5090,3847,6675
0.033,17,2,279,1,36,0,36,64,1,187,0,187,215
1764.686,1,75,6300,75,56,23847,56,6300,0,0,0,0,0
0.503,6,28,9099,13,248,41,633,1678,15,827,33,1368,7421
252.494,2,2,64,2,8,252494,8,64,0,0,0,0,0
402.871,6,18,1242,14,180,30990,180,916,4,110,20080,110,326
1681.791,17,14,1036,7,30,280293,30,406,7,62,280294,62,630
0.781,6,51,13701,25,533,32,1301,4752,26,493,31,2720,8949
547.76,17,151,43849,151,262,3651,422,43849,0,0,0,0,0
0.878,17,2,586,1,46,0,46,74,1,484,0,484,512
1784.751,17,86,3606,85,14,21247,14,3570,1,8,0,8,36
203.273,17,4,352,2,60,203272,60,176,2,60,203272,60,176
1742.136,6,92,6918,61,36,29035,205,4276,31,33,58060,98,2642
240.36,6,43,9099,21,524,12017,1418,5821,22,236,11444,639,3278
1783.694,17,83,3480,82,14,22020,14,3444,1,8,0,8,36
17.507,17,37,12667,19,470,970,1350,9474,18,149,1027,1350,3193
0.343,17,2,157,1,31,0,31,59,1,70,0,70,98
1.573,6,50,18716,29,843,56,1360,13055,21,480,68,4075,5661
1787.027,6,104,8376,68,65,26672,65,4930,36,59,51055,59,3446
8.177,6,79,24930,40,568,209,1152,19229,39,413,208,1152,5701
1781.063,1,122,6832,122,28,14719,28,6832,0,0,0,0,0
1771.349,6,103,9514,66,66,27251,66,5610,37,60,49201,60,3904
5.007,17,4,558,2,36,5003,36,128,2,187,5003,187,430
0.598,6,28,7048,17,244,37,656,2394,11,701,57,1688,4654
0.967,6,29,8303,15,225,58,561,1985,14,820,60,1440,6318
3.998,17,4,244,4,33,1332,33,244,0,0,0,0,0
1683.51,1,7,392,7,28,280585,28,392,0,0,0,0,0
125.44,6,34,7866,12,155,28,267,1266,22,336,5972,1997,6600
1783.421,6,352,22498,204,69,8785,69,12369,148,69,12132,69,10129
0.198,17,2,602,1,46,0,46,74,1,500,0,500,528
0.771,17,22,9993,11,537,70,1350,6221,11,314,69,1350,3772
116.723,6,30,7432,13,158,9726,267,1317,17,543,7292,1400,6115
0.046,17,2,329,1,45,0,45,73,1,228,0,228,256
39.049,17,22,1672,22,48,1859,48,1672,0,0,0,0,0
7.278,6,1393,1276000,876,1379,8,1408,1244452,517,931,13,2801,31548
27.853,6,48,12584,23,176,1266,721,2684,25,684,1144,2840,9900
1772.368,6,182,15560,120,69,14893,69,8940,62,69,29049,69,6620
1799.715,6,83,4860,42,31,43894,36,2246,41,241,44991,456,2614
1795.54,17,447,39864,402,35,4477,288,25644,45,288,40010,288,14220
1764.111,2,12,384,12,8,160373,8,384,0,0,0,0,0
243.201,6,171,125310,73,542,3377,1418,8155,98,1349,2507,1418,117155
0.01,17,2,157,1,31,0,31,59,1,70,0,70,98
1770.425,6,100,9358,66,66,27237,66,5610,34,60,53646,60,3748
1785.855,6,360,24156,210,88,8544,469,13878,150,69,11985,69,10278
163.458,17,4,352,2,60,163457,60,176,2,60,163457,60,176
1787.75,6,361,22858,209,69,8594,69,12638,152,69,11838,69,10220
180.074,17,4,352,2,60,180073,60,176,2,60,180073,60,176
753.835,1,12,672,12,28,68530,28,672,0,0,0,0,0
30.985,17,6,528,3,48,15490,48,228,3,72,15490,72,300
280.26,6,28,7352,13,158,23355,267,1317,15,678,20015,3436,6035
149.017,17,8,2688,8,308,21288,308,2688,0,0,0,0,0
280.367,6,30,7432,13,158,23363,267,1317,17,543,17517,1300,6115
16.972,6,22,1583,11,222,1696,222,892,11,231,1696,231,691
1.191,6,58,18046,28,707,44,1360,8937,30,438,40,1360,9109
164.355,1,6,336,6,28,32871,28,336,0,0,0,0,0
1.963,17,22,5709,22,231,93,389,5709,0,0,0,0,0
1299.759,1,6,336,6,28,259951,28,336,0,0,0,0,0
162.118,6,36,23936,19,840,33,1360,5835,17,1740,10124,5423,18101
1799.836,6,113,9441,73,58,24997,205,5837,40,38,46144,98,3604
0.137,6,9,1346,5,145,34,145,349,4,833,20,833,997
1.405,6,50,19297,27,892,54,1440,13601,23,433,55,1440,5696
2.899,17,3,183,3,33,1449,33,183,0,0,0,0,0
541.404,2,6,192,6,8,108280,8,192,0,0,0,0,0
0.005,17,2,456,1,60,0,60,88,1,340,0,340,368
1795.461,1,58,4872,0,0,0,0,0,58,56,31499,56,4872
2.256,6,28,10679,13,164,173,267,1384,15,945,148,1402,9295
142.115,6,207,169103,133,1328,1076,1448,154371,74,604,1856,1448,14732
61.319,6,35,15834,22,800,2919,1408,9159,13,855,5089,3847,6675
1796.041,17,80,3354,79,14,23026,14,3318,1,8,0,8,36
1787.6,6,160,31790,95,430,19017,1258,24880,65,93,27929,192,6910
1799.218,6,371,24941,215,87,8407,469,14354,156,69,11605,69,10587
36.921,17,4,300,2,47,36920,47,150,2,47,36920,47,150
0.116,17,2,152,1,48,0,48,76,1,48,0,48,76
1764.089,2,10,320,10,8,196009,8,320,0,0,0,0,0
0.065,6,12,3462,6,75,13,75,395,6,1373,13,1448,3067
0.025,17,2,912,1,308,0,308,336,1,548,0,548,576
75.745,1,2,112,2,28,75745,28,112,0,0,0,0,0
1783.192,17,83,3480,82,14,22014,14,3444,1,8,0,8,36
33.432,17,12,1764,6,48,6684,48,456,6,190,6684,308,1308
0.03,17,2,144,1,36,0,36,64,1,52,0,52,80
65.357,6,28,7352,12,158,5941,267,1277,16,775,4353,3465,6075
1681.575,17,14,1036,7,30,280257,30,406,7,62,280257,62,630
1.394,6,23,7952,12,164,108,267,1288,11,1216,117,3859,6664
421.216,2,4,128,4,8,140405,8,128,0,0,0,0,0
0.004,17,2,411,1,39,0,39,67,1,316,0,316,344
0.106,17,2,258,1,60,0,60,88,1,142,0,142,170
2.374,6,67,17891,33,549,74,1429,5304,34,467,60,1986,12587
61.789,6,68,45157,42,1162,1507,1448,37074,26,747,2462,1448,8083
1773.247,6,180,15480,120,69,14901,69,8940,60,69,30049,69,6540
1766.281,17,170,14448,157,30,11322,37,9155,13,379,142213,463,5293
0.007,6,3,144,1,0,0,0,40,2,0,1,0,104
196.836,17,32,2432,32,48,6349,48,2432,0,0,0,0,0
78.301,6,49,14523,26,948,392,1360,8708,23,348,3551,2667,5815
1772.2,6,180,15480,120,69,14892,69,8940,60,69,30032,69,6540
23.787,17,4,352,2,60,23786,60,176,2,60,23786,60,176
26.142,6,19,2261,10,125,2904,186,799,9,320,3129,888,1462
31.562,6,7,308,1,0,0,0,44,6,0,6295,0,264
14.546,6,24,6993,13,275,1212,275,1078,11,910,951,1440,5915
2.063,6,19,3781,10,234,229,564,1452,9,463,235,1343,2329
1.431,6,37,9087,20,399,75,1360,3631,17,476,77,2715,5456
1771.419,6,99,9174,66,64,27252,64,5544,33,58,55353,58,3630
4.018,6,8,460,4,0,1339,0,220,4,0,999,0,240
78.441,6,32,7696,11,155,53,267,1226,21,330,3921,1460,6470
0.792,6,2,80,1,0,0,0,40,1,0,0,0,40
0.016,17,4,360,2,30,1,30,116,2,94,1,94,244
21.453,6,14,2708,6,837,4287,1452,1918,8,231,3062,231,790
280.285,6,30,7432,13,158,23357,267,1317,17,543,17516,1400,6115
1760.585,17,227,55262,227,215,7790,422,55262,0,0,0,0,0
1.193,17,18,7302,9,497,149,1350,4730,9,257,142,1350,2572
82.127,6,91,30991,45,644,1866,1440,16124,46,542,1813,1440,14867
9.052,6,40,8625,19,378,502,786,1938,21,364,445,1440,6687
604.7,6,114,7182,65,69,8488,69,3911,49,69,12597,69,3271
1.174,6,23,7952,12,164,91,267,1288,11,1216,100,2816,6664
1.185,6,25,8056,12,164,91,267,1288,13,869,83,1448,6768
9.057,6,14,2242,8,210,1288,210,844,6,545,1799,904,1398
0.139,17,2,348,1,39,0,39,67,1,253,0,253,281
0.756,6,18,5172,10,150,84,174,704,8,828,95,1420,4468
1.005,17,3,186,3,34,502,34,186,0,0,0,0,0
1799.76,17,142,11360,71,48,25710,48,5396,71,56,25710,56,5964
0.139,17,2,904,2,424,139,548,904,0,0,0,0,0
1798.63,6,162,12217,89,84,20438,208,8305,73,31,24976,31,3912
28.064,6,17,4314,9,267,3508,501,1165,8,565,3996,1420,3149
63.569,6,62,39197,38,1168,1718,1408,31207,24,748,2669,1408,7990
82.396,6,17,692,7,0,8300,0,284,10,0,9153,0,408
1.62,6,50,19170,29,878,57,1360,13509,21,400,70,1360,5661
180.719,6,39,8119,21,449,9035,1402,5584,18,227,10629,580,2535
0.467,17,21,7570,11,412,46,1350,4842,10,244,45,1350,2728
61.979,6,73,49613,45,1184,1408,1448,41428,28,746,2286,1448,8185
1741.367,6,95,6867,61,31,29022,31,4145,34,31,52768,31,2722
12.942,6,40,7507,19,218,719,314,3383,21,410,633,1179,4124
1.693,6,13,2311,8,188,241,245,700,5,1407,359,1407,1611
1790.117,6,356,22520,208,69,8647,69,12460,148,69,12177,69,10060
297.668,6,747,646451,497,1334,599,1360,628345,250,192,1194,1360,18106
35.853,6,32,5471,16,180,2390,722,1947,16,336,2355,1448,3524
1681.344,17,14,1036,7,30,280220,30,406,7,62,280220,62,630
421.179,2,4,128,4,8,140393,8,128,0,0,0,0,0
1.405,6,14,1765,7,288,232,288,608,7,426,204,434,1157
1787.219,6,104,8252,68,63,26674,64,4868,36,57,51060,58,3384
0.089,17,2,192,1,37,0,37,65,1,99,0,99,127
300.841,6,46,10280,24,433,13080,910,3194,22,364,743,2720,7086
4.92,17,4,558,2,36,4916,36,128,2,187,4915,187,430
1786.476,6,102,8296,68,65,26663,65,4930,34,59,54132,59,3366
382.347,6,18,1242,14,180,29411,180,916,4,110,20061,110,326
0.522,17,2,672,2,308,522,308,672,0,0,0,0,0
615.816,6,138,18039,54,103,11619,615,5392,84,149,7358,1629,12647
10.751,6,18,5610,10,275,1194,275,958,8,1440,807,1440,4652
61.854,6,77,52988,47,1207,1344,1448,44698,30,746,2125,1448,8290
0.302,6,21,7290,13,335,24,668,2026,8,1210,42,1906,5264
9.981,6,1295,1190364,842,1366,11,1432,1167536,453,425,22,1432,22828
120.522,6,9,1647,6,100,24104,100,344,3,1179,60131,1179,1303
3.709,6,230,218474,157,807,23,1360,14523,73,3140,49,16320,203951
1781.432,1,59,4956,59,56,30714,56,4956,0,0,0,0,0
1781.76,6,360,24694,210,94,8525,469,14347,150,69,11958,69,10347
0.767,17,19,12025,10,664,85,1350,6928,9,538,54,1350,5097
368.047,6,94,70267,62,1244,6033,1408,60479,32,811,2487,3847,9788
1797.116,17,364,121212,364,305,4950,422,121212,0,0,0,0,0
1282.019,6,85,11501,51,97,20620,498,4384,34,198,38846,1420,7117
4.63,6,37,7189,19,218,257,314,3383,18,513,256,1179,3806
1.749,6,14,2351,8,188,249,245,700,6,703,294,1152,1651
0.555,6,23,6673,10,181,48,267,1128,13,627,37,1400,5545
0.728,6,28,7480,17,306,45,1087,2826,11,701,71,1728,4654
1.89,17,3,183,3,33,945,33,183,0,0,0,0,0
1641.491,1,9,504,9,28,205186,28,504,0,0,0,0,0
0.984,6,29,12011,16,525,65,1360,3298,13,909,65,1379,8713
0.289,6,20,4960,10,137,32,267,1092,10,692,31,1467,3868
0.022,17,2,656,1,300,0,300,328,1,300,0,300,328
0.039,17,2,290,1,40,0,40,68,1,194,0,194,222
1771.975,6,180,15480,120,69,14890,69,8940,60,69,30033,69,6540
110.249,6,84,61212,55,1217,2041,1408,51564,29,739,3929,2439,9648
0.905,6,27,8313,14,275,58,583,1967,13,1162,62,3151,6346
1793.653,17,66,2766,65,14,28025,14,2730,1,8,0,8,36
0.216,17,2,152,1,48,0,48,76,1,48,0,48,76
8.325,6,1634,1499683,1027,1382,7,1408,1463455,607,931,13,2801,36228
3.995,17,8,616,4,33,1331,33,244,4,65,1331,65,372
6.029,6,16,2394,10,210,669,210,996,6,545,1205,904,1398
300.826,6,43,15351,23,977,13673,1460,9749,20,399,454,1460,5602
2.141,6,45,11639,24,547,93,1360,5978,21,400,97,1360,5661
0.186,17,4,588,2,48,181,48,152,2,190,179,308,436
7.525,6,484,457404,187,246,40,517,14159,297,1455,25,4344,443245
421.166,2,6,192,6,8,84233,8,192,0,0,0,0,0
240.842,6,57,9175,28,249,8919,585,4293,29,257,8599,973,4882
0.022,17,2,152,1,48,0,48,76,1,48,0,48,76
1795.294,17,80,3354,79,14,23016,14,3318,1,8,0,8,36
346.303,1,30,3180,30,78,11941,78,3180,0,0,0,0,0
2.588,17,21,7550,9,399,323,1350,3847,12,280,211,1350,3703
87.854,17,5,5101,5,992,21963,1451,5101,0,0,0,0,0
20.155,6,22,5469,13,107,1679,159,1126,9,773,2517,1418,4343
8.092,6,1631,1474496,1007,1385,7,1408,1437384,624,931,12,2816,37112
1772.863,6,180,15480,120,69,14898,69,8940,60,69,30041,69,6540
1791.382,6,359,22709,209,69,8612,69,12569,150,69,12022,69,10140
379.836,6,18,1242,14,180,29218,180,916,4,110,20057,110,326
1.529,6,49,19650,27,920,58,1360,13994,22,433,62,1360,5656
18.95,17,25,16590,15,840,1329,1350,13025,10,328,2060,1350,3565
1742.131,1,15,840,15,28,124437,28,840,0,0,0,0,0
242.896,17,4,352,2,60,242895,60,176,2,60,242895,60,176
0.019,17,2,212,1,46,0,46,74,1,110,0,110,138
1.063,17,3,451,2,39,605,39,134,1,289,0,289,317
0.303,17,4,240,2,32,302,32,120,2,32,302,32,120
1785.965,6,108,8526,69,64,26264,64,4936,39,58,46996,58,3590
1.22,6,24,6041,13,108,101,147,959,11,773,107,1608,5082
5.681,6,39,7269,20,218,299,314,3423,19,513,300,1179,3846
1770.557,6,105,9552,66,65,27239,65,5577,39,59,46591,59,3975
1784.161,6,356,22520,208,69,8619,69,12460,148,69,12137,69,10060
1772.87,1,58,4872,58,56,31102,56,4872,0,0,0,0,0
1790.484,6,374,23654,214,69,8406,69,13114,160,69,11260,69,10540
240.286,6,43,8915,21,524,12013,1418,5819,22,216,11441,618,3096
1799.831,17,449,39928,404,35,4466,288,25708,45,288,40020,288,14220
0.011,17,2,206,1,44,0,44,72,1,106,0,106,134
0.433,6,12,1653,6,288,82,288,548,6,426,44,434,1105
1744.905,6,95,7203,63,38,28143,205,4476,32,33,56274,98,2727
1740.511,17,29,30624,29,1028,62161,1028,30624,0,0,0,0,0
2.938,17,3,468,3,128,1469,128,468,0,0,0,0,0
4.246,17,417,208593,204,879,20,1350,185045,213,82,18,1350,23548
1786.551,6,102,8228,68,64,26664,64,4896,34,58,54135,58,3332
14.266,6,30,7573,12,155,1296,267,1266,18,398,838,3417,6307
1787.903,6,363,23007,211,69,8513,69,12787,152,69,11840,69,10220
1786.218,17,87,3648,86,14,21014,14,3612,1,8,0,8,36
0.095,6,10,1514,5,503,23,503,771,5,475,23,475,743
1772.872,6,180,15480,120,69,14898,69,8940,60,69,30040,69,6540
1785.861,6,364,24923,212,94,8463,469,14427,152,69,11826,69,10496
1788.065,17,85,3561,83,13,21751,14,3481,2,12,1787894,16,80
1.154,6,25,8056,12,164,88,267,1288,13,869,81,1408,6768
0.162,17,4,240,2,32,161,32,120,2,32,161,32,120
0.971,6,29,8544,15,222,58,540,2008,14,852,60,1360,6536
0.183,6,26,7256,13,155,15,267,1301,13,603,14,1400,5955
8.93,6,83,26746,42,573,217,1152,20624,41,447,216,1179,6122
1799.09,17,448,38816,404,34,4464,288,25160,44,282,40952,288,13656
1784.612,6,356,22520,208,69,8621,69,12460,148,69,12138,69,10060
0.191,17,2,374,1,47,0,47,75,1,271,0,271,299
1683.295,17,14,1036,7,30,280541,30,406,7,62,280539,62,630
1718.622,1,8,448,8,28,245517,28,448,0,0,0,0,0
49.606,6,46,8977,21,410,625,882,2162,25,386,2061,1360,6815
0.454,6,29,7376,14,155,34,267,1341,15,678,28,3456,6035
1113.122,6,153,16639,75,92,15039,721,7437,78,216,14453,1440,9202
240.654,6,60,20559,33,787,7519,1418,17466,27,209,9255,580,3093
5.002,17,4,542,2,36,4992,36,128,2,179,4988,187,414
1735.959,1,29,3392,29,88,61998,125,3392,0,0,0,0,0
1799.59,6,368,33593,161,67,11048,616,12407,207,93,8735,1938,21186
1770.982,6,104,9626,66,66,27245,66,5610,38,60,47861,60,4016
1797.5,17,448,39896,403,35,4471,288,25676,45,288,40019,288,14220
0.849,17,18,6190,7,348,141,1350,2637,11,295,77,1350,3553
2.668,6,43,8928,22,334,127,1164,3267,21,400,116,1460,5661
1779.86,1,342,28728,342,56,5219,56,28728,0,0,0,0,0
195.689,6,73,50332,46,1205,4348,1368,42192,27,841,2377,2519,8140
1779.924,6,453,38545,217,66,8239,615,15140,236,86,7573,2720,23405
1.302,6,45,18080,26,882,52,1360,12544,19,476,62,2720,5536
108.772,6,26,5021,10,235,224,516,1346,16,275,7245,1452,3675
92.927,6,22,9977,11,380,66,832,1625,11,1128,9280,2568,8352
1.544,6,25,8092,12,164,124,267,1324,13,869,113,1448,6768
0.161,17,4,368,2,32,102,32,120,2,96,58,96,248
37.934,17,4,352,2,60,37932,60,176,2,60,37932,60,176
0.024,6,14,4020,7,88,3,88,388,7,1113,4,1460,3632
1537.411,1,54,5724,54,78,29007,78,5724,0,0,0,0,0
0.156,6,10,1327,5,299,25,299,567,5,246,30,459,760
280.056,6,28,7352,13,158,23338,267,1317,15,678,20000,2800,6035
2.376,17,6,1384,3,60,1182,60,264,3,345,1182,356,1120
241.449,6,27,2322,17,76,15090,138,1370,10,69,26826,69,952
1.324,6,48,19121,26,953,52,1460,13465,22,433,54,1460,5656
0.131,6,14,3436,8,106,18,106,518,6,866,25,1448,2918
1747.336,6,130,13280,83,81,21308,516,6415,47,121,37983,1452,6865
20.148,6,21,5418,12,107,1831,159,1074,9,773,2516,1402,4344
117.796,6,41,8289,18,131,6929,267,1782,23,348,5345,1460,6507
1779.12,1,64,6784,64,78,28240,78,6784,0,0,0,0,0
1776.964,17,73,3060,72,14,25027,14,3024,1,8,0,8,36
2.995,17,4,240,4,32,998,32,240,0,0,0,0,0
280.524,6,29,7392,13,158,23377,267,1317,16,603,18695,2036,6075
2.888,17,27,19566,16,715,190,1350,11894,11,669,285,1350,7672
176.687,17,5,2050,5,382,44171,394,2050,0,0,0,0,0
8.264,6,1717,1577893,1056,1414,7,1448,1538857,661,776,12,1448,39036
1746.324,6,95,7203,63,38,28166,205,4476,32,33,56319,98,2727
0.062,17,3,234,2,39,29,39,134,1,72,0,72,100
1.314,6,43,15320,24,799,57,1460,9784,19,433,63,1460,5536
0.003,6,6,7340,1,0,0,0,40,5,1420,0,1420,7300
1744.715,6,99,7808,65,45,27261,205,4844,34,35,52864,98,2964
1679.658,17,12,498,11,14,167965,14,462,1,8,0,8,36
173.023,17,6,2016,6,308,34604,308,2016,0,0,0,0,0
0.505,6,26,7751,16,339,33,949,3017,10,721,53,1420,4734
0.434,6,20,7252,13,337,36,674,2032,7,1212,66,1946,5220
4.599,6,37,7205,19,218,255,314,3383,18,516,255,1179,3822
0.112,17,2,178,1,29,0,29,57,1,93,0,93,121
1741.491,1,15,870,15,30,124392,30,870,0,0,0,0,0
5.36,6,39,7269,20,218,282,314,3423,19,513,283,1179,3846
0.335,6,10,1185,6,279,67,279,587,4,191,55,272,598
1750.61,17,12,498,11,14,175061,14,462,1,8,0,8,36
0.486,6,457,614363,248,183,1,230,13549,209,2849,2,21030,600814
1794.918,17,87,3648,86,14,21116,14,3612,1,8,0,8,36
20.024,17,26,1975,14,40,1540,41,960,12,56,1804,57,1015
1789.314,6,329,27813,189,75,9517,267,12624,140,131,12872,1452,15189
0.881,6,10,1687,7,100,146,100,384,3,1179,312,1179,1303
300.776,6,55,30178,31,190,10025,444,2509,24,1467,10547,4050,27669
1741.697,6,91,6604,59,31,30029,31,3998,32,31,56183,31,2606
0.557,6,10,924,5,283,92,283,551,5,105,94,105,373
1795.809,17,142,11360,71,48,25654,48,5396,71,56,25654,56,5964
0.419,6,25,7711,16,339,27,949,3017,9,721,50,1420,4694
21.164,17,4,352,2,48,21152,48,152,2,72,21151,72,200
11.5,6,6,328,4,0,3833,0,216,2,0,11274,0,112
109.913,17,8,333,7,13,18318,14,289,1,16,0,16,44
0.018,17,2,162,1,36,0,36,64,1,70,0,70,98
1344.127,6,167,12912,64,73,21333,328,6301,103,48,13176,78,6611
0.062,17,2,154,1,33,0,33,61,1,65,0,65,93
102.108,17,9,693,9,49,12763,49,693,0,0,0,0,0
1.312,6,25,8056,12,164,102,267,1288,13,1014,93,2804,6768
601.58,2,7,224,7,8,100263,8,224,0,0,0,0,0
18.532,17,33,8443,15,274,1321,1350,4536,18,189,1088,1350,3907
19.608,17,35,20466,17,547,1223,1350,9781,18,565,1151,1350,10685
62.358,6,68,46953,43,1183,1484,1368,38919,25,840,2586,2519,8034
2.349,6,20,3833,11,234,234,564,1504,9,463,256,1343,2329
1.336,17,4,947,2,33,1324,37,123,2,384,1323,463,824
217.912,17,4,240,2,32,217910,32,120,2,32,217911,32,120
3.992,17,6,1356,6,198,798,207,1356,0,0,0,0,0
132.667,6,31,8912,14,158,10205,267,1357,17,763,8285,2076,7555
240.553,6,126,81931,49,548,5011,1418,6982,77,1108,3164,2836,74949
88.821,1,3,279,3,65,44410,88,279,0,0,0,0,0
949.004,1,54,5724,54,78,17905,78,5724,0,0,0,0,0
12.414,17,2,2116,2,1030,12414,1030,2116,0,0,0,0,0
0.04,17,2,222,1,51,0,51,79,1,115,0,115,143
43.212,1,18,1008,18,28,2541,28,1008,0,0,0,0,0
23.402,17,8,704,4,48,7798,48,304,4,72,7798,72,400
0.282,6,9,1050,5,261,70,261,465,4,421,78,421,585
14.032,6,24,6993,13,275,1169,275,1078,11,910,900,1420,5915
1143.049,2,8,256,8,8,163292,8,256,0,0,0,0,0
1796.501,6,127,12515,77,62,23638,722,6401,50,94,36656,1408,6114
0.011,17,2,672,2,308,11,308,672,0,0,0,0,0
0.664,6,17,2777,9,324,83,585,1137,8,304,93,580,1640
10.643,6,4,1183,1,0,0,0,40,3,341,3836,341,1143
1787.909,6,365,25432,213,100,8433,469,14936,152,69,11840,69,10496
1799.162,17,142,11360,71,48,25702,48,5396,71,56,25702,56,5964
0.842,6,14,2033,7,288,137,288,876,7,426,111,434,1157
1757.793,17,138,11040,69,48,25849,48,5244,69,56,25849,56,5796
166.124,17,4,348,2,43,166123,43,142,2,75,166123,75,206
1.458,6,53,19598,29,900,52,1460,13817,24,400,54,1460,5781
369.746,6,27,1767,18,177,21749,177,1181,9,110,8599,110,586
11.451,6,1816,1582689,1096,1390,10,1414,1549668,720,467,15,1889,33021
0.515,6,10,861,5,222,123,222,426,5,231,124,231,435
280.551,6,32,7853,14,158,21580,267,1357,18,524,16500,1400,6496
1794.184,6,356,22520,208,69,8667,69,12460,148,69,12204,69,10060
100.198,6,32,13225,19,523,2048,690,4456,13,915,8339,3928,8769
0.173,17,4,624,2,64,172,64,184,2,192,58,192,440
1772.124,6,182,15629,121,69,14767,69,8980,61,69,29533,69,6649
1785.248,6,102,8296,68,65,26645,65,4930,34,59,54095,59,3366
1769.603,6,139,9841,77,70,23281,208,6245,62,31,29006,31,3596
1136.563,1,63,3528,63,28,18331,28,3528,0,0,0,0,0
1772.622,6,180,15480,120,69,14895,69,8940,60,69,30044,69,6540
3.862,6,33,6145,17,206,241,314,2744,16,551,240,1179,3401
1786.271,6,173,37146,102,472,17685,1284,28152,71,120,25516,242,8994
1772.885,6,180,15480,120,69,14898,69,8940,60,69,30040,69,6540
0.649,6,20,9674,12,410,59,922,1742,8,1520,72,4416,7932
62.208,6,78,56794,50,1210,1269,1368,48601,28,747,2295,1368,8193
280.507,6,29,7392,13,158,23375,267,1317,16,775,18697,4836,6075
299.517,6,29,8648,17,319,18719,1408,4404,12,602,27211,1408,4244
0.306,6,21,7281,12,334,26,663,1969,9,967,37,1912,5312
1.065,6,31,12136,17,525,66,1360,3362,14,820,69,1380,8774
1717.494,1,10,1080,10,80,190832,88,1080,0,0,0,0,0
0.101,17,2,212,1,46,0,46,74,1,110,0,110,138
13.601,6,2385,2225790,1538,1369,8,1408,2177082,847,931,15,2816,48708
19.839,6,20,2768,10,92,2204,92,708,10,750,1838,1408,2060
280.279,6,29,7392,13,158,23356,267,1317,16,603,18678,2036,6075
240.301,6,44,8498,22,449,11442,1408,5660,22,187,11442,580,2838
0.927,6,12,1163,6,222,182,222,688,6,231,182,231,475
15.533,17,17,6624,8,480,2204,1350,4069,9,255,1933,1350,2555
62.192,6,27,7310,9,165,14,267,1029,18,396,3657,2840,6281
1789.428,6,356,22520,208,69,8644,69,12460,148,69,12172,69,10060
1782.803,6,356,22520,208,69,8612,69,12460,148,69,12127,69,10060
6.674,6,64,20526,33,559,208,1152,15859,31,489,213,1179,4667
1.405,6,24,9230,12,733,127,1408,3564,12,629,120,1408,5666
5.005,17,4,288,2,36,5004,36,128,2,52,4960,52,160
13.551,6,14,1025,7,222,2257,222,506,7,231,2257,231,519
1740.632,17,30,7050,30,207,60021,207,7050,0,0,0,0,0
1.358,6,37,8214,19,321,75,1164,2718,18,529,69,4075,5496
7.764,6,16,4090,9,275,970,275,918,7,1440,984,1440,3172
1.445,6,47,19570,27,920,55,1360,13994,20,529,65,4075,5576
146.689,6,87,27338,41,565,299,1152,20302,46,432,3253,1179,7036
274.818,17,299,22717,167,40,1655,41,11465,132,57,2097,80,11252
15.445,6,22,6638,9,154,1930,267,832,13,586,1273,4260,5806
60.113,17,28,2339,26,30,2404,37,1515,2,384,357,463,824
0.074,17,2,198,1,63,0,63,91,1,79,0,79,107
73.075,6,7,388,2,0,7690,0,112,5,0,18176,0,276
3.9,17,5,340,5,40,975,40,340,0,0,0,0,0
1791.032,6,356,22520,208,69,8652,69,12460,148,69,12183,69,10060
4.375,6,39,7269,20,218,230,314,3423,19,513,228,1179,3846
23.446,6,18,6318,4,106,7815,106,274,14,456,1792,1420,6044
1787.38,17,348,26448,348,48,5150,48,26448,0,0,0,0,0
0.479,6,4,229,1,0,0,0,40,3,69,204,69,189
0.185,1,2,112,2,28,185,28,112,0,0,0,0,0
0.068,6,4,208,0,0,0,0,0,4,0,0,0,208
1743.538,1,46,2576,46,28,38745,28,2576,0,0,0,0,0
1795.544,17,448,39896,403,35,4466,288,25676,45,288,40018,288,14220
0.282,17,2,152,1,48,0,48,76,1,48,0,48,76
36.0,17,4,320,4,52,12000,52,320,0,0,0,0,0
0.636,17,18,7491,9,496,79,1350,4716,9,280,72,1350,2775
1787.905,6,360,24225,210,88,8554,469,13947,150,69,11999,69,10278
1740.481,17,29,19517,29,645,62160,645,19517,0,0,0,0,0
1741.489,6,136,13337,81,66,21768,722,6811,55,83,32244,1408,6526
3.682,6,12,1767,7,100,613,100,384,5,1179,853,1179,1383
280.457,6,28,7352,13,158,23371,267,1317,15,678,20028,3456,6035
7.164,6,1694,1564669,1072,1382,6,1408,1527661,622,931,11,2816,37008
1631.931,6,193,22890,101,76,16319,721,9047,92,260,15169,1440,13843
114.391,6,25,11058,12,433,77,990,1823,13,967,9521,1460,9235
281.059,6,28,7352,12,158,25550,267,1277,16,603,18725,1400,6075
1702.627,17,12,498,11,14,170262,14,462,1,8,0,8,36
6.502,6,13,3217,7,92,1083,92,564,6,1164,1188,1448,2653
382.512,6,21,1419,15,177,27322,177,989,6,110,12277,110,430
255.542,6,60,9989,31,661,8518,1418,6345,29,96,9126,580,3644
61.3,6,37,15938,22,800,2919,1408,9160,15,665,4360,1408,6778
1798.404,1,270,15120,270,28,6685,28,15120,0,0,0,0,0
21.467,17,22,5685,13,40,1788,41,892,9,504,2667,505,4793
8.154,6,18,6871,9,275,1019,275,643,9,1171,669,1440,6228
1796.054,6,111,8774,71,64,25657,64,5144,40,58,46050,58,3630
9.729,6,18,2474,10,210,1078,210,956,8,545,1385,904,1518
0.509,17,3,451,2,39,48,39,134,1,289,0,289,317
280.449,17,10,580,10,30,31161,30,580,0,0,0,0,0
0.406,6,7,295,4,0,135,0,164,3,7,106,7,131
1799.836,17,4524,217152,2262,20,796,20,108576,2262,20,796,20,108576
38.731,6,8303,8726602,3048,269,12,274,167175,5255,1578,7,8688,8559427
1741.695,6,137,8544,76,46,23222,208,5205,61,31,29023,31,3339
0.804,6,11,1727,7,100,134,100,384,4,589,180,1152,1343
1797.815,6,133,8530,75,50,24294,208,5280,58,31,31534,31,3250
1750.85,17,13,534,11,14,175058,14,462,2,8,1750665,8,72
0.007,17,4,865,2,47,2,47,150,2,329,2,341,715
1797.07,17,83,3480,82,14,22186,14,3444,1,8,0,8,36
0.036,17,2,235,1,36,0,36,64,1,143,0,143,171
1781.026,6,352,22360,206,69,8687,69,12380,146,69,12282,69,9980
5.103,6,41,7365,22,218,243,314,3503,19,516,269,1179,3862
1786.983,6,103,8401,69,65,26279,65,5035,34,59,54147,59,3366
105.91,6,18,1622,3,112,52955,112,240,15,82,7551,90,1382
20.567,6,24,5616,14,92,1582,159,1209,10,966,2281,1708,4407
1797.256,17,448,39896,403,35,4470,288,25676,45,288,40018,288,14220
0.245,17,3,451,2,39,47,39,134,1,289,0,289,317
0.401,6,22,7342,12,335,35,668,1974,10,1210,43,1906,5368
1.243,6,47,19114,27,887,47,1360,13538,20,476,56,2715,5576
1785.898,6,102,8364,68,66,26655,66,4964,34,60,54115,60,3400
0.109,6,9,1346,5,145,27,145,349,4,833,30,833,997
1787.901,6,356,22589,207,69,8679,69,12420,149,69,12080,69,10169
1787.134,6,356,22520,208,69,8633,69,12460,148,69,12157,69,10060
10.222,6,84,24917,43,544,243,1152,19136,41,413,249,1152,5781
159.176,6,4495,4034053,2779,1366,57,1368,3930255,1716,899,92,2736,103798
0.294,6,22,7333,12,334,26,663,1969,10,1209,31,1906,5364
1790.131,1,58,4872,58,56,31405,56,4872,0,0,0,0,0
190.463,17,4,300,2,47,190462,47,150,2,47,190461,47,150
366.474,6,23,1499,14,177,28190,177,913,9,110,11219,110,586
0.518,1,2,112,2,28,518,28,112,0,0,0,0,0
2.927,6,30,11719,13,252,243,646,1706,17,912,176,1438,10013
1788.457,1,200,11200,200,28,8987,28,11200,0,0,0,0,0
0.224,17,2,214,1,39,0,39,67,1,119,0,119,147
1794.017,6,132,13133,80,63,22709,721,6662,52,89,35168,2026,6471
33.527,17,3,228,3,48,16763,48,228,0,0,0,0,0
31.931,6,263,233563,106,122,304,289,6275,157,1432,204,2804,227288
1779.089,17,82,3438,81,14,22238,14,3402,1,8,0,8,36
123.609,6,40,24886,15,892,763,1460,5980,25,942,5150,1460,18906
3.815,17,30,13703,14,656,293,1350,9576,16,229,215,1350,4127
0.014,17,4,792,3,60,4,60,264,1,500,0,500,528
3.33,17,2,656,2,300,3330,300,656,0,0,0,0,0
3.073,17,4,368,4,64,1024,64,368,0,0,0,0,0
32.053,6,9,396,2,0,3483,0,88,7,0,5327,0,308
0.396,6,21,7203,13,318,33,600,1958,8,964,53,1471,5245
280.222,6,28,7352,13,158,23351,267,1317,15,678,20011,4200,6035
0.06,17,2,144,1,44,0,44,72,1,44,0,44,72
9.394,17,36,9744,11,367,939,1350,4350,25,187,390,1350,5394
0.162,6,46,21392,26,1093,6,1420,16371,20,467,8,1883,5021
0.429,6,46,17590,25,954,17,1380,12508,21,421,18,1923,5082
0.255,17,2,362,1,46,0,46,74,1,260,0,260,288
1800.0,6,491,78910,220,186,8082,1360,42619,271,251,6666,1398,36291
286.152,17,4,558,2,36,286147,36,128,2,187,286148,187,430
313.12,17,6,528,3,60,156559,60,264,3,60,156559,60,264
13.172,6,2,1175,1,0,0,0,40,1,1095,0,1095,1135
115.187,17,6,456,6,48,23037,48,456,0,0,0,0,0
1779.691,17,66,22176,66,308,27379,308,22176,0,0,0,0,0
1637.363,1,14,784,14,28,125951,28,784,0,0,0,0,0
1796.864,6,362,23036,209,69,8638,69,12638,153,69,11821,69,10398
35.204,6,4695,4415158,3064,1362,11,1408,4325682,1631,931,21,2801,89476
25.121,6,20,3130,12,183,2283,517,1561,8,381,3587,499,1569
1785.457,6,359,22778,209,69,8583,69,12569,150,69,11982,69,10209
1.406,6,46,18674,27,859,54,1360,13138,19,476,67,2715,5536
240.825,6,45,9224,22,524,11467,1418,5870,23,238,10946,639,3354
1741.228,6,87,6322,58,31,30547,31,3915,29,31,62184,31,2407
0.006,17,2,598,1,34,0,34,62,1,508,0,508,536
20.5,6,26,4774,12,204,1863,722,1644,14,299,1531,1408,3130
1789.205,17,83,3480,82,14,22088,14,3444,1,8,0,8,36
1787.089,6,133,10154,76,86,23827,208,6944,57,31,31904,31,3210
1737.038,1,56,4704,56,56,31582,56,4704,0,0,0,0,0
1799.508,17,485,181468,485,346,3717,548,181468,0,0,0,0,0
1775.558,1,58,4872,0,0,0,0,0,58,56,31150,56,4872
7.6,6,12,945,6,222,1517,222,466,6,231,1517,231,479
0.032,17,2,338,1,33,0,33,61,1,249,0,249,277
0.541,6,23,7428,13,273,45,663,2052,10,1209,56,2736,5376
421.127,2,7,224,7,8,70187,8,224,0,0,0,0,0
630.059,2,6,192,6,8,126011,8,192,0,0,0,0,0
15.542,17,22,8813,10,379,1723,1350,4077,12,366,1409,1350,4736
15.64,6,6,264,1,0,0,0,44,5,0,3847,0,220
1786.647,6,109,8644,68,66,26666,66,4964,41,60,44663,60,3680
10.803,6,8,440,4,0,3601,0,216,4,0,3589,0,224
1788.439,17,87,3648,86,14,21040,14,3612,1,8,0,8,36
300.473,6,70,54694,44,1312,6987,1448,46918,26,802,1087,1448,7776
0.037,17,4,284,2,32,30,32,120,2,54,29,60,164
1799.671,17,4266,204768,2133,20,844,20,102384,2133,20,844,20,102384
0.003,17,2,548,2,246,3,246,548,0,0,0,0,0
1798.91,1,59,4956,59,56,31015,56,4956,0,0,0,0,0
1772.397,6,180,15480,120,69,14894,69,8940,60,69,30038,69,6540
1.007,6,10,1687,7,100,167,100,384,3,1179,370,1179,1303
17.625,6,24,2944,13,145,1468,145,826,11,827,1469,827,2118
62.207,6,27,7177,13,155,5183,267,1306,14,530,4784,2840,5871
369.526,6,23,1538,16,180,24635,180,1056,7,110,10382,110,482
1759.404,6,133,8155,71,27,25133,27,4289,62,27,28841,27,3866
1.553,6,38,8581,20,321,81,1360,3085,18,433,80,1360,5496
300.741,6,41,8549,21,232,15037,584,1826,20,422,470,1460,6723
1786.643,6,104,8376,68,65,26666,65,4930,36,59,51044,59,3446
315.988,6,69,13285,34,123,9575,615,3992,35,375,9289,4649,9293
1781.757,6,286,36242,115,136,15628,1360,16847,171,144,10480,1360,19395
0.451,6,100,69282,60,1269,7,1420,63377,40,467,11,2840,5905
0.618,6,25,6054,13,108,51,147,959,12,658,55,1430,5095
0.196,6,9,1002,5,213,49,213,417,4,421,48,421,585
20.428,1,3,346,3,87,10214,93,346,0,0,0,0,0
0.039,1,2,163,2,53,39,78,163,0,0,0,0,0
0.288,17,2,152,1,48,0,48,76,1,48,0,48,76
1771.565,6,82,4354,41,26,44288,26,2170,41,26,44288,26,2184
1763.31,2,11,352,11,8,176331,8,352,0,0,0,0,0
57.734,6,27,7421,6,165,1068,267,909,21,333,2886,1460,6512
1.339,6,50,19327,27,894,51,1460,13631,23,433,52,1460,5696
26.733,6,45,13769,21,299,1336,722,3242,24,683,1147,1380,10527
1767.808,1,58,4872,0,0,0,0,0,58,56,31014,56,4872
1.012,17,2,685,1,308,0,308,336,1,321,0,321,349
8.259,6,1565,1461027,972,1424,8,1448,1425515,593,776,13,1448,35512
1396.835,1,18,1008,18,28,82166,28,1008,0,0,0,0,0
0.572,6,10,2219,6,649,114,1141,1542,4,513,190,513,677
0.314,6,25,6032,12,164,28,453,1442,13,651,24,1440,4590
702.672,1,24,2016,24,56,30550,56,2016,0,0,0,0,0
100.868,6,24,10168,13,549,51,1360,2749,11,1161,10075,2720,7419
1782.352,6,433,26164,217,69,8251,69,13096,216,36,8289,69,13068
1.379,6,10,1687,7,100,229,100,384,3,1179,561,1179,1303
1.554,6,47,18624,27,852,59,1360,13048,20,476,70,2715,5576
2.16,6,34,8280,15,174,154,267,1653,19,418,104,1460,6627
4.684,6,41,7349,20,218,246,314,3423,21,513,219,1179,3926
0.629,6,7,295,4,0,209,0,164,3,7,210,7,131
1738.437,1,15,840,15,28,124174,28,840,0,0,0,0,0
378.076,2,3,96,3,8,189038,8,96,0,0,0,0,0
1.718,6,25,8703,15,275,122,557,1429,10,981,170,1420,7274
3.876,17,3,201,3,39,1938,39,201,0,0,0,0,0
5.022,17,4,328,2,46,5006,46,148,2,62,4996,62,180
1779.337,1,59,4956,0,0,0,0,0,59,56,30678,56,4956
1785.42,6,356,22520,208,69,8625,69,12460,148,69,12145,69,10060
756.13,2,5,160,5,8,189032,8,160,0,0,0,0,0
720.442,2,8,256,8,8,102920,8,256,0,0,0,0,0
24.529,6,24,3996,14,179,1886,517,1824,10,411,2724,499,2172
1790.693,1,122,6832,122,28,14799,28,6832,0,0,0,0,0
5.037,17,4,288,2,36,5006,36,128,2,52,5004,52,160
0.056,1,10,840,10,56,6,56,840,0,0,0,0,0
1772.768,6,180,15480,120,69,14897,69,8940,60,69,30041,69,6540
1799.305,6,355,22480,207,69,8734,69,12420,148,69,12240,69,10060
280.494,6,28,7352,13,158,23374,267,1317,15,775,20030,3465,6035
15.35,6,587,524148,369,1351,41,1368,507260,218,776,69,2736,16888
0.456,6,22,5040,11,137,45,267,1132,11,692,41,1467,3908
61.319,6,35,15901,22,807,2919,1408,9227,13,855,5088,3847,6674
0.508,6,10,1669,6,551,101,947,1346,4,159,169,159,323
0.163,17,2,255,1,43,0,43,71,1,156,0,156,184
11.491,6,26,13056,14,520,883,1252,2165,12,1299,1027,2368,10891
849.234,1,102,5712,102,28,8408,28,5712,0,0,0,0,0
0.233,6,420,558762,240,142,0,229,13203,180,3012,1,21120,545559
67.524,6,19,6623,11,634,6752,1069,2484,8,743,9638,1400,4139
271.222,17,4,240,2,32,271221,32,120,2,32,271221,32,120
1.756,6,15,1432,8,256,234,256,840,7,304,278,304,592
0.087,6,9,1002,5,213,21,213,417,4,421,23,421,585
0.461,6,20,7238,13,335,38,668,2026,7,1210,71,1946,5212
378.03,2,3,96,3,8,189015,8,96,0,0,0,0,0
1799.312,17,449,39928,404,35,4464,288,25708,45,288,40016,288,14220
1797.076,6,135,8464,75,46,24284,208,5103,60,31,30454,31,3361
2.149,2,3,96,3,8,1074,8,96,0,0,0,0,0
1782.661,17,83,3480,82,14,22008,14,3444,1,8,0,8,36
3.922,17,5,295,5,31,980,31,295,0,0,0,0,0
1775.473,17,223,25742,223,87,7997,362,25742,0,0,0,0,0
165.211,6,16,660,5,0,3044,0,204,11,0,16519,0,456
1.426,6,48,19282,27,896,54,1360,13666,21,476,61,2715,5616
1794.452,1,59,4956,59,56,30938,56,4956,0,0,0,0,0
1785.036,6,102,8296,68,65,26642,65,4930,34,59,54089,59,3366
1799.843,17,442,39136,398,35,4533,288,25232,44,288,40951,288,13904
0.256,17,2,194,1,61,0,61,89,1,77,0,77,105
0.169,6,12,624,0,0,0,0,0,12,0,0,0,624
1.822,17,2,279,1,36,0,36,64,1,187,0,187,215
1.606,6,41,10025,23,440,73,1360,4484,18,437,82,2720,5541
0.183,17,4,284,2,32,0,32,120,2,54,0,60,164
1788.189,6,358,22669,209,69,8597,69,12569,149,69,12082,69,10100
8.242,6,2001,1876163,1283,1385,6,1408,1834163,718,931,11,2816,42000
1772.128,6,180,15480,120,69,14891,69,8940,60,69,30031,69,6540
1796.159,6,367,25650,214,99,8432,469,15045,153,69,11816,69,10605
1187.307,17,218,16568,218,48,5471,48,16568,0,0,0,0,0
0.083,17,2,245,1,32,0,32,60,1,157,0,157,185
1.387,6,50,21369,28,970,51,1460,15713,22,433,56,1460,5656
5.794,6,9,520,4,0,1931,0,220,5,0,765,0,300
1746.964,6,149,9325,80,48,22113,208,5666,69,31,25687,31,3659
1772.454,6,180,15480,120,69,14894,69,8940,60,69,30032,69,6540
373.339,6,18,1242,14,180,28718,180,916,4,110,20057,110,326
0.022,17,2,154,1,33,0,33,61,1,65,0,65,93
0.253,6,24,5980,12,164,23,453,1442,12,781,22,2224,4538
2.316,6,12,3423,6,188,463,245,620,6,1279,410,1407,2803
3.893,17,4,268,4,39,1297,39,268,0,0,0,0,0
17.989,6,17,4217,9,267,2248,501,1165,8,681,2534,1420,3052
1743.222,6,96,7286,63,38,28116,205,4476,33,33,54461,98,2810
20.638,17,2,152,2,48,20638,48,152,0,0,0,0,0
0.009,17,2,382,1,33,0,33,61,1,293,0,293,321
1748.16,6,95,7203,63,38,28196,205,4476,32,33,56384,98,2727
10.698,6,20,4442,11,275,1069,275,998,9,768,741,1440,3444
4.879,6,39,7269,21,218,243,314,3463,18,513,271,1179,3806
1.022,17,8,568,4,32,337,32,240,4,54,336,60,328
280.415,6,29,7392,13,158,23367,267,1317,16,603,18692,2076,6075
1797.095,1,342,28728,342,56,5270,56,28728,0,0,0,0,0
1.33,6,25,8056,12,164,102,267,1288,13,869,93,1448,6768
1744.541,6,95,7203,63,38,28137,205,4476,32,33,56263,98,2727
4.075,17,10,1287,5,31,1016,31,295,5,170,1015,196,992
1.911,6,52,22438,28,972,70,1460,16702,24,433,74,1460,5736
1221.35,17,113,9712,104,30,11857,37,6067,9,377,145199,463,3645
2.678,6,17,4523,10,327,291,634,1836,7,767,441,1328,2687
43.046,17,4,352,2,60,43045,60,176,2,60,43044,60,176
280.482,6,29,7392,13,158,23373,267,1317,16,678,18690,2760,6075
317.042,6,85,20366,39,326,8343,1360,10085,46,280,7042,4649,10281
1789.745,6,362,22898,210,69,8563,69,12678,152,69,11852,69,10220
15.232,17,24,16802,12,946,1381,1350,11699,12,397,1381,1350,5103
0.415,17,2,152,1,48,0,48,76,1,48,0,48,76
1794.313,17,144,11520,72,48,25271,48,5472,72,56,25271,56,6048
5.043,17,4,804,2,41,5034,41,138,2,305,5031,305,666
61.702,6,30,7432,13,158,5141,267,1317,17,543,3854,1400,6115
2.03,6,51,20986,28,942,75,1440,15290,23,433,80,1440,5696
0.01,6,3,120,0,0,0,0,0,3,0,0,0,120
0.156,17,2,2384,2,1164,156,1164,2384,0,0,0,0,0
1782.771,17,83,3480,82,14,22009,14,3444,1,8,0,8,36
1773.283,6,180,15480,120,69,14901,69,8940,60,69,30051,69,6540
240.361,6,46,9367,24,523,10450,1408,5978,22,223,11445,618,3389
0.0,17,1,316,1,288,0,288,316,0,0,0,0,0
1798.74,17,759,45807,759,32,2373,37,45807,0,0,0,0,0
21.799,6,9,577,0,0,0,0,0,9,31,2724,31,577
280.221,6,26,7272,12,158,25474,267,1277,14,775,21552,3445,5995
0.801,17,4,624,2,64,489,64,184,2,192,523,192,440
37.621,17,44,6468,22,48,1791,48,1672,22,190,1790,308,4796
1741.364,6,88,6374,58,31,30550,31,3915,30,31,60044,31,2459
1798.159,1,16,896,16,28,119877,28,896,0,0,0,0,0
7.273,6,3,127,1,0,0,0,40,2,7,0,7,87
240.24,6,56,20595,30,840,8283,1418,17531,26,213,9609,580,3064
372.173,6,26,1703,17,177,23260,177,1117,9,110,8900,110,586
32.383,6,6,340,5,0,8095,0,280,1,0,0,0,60
11.377,6,38,13962,18,223,669,721,2291,20,905,542,1420,11671
1790.943,6,257,46635,125,838,14443,1418,33458,132,61,13671,580,13177
12.178,6,24,6983,7,146,2029,267,1018,17,479,756,1460,5965
9.352,6,85,27354,43,572,222,1152,21192,42,407,221,1152,6162
62.984,6,7,759,5,304,15746,304,572,2,83,55956,83,187
0.253,17,2,214,1,39,0,39,67,1,119,0,119,147
0.115,17,2,245,1,32,0,32,60,1,157,0,157,185
315.829,6,120,35400,58,498,5540,1360,23799,62,239,5157,4649,11601
1740.551,1,128,7168,128,28,13705,28,7168,0,0,0,0,0
7.039,6,1401,1282579,875,1388,7,1408,1250539,526,776,13,1408,32040
1.386,6,46,18907,27,875,53,1360,13371,19,476,66,2715,5536
2.887,17,8,792,4,39,962,39,268,4,103,961,103,524
0.159,17,2,198,1,63,0,63,91,1,79,0,79,107
1772.807,6,180,15480,120,69,14897,69,8940,60,69,30045,69,6540
1782.543,17,83,3480,82,14,22006,14,3444,1,8,0,8,36
1401.449,17,12,888,6,30,280285,30,348,6,62,280285,62,540
0.192,17,4,284,2,32,0,32,120,2,54,1,60,164
299.6,6,8,475,5,31,74900,31,262,3,31,149793,31,213
503.285,2,3,96,3,8,251642,8,96,0,0,0,0,0
95.244,6,37,5417,21,180,4762,722,2182,16,299,1084,1448,3235
1799.111,6,376,26217,217,98,8329,469,15372,159,69,11386,69,10845
1798.452,17,332,70575,332,184,5433,364,70575,0,0,0,0,0
48.56,6,7,328,2,0,48560,0,88,5,0,3858,0,240
240.536,6,49,6528,22,213,11454,585,3098,27,168,9251,580,3430
0.035,17,4,420,2,33,0,33,122,2,121,1,145,298
0.164,6,9,1340,5,145,41,145,349,4,827,31,827,991
33.875,6,30,5077,15,154,2419,721,1894,15,399,2405,2026,3183
1741.723,17,30,20190,30,645,60059,645,20190,0,0,0,0,0
3.931,6,5,280,2,0,3931,0,100,3,0,1184,0,180
37.85,17,11,836,11,48,3785,48,836,0,0,0,0,0
1.248,17,4,694,3,32,614,32,180,1,486,0,486,514
10.541,6,9,1738,6,95,2108,100,435,3,1179,3224,1179,1303
13.72,17,8,704,4,48,4569,48,304,4,72,4569,72,400
300.959,6,28,8082,12,204,27343,467,1448,16,483,20051,2688,6634
117.162,17,4,304,2,48,117148,48,152,2,48,117147,48,152
12.637,6,1914,1698824,1201,1362,10,1380,1664139,713,558,17,1923,34685
240.224,6,57,20377,31,837,8007,1418,17535,26,185,9608,580,2842
49.759,6,17,700,9,0,6218,0,364,8,0,7107,0,336
75.538,6,31,7613,12,155,29,267,1266,19,398,4196,3417,6347
0.019,17,2,283,1,31,0,31,59,1,196,0,196,224
1769.523,1,58,4872,58,56,31044,56,4872,0,0,0,0,0
0.197,6,10,1042,5,213,49,213,417,5,421,40,421,625
1799.929,6,367,25650,214,99,8450,469,15045,153,69,11840,69,10605
1606.03,1,64,6784,64,78,25492,78,6784,0,0,0,0,0
0.019,17,2,162,1,36,0,36,64,1,70,0,70,98
300.583,6,39,8511,20,291,15820,786,1997,19,441,469,1440,6514
15.706,6,27,6249,15,282,1121,546,1454,12,716,1319,1420,4795
122.269,6,29,13740,16,739,808,1360,5111,13,1012,10172,1791,8629
1.457,1,10,840,10,56,161,56,840,0,0,0,0,0
3.286,6,2,88,2,0,0,0,88,0,0,0,0,0
0.099,6,3,156,0,0,0,0,0,3,0,0,0,156
0.249,6,21,5512,10,150,27,267,1156,11,652,23,1400,4356
49.028,6,57,12022,32,180,1581,517,4068,25,473,2042,499,7954
66.947,6,25,7097,12,155,6086,267,1266,13,589,5578,3426,5831
1799.071,1,59,4956,59,56,31018,56,4956,0,0,0,0,0
280.562,6,30,7432,13,158,23380,267,1317,17,603,17526,2076,6115
7.334,6,5,220,1,0,0,0,44,4,0,2360,0,176
144.535,17,12,2000,6,48,28905,48,456,6,229,28905,308,1544
300.792,6,38,8566,20,315,15831,882,2093,18,441,501,1440,6473
229.183,6,5,293,4,31,76394,31,222,1,31,0,31,71
0.073,6,2,104,0,0,0,0,0,2,0,0,0,104
0.307,17,2,166,1,39,0,39,67,1,71,0,71,99
91.084,6,42,9849,18,236,5356,1189,3088,24,413,3959,1420,6761
1.523,17,3,1170,3,362,761,362,1170,0,0,0,0,0
1795.929,17,142,11360,71,48,25655,48,5396,71,56,25655,56,5964
113.939,6,25,10354,12,579,60,1360,2855,13,995,9484,1360,7499
20.454,6,10,2516,9,256,2556,365,2412,1,64,0,64,104
252.362,2,2,64,2,8,252362,8,64,0,0,0,0,0
1786.624,6,102,8364,68,66,26666,66,4964,34,60,54136,60,3400
1764.14,2,15,480,15,8,126010,8,480,0,0,0,0,0
1788.592,6,363,23007,211,69,8517,69,12787,152,69,11842,69,10220
1783.442,17,73,3060,72,14,25118,14,3024,1,8,0,8,36
1788.302,17,87,3648,86,14,21038,14,3612,1,8,0,8,36
1771.416,6,99,9306,66,66,27252,66,5610,33,60,55353,60,3696
1795.03,1,342,28728,342,56,5264,56,28728,0,0,0,0,0
1786.64,6,141,20826,86,248,21019,1302,14139,55,101,33084,268,6687
10.001,17,3,3212,3,1042,5000,1044,3212,0,0,0,0,0
1783.816,6,353,22400,206,69,8701,69,12380,147,69,12217,69,10020
0.022,17,2,182,1,39,0,39,67,1,87,0,87,115
1794.217,17,80,3354,79,14,23002,14,3318,1,8,0,8,36
1785.861,6,365,25501,212,100,8463,469,14896,153,69,11749,69,10605
1781.945,17,140,11200,70,48,25825,48,5320,70,56,25825,56,5880
1797.815,1,270,15120,270,28,6683,28,15120,0,0,0,0,0
1785.861,6,102,8364,68,66,26654,66,4964,34,60,54114,60,3400
1792.855,6,356,22520,208,69,8661,69,12460,148,69,12195,69,10060
1796.593,6,416,24920,208,69,8679,69,12460,208,34,8679,48,12460
1795.644,17,497,61229,244,157,7389,1350,45229,253,35,7115,1350,16000
1792.787,17,144,11520,72,48,25250,48,5472,72,56,25250,56,6048
371.261,6,25,1651,17,177,23203,177,1117,8,110,9236,110,534
495.188,6,8,475,6,31,99037,31,333,2,31,299540,31,142
0.089,6,3,120,2,0,89,0,80,1,0,0,0,40
300.769,6,39,8574,21,286,15038,797,2040,18,446,499,3488,6534
1683.321,17,14,1036,7,30,280547,30,406,7,62,280548,62,630
1787.796,6,102,8296,68,65,26683,65,4930,34,59,54173,59,3366
3.245,6,13,2311,8,188,463,245,700,5,703,155,1152,1611
0.006,6,2,426,1,334,0,334,386,1,0,0,0,40
102.684,17,4,824,2,48,102676,48,152,2,308,102677,308,672
5.782,6,1718,1598917,1089,1390,5,1408,1561545,629,931,8,2801,37372
1681.866,17,14,1036,7,30,280308,30,406,7,62,280309,62,630
0.146,6,10,1673,6,553,29,949,1350,4,159,48,159,323
2.793,17,2,178,1,29,0,29,57,1,93,0,93,121
299.929,6,12,790,4,31,99976,31,222,8,31,42843,31,568
1775.38,17,138,11040,69,48,26108,48,5244,69,56,26108,56,5796
1791.495,1,15,1927,15,100,127963,173,1927,0,0,0,0,0
372.119,6,22,2380,16,184,24807,184,856,6,424,4653,434,1524
1.009,6,12,1653,6,288,196,288,548,6,426,108,434,1105
1.53,6,39,9888,21,440,76,1360,4392,18,433,77,1360,5496
8.099,6,1817,1688186,1157,1381,6,1408,1649202,660,931,12,2816,38984
10.014,17,2,124,2,34,10014,34,124,0,0,0,0,0
28.346,17,4,947,2,33,28338,37,123,2,384,28337,463,824
2.431,17,31,13303,13,512,202,1350,7021,18,321,118,1350,6282
1681.889,1,8,448,8,28,240269,28,448,0,0,0,0,0
0.147,6,9,1344,5,145,36,145,349,4,831,45,831,995
1794.99,6,359,22709,209,69,8629,69,12569,150,69,12046,69,10140
1773.095,6,180,15480,120,69,14899,69,8940,60,69,30050,69,6540
1791.216,6,259,37906,159,302,11336,302,27350,100,83,18092,83,10556
6.1,6,37,13281,19,219,338,531,1929,18,1039,348,1448,11352
24.925,17,4,240,2,32,24924,32,120,2,32,24924,32,120
0.511,6,535,507692,329,183,1,230,18841,206,2343,2,16413,488851
27.47,17,8,608,8,48,3924,48,608,0,0,0,0,0
1799.963,17,448,39896,403,35,4477,288,25676,45,288,40019,288,14220
1789.423,17,142,11360,71,48,25563,48,5396,71,56,25563,56,5964
1.329,6,40,8389,20,320,69,1162,2768,20,400,60,1360,5621
170.357,6,224,173036,136,1293,1261,1368,158470,88,679,1443,2519,14566
1.005,6,43,18095,25,846,41,1188,13146,18,400,54,658,4949
95.555,17,4,1344,4,308,31851,308,1344,0,0,0,0,0
1799.999,6,213,16920,78,74,22987,374,8142,135,49,13432,144,8778
0.759,6,28,5760,14,121,58,267,1295,14,650,53,1420,4465
11.135,6,20,4442,11,275,1113,275,998,9,768,781,1440,3444
280.239,6,30,7432,13,158,23353,267,1317,17,543,17514,1400,6115
300.872,6,39,9691,20,547,15835,1360,4129,19,399,480,1360,5562
1684.526,2,18,576,18,8,99089,8,576,0,0,0,0,0
1743.082,6,94,7151,62,38,28575,205,4424,32,33,56222,98,2727
1799.084,1,160,8960,160,28,11314,28,8960,0,0,0,0,0
0.15,1,10,280,10,0,0,0,280,0,0,0,0,0
1764.269,2,14,448,14,8,135713,8,448,0,0,0,0,0
1773.014,6,181,15589,120,69,14899,69,8940,61,69,29544,69,6649
87.606,6,23,952,9,0,6895,0,368,14,0,6735,0,584
6.263,2,2,64,2,8,6263,8,64,0,0,0,0,0
1794.859,6,103,6697,67,45,27194,208,4327,36,31,51273,31,2370
1770.873,6,100,9292,66,65,27244,65,5577,34,59,53659,59,3715
1754.188,6,95,7203,63,38,28293,205,4476,32,33,56572,98,2727
7.296,6,14,2245,8,211,1042,211,846,6,545,1448,904,1399
1.07,17,2,148,2,46,1070,46,148,0,0,0,0,0
1791.014,6,365,23087,211,69,8528,69,12787,154,69,11705,69,10300
18.37,17,62,16089,62,231,301,389,16089,0,0,0,0,0
1778.746,1,272,28832,272,78,6563,78,28832,0,0,0,0,0
67.696,6,28,7286,13,155,5641,267,1306,15,488,4834,3417,5980
68.454,6,78,29769,41,728,1707,1440,21346,37,533,1896,1440,8423
13.815,17,16,2352,8,48,1971,48,608,8,190,1971,308,1744
244.09,6,15,1481,5,191,14,191,459,10,247,27119,462,1022
0.011,17,2,570,1,30,0,30,58,1,484,0,484,512
1782.641,6,365,29046,210,75,8529,267,13533,155,132,11575,1460,15513
1059.422,6,87,9297,48,71,22537,722,4159,39,107,27874,2026,5138
217.304,6,154,23477,80,304,2750,304,16192,74,83,2971,83,7285
11.837,6,25,8453,13,275,986,275,1078,12,983,853,1420,7375
0.329,6,3,189,1,0,0,0,40,2,69,212,69,149
1.102,6,23,7952,11,164,93,267,1236,12,1014,85,2423,6716
61.279,6,37,15816,22,788,2918,1448,9038,15,665,4359,1448,6778
0.064,17,2,254,1,76,0,76,104,1,122,0,122,150
369.548,6,25,1651,17,177,23096,177,1117,8,110,9216,110,534
11.988,6,19,4398,10,275,1332,275,954,9,768,900,1440,3444
86.491,17,4,240,2,32,86490,32,120,2,32,86490,32,120
1797.313,1,58,4872,58,56,31531,56,4872,0,0,0,0,0
240.25,6,53,18214,28,817,8897,1402,15365,25,192,10010,580,2849
5.354,6,40,7309,21,218,267,314,3463,19,513,282,1179,3846
0.347,6,12,3702,6,170,69,170,490,6,964,47,1448,3212
10.256,6,18,4170,10,275,1139,275,958,8,1440,1118,1440,3212
0.319,6,27,9069,13,261,26,683,1728,14,943,23,1438,7341
0.511,17,14,6932,7,613,85,1350,4490,7,320,59,1350,2442
0.548,17,3,1167,3,361,274,361,1167,0,0,0,0,0
65.929,6,35,17003,19,1014,3662,1448,9134,16,702,4381,1448,7869
1784.718,6,288,38013,119,155,15123,1360,18614,169,148,10622,4662,19399
1781.484,17,44,14784,44,308,41429,308,14784,0,0,0,0,0
1799.832,17,448,39612,404,35,4466,288,25708,44,288,40950,288,13904
0.008,17,2,167,1,39,0,39,67,1,72,0,72,100
0.0,17,1,72,1,44,0,44,72,0,0,0,0,0
131.864,6,143,113622,93,1305,1433,1448,101451,50,683,2422,2359,12171
1773.405,6,181,15589,120,69,14902,69,8940,61,69,29550,69,6649
3.079,17,8,628,4,31,1016,31,236,4,70,1004,70,392
301.69,6,37,8499,20,308,15878,888,2067,17,478,574,2920,6432
0.143,17,4,390,2,44,38,44,144,2,95,3,95,246
1775.617,17,116,9384,58,49,31151,136,4496,58,56,31151,72,4888
5.441,17,4,240,2,32,5440,32,120,2,32,5440,32,120
299.945,1,4,224,4,28,99981,28,224,0,0,0,0,0
127.167,6,19,3426,8,92,18166,92,504,11,260,12697,1408,2922
15.26,6,23,4039,13,211,1267,211,1325,10,545,1695,904,2714
1.344,6,50,19767,27,925,51,1460,14071,23,433,51,1460,5696
1.932,17,4,580,2,40,1921,40,136,2,194,1913,194,444
1772.881,6,180,15480,120,69,14898,69,8940,60,69,30041,69,6540
1755.441,6,137,8398,75,42,23722,208,4957,62,31,28769,31,3441
1603.367,1,8,448,8,28,229052,28,448,0,0,0,0,0
0.001,17,2,144,1,36,0,36,64,1,52,0,52,80
1788.031,1,167,9352,167,28,10771,28,9352,0,0,0,0,0
141.259,6,24,6229,10,181,15695,293,1309,14,725,10846,1179,4920
244.19,2,23,960,23,17,11099,24,960,0,0,0,0,0
374.696,6,18,1242,14,180,28822,180,916,4,110,20073,110,326
2.606,6,18,3257,10,99,270,182,924,8,477,348,1343,2333
190.341,17,4,352,2,60,190339,60,176,2,60,190340,60,176
1.537,6,10,924,5,283,244,283,551,5,105,271,105,373
0.088,6,9,1348,5,145,22,145,349,4,835,27,835,999
301.071,6,42,11036,23,566,13685,1460,3834,19,494,492,2194,7202
2.232,17,33,26507,17,970,139,1350,16976,16,567,146,1350,9531
426.571,6,66,10738,35,96,12545,267,3152,31,243,14218,1420,7586
1215.895,6,260,46713,109,362,11258,1360,27136,151,120,8105,3289,19577
65.827,1,2,232,2,88,65827,88,232,0,0,0,0,0
1799.916,6,375,26577,216,104,8371,469,15732,159,69,11391,69,10845
1772.274,6,180,15480,120,69,14893,69,8940,60,69,30036,69,6540
1771.996,6,180,15480,120,69,14890,69,8940,60,69,30033,69,6540
1.328,6,48,20103,27,955,51,1460,14487,21,433,57,1460,5616
176.024,6,26,6649,12,274,15998,517,1456,14,744,13536,1418,5193
53.708,6,26,7317,7,165,915,267,949,19,373,2966,1917,6368
0.105,6,2,92,1,0,0,0,40,1,0,0,0,52
159.041,1,2,112,2,28,159041,28,112,0,0,0,0,0
297.619,6,34,8006,12,158,27056,267,1277,22,389,14171,1400,6729
0.328,17,8,2742,8,314,46,353,2742,0,0,0,0,0
1787.409,6,104,8376,68,65,26677,65,4930,36,59,51065,59,3446
1798.189,1,196,10976,196,28,9221,28,10976,0,0,0,0,0
75.857,17,6,528,3,60,37928,60,264,3,60,37928,60,264
1765.161,17,18,1413,9,30,220643,37,529,9,70,220641,136,884
1795.054,6,360,22818,209,69,8630,69,12569,151,69,11966,69,10249
0.435,6,25,8965,13,261,36,683,1728,12,1100,37,2896,7237
1720.454,17,12,498,11,14,172045,14,462,1,8,0,8,36
1740.183,6,87,6322,58,31,30529,31,3915,29,31,62149,31,2407
0.431,6,12,1653,6,288,83,288,548,6,426,49,434,1105
27.755,6,45,8895,22,153,1321,721,2420,23,504,1214,1420,6475
4.188,6,47,8962,23,320,190,1162,2924,24,337,171,1460,6038
1.008,17,2,925,1,548,0,548,576,1,321,0,321,349
1.446,17,4,612,2,33,998,33,122,2,217,25,217,490
39.667,6,21,6596,6,154,7933,267,712,15,527,2823,1460,5884
11.462,17,46,10286,20,247,601,1350,5515,26,155,457,1350,4771
18.678,6,6923,6964673,2381,297,7,297,124117,4542,1455,4,5792,6840556
0.825,6,34,7934,20,289,43,693,2872,14,561,49,2744,5062
1.653,6,14,2351,8,188,236,245,700,6,703,278,1152,1651
1782.119,17,46,15456,46,308,39602,308,15456,0,0,0,0,0
73.72,6,65,42723,41,1163,1843,1448,34722,24,749,2671,1448,8001
1779.976,1,342,28728,342,56,5219,56,28728,0,0,0,0,0
1702.456,17,13,540,12,14,154768,14,504,1,8,0,8,36
15.311,6,13,6056,4,222,5060,222,402,9,1760,1897,4848,5654
316.973,6,121,36918,59,502,5465,1360,24995,62,241,5194,1929,11923
1764.424,2,15,480,15,8,126030,8,480,0,0,0,0,0
3.456,6,2,88,2,0,0,0,88,0,0,0,0,0
0.325,6,27,9027,13,244,27,618,1663,14,946,24,2816,7364
2.225,6,31,6526,18,164,130,267,2050,13,564,118,1420,4476
486.907,17,4,602,4,122,162302,352,602,0,0,0,0,0
399.261,17,56,4666,52,30,7828,37,3030,4,381,113535,463,1636
1767.93,6,125,8294,72,55,24900,208,5275,53,31,33993,31,3019
15.152,6,5,706,3,46,7576,46,166,2,460,14962,460,540
1741.034,6,87,6322,58,31,30544,31,3915,29,31,62179,31,2407
4.66,17,4,824,2,48,4653,48,152,2,308,4653,308,672
0.013,17,2,481,1,48,0,48,76,1,377,0,377,405
1783.325,17,73,3060,72,14,25117,14,3024,1,8,0,8,36
1744.649,2,29,928,29,8,62308,8,928,0,0,0,0,0
1742.51,6,96,7286,63,38,28105,205,4476,33,33,54445,98,2810
1781.79,6,354,22440,207,69,8649,69,12420,147,69,12203,69,10020
281.814,6,60,8723,28,158,10437,267,1917,32,502,9078,1400,6806
240.195,6,54,18047,29,805,8578,1402,15212,25,190,10007,580,2835
0.118,17,4,284,2,32,44,32,120,2,54,75,60,164
0.084,17,2,154,1,33,0,33,61,1,65,0,65,93
280.04,6,27,7312,13,158,23336,267,1317,14,775,21538,2800,5995
64.677,6,21,8140,11,500,85,1194,1973,10,1151,7166,3151,6167
1759.318,6,135,9796,75,75,23774,208,6311,60,31,29811,31,3485
240.222,6,57,20136,31,827,8007,1418,17334,26,180,9608,580,2802
1799.58,17,449,39928,404,35,4465,288,25708,45,288,40020,288,14220
65.171,6,44,8971,20,410,588,882,2134,24,345,2827,1360,6837
11.937,6,1881,1644782,1163,1362,10,1380,1608505,718,683,16,3303,36277
12.013,17,6,376,5,32,3003,32,300,1,48,0,48,76
0.77,6,24,8039,14,334,59,663,2085,10,1082,80,3314,5954
1.999,17,2,116,2,30,1999,30,116,0,0,0,0,0
1791.133,6,356,22520,208,69,8652,69,12460,148,69,12184,69,10060
1.214,6,46,18124,26,882,48,1360,12548,20,433,55,1360,5576
1248.038,1,44,2464,44,28,29024,28,2464,0,0,0,0,0
1744.32,1,8,448,8,28,249188,28,448,0,0,0,0,0
138.986,17,50,7468,25,48,5790,48,1900,25,194,5790,308,5568
1741.389,6,90,6552,60,31,29515,31,4062,30,31,60047,31,2490
2.605,6,14,2351,8,188,372,245,700,6,703,469,1152,1651
1775.422,17,73,3060,72,14,25005,14,3024,1,8,0,8,36
841.351,1,8,652,8,53,120193,78,652,0,0,0,0,0
1791.75,6,355,22480,205,69,8783,69,12409,150,69,12023,69,10071
1785.182,17,87,3648,86,14,21002,14,3612,1,8,0,8,36
0.126,17,2,198,1,37,0,37,65,1,105,0,105,133
280.081,6,29,7392,14,158,21544,267,1357,15,678,20000,3436,6035
86.942,17,2,457,2,200,86942,355,457,0,0,0,0,0
287.798,17,4,352,2,60,287797,60,176,2,60,287797,60,176
1789.95,6,368,25552,213,99,8443,469,15005,155,69,11623,69,10547
16.601,17,4,1344,4,308,5533,308,1344,0,0,0,0,0
1.361,6,50,20183,27,955,52,1460,14487,23,433,53,1460,5696
176.895,6,23,10713,11,386,70,844,1632,12,1227,16069,1460,9081
1779.799,1,342,28728,342,56,5219,56,28728,0,0,0,0,0
1762.721,1,73,6132,73,56,24482,56,6132,0,0,0,0,0
0.033,17,8,1670,8,180,4,219,1670,0,0,0,0,0
240.209,6,57,19654,31,793,8006,1408,16702,26,199,9608,580,2952
1.534,6,42,10594,21,513,76,1360,4978,21,433,66,1360,5616
280.445,6,29,7392,13,158,23370,267,1317,16,603,18693,2236,6075
1.486,6,24,8004,12,164,115,267,1288,12,1014,116,2491,6716
126.68,17,4,352,2,60,126678,60,176,2,60,126679,60,176
1797.037,1,58,4872,58,56,31526,56,4872,0,0,0,0,0
1783.811,6,366,24672,211,88,8494,469,13987,155,69,11583,69,10685
45.036,1,2,221,2,82,45036,89,221,0,0,0,0,0
1768.823,6,101,9344,66,65,27212,65,5577,35,59,52020,59,3767
1746.968,6,104,7800,66,38,26876,205,4725,38,33,47206,98,3075
9.847,6,19,2562,12,210,891,210,1112,7,545,1635,904,1450
106.727,1,2,120,2,32,106727,32,120,0,0,0,0,0
1786.334,6,364,25930,209,105,8588,469,15245,155,69,11597,69,10685
14.813,17,12,1764,6,48,2961,48,456,6,190,2960,308,1308
8.462,6,1534,1400364,963,1377,8,1408,1366008,571,931,14,2801,34356
1740.462,17,30,20190,30,645,60015,645,20190,0,0,0,0,0
1645.476,1,7,392,7,28,274246,28,392,0,0,0,0,0
157.422,6,21,8321,11,532,88,1257,2068,10,973,17472,2720,6253
1792.629,17,144,11520,72,48,25248,48,5472,72,56,25248,56,6048
10.594,17,2,152,2,48,10594,48,152,0,0,0,0,0
38.748,6,5242,5027847,3496,1361,11,1408,4932391,1746,931,22,2801,95456
42.324,6,23,5793,13,107,3527,159,1138,10,825,4702,1668,4655
238.371,17,66,2660,15,12,3959,16,612,51,12,4767,16,2048
1795.35,17,144,11520,72,48,25286,48,5472,72,56,25286,56,6048
2.243,17,2,685,1,308,0,308,336,1,321,0,321,349
0.005,17,2,570,1,30,0,30,58,1,484,0,484,512
0.102,17,2,225,1,37,0,37,65,1,132,0,132,160
240.191,6,51,15727,27,727,9237,1402,13044,24,203,10442,580,2683
2.679,17,2,170,1,37,0,37,65,1,77,0,77,105
145.416,17,4,352,2,60,145415,60,176,2,60,145415,60,176
1797.331,1,345,28980,345,56,5224,56,28980,0,0,0,0,0
0.209,17,3,240,3,52,104,52,240,0,0,0,0,0
1151.435,17,90,7200,45,48,26168,48,3420,45,56,26168,56,3780
31.112,6,49,10455,23,533,693,910,3147,26,312,1239,1460,7308
1744.251,6,132,13134,81,67,21803,722,6848,51,84,34878,1408,6286
1740.542,6,87,6322,58,31,30535,31,3915,29,31,62161,31,2407
1.948,17,4,518,3,39,873,39,201,1,289,0,289,317
11.378,6,21,6825,12,275,1034,275,1038,9,1353,795,1440,5787
0.482,17,18,5617,8,361,66,1350,3117,10,222,48,1350,2500
22.475,6,9,392,8,0,3210,0,348,1,0,0,0,44
0.174,6,41,15991,23,916,7,1420,11050,18,420,9,1420,4941
268.858,6,157,65941,79,745,3446,1152,57588,78,402,3488,1179,8353
526.753,6,10,586,6,31,105350,31,333,4,31,175575,31,253
1138.077,6,228,14433,133,69,8621,69,8011,95,69,12106,69,6422
11.58,6,15,6634,4,275,3860,275,439,11,639,1111,2840,6195
2.05,6,63,43581,38,1228,55,1368,36376,25,982,76,2491,7205
0.407,6,5,1564,3,413,203,413,946,2,269,185,269,618
630.041,2,4,128,4,8,210013,8,128,0,0,0,0,0
0.008,17,2,363,1,29,0,29,57,1,278,0,278,306
0.034,6,9,1340,5,145,8,145,349,4,827,7,827,991
1741.929,1,78,6552,0,0,0,0,0,78,56,22622,56,6552
3.928,17,51,39720,20,372,206,1350,8018,31,994,116,1350,31702
280.206,6,30,7432,13,158,23350,267,1317,17,543,17510,1300,6115
0.392,6,21,6405,12,221,35,221,733,9,883,22,3488,5672
1581.298,17,95,9864,83,30,19283,37,4856,12,389,143753,463,5008
27.807,6,4009,3880893,2684,1370,10,1408,3807305,1325,931,20,2801,73588
0.465,17,2,152,1,48,0,48,76,1,48,0,48,76
0.015,17,4,809,2,33,1,33,122,2,315,3,327,687
1776.525,6,180,15480,120,69,14928,69,8940,60,69,30101,69,6540
26.086,6,18,2511,8,483,3726,483,1402,10,83,2896,83,1109
1788.573,6,355,22480,207,69,8682,69,12420,148,69,12167,69,10060
1787.703,6,117,13763,75,81,24158,504,5920,42,162,43600,1452,7843
503.263,17,15,5535,15,341,35947,461,5535,0,0,0,0,0
1798.281,1,38,2128,38,28,48602,28,2128,0,0,0,0,0
1796.521,6,356,22520,208,69,8678,69,12460,148,69,12221,69,10060
9.274,17,31,12193,13,469,770,1350,6464,18,290,543,1350,5729
351.293,17,8,2688,8,308,50184,308,2688,0,0,0,0,0
0.547,6,13,6011,5,517,136,517,773,8,1203,72,1418,5238
827.123,1,10,560,10,28,91902,28,560,0,0,0,0,0
1740.428,6,87,6322,58,31,30533,31,3915,29,31,62157,31,2407
383.977,6,6,519,6,46,76795,62,519,0,0,0,0,0
281.745,6,33,7781,13,158,23478,267,1317,20,435,14803,1400,6464
1.632,6,29,10386,17,367,102,833,1785,12,1014,140,1414,8601
256.051,6,21,8187,8,94,36577,106,707,13,869,21336,1460,7480
1785.378,1,112,6272,112,28,16084,28,6272,0,0,0,0,0
1761.915,6,105,8760,73,66,24471,66,5560,32,60,54139,60,3200
0.06,17,2,148,1,32,0,32,60,1,60,0,60,88
1789.954,6,380,24032,216,69,8325,69,13332,164,69,10981,69,10700
4.284,6,33,6113,18,206,252,314,2784,15,545,286,1179,3329
1.472,17,23,13299,12,895,131,1350,11085,11,173,144,1350,2214
1.183,6,26,9564,13,164,84,267,1388,13,1070,83,2816,8176
15.614,17,13,6733,7,612,2596,1350,4486,6,346,3115,1350,2247
4.996,6,37,7173,19,218,277,314,3383,18,511,278,1179,3790
14.016,6,22,8285,13,275,1168,275,1078,9,1708,1125,2840,7207
280.215,6,30,7432,13,158,23351,267,1317,17,543,17510,1400,6115
1792.878,17,179,13962,179,50,10072,50,13962,0,0,0,0,0
167.721,6,24,10306,12,433,71,990,1847,12,995,15236,1390,8459
20.093,6,20,5366,12,107,1826,159,1074,8,967,2869,1675,4292
397.385,6,17,1190,13,180,33115,180,864,4,110,20170,110,326
396.224,6,35,8280,15,168,11667,516,1615,20,344,20849,1452,6665
1798.465,17,443,38032,404,35,4462,288,25708,39,288,46394,288,12324
1.226,6,46,18854,27,871,47,1360,13318,19,476,58,2715,5536
1.295,6,36,8174,19,321,71,1164,2718,17,529,70,4075,5456
1799.903,17,348,26448,348,48,5187,48,26448,0,0,0,0,0
98.423,17,60,17888,27,353,3784,1350,10310,33,201,3074,1350,7578
165.978,6,20,3483,7,92,27663,92,452,13,235,13814,1408,3031
252.77,2,3,96,3,8,126385,8,96,0,0,0,0,0
0.277,17,2,384,1,39,0,39,67,1,289,0,289,317
0.366,17,8,2750,8,315,52,354,2750,0,0,0,0,0
415.193,17,56,54954,56,953,7548,1451,54954,0,0,0,0,0
1.352,6,53,23887,30,997,46,1460,18191,23,476,53,2615,5696
11.656,6,1851,1610670,1117,1386,10,1420,1577089,734,467,15,1883,33581
0.932,6,10,1687,7,100,155,100,384,3,1179,345,1179,1303
0.011,6,12,3645,6,100,1,100,420,6,968,2,1448,3225
246.96,6,54,6375,28,235,9146,752,3187,26,140,9878,594,3188
1769.623,1,59,4956,0,0,0,0,0,59,56,30510,56,4956
0.117,17,2,362,1,46,0,46,74,1,260,0,260,288
21.397,6,22,4109,12,189,1945,517,1438,10,428,2374,499,2671
0.311,6,21,5824,12,164,28,453,1442,9,651,35,1440,4382
8.478,6,678,618554,435,1355,19,1368,601242,243,776,34,1473,17312
113.147,6,24,9200,12,408,95,947,1738,12,995,10270,1360,7462
1711.026,17,342,71246,342,180,5017,422,71246,0,0,0,0,0
43.794,2,2,64,2,8,43794,8,64,0,0,0,0,0
1740.767,17,29,6815,29,207,62170,207,6815,0,0,0,0,0
0.031,6,15,6365,8,127,4,127,551,7,1360,3,2896,5814
15.441,17,22,13514,13,848,1284,1350,11397,9,207,1925,1350,2117
0.509,17,3,451,2,39,66,39,134,1,289,0,289,317
210.476,17,4,352,2,60,210474,60,176,2,60,210475,60,176
300.883,6,51,10578,26,433,12035,910,3310,25,329,637,2720,7268
2.748,6,10,1687,7,100,458,100,384,3,1179,1241,1179,1303
1794.717,1,98,5488,98,28,18502,28,5488,0,0,0,0,0
0.037,6,13,3514,7,75,6,75,447,6,1373,7,1448,3067
625.92,17,124,9424,124,48,5088,48,9424,0,0,0,0,0
1769.366,1,186,10416,186,28,9564,28,10416,0,0,0,0,0
61.849,6,37,15989,22,805,2945,1448,9211,15,665,4394,1448,6778
1798.11,17,449,39928,404,35,4461,288,25708,45,288,40022,288,14220
0.111,17,2,692,2,318,111,353,692,0,0,0,0,0
0.672,6,16,7726,10,353,74,750,1587,6,1454,90,3935,6139
151.86,6,29,5180,17,168,9491,515,1694,12,375,13792,1452,3486
1797.596,17,448,39896,403,35,4471,288,25676,45,288,40015,288,14220
0.015,17,3,634,2,32,0,32,120,1,486,0,486,514
7.914,6,27,5366,15,286,565,975,2898,12,496,433,1179,2468
11.85,6,1854,1629035,1150,1363,10,1380,1596633,704,421,16,1923,32402
0.013,17,2,196,1,62,0,62,90,1,78,0,78,106
0.1,6,10,1671,6,552,19,948,1348,4,159,33,159,323
7.269,6,23,7654,11,402,726,721,1650,12,690,443,2840,6004
16.98,6,2646,2472308,1711,1367,9,1408,2419024,935,931,17,2801,53284
4.636,6,37,7205,19,218,257,314,3383,18,516,257,1179,3822
3.474,17,4,1556,4,361,1158,361,1556,0,0,0,0,0
0.041,17,2,323,1,33,0,33,61,1,234,0,234,262
380.088,6,23,1523,15,177,27149,177,989,8,110,9297,110,534
1798.729,17,448,39896,403,35,4474,288,25676,45,288,40018,288,14220
316.972,6,117,36718,56,551,5763,1360,24881,61,240,5280,1929,11837
0.085,6,12,3462,6,75,17,75,395,6,1373,17,1448,3067
0.443,17,4,588,2,48,300,48,152,2,190,294,308,436
184.666,6,34,15371,21,860,9230,1343,9721,13,622,15386,1571,5650
0.127,17,4,336,2,45,124,45,146,2,67,121,73,190
242.94,2,4,128,4,8,80980,8,128,0,0,0,0,0
1.397,6,39,8351,21,321,69,1164,2810,18,480,71,4075,5541
1798.305,1,345,28980,345,56,5227,56,28980,0,0,0,0,0
1779.172,17,142,11360,71,48,25416,48,5396,71,56,25416,56,5964
295.001,1,4,326,4,53,98333,78,326,0,0,0,0,0
0.025,17,2,363,1,29,0,29,57,1,278,0,278,306
1792.53,6,356,22520,208,69,8659,69,12460,148,69,12193,69,10060
1787.876,17,142,11360,71,48,25540,48,5396,71,56,25540,56,5964
1.276,6,46,18739,27,863,49,1360,13203,19,476,60,2715,5536
0.27,17,2,396,1,39,0,39,67,1,301,0,301,329
1787.62,1,220,12320,220,28,8162,28,12320,0,0,0,0,0
43.466,1,8,448,8,28,6209,28,448,0,0,0,0,0
1.834,6,27,8824,16,281,122,577,1489,11,984,165,1452,7335
280.008,6,29,7392,14,158,21539,267,1357,15,678,20000,3436,6035
1774.892,6,181,15589,120,69,14915,69,8940,61,69,29574,69,6649
125.963,17,4,240,2,32,125962,32,120,2,32,125962,32,120
0.542,6,14,1745,7,288,63,288,600,7,426,62,434,1145
0.0,17,1,58,1,30,0,30,58,0,0,0,0,0
0.274,6,21,7281,12,334,24,663,1969,9,967,33,1471,5312
0.055,17,4,368,2,32,9,32,120,2,96,1,96,248
278.757,6,28,7352,13,158,23229,267,1317,15,678,19908,2800,6035
1794.48,17,87,3648,86,14,21111,14,3612,1,8,0,8,36
1798.833,17,449,39928,404,35,4463,288,25708,45,288,40022,288,14220
11.918,17,4,1344,4,308,3972,308,1344,0,0,0,0,0
221.088,6,30,7432,13,158,18424,267,1317,17,603,13815,2076,6115
1784.997,1,58,4872,58,56,31315,56,4872,0,0,0,0,0
5.362,6,40,7309,21,218,268,314,3463,19,513,283,1179,3846
1783.811,6,356,22920,208,75,8617,469,12860,148,69,12134,69,10060
11.009,6,20,4442,11,275,1100,275,998,9,768,770,1440,3444
126.612,2,2,64,2,8,126612,8,64,0,0,0,0,0
61.288,6,37,15937,22,800,2918,1408,9159,15,665,4359,1408,6778
315.824,6,83,13919,35,178,9288,1305,4184,48,216,6524,1629,9735
25.194,6,34,8211,16,199,1679,722,2038,18,681,1469,2760,6173
2.008,17,3,183,3,33,1004,33,183,0,0,0,0,0
1740.601,17,29,30624,29,1028,62164,1028,30624,0,0,0,0,0
4.006,6,10,1514,5,503,1001,503,771,5,475,1001,475,743
0.118,17,2,245,1,32,0,32,60,1,157,0,157,185
6.195,6,1651,1578352,1079,1386,5,1408,1543846,572,792,10,1408,34506
251.837,17,4,352,2,60,251836,60,176,2,60,251836,60,176
1745.492,6,96,7286,63,38,28153,205,4476,33,33,54536,98,2810
11.232,6,27,11433,13,275,936,275,1078,14,1087,848,1440,10355
79.023,6,10215,9811415,6841,1357,11,1408,9631205,3374,950,23,2801,180210
123.738,17,4,352,2,60,123737,60,176,2,60,123737,60,176
1794.321,17,142,11360,71,48,25633,48,5396,71,56,25633,56,5964
0.222,6,21,5000,10,137,24,267,1092,11,692,21,2800,3908
0.164,6,27,7296,13,155,13,267,1301,14,603,11,2800,5995
0.979,17,4,1344,4,308,326,308,1344,0,0,0,0,0
0.393,17,2,146,1,37,0,37,65,1,53,0,53,81
0.04,17,2,503,1,40,0,40,68,1,407,0,407,435
1798.582,17,449,39928,404,35,4462,288,25708,45,288,40015,288,14220
0.023,6,3,226,2,106,0,106,186,1,0,0,0,40
299.525,6,6,364,4,31,99841,31,222,2,31,299515,31,142
0.108,6,9,1346,5,145,27,145,349,4,833,29,833,997
5.361,17,4,352,2,60,5360,60,176,2,60,5360,60,176
5.962,6,45,8409,22,227,283,314,4062,23,427,258,1152,4347
1739.541,6,87,6322,58,31,30518,31,3915,29,31,62125,31,2407
1788.329,6,99,6444,63,47,28844,208,4074,36,31,51084,31,2370
378.7,6,27,1767,18,177,22276,177,1181,9,110,8920,110,586
1746.721,6,101,7608,66,38,26872,205,4632,35,33,51362,98,2976
0.171,6,29,7376,14,155,13,267,1341,15,543,11,1400,6035
0.086,17,2,245,1,32,0,32,60,1,157,0,157,185
1795.027,17,449,39928,404,35,4454,288,25708,45,288,40016,288,14220
0.163,6,9,1340,5,145,40,145,349,4,827,50,827,991
1.251,6,51,19594,27,910,48,1460,13858,24,433,47,1460,5736
1.051,17,3,451,2,39,468,39,134,1,289,0,289,317
0.388,6,20,7151,11,318,37,600,1854,9,964,46,1471,5297
0.847,6,10,1687,7,100,141,100,384,3,1179,302,1179,1303
1795.869,17,447,39864,402,35,4478,288,25644,45,288,40021,288,14220
70.328,17,2,368,2,156,70328,156,368,0,0,0,0,0
9.889,6,68,20222,35,562,290,1152,15459,33,491,300,1179,4763
1786.305,6,108,8526,69,64,26269,64,4936,39,58,47005,58,3590
1786.916,6,102,8228,68,64,26670,64,4896,34,58,54146,58,3332
0.23,17,12,4365,12,335,20,358,4365,0,0,0,0,0
0.103,6,9,1348,5,145,25,145,349,4,835,32,835,999
1787.906,6,368,25621,214,99,8393,469,15045,154,69,11685,69,10576
0.015,17,2,588,1,39,0,39,67,1,493,0,493,521
1782.122,17,138,11040,69,48,26207,48,5244,69,56,26207,56,5796
280.195,6,29,7392,14,158,21553,267,1357,15,678,20011,3536,6035
1787.907,6,369,23316,212,69,8473,69,12896,157,69,11460,69,10420
233.39,17,4,352,2,60,233389,60,176,2,60,233389,60,176
1.002,1,2,168,0,0,0,0,0,2,56,1002,56,168
1681.6,17,14,1036,7,30,280263,30,406,7,62,280264,62,630
280.403,6,30,7432,14,158,21569,267,1357,16,678,18690,3456,6075
5.201,6,34,6185,18,206,305,314,2784,16,551,328,1179,3401
7.257,17,4,240,2,32,7256,32,120,2,32,7256,32,120
0.274,6,9,527,5,43,68,43,311,4,0,58,0,216
0.045,17,4,350,2,34,1,34,124,2,85,37,91,226
2.366,6,14,1640,7,256,393,256,1052,7,304,393,304,588
0.505,17,3,451,2,39,288,39,134,1,289,0,289,317
1794.291,1,56,4704,56,56,32623,56,4704,0,0,0,0,0
1796.837,1,282,15792,282,28,6394,28,15792,0,0,0,0,0
6.847,6,44,8369,23,227,311,314,4102,21,489,328,1179,4267
55.187,6,22,4852,13,195,4598,722,2050,9,463,1780,1448,2802
19.681,6,30,7432,13,158,1640,267,1317,17,543,1228,1400,6115
240.286,6,42,8970,21,523,12014,1408,5811,21,228,12014,618,3159
102.203,6,42,25867,19,840,41,1460,5847,23,1193,4639,1460,20020
1681.032,1,15,840,15,28,120073,28,840,0,0,0,0,0
629.645,2,6,192,6,8,125929,8,192,0,0,0,0,0
1787.605,17,87,3648,86,14,21030,14,3612,1,8,0,8,36
1783.487,17,73,3060,72,14,25119,14,3024,1,8,0,8,36
1792.043,6,359,22847,207,69,8699,69,12489,152,69,11866,69,10358
57.487,6,36,8455,18,410,517,882,1982,18,478,3371,2128,6473
4.722,6,24,6512,11,262,467,517,1368,13,744,389,1418,5144
11.067,2,3,96,3,8,5533,8,96,0,0,0,0,0
175.249,17,2,72,1,8,0,8,36,1,8,0,8,36
0.572,17,125,113684,45,139,12,1350,7533,80,1298,7,1350,106151
371.43,6,23,1535,16,177,24762,177,1053,7,110,10381,110,482
1.621,17,4,284,2,32,0,32,120,2,54,0,60,164
2.598,6,29,6175,15,338,185,1314,2294,14,368,198,1420,3881
4.511,17,30,13750,14,654,347,1350,9557,16,234,213,1350,4193
45.189,17,36,6000,18,48,2657,48,1368,18,229,2657,308,4632
0.429,17,18,11198,8,540,61,1350,4547,10,637,40,1350,6651
1783.599,1,58,4872,58,56,31291,56,4872,0,0,0,0,0
1788.983,17,1699,128733,946,40,1893,41,64953,753,56,2378,57,63780
882.678,2,7,224,7,8,147113,8,224,0,0,0,0,0
95.098,6,43,8588,14,134,7060,267,1644,29,288,3396,1997,6944
0.432,6,26,8418,12,257,38,748,1687,14,749,32,1418,6731
179.635,17,4,352,2,60,179633,60,176,2,60,179634,60,176
0.101,17,4,284,2,32,0,32,120,2,54,2,60,164
1741.321,6,91,6604,60,31,29513,31,4081,31,31,58043,31,2523
1.141,6,2,111,1,0,0,0,40,1,31,0,31,71
155.802,6,140,20818,72,304,2194,304,13964,68,83,2325,83,6854
1713.26,1,46,2576,46,28,38072,28,2576,0,0,0,0,0
0.025,17,2,290,1,40,0,40,68,1,194,0,194,222
1748.633,6,95,7203,63,38,28203,205,4476,32,33,56393,98,2727
1793.273,17,86,3606,85,14,21348,14,3570,1,8,0,8,36
1793.737,1,222,12432,222,28,8116,28,12432,0,0,0,0,0
7.68,6,43,12889,21,208,384,721,2513,22,791,356,2840,10376
1681.855,1,15,840,15,28,120132,28,840,0,0,0,0,0
18.388,17,39,28717,19,631,1019,1350,12522,20,781,965,1350,16195
1746.91,6,95,7203,63,38,28175,205,4476,32,33,56337,98,2727
0.303,6,27,9076,13,252,25,647,1692,14,831,22,1438,7384
1786.14,17,83,3480,82,14,22051,14,3444,1,8,0,8,36
280.329,6,30,7432,13,158,23360,267,1317,17,543,17518,1400,6115
5.018,17,4,288,2,36,5002,36,128,2,52,5000,52,160
3.113,17,3,174,3,30,1556,30,174,0,0,0,0,0
300.222,6,95,15461,48,317,6387,1408,7917,47,203,6526,1408,7544
1774.415,17,140,11200,70,48,25716,48,5320,70,56,25716,56,5880
1.114,6,28,8263,15,225,67,561,1985,13,957,78,1631,6278
0.655,6,24,6435,14,310,49,889,2115,10,979,70,1691,4320
33.589,6,30,5042,15,154,2399,722,1860,15,399,2384,1440,3182
0.025,17,2,334,1,39,0,39,67,1,239,0,239,267
7.282,6,1812,1690124,1155,1386,6,1408,1651296,657,931,10,2816,38828
55.621,17,6,764,3,48,27805,48,228,3,150,27805,308,536
240.207,6,52,17889,27,801,9238,1408,15045,25,192,10008,580,2844
1681.458,17,20,5144,10,31,186826,37,594,10,427,186827,463,4550
1773.194,6,180,15480,120,69,14900,69,8940,60,69,30052,69,6540
1760.209,6,77,4056,39,26,46320,26,2054,38,26,47572,26,2002
287.447,17,4,352,2,60,287446,60,176,2,60,287446,60,176
0.487,6,12,1653,6,288,90,288,548,6,426,58,434,1105
1008.062,2,6,192,6,8,201612,8,192,0,0,0,0,0
0.501,6,21,7281,13,334,41,663,2021,8,967,64,1946,5260
1799.634,1,58,4872,58,56,31572,56,4872,0,0,0,0,0
1.58,17,3,220,2,34,998,34,124,1,68,0,68,96
0.403,6,6,248,4,0,134,0,164,2,0,204,0,84
0.418,6,21,7248,13,325,34,626,1984,8,1210,58,1906,5264
0.935,6,10,1687,7,100,155,100,384,3,1179,340,1179,1303
0.639,17,4,288,2,36,637,36,128,2,52,637,52,160
0.07,17,2,255,1,43,0,43,71,1,156,0,156,184
1.364,6,47,18511,26,909,54,1460,12895,21,433,59,1460,5616
0.029,6,6,328,4,0,9,0,216,2,0,12,0,112
2.087,6,14,4292,4,288,695,288,468,10,568,202,853,3824
373.94,6,20,1355,15,177,26710,177,977,5,110,15171,110,378
0.238,6,12,3462,6,75,47,75,395,6,1373,47,1448,3067
0.079,17,2,231,1,34,0,34,62,1,141,0,141,169
0.409,17,2,136,1,32,0,32,60,1,48,0,48,76
1770.674,6,137,8441,73,27,24592,27,4447,64,27,28105,27,3994
0.014,17,2,396,1,32,0,32,60,1,308,0,308,336
8.065,6,20,7900,12,348,733,735,1676,8,1160,1127,2736,6224
0.053,17,2,588,1,39,0,39,67,1,493,0,493,521
0.408,17,2,677,1,300,0,300,328,1,321,0,321,349
7.518,6,685,614635,433,1349,16,1368,595871,252,776,29,2736,18764
1.267,6,56,24100,30,1003,43,1360,18284,26,433,43,1360,5816
1763.577,2,15,480,15,8,125969,8,480,0,0,0,0,0
1765.566,17,44,14784,44,308,41059,308,14784,0,0,0,0,0
0.045,6,2,80,1,0,0,0,40,1,0,0,0,40
5.101,17,25,7756,10,305,566,1350,3336,15,266,231,1350,4420
0.464,6,22,10013,11,136,46,136,716,11,1089,46,1448,9297
379.125,6,27,1755,17,177,23695,177,1117,10,110,8681,110,638
1.35,6,46,18609,26,920,54,1460,13033,20,476,61,2615,5576
257.359,6,311,49841,171,304,1513,304,34712,140,83,1842,83,15129
1764.193,2,13,416,13,8,147016,8,416,0,0,0,0,0
258.362,6,89,27565,40,732,6624,1440,15582,49,342,5377,1702,11983
227.374,17,4,240,2,32,227372,32,120,2,32,227373,32,120
761.749,6,154,9748,90,69,8558,69,5394,64,69,12086,69,4354
33.906,6,28,4938,14,154,2608,722,1807,14,479,2594,1440,3131
39.156,17,6,456,6,48,7831,48,456,0,0,0,0,0
183.071,6,52,20539,30,849,6312,1402,17690,22,242,8596,580,2849
0.061,17,2,588,1,39,0,39,67,1,493,0,493,521
0.094,6,11,913,6,182,18,182,490,5,77,12,134,423
123.354,17,4,1312,4,300,41118,308,1312,0,0,0,0,0
5.033,17,4,288,2,36,5001,36,128,2,52,4995,52,160
1.537,17,20,12589,9,631,186,1350,5936,11,576,143,1350,6653
1797.542,17,449,39928,404,35,4460,288,25708,45,288,40016,288,14220
1793.713,1,232,12992,232,28,7764,28,12992,0,0,0,0,0
248.225,17,4,352,2,60,248224,60,176,2,60,248224,60,176
88.051,17,4,558,2,36,88046,36,128,2,187,88046,187,430
1794.697,17,83,3480,82,14,22156,14,3444,1,8,0,8,36
36.99,17,4,352,2,60,36988,60,176,2,60,36989,60,176
1759.393,6,116,6998,64,27,27926,27,3811,52,27,34497,27,3187
300.326,6,39,9121,21,441,15016,1178,2950,18,402,2262,1491,6171
992.456,6,286,26734,145,118,6892,1189,12947,141,173,7086,1917,13787
7.177,6,126,196998,81,133,89,201,3807,45,4667,158,32522,193191
61.536,6,12,951,6,177,12307,177,521,6,110,12240,110,430
31.592,6,7,336,1,0,0,0,48,6,0,6316,0,288
2.038,6,51,18858,25,923,84,1440,13042,26,433,74,1440,5816
52.938,6,47,13369,23,930,1002,1360,7514,24,325,2293,1360,5855
1.106,17,4,288,2,36,1073,36,128,2,52,1073,52,160
5.543,6,39,21270,23,945,251,1408,9723,16,973,337,1408,11547
13.757,2,2,64,2,8,13757,8,64,0,0,0,0,0
361.873,6,18,1242,14,180,27836,180,916,4,110,20054,110,326
14.871,1,8,832,0,0,0,0,0,8,76,2124,76,832
0.48,17,2,174,1,45,0,45,73,1,73,0,73,101
11.996,17,4,1344,4,308,3998,308,1344,0,0,0,0,0
241.887,6,58,11703,26,306,9675,1312,4763,32,374,7802,1691,6940
89.027,6,25,11758,12,741,74,1460,3478,13,1106,7407,1460,8280
637.723,6,110,37238,53,129,12261,582,4312,57,935,11384,1418,32926
11.104,6,30,8110,16,296,740,721,2124,14,774,779,2007,5986
61.321,6,37,16052,22,809,2920,1408,9273,15,665,4362,1408,6779
1.591,17,21,8044,10,389,167,1350,4172,11,324,147,1350,3872
7.847,6,40,7309,21,218,392,314,3463,19,513,409,1179,3846
1799.304,1,57,4788,57,56,32130,56,4788,0,0,0,0,0
0.017,17,2,200,1,40,0,40,68,1,104,0,104,132
0.162,17,2,152,1,48,0,48,76,1,48,0,48,76
1798.24,17,449,39928,404,35,4462,288,25708,45,288,40024,288,14220
1799.961,6,205,14180,75,46,23918,46,5990,130,46,13952,46,8190
371.818,6,62,10095,33,97,11619,267,2796,29,255,13272,1452,7299
0.412,6,10,968,5,256,100,256,460,5,304,100,304,508
12.237,6,1925,1689233,1174,1385,10,1420,1654972,751,467,16,1883,34261
11.75,6,1874,1594911,1125,1363,10,1380,1560697,749,421,15,1923,34214
3.938,6,12,3234,5,92,984,92,348,7,503,158,1448,2886
1772.372,1,58,4872,58,56,31094,56,4872,0,0,0,0,0
33.661,6,31,5095,15,154,2404,722,1859,16,342,2231,1408,3236
0.071,17,4,368,2,32,19,32,120,2,96,1,96,248
15.888,6,29,4971,14,154,1178,722,1819,15,338,1096,1448,3152
0.399,17,2,178,1,29,0,29,57,1,93,0,93,121
0.491,6,2,80,1,0,0,0,40,1,0,0,0,40
60.896,6,10,823,5,177,15224,177,445,5,110,15169,110,378
20.302,6,21,5418,13,107,1691,159,1126,8,967,2892,1709,4292
0.064,6,6,336,4,0,21,0,220,2,0,51,0,116
227.697,17,4,352,2,60,227696,60,176,2,60,227696,60,176
1751.416,6,96,7286,63,38,28248,205,4476,33,33,54718,98,2810
1722.423,17,12,498,11,14,172242,14,462,1,8,0,8,36
0.048,17,4,608,2,60,26,60,176,2,188,29,188,432
0.553,6,22,7333,13,334,46,663,2021,9,1209,62,1946,5312
1772.033,6,180,15480,120,69,14891,69,8940,60,69,30033,69,6540
9.632,6,25,7662,12,301,875,721,1689,13,681,727,2840,5973
241.389,17,4,240,2,32,241387,32,120,2,32,241388,32,120
60.822,6,10,544,6,0,12164,0,320,4,0,20172,0,224
0.561,6,51,21110,28,986,20,1380,15948,23,421,23,1923,5162
1745.394,6,95,7203,63,38,28151,205,4476,32,33,56294,98,2727
387.575,6,18,1242,14,180,29813,180,916,4,110,20070,110,326
227.876,6,134,80613,78,1131,1123,1360,55238,56,856,4140,2720,25375
1768.497,6,228,22089,112,85,15932,721,11057,116,168,15376,1440,11032
12.084,6,1824,1657045,1128,1415,10,1432,1624984,696,420,17,1432,32061
0.282,6,27,9095,13,247,23,624,1696,14,832,21,1408,7399
0.554,1,10,840,10,56,61,56,840,0,0,0,0,0
288.444,17,4,352,2,60,288443,60,176,2,60,288443,60,176
1795.723,1,268,15008,268,28,6725,28,15008,0,0,0,0,0
11.821,6,25,8473,13,275,985,275,1078,12,986,842,1440,7395
1772.829,6,180,15480,120,69,14897,69,8940,60,69,30046,69,6540
1756.282,6,4144,4462241,1476,145,1190,908,91325,2668,1630,658,9814,4370916
1.579,6,12,949,6,222,307,222,470,6,231,308,231,479
0.001,17,2,327,1,35,0,35,63,1,236,0,236,264
300.012,6,40,9850,21,569,14998,1360,4288,19,399,16656,1360,5562
9.012,6,21,3905,11,234,901,564,1516,10,463,736,1343,2389
1.353,6,2,80,1,0,0,0,40,1,0,0,0,40
0.407,6,12,2078,7,329,67,594,1018,5,396,98,580,1060
0.042,6,10,1512,5,503,10,503,771,5,473,10,473,741
0.496,17,3,451,2,39,443,39,134,1,289,0,289,317
0.019,6,13,3980,7,88,3,88,388,6,1670,3,2920,3592
61.33,6,37,16032,22,810,2920,1440,9253,15,665,4362,1440,6779
1797.482,6,220,27149,139,103,13025,469,12831,81,145,22468,1420,14318
355.16,6,51,3444,20,46,18692,46,1514,31,46,11833,46,1930
107.967,6,23,9853,12,545,80,1327,2147,11,1036,10782,2054,7706
145.257,17,4,352,2,60,145256,60,176,2,60,145256,60,176
0.013,17,6,462,3,33,0,33,183,3,65,0,65,279
87.467,17,24,8778,24,337,3802,360,8778,0,0,0,0,0
0.164,6,30,7416,15,155,11,267,1381,15,543,11,1400,6035
1797.471,17,447,39580,403,35,4471,288,25676,44,288,40948,288,13904
1776.894,6,101,8103,61,66,25168,66,4486,40,54,45558,60,3617
1751.559,1,58,4872,58,56,30729,56,4872,0,0,0,0,0
29.322,17,14,7736,8,655,4188,1350,5471,6,349,53,1350,2265
368.846,6,25,1651,17,177,23052,177,1117,8,110,9199,110,534
1744.121,6,95,7203,63,38,28130,205,4476,32,33,56253,98,2727
0.335,6,26,9013,13,252,27,646,1694,13,947,25,1438,7319
0.041,17,8,2438,8,276,5,315,2438,0,0,0,0,0
98.642,6,36,8410,11,141,9862,267,1439,25,298,4109,1917,6971
240.33,6,42,9110,21,523,12016,1408,5809,21,244,12016,617,3301
153.614,6,31,7900,8,141,6934,267,1175,23,305,6981,1460,6725
140.999,6,21,7979,11,525,92,1237,2048,10,919,15646,1591,5931
1783.586,17,83,3480,82,14,22019,14,3444,1,8,0,8,36
39.237,17,22,1936,11,48,3921,48,836,11,72,3918,72,1100
256.438,6,22,6058,9,267,111,501,1165,13,436,21362,1420,4893
74.94,6,25,8121,9,266,97,500,1164,16,450,4989,1420,6957
1773.0,1,8,448,8,28,253285,28,448,0,0,0,0,0
244.914,6,3194,2604066,1482,194,165,210,80745,1712,1425,143,5632,2523321
129.973,6,22,9142,11,423,69,934,1741,11,992,12982,1460,7401
0.061,17,8,2750,8,315,8,354,2750,0,0,0,0,0
0.389,6,8,335,4,0,129,0,164,4,7,64,7,171
0.39,6,20,7196,12,325,34,626,1932,8,1210,54,1906,5264
35.012,17,40,5880,20,48,1842,48,1520,20,190,1842,308,4360
0.136,17,7,3453,4,416,45,1350,1779,3,530,31,1350,1674
0.133,6,12,3462,6,75,26,75,395,6,1373,26,1448,3067
300.635,6,39,8606,20,315,15822,882,2093,19,441,471,1440,6513
1.234,17,2,152,1,48,0,48,76,1,48,0,48,76
39.973,17,24,2112,12,48,3632,48,912,12,72,3626,72,1200
354.584,6,32,10261,22,128,16884,844,2320,10,1254,59,2720,7941
5.998,17,3,1008,3,308,2999,308,1008,0,0,0,0,0
3.792,6,2,88,2,0,0,0,88,0,0,0,0,0
13.165,6,1389,1212903,848,1350,15,1408,1180107,541,931,24,2801,32796
8.53,6,2,104,2,0,0,0,104,0,0,0,0,0
1786.198,17,87,3648,86,14,21014,14,3612,1,8,0,8,36
693.186,6,171,19205,87,142,7544,469,8464,84,175,8351,1460,10741
8.768,6,25,6847,8,138,1252,267,883,17,479,520,1460,5964
287.153,6,28,2968,14,324,22085,584,1396,14,282,22084,580,1572
0.77,6,11,1727,7,100,128,100,384,4,589,173,1152,1343
240.182,6,57,17655,31,778,8005,1408,14859,26,159,9607,580,2796
105.723,6,41,8801,20,401,725,889,2084,21,391,5278,2720,6717
1.591,6,47,19203,27,893,61,1360,13627,20,433,73,1360,5576
3.964,17,8,668,4,39,1310,39,268,4,72,1310,72,400
22.285,6,197,82476,103,758,218,1152,73893,94,401,236,1152,8583
1120.969,17,10,2745,5,30,280221,30,290,5,463,280239,463,2455
1798.789,17,768,46364,768,32,2345,37,46364,0,0,0,0,0
110.109,17,8,333,7,13,18351,14,289,1,16,0,16,44
0.006,17,2,189,1,39,0,39,67,1,94,0,94,122
1745.552,6,95,7203,63,38,28154,205,4476,32,33,56300,98,2727
0.132,17,2,198,1,39,0,39,67,1,103,0,103,131
0.288,6,20,7229,12,334,25,663,1969,8,1209,40,2816,5260
44.385,6,83,42476,50,1165,902,1360,35851,33,330,1381,2667,6625
124.44,6,37,8391,14,147,9571,267,1751,23,317,5655,1452,6640
1779.976,17,138,11040,69,48,26175,48,5244,69,56,26175,56,5796
8.159,6,1009,933267,617,1435,12,1448,907727,392,776,20,1448,25540
1.196,6,25,8056,12,164,93,267,1288,13,869,85,1408,6768
0.269,17,2,456,2,200,269,352,456,0,0,0,0,0
275.341,6,20,3046,15,187,19667,187,2284,5,247,60009,462,762
2.601,6,13,2311,8,188,371,245,700,5,1407,585,1407,1611
1783.615,1,58,4872,58,56,31291,56,4872,0,0,0,0,0
0.103,17,4,1038,2,40,93,40,136,2,423,88,423,902
1745.249,6,95,7203,63,38,28149,205,4476,32,33,56289,98,2727
4.17,6,38,7229,19,218,231,314,3383,19,513,216,1179,3846
16.796,6,17,2471,8,188,2399,245,700,9,1407,2065,1407,1771
15.264,6,26,4839,13,154,1238,722,1791,13,473,1235,2026,3048
1771.258,6,99,9240,66,65,27250,65,5577,33,59,55348,59,3663
40.674,17,32,5412,16,48,2710,48,1216,16,234,2710,308,4196
31.224,6,8,348,2,0,11,0,84,6,0,6243,0,264
280.441,6,28,7352,13,158,23370,267,1317,15,678,20026,3436,6035
84.366,6,32,8952,14,158,6489,267,1357,18,624,4954,1400,7595
1511.615,2,11,352,11,8,151161,8,352,0,0,0,0,0
9.191,6,9,396,3,0,2966,0,132,6,0,1798,0,264
0.025,6,10,1677,6,555,4,951,1354,4,159,8,159,323
3.904,6,597,536415,385,1358,10,1432,523644,212,427,18,1432,12771
5.009,6,38,7229,19,218,278,314,3383,19,513,263,1179,3846
10.742,6,20,4402,11,275,1074,275,998,9,758,746,1420,3404
1.379,6,28,6109,14,154,106,267,1644,14,780,95,1460,4465
0.212,6,21,5000,10,137,23,267,1092,11,692,20,1467,3908
0.07,17,2,194,1,61,0,61,89,1,77,0,77,105
1789.823,6,356,22589,207,69,8688,69,12420,149,69,12093,69,10169
0.04,1,2,294,2,119,40,119,294,0,0,0,0,0
1.97,17,4,610,3,39,724,39,201,1,381,0,381,409
1786.417,6,408,41055,189,308,9502,841,17118,219,63,8190,1537,23937
0.128,17,2,2382,2,1163,128,1163,2382,0,0,0,0,0
110.33,1,6,336,6,28,22066,28,336,0,0,0,0,0
280.068,6,28,7352,13,158,23339,267,1317,15,678,20002,2045,6035
1773.253,1,8,448,8,28,253321,28,448,0,0,0,0,0
0.371,6,10,1185,6,279,74,279,587,4,191,62,272,598
0.016,17,2,554,1,30,0,30,58,1,468,0,468,496
0.026,6,13,3980,7,88,4,88,388,6,1670,5,2920,3592
280.251,6,27,7312,13,158,23354,267,1317,14,775,21555,4836,5995
0.263,6,11,1170,6,135,51,135,379,5,587,64,587,791
273.848,6,30,7432,13,158,22820,267,1317,17,543,17107,1400,6115
81.869,17,6,528,3,48,40931,48,228,3,72,40930,72,300
73.212,6,21,860,10,0,5394,0,404,11,0,7320,0,456
0.288,17,4,1108,2,30,278,30,116,2,468,275,468,992
5.841,6,44,8369,22,227,278,314,4062,22,489,265,1179,4307
113.735,17,20,1520,20,48,5986,48,1520,0,0,0,0,0
1740.45,17,30,6930,30,203,60015,203,6930,0,0,0,0,0
1.405,17,6,936,3,64,533,64,276,3,192,561,192,660
77.287,6,743,357236,401,829,193,1152,338035,342,424,225,1179,19201
56.696,6,31,7725,11,155,5669,267,1226,20,355,2983,2006,6499
31.977,6,9,396,2,0,3485,0,88,7,0,5314,0,308
0.038,17,2,572,1,39,0,39,67,1,477,0,477,505
1.288,17,18,6543,8,480,184,1350,4064,10,219,138,1350,2479
14.095,6,22,7982,12,275,1281,275,763,10,1134,1009,1440,7219
1.414,6,51,21595,29,921,50,1360,15939,22,433,58,1360,5656
6.201,17,3,208,2,36,6169,36,128,1,52,0,52,80
1785.701,17,75,3141,73,13,24801,14,3061,2,12,524784,16,80
0.134,6,9,1346,5,145,33,145,349,4,833,39,833,997
180.873,17,15,1140,15,48,12919,48,1140,0,0,0,0,0
0.993,17,2,677,1,300,0,300,328,1,321,0,321,349
52.502,17,8,1648,4,48,17498,48,304,4,308,17498,308,1344
1793.65,6,356,22520,208,69,8664,69,12460,148,69,12201,69,10060
89.302,17,6,456,6,48,17860,48,456,0,0,0,0,0
1761.201,6,196,12325,97,51,18345,208,7404,99,31,17969,31,4921
21.656,6,3295,3087817,2130,1371,10,1408,3022573,1165,776,18,1408,65244
18.391,6,14,1161,5,302,4597,302,558,9,83,2290,83,603
0.104,17,2,144,1,36,0,36,64,1,52,0,52,80
1789.951,6,363,24345,211,88,8523,469,13987,152,69,11853,69,10358
0.944,17,4,624,2,64,942,64,184,2,192,800,192,440
240.813,6,45,8803,22,523,11466,1418,5867,23,191,10945,618,2936
1790.338,6,356,22520,208,69,8648,69,12460,148,69,12179,69,10060
15.453,17,13,6699,7,613,2570,1350,4492,6,339,3084,1350,2207
1799.347,17,4216,202368,2108,20,853,20,101184,2108,20,853,20,101184
0.815,6,7,958,4,241,271,241,654,3,92,265,92,304
175.28,17,2,72,1,8,0,8,36,1,8,0,8,36
94.402,17,4,352,2,60,94400,60,176,2,60,94401,60,176
1744.186,6,105,7602,66,31,26833,31,4503,39,31,45899,31,3099
126.503,2,2,64,2,8,126503,8,64,0,0,0,0,0
69.613,6,29,7322,13,155,5801,267,1306,16,488,4639,3537,6016
0.004,17,2,164,1,46,0,46,74,1,62,0,62,90
1776.145,17,75,3141,73,13,24666,14,3061,2,12,1775980,16,80
1799.362,6,234,17778,146,69,12409,69,10118,88,69,20682,69,7660
1794.226,1,58,4872,58,56,31477,56,4872,0,0,0,0,0
1787.639,6,104,8376,68,65,26681,65,4930,36,59,51071,59,3446
300.761,6,36,8323,20,271,15829,739,1930,16,521,573,3488,6393
232.834,6,29,8147,11,189,11074,516,1390,18,402,13691,1452,6757
7.729,1,13,1352,0,0,0,0,0,13,76,644,76,1352
1796.236,17,449,39928,404,35,4457,288,25708,45,288,40019,288,14220
1.307,6,48,19006,27,876,50,1360,13390,21,433,55,1360,5616
368.538,6,19,1303,14,177,28349,177,925,5,110,18460,110,378
362.725,17,16,5376,16,308,24181,308,5376,0,0,0,0,0
31.948,6,6,360,0,0,0,0,0,6,0,0,0,360
85.649,17,4,352,2,60,85648,60,176,2,60,85648,60,176
1770.649,1,118,12508,118,78,15133,78,12508,0,0,0,0,0
1787.377,6,108,8654,68,65,26677,65,4930,40,59,45828,59,3724
0.344,6,27,9090,13,262,28,690,1735,14,945,25,1408,7355
27.04,17,4,240,2,32,27038,32,120,2,32,27039,32,120
64.923,6,30,13367,15,865,80,1360,5824,15,990,4624,2241,7543
1787.677,6,102,8296,68,65,26681,65,4930,34,59,54169,59,3366
2.744,6,31,6501,15,164,196,267,1922,16,655,172,1452,4579
1.38,17,2,778,2,361,1380,361,778,0,0,0,0,0
1.323,6,49,21026,28,950,49,1360,15410,21,433,57,1360,5616
0.918,6,38,8324,19,254,51,671,1810,19,441,42,1460,6514
0.278,6,10,2535,6,551,55,947,1346,4,1025,92,1025,1189
1661.24,1,7,742,7,78,276873,78,742,0,0,0,0,0
300.252,6,75,12281,36,334,8578,1111,6591,39,191,7901,1386,5690
81.863,6,29,7756,7,155,815,267,1066,22,322,3897,1420,6690
11.001,6,22,4526,12,275,1000,275,1038,10,768,700,1440,3488
18.802,17,12,1056,6,48,3758,48,456,6,72,3758,72,600
407.095,6,50,8456,33,96,12721,479,3063,17,362,20234,1452,5393
1783.427,17,83,3480,82,14,22017,14,3444,1,8,0,8,36
240.227,6,51,17803,27,793,9239,1418,14898,24,235,10444,580,2905
1160.419,17,787,55068,722,40,1609,41,49571,65,56,531,57,5497
0.023,6,2,173,2,46,23,62,173,0,0,0,0,0
3.208,17,16,2055,16,100,213,352,2055,0,0,0,0,0
37.396,6,10,665,7,43,6232,43,501,3,0,18692,0,164
35.173,6,34,7679,14,165,2705,204,1086,20,782,1806,1438,6593
249.164,17,14,1940,7,48,41526,48,532,7,173,41525,308,1408
89.043,6,48,9172,22,401,693,889,2224,26,327,3556,1360,6948
0.093,17,4,642,2,44,0,44,144,2,221,88,324,498
1784.713,6,368,25152,213,93,8418,469,14605,155,69,11588,69,10547
1785.187,6,349,22102,204,69,8794,69,12231,145,69,12397,69,9871
67.914,6,40,27546,22,421,3234,620,2463,18,1609,3894,7040,25083
70.299,6,183,137793,83,430,857,647,5686,100,1321,690,1408,132107
1772.958,6,180,15480,120,69,14898,69,8940,60,69,30044,69,6540
0.086,6,11,819,6,186,16,186,506,5,45,19,45,313
0.327,17,5,1735,5,319,81,354,1735,0,0,0,0,0
0.171,6,25,7216,13,155,14,267,1301,12,678,14,2800,5915
44.828,17,44,6468,22,48,2134,48,1672,22,190,2134,308,4796
1.105,17,30,15191,14,577,85,1350,8472,16,391,66,1350,6719
7.233,6,1535,1480819,1015,1385,6,1408,1449115,520,776,13,1408,31704
1.147,6,25,8068,12,164,88,267,1300,13,869,81,1408,6768
1741.112,6,87,6322,58,31,30545,31,3915,29,31,62179,31,2407
1787.906,6,375,26508,216,104,8315,469,15732,159,69,11315,69,10776
33.552,6,41,8914,20,200,1765,722,2613,21,908,1625,2760,6301
1.411,6,10,1687,7,100,235,100,384,3,1179,576,1179,1303
1797.83,17,140,11200,70,48,26055,48,5320,70,56,26055,56,5880
1.183,6,24,8004,12,164,91,267,1288,12,1014,90,2804,6716
174.727,17,4,240,2,32,174726,32,120,2,32,174726,32,120
555.146,1,60,5040,60,56,9409,56,5040,0,0,0,0,0
1787.958,6,358,23538,209,82,8595,469,13369,149,69,12077,69,10169
0.024,17,3,672,2,60,0,60,176,1,468,0,468,496
1.893,6,9,527,5,43,473,43,311,4,0,627,0,216
1279.525,6,133,17627,70,79,18543,267,6553,63,149,20637,1942,11074
1792.642,17,87,3648,86,14,21089,14,3612,1,8,0,8,36
110.661,2,3,96,3,8,55330,8,96,0,0,0,0,0
61.931,6,21,7501,12,261,5630,467,1405,9,802,7686,1448,6096
0.596,6,12,2073,7,326,99,589,1013,5,396,108,580,1060
1.388,6,42,11637,22,572,66,1460,6061,20,476,63,2615,5576
151.353,6,29,13320,16,555,73,928,4004,13,976,12603,4416,9316
0.954,17,8,2758,8,316,136,355,2758,0,0,0,0,0
3.08,17,2,122,2,33,3080,33,122,0,0,0,0,0
0.092,17,2,162,1,34,0,34,62,1,72,0,72,100
1794.202,6,356,22520,208,69,8667,69,12460,148,69,12205,69,10060
2.04,6,14,2351,8,188,291,245,700,6,703,356,1152,1651
1787.369,6,356,22520,208,69,8634,69,12460,148,69,12157,69,10060
1793.432,1,58,4872,58,56,31463,56,4872,0,0,0,0,0
449.1,1,4,224,4,28,149700,28,224,0,0,0,0,0
1792.321,6,232,20316,87,81,20839,339,9356,145,70,12445,1062,10960
613.482,1,19,2014,19,78,34082,78,2014,0,0,0,0,0
1782.104,17,79,3312,78,14,23144,14,3276,1,8,0,8,36
0.431,6,418,547013,101,186,4,283,5820,317,1665,1,8448,541193
1770.02,6,99,9306,66,66,27231,66,5610,33,60,55310,60,3696
1.422,6,32,11144,17,437,88,1232,3338,15,1027,89,2720,7806
0.487,6,10,968,5,256,107,256,460,5,304,112,304,508
137.64,17,4,240,2,32,137639,32,120,2,32,137639,32,120
280.471,6,28,7352,13,158,23372,267,1317,15,678,20027,3456,6035
280.23,6,27,7312,13,158,23352,267,1317,14,775,21550,4836,5995
32.885,17,20,1760,10,48,3651,48,760,10,72,3646,72,1000
373.479,6,18,1242,14,180,28729,180,916,4,110,20070,110,326
1779.867,17,142,11360,71,48,25426,48,5396,71,56,25426,56,5964
120.513,6,10,562,3,106,60250,106,234,7,0,20083,0,328
207.103,1,6,336,6,28,41420,28,336,0,0,0,0,0
9.421,6,22,7680,10,255,1046,722,1679,12,919,834,1380,6001
164.566,2,7,328,7,22,27427,32,328,0,0,0,0,0
199.742,6,20248,16957270,9596,1247,20,1388,539099,10652,1490,18,9772,16418171
271.385,17,4,352,2,60,271383,60,176,2,60,271384,60,176
0.09,17,2,2384,2,1164,90,1164,2384,0,0,0,0,0
1700.472,17,12,498,11,14,170047,14,462,1,8,0,8,36
0.275,17,2,152,1,48,0,48,76,1,48,0,48,76
10.046,17,4,724,2,41,10039,41,138,2,265,10039,265,586
1777.402,17,79,3312,78,14,23083,14,3276,1,8,0,8,36
1770.319,6,99,9240,66,65,27235,65,5577,33,59,55319,59,3663
3.016,17,4,624,4,128,1005,128,624,0,0,0,0,0
221.029,6,22,6974,10,181,24558,267,1128,12,766,20083,2045,5846
126.061,2,2,64,2,8,126061,8,64,0,0,0,0,0
147.281,1,12,672,12,28,13389,28,672,0,0,0,0,0
11.408,6,1830,1577240,1102,1377,10,1420,1543899,728,467,15,1883,33341
1.429,17,6,552,3,32,542,32,180,3,96,548,96,372
37.879,17,44,6468,22,48,1803,48,1672,22,190,1803,308,4796
0.219,1,2,112,2,28,219,28,112,0,0,0,0,0
154.152,6,18,4463,7,272,209,516,1100,11,364,15405,1452,3363
1791.943,6,4036,3959423,1315,129,1363,361,76410,2721,1415,658,2836,3883013
0.606,6,7,288,4,0,202,0,164,3,0,152,0,124
0.048,6,10,767,5,186,11,186,454,5,45,10,45,313
0.182,1,2,163,2,53,182,78,163,0,0,0,0,0
0.186,6,9,1339,5,145,46,145,349,4,826,43,826,990
7.773,6,15,1362,8,275,1110,275,878,7,96,984,96,484
65.601,6,10,3830,10,331,7289,477,3830,0,0,0,0,0
1773.657,6,106,6322,60,27,30061,27,3525,46,27,39413,27,2797
177.479,6,33,11559,17,423,366,692,2461,16,843,11823,1460,9098
171.254,6,32,13777,17,847,1209,1384,4949,15,912,12219,1664,8828
190.38,6,59,12182,26,235,7615,469,4585,33,250,5943,1452,7597
45.086,17,2,122,2,33,45086,33,122,0,0,0,0,0
0.434,6,12,3705,6,171,86,171,491,6,964,86,1448,3214
0.103,17,4,2876,2,689,103,1350,1434,2,693,70,1350,1442
0.095,17,2,255,1,43,0,43,71,1,156,0,156,184
284.871,6,31,7994,16,187,18991,267,1959,15,678,20342,3436,6035
0.005,17,2,516,1,42,0,42,70,1,418,0,418,446
16.588,6,12,568,6,0,3317,0,280,6,0,3315,0,288
240.691,2,3,96,3,8,120345,8,96,0,0,0,0,0
6.473,6,69,20246,34,562,196,1152,15419,35,427,182,1152,4827
0.609,6,14,1745,7,288,68,288,600,7,426,73,434,1145
301.044,6,42,8971,22,272,14335,888,2285,20,419,467,1460,6686
161.123,17,8,2688,8,308,23017,308,2688,0,0,0,0,0
4.792,17,26,8594,10,248,532,1350,2761,16,336,213,1350,5833
0.414,6,12,1653,6,288,82,288,548,6,426,48,434,1105
1776.502,17,140,11200,70,48,25746,48,5320,70,56,25746,56,5880
1743.57,6,98,7390,63,38,28122,205,4476,35,33,51270,98,2914
187.918,17,4,240,2,32,187917,32,120,2,32,187917,32,120
0.936,6,27,8506,15,229,55,583,2007,12,1201,69,3151,6499
1790.276,6,358,22669,208,69,8648,69,12529,150,69,12014,69,10140
7.281,17,4,352,2,60,7279,60,176,2,60,7280,60,176
2.463,6,29,6175,15,338,175,1314,2294,14,368,188,1414,3881
503.548,2,3,96,3,8,251774,8,96,0,0,0,0,0
0.097,1,2,212,2,78,97,78,212,0,0,0,0,0
11.557,6,569,432964,273,248,42,255,23998,296,1334,39,1773,408966
280.37,6,28,7352,12,158,25488,267,1277,16,603,18686,1400,6075
1.086,17,19,14733,9,643,135,1350,6041,10,841,80,1350,8692
1.318,6,10,924,5,283,211,283,551,5,105,225,105,373
5.04,17,4,558,2,36,5035,36,128,2,187,5034,187,430
0.878,1,2,112,2,28,878,28,112,0,0,0,0,0
0.226,6,9,1002,5,213,56,213,417,4,421,60,421,585
15.12,17,17,5124,7,309,2514,1350,2363,10,248,1676,1350,2761
0.287,6,9,1338,5,549,71,549,753,4,421,71,421,585
10.709,6,18,5610,10,275,1189,275,958,8,1440,812,1440,4652
300.883,6,53,10670,27,433,11572,910,3362,26,329,601,2720,7308
1674.138,1,8,448,8,28,239162,28,448,0,0,0,0,0
2.389,17,2,144,1,36,0,36,64,1,52,0,52,80
1786.11,6,155,19626,92,302,19627,302,13852,63,83,28808,83,5774
12.137,6,1929,1676604,1170,1377,10,1420,1642023,759,467,15,1883,34581
11.751,6,1956,1788472,1229,1376,9,1408,1746004,727,931,15,2801,42468
0.574,17,4,660,2,30,563,30,116,2,244,237,244,544
1779.471,17,140,11200,70,48,25789,48,5320,70,56,25789,56,5880
38.292,6,45,9030,21,410,665,882,2162,24,327,1659,1360,6868
1624.31,2,12,384,12,8,147664,8,384,0,0,0,0,0
149.318,6,24,5164,9,220,7150,516,1245,15,275,10659,1452,3919
62.131,6,70,49016,45,1170,1412,1368,40982,25,840,2578,2519,8034
164.729,17,4,5512,4,1350,54909,1350,5512,0,0,0,0,0
28.255,6,29,7597,11,155,2825,267,1226,18,403,1661,3426,6371
1799.556,6,355,22480,207,69,8735,69,12420,148,69,12241,69,10060
1.414,6,47,19088,26,953,56,1460,13472,21,433,59,1460,5616
1791.341,1,68,5712,68,56,26736,56,5712,0,0,0,0,0
1792.79,6,356,22520,208,69,8660,69,12460,148,69,12195,69,10060
11.028,6,20,4402,11,275,1102,275,998,9,758,781,1420,3404
1794.428,6,370,23425,213,69,8464,69,13005,157,69,11501,69,10420
0.084,17,4,344,2,47,80,47,150,2,69,6,75,194
1792.57,6,240,35580,150,302,12030,302,25920,90,83,20141,83,9660
661.741,2,7,224,7,8,110290,8,224,0,0,0,0,0
44.394,6,5866,5524460,3830,1364,11,1408,5413924,2036,931,21,2801,110536
1679.819,17,12,498,11,14,167981,14,462,1,8,0,8,36
0.197,6,2,116,1,0,0,0,64,1,0,0,0,52
0.013,17,2,375,1,51,0,51,79,1,268,0,268,296
2.845,6,53,13930,25,551,118,1429,4892,28,439,98,1986,9038
0.169,6,2,339,1,259,0,259,299,1,0,0,0,40
885.751,1,8,448,8,28,126535,28,448,0,0,0,0,0
1.474,6,38,9904,20,510,77,1440,4408,18,433,75,1440,5496
0.551,17,2,147,1,32,0,32,60,1,59,0,59,87
31.619,6,6,360,0,0,0,0,0,6,0,0,0,360
0.435,6,28,9027,14,237,33,590,1687,14,941,33,1408,7340
218.467,6,29,7392,13,158,18205,267,1317,16,603,14561,2036,6075
131.736,6,8,3352,3,92,20250,92,256,5,1408,32888,1408,3096
36.597,17,41,23496,21,492,1827,1350,10932,20,600,1925,1350,12564
290.245,17,4,240,2,32,290244,32,120,2,32,290244,32,120
2.628,6,14,1640,7,256,434,256,1052,7,304,434,304,588
0.072,17,2,334,1,32,0,32,60,1,246,0,246,274
0.086,17,6,2002,6,305,17,353,2002,0,0,0,0,0
1772.874,6,183,15738,121,69,14773,69,8980,62,69,29057,69,6758
37.91,6,55,20819,30,1129,529,1360,14862,25,329,1572,4027,5957
0.542,17,2,384,1,39,0,39,67,1,289,0,289,317
63.157,6,7,420,7,0,0,0,420,0,0,0,0,0
3.34,17,5,295,5,31,835,31,295,0,0,0,0,0
1799.942,6,360,23025,208,69,8695,69,12805,152,69,11919,69,10220
0.05,17,4,352,2,37,0,37,130,2,83,11,89,222
0.838,6,20,5948,11,281,83,544,1288,9,716,94,1420,4660
1.654,17,2,136,1,32,0,32,60,1,48,0,48,76
39.831,17,11,836,11,48,3983,48,836,0,0,0,0,0
0.15,17,6,912,3,60,54,60,264,3,188,0,188,648
0.03,6,3,151,1,0,0,0,40,2,31,0,31,111
86.413,17,4,1344,4,308,28804,308,1344,0,0,0,0,0
306.751,6,36,10821,20,437,16144,1146,4985,16,822,2646,2736,5836
8.231,17,2,672,2,308,8231,308,672,0,0,0,0,0
0.015,6,2,80,1,0,0,0,40,1,0,0,0,40
1795.139,17,80,3354,79,14,23014,14,3318,1,8,0,8,36
1770.79,17,335,53220,335,130,5301,376,53220,0,0,0,0,0
1.521,6,10,1687,7,100,253,100,384,3,1179,626,1179,1303
1795.767,17,448,39896,403,35,4467,288,25676,45,288,40014,288,14220
111.225,6,23,6177,9,272,116,516,1180,14,403,8548,1452,4997
1740.137,17,30,1710,30,29,60004,29,1710,0,0,0,0,0
1.381,6,37,8214,19,321,76,1164,2718,18,476,70,2715,5496
300.952,6,24,9040,15,156,21496,285,1415,9,1191,8328,2259,7625
4.691,17,57,24009,29,635,167,1350,19253,28,141,171,1350,4756
0.505,17,3,451,2,39,474,39,134,1,289,0,289,317
0.0,6,2,92,2,0,0,0,92,0,0,0,0,0
292.535,6,37,8219,18,274,17205,517,1780,19,778,16249,1418,6439
237.133,17,4,352,2,60,237132,60,176,2,60,237132,60,176
1708.044,6,104,8454,71,64,24400,64,5336,33,58,50762,58,3118
0.007,17,2,382,1,33,0,33,61,1,293,0,293,321
212.71,6,18,1269,9,65,26588,208,754,9,31,18788,31,515
0.059,6,10,1380,5,145,14,145,349,5,827,12,827,1031
0.635,6,123,91005,75,1298,8,1432,84794,48,534,13,3303,6211
0.132,17,2,198,1,39,0,39,67,1,103,0,103,131
300.135,6,28,8790,16,404,20009,1242,2481,12,630,5985,1448,6309
52.853,6,15,1887,6,100,133,100,344,9,1179,6575,1179,1543
11.295,6,1810,1555225,1092,1370,10,1420,1522284,718,467,15,1883,32941
1787.719,17,324,24624,324,48,5534,48,24624,0,0,0,0,0
1796.096,6,383,24497,216,69,8353,69,13194,167,69,10819,69,11303
1.115,6,25,8080,12,164,86,267,1312,13,869,78,1408,6768
1748.071,6,100,7860,66,45,26893,205,4896,34,35,52963,98,2964
9.437,6,1734,1587647,1093,1374,8,1408,1549651,641,931,14,2816,37996
1771.778,6,104,9648,68,65,26444,65,5758,36,59,50619,59,3890
1680.92,1,15,840,15,28,120065,28,840,0,0,0,0,0
1797.314,17,448,39896,403,35,4470,288,25676,45,288,40024,288,14220
1.274,6,46,18120,26,882,50,1440,12544,20,433,58,1440,5576
11.637,6,25,8473,13,275,969,275,1078,12,986,775,1440,7395
1773.47,6,181,15589,120,69,14903,69,8940,61,69,29552,69,6649
1679.632,1,7,392,7,28,279938,28,392,0,0,0,0,0
7.361,6,5,284,1,0,0,0,60,4,0,2392,0,224
65.91,17,2,152,2,48,65910,48,152,0,0,0,0,0
1744.646,2,27,864,27,8,67101,8,864,0,0,0,0,0
0.055,17,3,1007,1,137,0,137,165,2,393,4,393,842
0.269,17,3,451,2,39,245,39,134,1,289,0,289,317
1750.602,17,12,498,11,14,175060,14,462,1,8,0,8,36
1790.304,6,255,63471,138,642,13066,1259,49884,117,129,15432,249,13587
778.36,17,10,902,5,32,194576,37,304,5,91,194577,136,598
1744.69,2,14,448,14,8,134206,8,448,0,0,0,0,0
1772.579,6,180,15480,120,69,14895,69,8940,60,69,30035,69,6540
1796.27,17,449,39928,404,35,4457,288,25708,45,288,40015,288,14220
0.324,6,22,7333,12,334,28,663,1969,10,1209,35,2816,5364
226.896,6,28,6562,11,220,6304,516,1325,17,325,14175,1452,5237
1638.623,1,7,392,7,28,273103,28,392,0,0,0,0,0
0.53,6,14,2181,8,324,75,585,1061,6,396,104,580,1120
38.814,17,22,1672,22,48,1848,48,1672,0,0,0,0,0
1.048,17,5,980,3,32,480,32,180,2,372,88,470,800
1786.829,6,103,8404,68,66,26669,66,4964,35,60,52551,60,3440
0.324,17,8,2774,8,318,46,357,2774,0,0,0,0,0
2.999,17,3,183,3,33,1499,33,183,0,0,0,0,0
0.197,17,2,154,1,33,0,33,61,1,65,0,65,93
3.759,6,32,6105,17,206,234,314,2744,15,551,249,1179,3361
0.06,2,2,64,2,8,60,8,64,0,0,0,0,0
1.068,6,23,7952,12,164,82,267,1288,11,1216,91,3819,6664
0.409,17,4,240,2,32,408,32,120,2,32,408,32,120
1.935,17,5,1160,5,204,483,204,1160,0,0,0,0,0
1681.759,1,15,840,15,28,120125,28,840,0,0,0,0,0
1699.512,17,12,498,11,14,169951,14,462,1,8,0,8,36
0.0,17,1,493,1,465,0,465,493,0,0,0,0,0
280.458,6,32,7773,14,175,21573,267,1618,18,603,16493,2760,6155
1799.236,17,449,39928,404,35,4464,288,25708,45,288,40017,288,14220
0.176,17,2,157,1,31,0,31,59,1,70,0,70,98
1.143,17,4,580,2,40,1103,40,136,2,194,1113,194,444
0.244,6,9,1002,5,213,61,213,417,4,421,66,421,585
0.575,17,2,144,1,36,0,36,64,1,52,0,52,80
1318.805,1,16,896,16,28,87920,28,896,0,0,0,0,0
302.034,6,33,6397,17,286,18877,1314,2405,16,334,20134,1420,3992
333.159,1,5,447,5,61,83289,93,447,0,0,0,0,0
74.878,6,21,10149,11,433,63,990,1771,10,1327,8306,3928,8378
0.033,17,2,489,1,34,0,34,62,1,399,0,399,427
0.432,17,2,925,1,548,0,548,576,1,321,0,321,349
1790.668,17,87,3648,86,14,21066,14,3612,1,8,0,8,36
76.235,6,15,620,7,0,4220,0,284,8,0,10889,0,336
0.103,17,2,347,1,29,0,29,57,1,262,0,262,290
103.701,17,6,1236,3,48,51847,48,228,3,308,51846,308,1008
1772.383,6,180,15480,120,69,14893,69,8940,60,69,30037,69,6540
0.729,6,120,87454,54,131,13,232,2689,66,1346,11,1420,84765
2.906,1,30,2520,30,56,100,56,2520,0,0,0,0,0
280.033,6,29,7392,14,158,21541,267,1357,15,678,20000,3436,6035
9.059,6,41,8480,20,333,476,685,1856,21,412,444,1460,6624
1793.663,6,356,22520,208,69,8665,69,12460,148,69,12201,69,10060
133.989,17,10,3360,10,308,14887,308,3360,0,0,0,0,0
147.874,6,133,36121,64,442,2347,1440,18108,69,410,2172,1702,18013
93.048,6,59,30113,32,1106,613,1360,16813,27,763,3571,3639,13300
6.037,6,33,6129,17,206,377,314,2744,16,548,367,1179,3385
0.117,17,2,672,2,308,117,308,672,0,0,0,0,0
1778.253,17,140,11200,70,48,25771,48,5320,70,56,25771,56,5880
76.028,2,2,64,2,8,76028,8,64,0,0,0,0,0
0.907,6,28,8503,14,270,57,561,1945,14,997,57,1791,6558
0.373,6,11,3410,5,75,93,75,343,6,1373,74,1448,3067
1309.135,17,63,2646,63,14,21115,14,2646,0,0,0,0,0
1728.097,17,16,5684,16,327,115206,961,5684,0,0,0,0,0
33.762,17,40,5880,20,48,1776,48,1520,20,190,1776,308,4360
2.468,6,1998,1862803,1130,212,2,230,62675,868,2026,2,12672,1800128
1.902,6,12,1303,6,256,377,256,756,6,303,377,303,547
33.544,17,6,1236,3,48,16765,48,228,3,308,16765,308,1008
1796.131,17,447,39864,402,35,4479,288,25644,45,288,40015,288,14220
1785.582,6,102,8296,68,65,26650,65,4930,34,59,54105,59,3366
1790.02,6,481,85394,312,304,5755,304,63424,169,83,10654,83,21970
1799.987,1,344,28896,344,56,5247,56,28896,0,0,0,0,0
1768.85,6,82,5272,41,36,44220,36,2216,41,456,44220,456,3056
0.381,17,2,279,1,36,0,36,64,1,187,0,187,215
240.261,6,41,8579,22,523,11440,1408,5863,19,245,13347,638,2716
17.801,17,4,1344,4,308,5933,308,1344,0,0,0,0,0
3.433,6,2,88,2,0,0,0,88,0,0,0,0,0
1793.09,6,355,22618,205,69,8789,69,12340,150,69,12034,69,10278
0.395,6,10,887,5,248,92,248,452,5,231,90,231,435
240.244,6,57,17581,28,756,8897,1402,14320,29,218,8579,580,3261
0.009,6,4,4011,1,0,0,0,40,3,1925,2,2840,3971
1740.854,1,12,696,12,30,158259,30,696,0,0,0,0,0
10.932,6,50,11213,26,296,437,745,2318,24,440,458,1460,8895
34.932,17,20,1760,10,48,3879,48,760,10,72,3879,72,1000
0.53,17,4,768,2,39,521,39,134,2,289,12,289,634
0.011,17,4,284,2,32,3,32,120,2,54,2,60,164
0.021,17,2,159,1,35,0,35,63,1,68,0,68,96
314.762,6,43390,45745530,14108,647,22,650,800400,29282,1483,10,7240,44945130
1680.962,1,15,840,15,28,120068,28,840,0,0,0,0,0
0.163,17,2,136,1,32,0,32,60,1,48,0,48,76
1624.317,2,15,480,15,8,116022,8,480,0,0,0,0,0
33.807,6,32,5156,15,180,2414,721,1859,17,267,2097,1368,3297
10.259,6,96,33376,50,626,209,1152,27054,46,407,222,1152,6322
1.998,6,45,18080,26,882,79,1460,12544,19,529,94,4075,5536
0.263,17,2,152,1,48,0,48,76,1,48,0,48,76
2.023,17,2,517,1,34,0,34,62,1,427,0,427,455
1770.502,6,215,25460,135,104,13212,469,12533,80,127,22407,1420,12927
1795.12,1,58,4872,58,56,31493,56,4872,0,0,0,0,0
1772.436,6,180,15480,120,69,14894,69,8940,60,69,30035,69,6540
0.503,17,2,167,1,39,0,39,67,1,72,0,72,100
3.722,17,4,352,2,60,3721,60,176,2,60,3721,60,176
107.389,17,4,240,2,32,107388,32,120,2,32,107387,32,120
126.845,2,2,64,2,8,126845,8,64,0,0,0,0,0
1.205,6,23,6512,13,333,99,1006,2192,10,979,132,1731,4320
1.942,6,24,5755,13,158,161,370,1315,11,799,193,1420,4440
1796.084,1,57,4788,57,56,32072,56,4788,0,0,0,0,0
1679.059,1,15,840,15,28,119932,28,840,0,0,0,0,0
300.613,6,50,9136,25,278,12525,766,2228,25,327,627,1460,6908
1771.094,6,112,12008,70,109,25668,822,7462,42,67,43195,191,4546
0.095,17,2,198,1,39,0,39,67,1,103,0,103,131
1783.814,6,358,22669,209,69,8575,69,12569,149,69,12052,69,10100
0.354,17,2,136,1,32,0,32,60,1,48,0,48,76
0.157,6,27,7296,13,155,13,267,1301,14,603,11,2036,5995
11.87,6,1895,1640650,1144,1379,10,1420,1606161,751,467,15,1883,34489
64.695,6,12,976,4,226,118,226,442,8,110,9217,110,534
0.06,17,2,327,1,35,0,35,63,1,236,0,236,264
1784.521,6,102,8296,68,65,26634,65,4930,34,59,54073,59,3366
1786.637,6,102,8364,68,66,26666,66,4964,34,60,54137,60,3400
73.167,6,25,8165,13,368,68,801,1704,12,746,6641,4080,6461
6.922,6,704,590140,421,1328,16,1368,570760,283,776,23,2736,19380
1740.714,17,30,31680,30,1028,60024,1028,31680,0,0,0,0,0
18.316,6,95,69911,57,1289,327,1440,62308,38,702,491,1440,7603
7.179,6,1481,1385982,924,1422,7,1448,1352342,557,776,12,1448,33640
1797.291,17,448,39896,403,35,4470,288,25676,45,288,40020,288,14220
3.618,17,4,768,2,39,1936,39,134,2,289,3123,289,634
152.894,17,4,240,2,32,152893,32,120,2,32,152893,32,120
0.263,17,3,451,2,39,179,39,134,1,289,0,289,317
0.75,6,2,87,1,0,0,0,40,1,7,0,7,47
55.1,6,25,7103,12,156,5009,267,1272,13,589,4590,3426,5831
0.013,17,4,524,2,39,0,39,134,2,167,1,167,390
60.673,6,12,1220,7,180,10112,180,732,5,110,15111,110,488
5.14,6,4,176,3,0,2570,0,128,1,0,0,0,48
0.184,6,27,7296,13,155,15,267,1301,14,603,12,2036,5995
38.086,17,11,836,11,48,3808,48,836,0,0,0,0,0
28.477,6,47,13903,23,315,1294,721,3447,24,678,1193,1420,10456
17.285,6,11,1306,6,304,3455,304,932,5,102,4318,102,374
1772.836,6,181,15589,120,69,14897,69,8940,61,69,29545,69,6649
1.401,6,49,20056,28,885,51,1360,14440,21,433,60,1360,5616
8.998,6,37,9982,20,619,473,1360,3310,17,543,548,3502,6672
0.414,6,7,376,4,0,138,0,216,3,0,100,0,160
13.768,6,25,4614,14,275,1059,275,1122,11,758,899,1420,3492
1772.292,6,180,15480,120,69,14893,69,8940,60,69,30033,69,6540
280.562,6,29,7392,13,158,23380,267,1317,16,603,18697,2036,6075
1592.639,1,14,784,14,28,122510,28,784,0,0,0,0,0
1779.436,17,73,3060,72,14,25062,14,3024,1,8,0,8,36
1799.875,17,140,11200,70,48,26085,48,5320,70,56,26085,56,5880
29.415,17,10,1588,5,48,7351,48,380,5,213,7351,308,1208
3.716,6,41,15547,23,746,168,1408,13141,18,208,218,580,2406
171.877,6,25,10819,14,617,53,1360,3679,11,1114,17174,2720,7140
48.558,6,27,7177,13,155,4046,267,1306,14,530,3734,3417,5871
150.391,6,29,7392,13,158,12532,267,1317,16,603,10023,2036,6075
0.123,17,2,198,1,39,0,39,67,1,103,0,103,131
0.15,6,2,80,1,0,0,0,40,1,0,0,0,40
150.171,17,4,332,2,31,150152,33,118,2,79,150153,93,214
265.127,17,4,240,2,32,265126,32,120,2,32,265126,32,120
1.554,17,21,6399,10,321,168,1350,3491,11,236,151,1350,2908
1685.783,17,13,534,11,14,168560,14,462,2,8,1685603,8,72
283.519,6,33,7813,15,175,20251,267,1658,18,543,16674,1380,6155
140.076,6,157,123568,102,1275,1386,1408,111195,55,731,1635,3847,12373
1789.174,6,424,43910,200,144,8990,1360,20684,224,98,8022,4649,23226
0.263,6,2,364,1,0,0,0,40,1,272,0,272,324
0.486,17,11,4664,5,432,121,1350,2303,6,365,60,1350,2361
0.73,6,4,220,2,0,730,0,100,2,0,303,0,120
53.311,6,20,5445,11,290,5331,517,1161,9,1266,6648,1802,4284
3.647,6,2,88,2,0,0,0,88,0,0,0,0,0
240.652,6,45,9085,23,519,10938,1402,5891,22,226,11459,618,3194
12.188,6,1892,1631109,1152,1361,10,1380,1597267,740,421,16,1923,33842
0.509,17,4,288,2,36,490,36,128,2,52,494,52,160
1.0,17,2,122,2,33,1000,33,122,0,0,0,0,0
1746.956,6,95,7203,63,38,28176,205,4476,32,33,56341,98,2727
1743.784,6,95,7203,63,38,28125,205,4476,32,33,56239,98,2727
280.487,6,28,7352,13,158,23373,267,1317,15,678,20030,3456,6035
1740.586,6,87,6322,58,31,30536,31,3915,29,31,62163,31,2407
1785.973,17,83,3480,82,14,22049,14,3444,1,8,0,8,36
0.978,17,4,624,2,64,872,64,184,2,192,880,192,440
1786.609,6,106,8456,68,65,26665,65,4930,38,59,48284,59,3526
138.695,6,272,196985,130,1128,49,1440,20163,142,1316,982,1614,176822
1203.201,2,9,288,9,8,150400,8,288,0,0,0,0,0
148.287,17,12,912,12,48,13480,48,912,0,0,0,0,0
1789.539,6,240,35580,150,302,12010,302,25920,90,83,20107,83,9660
280.254,6,28,7352,12,158,25477,267,1277,16,603,18679,1400,6075
0.215,6,17,6096,9,70,25,133,504,8,1317,29,1414,5592
1.342,6,60,18098,30,706,46,1360,8989,30,438,45,1360,9109
5.734,6,19,9257,9,275,716,275,639,10,1026,605,2840,8618
3.429,6,21,6369,10,268,376,517,1333,11,744,338,1418,5036
1.975,17,23,17568,12,542,179,1350,6843,11,947,98,1350,10725
370.88,6,18,1242,14,180,28529,180,916,4,110,20062,110,326
64.576,6,41,8801,20,401,652,889,2084,21,391,3221,2720,6717
252.976,1,40,3360,40,56,6486,56,3360,0,0,0,0,0
0.596,6,27,9145,13,273,49,733,1778,14,945,39,1368,7367
35.906,6,27,7177,13,155,2992,267,1306,14,530,2761,3417,5871
369.773,6,21,1419,15,177,26412,177,989,6,110,12240,110,430
1788.999,17,83,3480,82,14,22086,14,3444,1,8,0,8,36
1786.245,17,140,11200,70,48,25887,48,5320,70,56,25887,56,5880
65.134,6,22,7911,11,366,96,795,1570,11,841,6496,2720,6341
152.883,6,16,1144,9,34,19093,38,638,7,35,25457,40,506
17.902,6,2632,2465331,1706,1367,10,1408,2412515,926,931,19,2816,52816
59.495,6,41,8635,20,360,746,766,1949,21,388,2968,2128,6686
1786.495,6,117,9402,75,66,24141,66,5442,42,60,43570,60,3960
3.487,17,5,290,5,30,871,30,290,0,0,0,0,0
1787.241,6,105,8484,68,66,26675,66,4964,37,60,49643,60,3520
1682.589,17,14,1036,7,30,280424,30,406,7,62,280420,62,630
0.853,6,4,191,1,0,0,0,40,3,31,0,31,151
280.827,6,57,9621,30,657,9683,1418,6227,27,103,10800,580,3394
1344.751,17,65,2730,65,14,21011,14,2730,0,0,0,0,0
986.1,6,123,9663,46,75,21910,374,4697,77,49,12973,143,4966
280.426,6,32,7512,13,158,23368,267,1317,19,543,15576,1380,6195
5.863,17,700,153620,438,267,13,1108,129511,262,64,22,598,24109
82.919,6,33,7762,13,155,6909,267,1306,20,376,4363,4260,6456
3.493,6,2,88,2,0,0,0,88,0,0,0,0,0
1773.264,6,180,15480,120,69,14901,69,8940,60,69,30047,69,6540
0.039,6,2,80,1,0,0,0,40,1,0,0,0,40
0.658,6,10,924,5,283,110,283,551,5,105,115,105,373
372.241,6,18,1242,14,180,28633,180,916,4,110,20072,110,326
61.861,6,70,47104,43,1184,1472,1448,38971,27,746,2370,1448,8133
11.365,6,1811,1571023,1097,1378,10,1420,1538230,714,467,15,1883,32793
300.666,6,63,49048,37,265,8351,474,3018,26,2030,1079,5450,46030
1789.227,6,371,24872,214,87,8400,469,14314,157,69,11469,69,10558
0.723,6,381,283348,193,183,3,230,11025,188,1411,3,2816,272323
280.323,6,30,7432,13,158,23360,267,1317,17,543,17518,1400,6115
0.279,6,26,9072,13,271,23,726,1783,13,943,22,1408,7289
3.104,17,4,272,2,32,3094,32,120,2,48,3097,48,152
1.407,6,44,13423,23,685,63,1460,7807,21,433,60,1460,5616
165.227,2,5,160,5,8,41306,8,160,0,0,0,0,0
10.656,6,1769,1481841,1049,1361,10,1380,1446831,720,515,14,1923,35010
33.477,6,28,4974,15,180,2391,721,1894,13,480,2774,2026,3080
0.055,17,8,2446,8,277,7,316,2446,0,0,0,0,0
0.059,17,4,865,2,47,49,47,150,2,329,48,341,715
2.283,17,2,925,1,548,0,548,576,1,321,0,321,349
300.562,6,24,8187,13,286,25046,832,1854,11,960,30055,2523,6333
1772.619,6,180,15480,120,69,14895,69,8940,60,69,30038,69,6540
11.8,6,1791,1566555,1107,1362,10,1380,1534953,684,421,17,1923,31602
62.999,6,10,520,10,0,0,0,520,0,0,0,0,0
0.014,17,3,234,2,39,0,39,134,1,72,0,72,100
287.834,6,17,6711,5,290,857,517,861,12,578,26166,1408,5850
1782.038,6,102,8228,68,64,26597,64,4896,34,58,53998,58,3332
1796.325,6,367,25650,214,99,8433,469,15045,153,69,11814,69,10605
4.879,6,39,7269,19,218,271,314,3383,20,513,242,1179,3886
11.835,6,21,4482,11,275,1183,275,998,10,768,1208,1440,3484
0.001,17,2,136,1,32,0,32,60,1,48,0,48,76
0.858,6,51,13849,24,549,37,1429,4860,27,464,32,1986,8989
445.635,17,6,360,3,32,222817,32,180,3,32,222817,32,180
4.017,17,4,244,4,33,1339,33,244,0,0,0,0,0
1796.025,6,356,22520,208,69,8676,69,12460,148,69,12217,69,10060
33.842,6,33,5197,16,154,2256,722,1910,17,299,2100,1408,3287
0.215,17,2,167,1,39,0,39,67,1,72,0,72,100
1785.854,6,367,25581,213,99,8423,469,15005,154,69,11672,69,10576
4.001,6,33,6129,17,206,250,314,2744,16,548,247,1179,3385
1.391,6,48,20076,27,953,53,1440,14460,21,433,59,1440,5616
280.008,6,30,7432,14,158,21539,267,1357,16,543,18666,1400,6075
3.007,6,4,1600,2,0,3007,0,80,2,1440,1688,1440,1520
1749.752,17,13,534,11,14,174957,14,462,2,8,1749544,8,72
0.151,17,4,284,2,32,139,32,120,2,54,17,60,164
1.415,6,20,3833,11,234,141,564,1504,9,463,154,1343,2329
280.532,6,28,7352,13,158,23377,267,1317,15,775,20030,3465,6035
1788.661,17,87,3648,86,14,21043,14,3612,1,8,0,8,36
1.359,6,24,8004,12,164,105,267,1288,12,1014,105,2491,6716
0.363,6,45,18155,25,1004,15,1380,13113,20,421,17,1923,5042
2.062,6,834,1625292,443,221,4,230,26825,391,4056,5,12672,1598467
0.131,6,10,1669,6,551,26,947,1346,4,159,43,159,323
10.986,6,19,1534,10,275,1220,275,962,9,96,1136,96,572
280.338,6,30,7432,13,158,23361,267,1317,17,543,17515,1400,6115
11.151,17,2,672,2,308,11151,308,672,0,0,0,0,0
1.765,6,24,8004,12,164,141,267,1288,12,1014,141,2491,6716
0.08,6,10,1495,5,507,19,507,727,5,556,19,556,768
2.09,6,15,2391,9,188,261,245,740,6,703,367,1152,1651
1783.293,17,136,10880,68,48,26616,48,5168,68,56,26616,56,5712
294.499,17,4,352,2,60,294498,60,176,2,60,294498,60,176
1797.953,6,356,22520,208,69,8685,69,12460,148,69,12230,69,10060
1681.543,17,14,1036,7,30,280255,30,406,7,62,280255,62,630
2.439,17,4,574,3,39,965,39,201,1,345,0,345,373
0.178,1,2,112,2,28,178,28,112,0,0,0,0,0
1797.948,17,354,47010,174,181,10392,1350,36402,180,30,10044,61,10608
1792.92,1,57,4788,57,56,32016,56,4788,0,0,0,0,0
1799.923,6,378,26366,218,97,8294,469,15481,160,69,11317,69,10885
1776.755,17,140,11200,70,48,25750,48,5320,70,56,25750,56,5880
0.065,6,14,4482,8,135,9,136,695,6,1159,12,1863,3787
1756.836,6,107,6374,60,27,29776,27,3525,47,27,38191,27,2849
0.361,6,25,8859,13,237,30,590,1635,12,1098,32,2816,7224
1798.68,17,87,3648,86,14,21160,14,3612,1,8,0,8,36
16.423,17,26,17921,14,885,1258,1350,12795,12,399,1485,1350,5126
1783.805,6,392,26752,225,100,7963,469,15416,167,58,10745,69,11336
1770.687,6,100,9358,66,66,27241,66,5610,34,60,53654,60,3748
46.724,6,45,9036,21,412,659,889,2168,24,327,2026,1360,6868
0.251,17,2,384,1,39,0,39,67,1,289,0,289,317
1.475,6,48,18938,27,872,56,1360,13322,21,433,63,1360,5616
311.6,6,23,5479,10,133,34621,159,939,13,967,25966,1669,4540
0.186,17,2,152,1,48,0,48,76,1,48,0,48,76
280.199,6,29,7392,13,158,23349,267,1317,16,543,18679,1400,6075
231.57,6,868,416497,460,835,503,1152,395940,408,470,568,1179,20557
1771.599,6,101,9278,66,64,27255,64,5544,35,58,52102,58,3734
855.159,6,24135,20488903,11023,347,77,349,717087,13112,1459,65,4104,19771816
1746.343,6,94,7151,62,38,28628,205,4424,32,33,56325,98,2727
1745.711,6,99,7411,63,38,28156,205,4476,36,33,49871,98,2935
8.157,6,13,2119,7,253,1359,597,1365,6,147,1076,346,754
0.53,17,3,451,2,39,451,39,134,1,289,0,289,317
299.596,6,6,364,4,31,99865,31,222,2,31,299566,31,142
4.366,17,2,656,2,300,4366,300,656,0,0,0,0,0
26.441,6,35,8985,17,303,1652,722,2812,18,778,1369,2760,6173
577.482,6,26,1352,13,0,48119,0,676,13,0,48119,0,676
1799.297,17,449,39928,404,35,4464,288,25708,45,288,40018,288,14220
0.437,6,6,324,4,0,145,0,216,2,0,246,0,108
916.625,6,55,4305,36,64,26189,64,2528,19,56,50903,58,1777
5.02,6,42,8289,21,227,251,314,4022,21,489,237,1179,4267
87.436,17,5,1672,5,306,21859,308,1672,0,0,0,0,0
27.485,17,16,1408,8,48,3924,48,608,8,72,3924,72,800
1789.942,6,356,22520,208,69,8647,69,12460,148,69,12176,69,10060
0.015,6,9,1556,5,515,3,515,783,4,557,4,557,773
132.239,6,33,14370,16,488,323,1460,3127,17,959,8256,1460,11243
0.089,17,2,158,1,34,0,34,62,1,68,0,68,96
15.982,6,7,435,0,0,0,0,0,7,31,2663,31,435
11.39,6,19,4402,10,275,1265,275,958,9,768,776,1440,3444
666.078,17,19,1712,19,62,37004,352,1712,0,0,0,0,0
1786.096,17,142,11360,71,48,25515,48,5396,71,56,25514,56,5964
0.171,6,18,3004,9,266,21,517,1542,9,493,20,828,1462
7.186,17,3,1008,3,308,3593,308,1008,0,0,0,0,0
0.0,17,3,658,3,191,0,219,658,0,0,0,0,0
4.697,17,6,400,5,36,1166,36,320,1,52,0,52,80
1.447,6,50,18787,27,855,55,1360,13091,23,433,57,1360,5696
296.992,6,41,7067,18,128,17470,722,2227,23,280,10840,2330,4840
372.12,6,18,1242,14,180,28624,180,916,4,110,20060,110,326
0.008,17,2,216,1,45,0,45,73,1,115,0,115,143
2.854,17,4,624,4,128,951,128,624,0,0,0,0,0
0.261,6,24,5962,12,164,23,453,1442,12,648,22,2176,4520
0.619,6,22,5040,10,137,68,267,1092,12,577,51,1400,3948
0.006,6,2,430,1,338,0,338,390,1,0,0,0,40
2.514,17,2,440,1,39,0,39,67,1,345,0,345,373
3.034,17,4,340,2,37,3027,37,130,2,77,3027,77,210
11.16,6,1775,1542834,1074,1380,10,1420,1510573,701,467,15,1883,32261
18.336,17,35,11382,16,340,1220,1350,5899,19,260,1016,1350,5483
12.815,6,14,2193,8,324,1830,585,1073,6,396,2418,580,1120
0.68,6,10,924,5,283,117,283,551,5,105,122,105,373
1.446,6,38,8254,19,321,80,1164,2718,19,433,70,1360,5536
141.214,6,27,6494,11,220,6317,516,1326,16,348,9407,1452,5168
0.398,6,19,7099,12,318,36,600,1906,7,1205,64,1891,5193
1.159,6,201,159121,121,1334,9,1432,151630,80,427,14,1432,7491
0.101,6,10,1512,5,503,25,503,771,5,473,25,473,741
1792.039,6,123,7852,66,27,27568,27,3984,57,52,31999,427,3868
101.625,6,5,809,2,517,101625,517,629,3,0,1158,0,180
252.218,17,31,35557,31,1119,8407,1451,35557,0,0,0,0,0
34.815,17,10,760,10,48,3868,48,760,0,0,0,0,0
1772.466,6,180,15480,120,69,14894,69,8940,60,69,30039,69,6540
1790.744,6,355,22480,207,69,8692,69,12420,148,69,12181,69,10060
6.469,6,23,4478,12,213,588,597,1689,11,441,627,1402,2789
8.29,6,1636,1478046,1012,1381,8,1408,1440934,624,931,13,2801,37112
0.09,6,9,1002,5,213,22,213,417,4,421,22,421,585
452.391,17,8,673,4,31,150790,37,239,4,80,150791,136,434
1772.544,6,180,15480,120,69,14895,69,8940,60,69,30036,69,6540
0.118,6,11,1535,6,507,23,507,767,5,556,29,556,768
1.335,6,48,20142,28,894,49,1360,14566,20,476,60,2715,5576
1795.631,17,447,39864,402,35,4477,288,25644,45,288,40019,288,14220
23.252,6,32,8140,15,175,1660,722,2007,17,908,1439,1380,6133
68.92,6,51,14226,25,1014,676,1360,8229,26,290,2749,1360,5997
4.596,17,6,1437,3,40,2291,40,204,3,383,2292,391,1233
0.221,6,2,1183,1,1091,0,1091,1143,1,0,0,0,40
1772.951,6,180,15480,120,69,14898,69,8940,60,69,30041,69,6540
1659.112,1,8,448,8,28,237016,28,448,0,0,0,0,0
1787.149,6,104,8308,68,64,26673,64,4896,36,58,51059,58,3412
35.04,17,40,5880,20,48,1843,48,1520,20,190,1843,308,4360
465.186,6,47,3040,28,50,17222,208,2032,19,31,25834,31,1008
11.4,17,4,352,2,60,11398,60,176,2,60,11399,60,176
5.907,6,33,8992,15,158,421,267,1397,18,624,344,1400,7595
10.707,6,2189,2049373,1406,1380,7,1408,2003993,783,931,13,2801,45380
1715.816,1,8,848,8,78,245116,78,848,0,0,0,0,0
0.415,17,2,152,1,48,0,48,76,1,48,0,48,76
0.533,17,2,685,1,308,0,308,336,1,321,0,321,349
1.29,6,24,8004,12,164,99,267,1288,12,1014,99,2804,6716
1787.284,6,102,8296,68,65,26675,65,4930,34,59,54157,59,3366
1.342,17,27,12379,12,558,122,1350,7035,15,328,77,1350,5344
1797.261,1,32,1792,32,28,57976,28,1792,0,0,0,0,0
22.873,6,25,1713,14,182,1759,182,930,11,77,2239,134,783
125.91,2,2,64,2,8,125910,8,64,0,0,0,0,0
0.469,6,2,104,1,0,0,0,52,1,0,0,0,52
42.409,17,6,528,3,48,21198,48,228,3,72,21192,72,300
0.117,6,2,364,1,0,0,0,40,1,272,0,272,324
69.699,6,24,10136,13,541,52,1360,2717,11,1161,6956,2574,7419
3.375,6,8,339,4,0,1125,0,164,4,7,895,7,175
280.391,6,31,7733,14,175,21568,267,1618,17,543,17517,1400,6115
280.485,6,28,7352,13,158,23373,267,1317,15,775,20032,4836,6035
1221.526,6,246,55736,117,856,10530,1418,43833,129,66,9543,530,11903
8.515,17,4,240,2,32,8514,32,120,2,32,8514,32,120
1.729,17,6,360,3,32,864,32,180,3,32,864,32,180
1724.091,1,8,448,8,28,246298,28,448,0,0,0,0,0
240.338,6,43,8879,21,523,12016,1408,5810,22,213,11444,618,3069
300.972,6,39,8426,21,267,15048,731,1942,18,442,517,1360,6484
5.833,6,814,671961,468,1352,12,1368,646429,346,776,16,1473,25532
0.084,6,2,80,1,0,0,0,40,1,0,0,0,40
0.525,17,2,904,2,424,525,548,904,0,0,0,0,0
0.027,17,2,152,1,48,0,48,76,1,48,0,48,76
28.805,6,3909,3695792,2564,1364,11,1408,3621188,1345,931,21,2801,74604
1740.44,17,28,6580,28,207,64460,207,6580,0,0,0,0,0
132.423,6,27,6223,15,536,9458,1244,2982,12,260,5632,1282,3241
1637.826,2,12,384,12,8,148893,8,384,0,0,0,0,0
0.182,17,2,152,1,48,0,48,76,1,48,0,48,76
478.498,17,10,3360,10,308,53166,308,3360,0,0,0,0,0
2.02,17,6,1377,3,40,1004,40,204,3,363,1004,363,1173
295.168,17,4,352,2,60,295166,60,176,2,60,295167,60,176
1680.255,1,15,840,15,28,120018,28,840,0,0,0,0,0
8.928,6,2,120,2,0,0,0,120,0,0,0,0,0
20.131,17,19,6622,9,428,2512,1350,4109,10,223,2233,1350,2513
316.848,6,105,34450,57,494,5658,1360,23593,48,343,6737,1929,10857
1700.609,17,13,534,11,14,170043,14,462,2,8,1700433,8,72
1793.314,17,140,11200,70,48,25989,48,5320,70,56,25989,56,5880
1772.498,6,180,15480,120,69,14894,69,8940,60,69,30036,69,6540
1789.618,17,142,11360,71,48,25565,48,5396,71,56,25565,56,5964
240.193,6,54,18213,29,821,8577,1418,15476,25,178,10007,580,2737
37.101,17,44,6468,22,48,1764,48,1672,22,190,1765,308,4796
28.491,6,47,13987,23,289,1295,721,3531,24,730,1192,2840,10456
0.417,17,20,12939,11,921,41,1350,10448,9,248,48,1350,2491
85.344,6,38,24023,22,840,4064,1360,5979,16,1932,5676,6800,18044
130.972,6,18,4296,6,188,26194,245,620,12,399,11883,1407,3676
115.665,17,3,511,3,142,57832,335,511,0,0,0,0,0
15.265,17,18,11311,11,807,1523,1350,9191,7,274,2538,1350,2120
1781.272,17,142,11360,71,48,25446,48,5396,71,56,25446,56,5964
647.008,1,42,7560,42,152,15780,152,7560,0,0,0,0,0
1757.271,1,8,848,8,78,251038,78,848,0,0,0,0,0
126.24,1,2,232,2,88,126240,88,232,0,0,0,0,0
0.265,17,4,668,2,32,261,32,120,2,246,4,246,548
0.201,6,22,5858,12,164,18,453,1442,10,555,21,1448,4416
22.271,17,4,352,2,60,22270,60,176,2,60,22270,60,176
0.005,6,2,186,2,106,5,106,186,0,0,0,0,0
0.045,6,9,1147,5,145,11,145,349,4,634,11,634,798
4.883,6,39,8848,14,342,375,1164,2668,25,343,195,1440,6180
2.293,17,3,2906,3,940,1146,1451,2906,0,0,0,0,0
38.095,2,2,64,2,8,38095,8,64,0,0,0,0,0
1796.967,17,449,39416,404,34,4458,288,25444,45,282,40024,288,13972
24.563,17,38,8650,13,182,2044,1350,2736,25,208,1021,1350,5914
1782.333,17,83,3480,82,14,22004,14,3444,1,8,0,8,36
3.291,17,5,588,4,64,1090,64,368,1,192,0,192,220
0.053,17,2,160,1,48,0,48,76,1,56,0,56,84
1787.162,6,105,8544,68,66,26674,66,4964,37,60,49640,60,3580
4.781,17,29,9612,15,427,339,1350,6828,14,170,365,1350,2784
1684.536,2,24,768,24,8,73240,8,768,0,0,0,0,0
0.411,6,7,376,4,0,137,0,216,3,0,108,0,160
523.32,17,8,2592,8,296,74760,300,2592,0,0,0,0,0
1765.217,6,190,11669,94,47,18980,208,6837,96,31,18578,31,4832
498.408,17,88,19300,88,191,5728,464,19300,0,0,0,0,0
228.316,17,4,352,2,60,228315,60,176,2,60,228315,60,176
15.36,6,15,6120,4,190,5061,190,370,11,1059,1519,2720,5750
1773.101,6,180,15480,120,69,14900,69,8940,60,69,30047,69,6540
0.579,17,2,167,1,39,0,39,67,1,72,0,72,100
106.412,6,16,652,6,0,4568,0,244,10,0,11822,0,408
347.228,1,5,280,5,28,86807,28,280,0,0,0,0,0
11.677,6,1827,1600488,1107,1391,10,1414,1567455,720,467,16,1889,33033
1799.129,6,367,25650,214,99,8446,469,15045,153,69,11836,69,10605
147.958,17,10,585,10,30,16439,31,585,0,0,0,0,0
243.218,6,50,9089,24,461,10574,1408,5902,26,166,9728,580,3187
280.429,6,30,7432,13,158,23369,267,1317,17,603,17521,2076,6115
1770.713,6,99,9174,66,64,27241,64,5544,33,58,55331,58,3630
1742.737,6,147,10130,80,65,22059,208,6551,67,31,26399,31,3579
0.538,17,3,451,2,39,488,39,134,1,289,0,289,317
1.364,6,2,88,2,0,0,0,88,0,0,0,0,0
290.58,1,4,224,4,28,96860,28,224,0,0,0,0,0
1241.065,17,16,3955,8,32,177293,37,485,8,405,177293,463,3470
7.331,6,1315,1176116,807,1378,8,1408,1145036,508,931,14,2816,31080
1736.876,1,104,5824,104,28,16862,28,5824,0,0,0,0,0
310.398,6,81,14958,32,253,10012,1189,5087,49,329,6466,1420,9871
0.042,17,2,152,1,48,0,48,76,1,48,0,48,76
17.959,6,22,4915,12,211,1629,211,1301,10,771,1994,1091,3614
301.35,6,107,78913,35,349,7774,517,2468,72,1268,4244,1432,76445
1.641,6,47,19130,27,888,63,1360,13554,20,433,74,1360,5576
1787.656,6,370,23425,213,69,8432,69,13005,157,69,11456,69,10420
1783.823,6,387,26588,220,98,8145,469,15492,167,61,10745,69,11096
281.495,6,29,7392,13,158,23457,267,1317,16,543,18765,1400,6075
0.03,17,2,904,1,300,0,300,328,1,548,0,548,576
0.004,17,2,453,1,32,0,32,60,1,365,0,365,393
0.402,6,50,22454,27,1078,15,1380,17301,23,467,16,1923,5153
20.183,6,75,27679,34,962,611,1440,14980,41,522,499,1440,12699
0.185,17,4,284,2,32,51,32,120,2,54,136,60,164
300.914,6,37,11330,20,634,15837,1402,4245,17,476,953,2804,7085
1788.776,6,356,22520,208,69,8641,69,12460,148,69,12166,69,10060
1.143,6,24,6552,13,333,94,1006,2192,11,783,113,1420,4360
240.484,6,43,8520,21,560,12023,1408,5598,22,196,11451,580,2922
127.396,6,23,10660,9,275,15924,275,639,14,788,9632,1380,10021
1.374,6,47,18484,26,907,54,1460,12868,21,433,60,1460,5616
0.046,6,10,1512,5,503,11,503,771,5,473,11,473,741
241.299,6,49,8876,25,449,10053,1418,5840,24,178,10490,580,3036
1795.543,17,448,39896,403,35,4466,288,25676,45,288,40018,288,14220
301.055,1,3,174,3,30,150527,30,174,0,0,0,0,0
1788.373,1,342,28728,342,56,5244,56,28728,0,0,0,0,0
128.193,6,28,8853,8,138,18313,267,891,20,510,6736,1452,7962
0.017,17,2,548,2,246,17,246,548,0,0,0,0,0
284.38,6,34,7604,16,158,18958,267,1441,18,603,16723,1400,6163
365.472,6,34,7437,17,181,6890,498,1956,17,342,22836,1420,5481
1788.792,17,140,11200,70,48,25924,48,5320,70,56,25924,56,5880
184.939,1,8,448,8,28,26419,28,448,0,0,0,0,0
1787.191,6,360,24694,210,94,8551,469,14347,150,69,11992,69,10347
594.648,2,5,160,5,8,148662,8,160,0,0,0,0,0
0.133,17,2,152,1,48,0,48,76,1,48,0,48,76
8.721,6,78,24293,39,549,229,1152,18592,39,459,222,1179,5701
4.147,6,38,7229,19,218,230,314,3383,19,440,216,1152,3846
3.153,6,35,19627,20,782,165,1360,6322,15,1586,214,3934,13305
0.462,6,12,1653,6,288,92,288,548,6,426,58,434,1105
251.602,2,3,96,3,8,125801,8,96,0,0,0,0,0
49.599,17,4,352,2,60,49598,60,176,2,60,49598,60,176
0.136,17,2,373,1,34,0,34,62,1,283,0,283,311
1783.345,6,368,26090,216,105,8294,469,15525,152,69,11809,69,10565
280.339,6,30,7432,13,158,23361,267,1317,17,543,17518,1400,6115
1.341,6,49,19122,27,882,51,1360,13466,22,476,55,2715,5656
1776.996,17,140,11200,70,48,25753,48,5320,70,56,25753,56,5880
17.529,17,29,13601,14,684,1346,1350,9979,15,213,1249,1350,3622
368.388,6,18,1242,14,180,28337,180,916,4,110,20059,110,326
280.475,6,29,7392,12,158,25497,267,1277,17,678,17526,2085,6115
10.97,6,20,4390,11,275,1097,275,998,9,755,780,1414,3392
0.019,17,2,198,1,39,0,39,67,1,103,0,103,131
5.012,17,4,558,2,36,5008,36,128,2,187,5008,187,430
1793.112,17,144,11520,72,48,25255,48,5472,72,56,25255,56,6048
1.679,6,10,1687,7,100,279,100,384,3,1179,690,1179,1303
17.998,6,16,7424,5,106,4499,106,314,11,740,1790,1452,7110
0.147,17,4,2876,2,689,147,1350,1434,2,693,46,1350,1442
240.325,6,43,8995,21,517,12015,1418,5760,22,231,11443,639,3235
8.275,2,2,64,2,8,8275,8,64,0,0,0,0,0
985.995,6,283,85218,136,553,7303,1360,64188,147,229,6749,2720,21030
0.959,6,11,1727,7,100,159,100,384,4,589,226,1152,1343
280.413,6,28,7352,13,158,23367,267,1317,15,603,20025,2076,6035
14.046,6,19,5654,11,275,1404,275,1002,8,1440,824,1440,4652
17.628,6,10,416,6,0,3525,0,244,4,0,5870,0,172
1794.377,17,66,2766,65,14,28037,14,2730,1,8,0,8,36
1782.714,6,104,8376,68,65,26607,65,4930,36,59,50931,59,3446
1401.368,17,14,1117,7,31,233559,37,413,7,72,233559,136,704
0.548,6,117,76237,65,1268,8,1432,69866,52,475,10,1871,6371
2.484,6,1799,1610794,1004,214,2,230,56041,795,1908,2,15488,1554753
18.842,6,1131,992016,723,1297,25,1368,965480,408,776,45,1473,26536
1772.365,6,180,15480,120,69,14893,69,8940,60,69,30033,69,6540
16.181,17,15,6241,7,511,2690,1350,3778,8,279,2299,1350,2463
1765.127,17,120,28110,120,206,14833,422,28110,0,0,0,0,0
1746.339,6,99,7473,65,38,27286,205,4580,34,33,52912,98,2893
1681.268,17,16,4241,8,30,240178,37,471,8,443,240179,463,3770
19.978,17,4,824,2,48,19971,48,152,2,308,19971,308,672
1776.123,17,138,11040,69,48,26119,48,5244,69,56,26119,56,5796
280.053,6,28,7352,13,158,23337,267,1317,15,678,20000,2800,6035
0.004,6,2,80,0,0,0,0,0,2,0,0,0,80
1.285,6,47,18787,27,864,49,1360,13211,20,476,58,2715,5576
1795.129,6,356,22520,208,69,8672,69,12460,148,69,12209,69,10060
1776.221,1,56,4704,56,56,32294,56,4704,0,0,0,0,0
98.577,2,2,64,2,8,98577,8,64,0,0,0,0,0
11.258,6,27,11355,13,275,938,275,1078,14,1078,822,1414,10277
280.24,6,27,7312,12,158,25476,267,1277,15,678,20015,2045,6035
1789.488,17,142,11360,71,48,25564,48,5396,71,56,25564,56,5964
32.814,17,18,1584,9,48,4100,48,684,9,72,4100,72,900
7.237,6,6,260,2,0,16,0,84,4,0,2407,0,176
0.04,6,3,160,2,0,40,0,100,1,0,0,0,60
96.001,6,11,1056,5,110,23999,138,752,6,64,19199,64,304
7.414,6,857,729608,499,1382,14,1448,706328,358,776,20,1448,23280
1386.319,2,8,256,8,8,198045,8,256,0,0,0,0,0
1681.628,17,14,1036,7,30,280266,30,406,7,62,280264,62,630
280.444,6,30,7432,13,158,23370,267,1317,17,543,17524,1380,6115
1773.749,6,180,15480,120,69,14905,69,8940,60,69,30057,69,6540
117.382,6,179,145284,116,1303,1020,1408,132498,63,730,1694,3847,12786
1788.338,1,58,4872,58,56,31374,56,4872,0,0,0,0,0
240.303,6,43,8998,21,523,12014,1418,5814,22,225,11442,618,3184
381.116,6,18,1242,14,180,29316,180,916,4,110,20059,110,326
1792.248,6,374,23792,215,69,8374,69,13292,159,69,11342,69,10500
1.63,6,46,18964,27,879,62,1360,13428,19,529,78,4075,5536
2.208,6,13,2311,8,188,315,245,700,5,1407,491,1407,1611
1773.186,6,181,15589,120,69,14900,69,8940,61,69,29551,69,6649
1772.508,6,202,22319,130,75,13740,267,10057,72,137,24959,2840,12262
1798.144,17,142,11360,71,48,25687,48,5396,71,56,25687,56,5964
40.962,6,23,5589,8,150,98,174,624,15,363,2919,1420,4965
1681.257,17,14,1036,7,30,280206,30,406,7,62,280206,62,630
0.483,17,2,152,1,48,0,48,76,1,48,0,48,76
1.393,6,10,1185,6,279,278,279,587,4,191,253,272,598
40.146,1,4,224,4,28,13382,28,224,0,0,0,0,0
0.289,6,24,5980,12,164,26,453,1442,12,651,24,1440,4538
1.671,6,40,8415,21,321,83,1164,2834,19,437,81,2715,5581
2.288,6,14,2351,8,188,326,245,700,6,703,407,1152,1651
1.402,6,48,19226,27,892,53,1460,13610,21,433,60,1460,5616
0.014,17,2,167,1,39,0,39,67,1,72,0,72,100
9.118,6,10,440,4,0,2970,0,176,6,0,1782,0,264
99.349,6,6,910,6,134,19869,134,910,0,0,0,0,0
244.953,6,87,22148,43,520,5832,1402,13710,44,323,5696,1402,8438
37.985,6,8,798,0,0,0,0,0,8,68,5426,69,798
1788.119,6,356,22520,208,69,8638,69,12460,148,69,12164,69,10060
0.242,6,4,208,3,0,121,0,156,1,0,0,0,52
256.209,6,33,7597,8,138,36601,267,883,25,300,10647,1460,6714
0.444,17,8,2750,8,315,63,354,2750,0,0,0,0,0
94.599,6,36,8132,13,140,7882,267,1513,23,316,4299,1460,6619
1290.812,17,295,35714,141,161,9220,1350,26757,154,30,8436,63,8957
1758.605,6,101,7918,65,45,27478,205,4850,36,35,50235,98,3068
1785.992,6,110,9155,70,71,25883,292,5302,40,64,45792,247,3853
0.908,6,10,1687,7,100,151,100,384,3,1179,327,1179,1303
0.499,6,12,1653,6,288,94,288,548,6,426,54,434,1105
300.667,6,37,8526,19,315,16703,882,2053,18,441,500,1440,6473
248.422,6,37,9319,20,158,13074,517,2171,17,782,15525,1408,7148
4.203,6,34,6169,18,206,247,314,2784,16,456,263,1152,3385
5.227,6,14,10530,5,275,1306,275,479,9,1383,629,1440,10051
125.971,2,2,64,2,8,125971,8,64,0,0,0,0,0
1790.348,6,191,24960,106,304,17050,304,17436,85,83,21313,83,7524
314.708,6,31,2599,19,88,17483,478,1995,12,31,28593,31,604
315.856,6,93,20580,47,296,6866,1360,10299,46,280,7016,4649,10281
7.839,6,14,1251,6,222,1565,222,688,8,231,1117,231,563
15.231,17,10,880,5,48,3805,48,380,5,72,3805,72,500
13.529,6,24,6993,13,275,1127,275,1078,11,910,851,1420,5915
1788.515,17,87,3648,86,14,21041,14,3612,1,8,0,8,36
1783.818,6,360,22887,208,69,8617,69,12529,152,69,11813,69,10358
0.111,6,11,1971,6,451,22,500,1222,5,481,27,481,749
481.36,2,4,128,4,8,160453,8,128,0,0,0,0,0
1772.483,6,180,15480,120,69,14894,69,8940,60,69,30037,69,6540
266.173,17,4,352,2,60,266172,60,176,2,60,266172,60,176
174.451,6,28,13208,16,741,90,1360,5131,12,1081,15843,2580,8077
2.149,17,5,373,3,31,1058,31,177,2,70,2077,70,196
1773.018,6,180,15480,120,69,14899,69,8940,60,69,30046,69,6540
3.897,6,15,1418,7,283,620,283,679,8,105,531,105,739
10.512,6,1708,1561436,1081,1369,9,1408,1524168,627,931,16,2801,37268
0.198,17,2,154,1,33,0,33,61,1,65,0,65,93
63.73,2,2,64,2,8,63730,8,64,0,0,0,0,0
2.057,17,4,580,2,40,2006,40,136,2,194,2013,194,444
1745.501,6,98,7452,63,38,28153,205,4476,35,33,51329,98,2976
1770.852,6,99,9306,66,66,27243,66,5610,33,60,55336,60,3696
154.792,6,22,9549,11,537,81,1306,2128,11,995,15462,1360,7421
0.0,17,2,128,1,36,0,36,64,1,36,0,36,64
0.485,6,10,766,5,185,96,185,453,5,45,76,45,313
1791.887,6,359,22709,209,69,8614,69,12569,150,69,12024,69,10140
1.499,6,10,1687,7,100,249,100,384,3,1179,613,1179,1303
1786.675,17,87,3648,86,14,21019,14,3612,1,8,0,8,36
316.328,6,98,33802,56,506,5751,1360,23553,42,534,7712,4649,10249
10.773,6,18,4266,10,275,1197,275,958,8,992,858,1440,3308
1.052,17,4,300,4,47,350,47,300,0,0,0,0,0
0.01,17,2,742,2,343,10,354,742,0,0,0,0,0
1772.754,6,180,15480,120,69,14897,69,8940,60,69,30045,69,6540
1773.054,6,181,15589,120,69,14899,69,8940,61,69,29549,69,6649
35.101,17,4,1344,4,308,11700,308,1344,0,0,0,0,0
0.033,17,2,187,1,46,0,46,74,1,85,0,85,113
240.294,6,59,19678,31,840,8009,1418,16753,28,182,8899,580,2925
1777.155,6,102,8296,68,65,26524,65,4930,34,59,53850,59,3366
0.018,17,4,352,2,37,12,37,130,2,83,8,89,222
1614.555,17,45,15308,45,312,36694,320,15308,0,0,0,0,0
11.68,2,7,280,7,16,1946,16,280,0,0,0,0,0
1638.351,2,13,416,13,8,136529,8,416,0,0,0,0,0
0.095,17,2,2752,2,1348,95,1348,2752,0,0,0,0,0
1741.35,17,30,31620,30,1026,60046,1026,31620,0,0,0,0,0
40.083,17,12,1764,6,48,8015,48,456,6,190,8014,308,1308
3.63,17,5,295,5,31,907,31,295,0,0,0,0,0
50.871,6,7,480,5,92,12717,92,360,2,0,2714,0,120
275.381,17,4,542,2,36,275376,36,128,2,179,275376,187,414
1.328,6,41,8453,21,320,66,1162,2832,20,400,60,1360,5621
36.071,6,4844,4670486,3244,1363,11,1408,4582610,1600,931,22,2801,87876
62.222,6,12,7558,5,275,15555,275,479,7,1698,10133,2760,7079
0.67,6,24,5755,13,158,55,370,1315,11,999,66,1737,4440
1740.496,6,87,6322,58,31,30535,31,3915,29,31,62160,31,2407
42.5,6,27,7177,13,155,3541,267,1306,14,530,3268,3417,5871
36.109,17,20,1760,10,48,4011,48,760,10,72,4011,72,1000
1794.971,17,448,39896,403,35,4465,288,25676,45,288,40022,288,14220
1796.95,6,358,22738,210,69,8597,69,12678,148,69,12222,69,10060
4.938,17,4,288,2,36,4905,36,128,2,52,4901,52,160
124.981,6,23,9720,13,447,55,1360,2341,10,1393,13871,2720,7379
0.155,17,2,154,1,33,0,33,61,1,65,0,65,93
0.383,6,10,968,5,256,91,256,460,5,304,91,304,508
0.036,17,2,220,1,34,0,34,62,1,130,0,130,158
1793.957,1,215,12040,215,28,8382,28,12040,0,0,0,0,0
283.478,1,4,224,4,28,94492,28,224,0,0,0,0,0
38.091,17,4,352,2,60,38090,60,176,2,60,38090,60,176
240.233,6,52,17947,28,797,8897,1402,15024,24,238,10444,580,2923
0.713,6,68,69747,42,261,17,517,4025,26,2925,27,9856,65722
2.156,17,4,580,2,40,2124,40,136,2,194,2010,194,444
252.939,17,6,2016,6,308,50587,308,2016,0,0,0,0,0
27.24,6,11,640,4,0,9080,0,220,7,0,2917,0,420
30.482,17,8,608,8,48,4354,48,608,0,0,0,0,0
1786.965,6,104,8376,68,65,26671,65,4930,36,59,51052,59,3446
50.941,6,2746,2434888,1764,1300,28,1368,2376204,982,776,51,1473,58684
4.229,17,2,656,2,300,4229,300,656,0,0,0,0,0
1.057,6,39,10923,24,168,45,829,3350,15,870,62,4080,7573
0.073,17,2,290,1,40,0,40,68,1,194,0,194,222
7.015,17,3,2145,3,687,3507,687,2145,0,0,0,0,0
280.194,6,30,7432,14,158,21553,267,1357,16,603,18677,2800,6075
260.138,6,40,2924,16,68,17333,310,1395,24,47,11310,78,1529
1794.834,1,75,6300,0,0,0,0,0,75,56,24254,56,6300
0.464,17,7,2438,7,320,77,354,2438,0,0,0,0,0
27.449,6,27,7046,16,124,1829,159,1600,11,811,2743,1659,5446
1082.879,2,12,384,12,8,98443,8,384,0,0,0,0,0
1796.776,17,445,39516,401,35,4491,288,25612,44,288,40948,288,13904
280.199,6,30,7432,13,158,23349,267,1317,17,543,17509,1400,6115
9.279,6,14,2245,8,211,1322,211,846,6,545,1852,904,1399
19.631,17,32,13661,15,458,1400,1350,7299,17,346,1225,1350,6362
115.072,17,4,352,2,60,115071,60,176,2,60,115071,60,176
24.55,6,3485,3342182,2315,1367,10,1408,3276678,1170,776,20,1408,65504
0.152,17,2,2386,2,1165,152,1165,2386,0,0,0,0,0
259.002,6,232,95151,110,839,2376,1402,81301,122,227,2140,2804,13850
1.385,6,241,189915,144,1333,9,1432,181744,97,427,14,1432,8171
1745.077,6,95,7203,63,38,28146,205,4476,32,33,56278,98,2727
4.255,6,32,6105,17,206,265,314,2744,15,551,285,1179,3361
266.935,17,4,240,2,32,266934,32,120,2,32,266934,32,120
3.09,17,2,134,2,39,3090,39,134,0,0,0,0,0
280.412,6,30,7432,13,158,23367,267,1317,17,603,17523,2760,6115
1783.37,6,104,8376,68,65,26617,65,4930,36,59,50950,59,3446
1771.411,6,106,9820,68,66,26438,66,5792,38,60,47873,60,4028
1772.025,6,181,15589,120,69,14890,69,8940,61,69,29529,69,6649
1789.955,6,369,25661,214,99,8403,469,15045,155,69,11623,69,10616
18.255,17,6,456,6,48,3651,48,456,0,0,0,0,0
350.099,1,6,336,6,28,70019,28,336,0,0,0,0,0
1770.43,6,99,9240,66,65,27237,65,5577,33,59,55323,59,3663
0.333,6,28,6194,15,164,23,453,1622,13,555,26,1542,4572
1792.118,1,298,31588,298,78,6034,78,31588,0,0,0,0,0
0.003,6,2,364,1,0,0,0,40,1,272,0,272,324
1776.1,1,58,4872,58,56,31159,56,4872,0,0,0,0,0
4.72,6,28,8151,14,137,363,267,1252,14,791,334,1467,6899
1222.437,6,125,10727,83,69,14907,69,6149,42,69,29815,69,4578
1658.244,1,7,392,7,28,276374,28,392,0,0,0,0,0
0.882,6,10,1687,7,100,147,100,384,3,1179,315,1179,1303
0.032,17,2,164,1,46,0,46,74,1,62,0,62,90
1799.609,17,448,39896,403,35,4476,288,25676,45,288,40022,288,14220
1793.617,17,87,3648,86,14,21101,14,3612,1,8,0,8,36
0.024,17,2,338,1,33,0,33,61,1,249,0,249,277
0.186,6,43,19917,25,1073,7,1420,14976,18,467,10,1883,4941
1764.121,1,8,448,8,28,252017,28,448,0,0,0,0,0
60.081,6,8,432,5,0,15020,0,268,3,0,30036,0,164
302.501,6,36,13520,19,332,16805,661,2695,17,764,3986,1448,10825
15.3,6,106,34437,54,597,288,1152,27875,52,447,294,1179,6562
0.359,17,2,196,1,62,0,62,90,1,78,0,78,106
1786.807,6,102,8296,68,65,26668,65,4930,34,59,54142,59,3366
0.031,6,3,2880,1,0,0,0,40,2,1368,19,1368,2840
1794.795,17,144,11520,72,48,25278,48,5472,72,56,25278,56,6048
240.428,17,6,1496,3,32,120208,37,181,3,410,120208,463,1315
1794.454,6,443,28070,238,69,7571,69,15730,205,69,8795,69,12340
1771.577,6,101,9278,66,64,27255,64,5544,35,58,52102,58,3734
0.236,6,10,1090,5,261,59,261,465,5,421,45,421,625
0.514,6,20,7229,13,334,42,663,2021,7,1209,80,1946,5208
25.961,6,50,13277,26,892,413,1360,7377,24,328,1120,2667,5900
0.857,17,2,167,1,39,0,39,67,1,72,0,72,100
535.391,17,24,1536,24,36,23277,36,1536,0,0,0,0,0
1741.243,6,177,10963,88,48,20014,208,6442,89,31,19784,31,4521
195.017,17,4,352,2,60,195016,60,176,2,60,195016,60,176
0.008,17,2,219,1,41,0,41,69,1,122,0,122,150
217.384,6,29,8832,14,158,16721,267,1357,15,858,15519,2045,7475
1681.336,17,14,3787,7,30,280220,30,406,7,455,280220,463,3381
171.022,6,174,130883,104,1286,1660,1368,118628,70,738,1181,2736,12255
1793.117,17,66,2766,65,14,28017,14,2730,1,8,0,8,36
1700.526,17,12,498,11,14,170052,14,462,1,8,0,8,36
173.107,17,4,352,2,60,173105,60,176,2,60,173105,60,176
5.014,17,4,288,2,36,5013,36,128,2,52,4970,52,160
1.284,6,41,10025,23,440,58,1360,4484,18,437,65,2720,5541
0.089,6,11,1903,6,105,17,105,365,5,1326,22,1326,1538
18.773,17,12,1056,6,48,3752,48,456,6,72,3752,72,600
118.225,6,21,8717,11,316,91,639,1420,10,1147,13118,2720,7297
1.566,6,41,10555,21,513,78,1440,4979,20,433,72,1440,5576
9.534,17,4,824,2,48,9519,48,152,2,308,9514,308,672
1786.234,17,281,78031,281,249,6379,479,78031,0,0,0,0,0
0.044,17,4,368,2,32,11,32,120,2,96,0,96,248
421.816,17,9,4440,3,300,210010,300,984,6,548,84032,548,3456
127.457,1,4,224,4,28,42485,28,224,0,0,0,0,0
1748.581,6,154,9587,81,47,21857,208,5768,73,31,24268,31,3819
240.22,6,56,17968,30,800,8283,1418,15192,26,177,9608,580,2776
1772.599,6,180,15480,120,69,14895,69,8940,60,69,30039,69,6540
304.543,6,9,416,2,0,304530,0,88,7,0,50755,0,328
0.483,6,21,7281,13,334,40,663,2021,8,967,63,1946,5260
1.258,6,47,18160,26,882,50,1460,12544,21,433,54,1460,5616
8.535,2,2,64,2,8,8535,8,64,0,0,0,0,0
280.494,6,28,7352,13,158,23374,267,1317,15,603,20031,2076,6035
0.157,17,2,2386,2,1165,157,1165,2386,0,0,0,0,0
252.133,2,2,64,2,8,252133,8,64,0,0,0,0,0
387.589,17,16,5360,16,307,25839,308,5360,0,0,0,0,0
0.056,6,2,92,1,0,0,0,40,1,0,0,0,52
92.793,6,29,14054,15,519,56,884,2721,14,1076,7128,2720,11333
280.452,6,30,7432,14,158,21573,267,1357,16,678,18694,3456,6075
70.356,6,28,7239,12,155,6396,267,1266,16,443,4681,1460,5973
1798.089,17,448,39384,403,35,4472,288,25412,45,282,40018,288,13972
525.789,1,12,672,12,28,47799,28,672,0,0,0,0,0
1795.589,17,449,39928,404,35,4455,288,25708,45,288,40023,288,14220
1771.722,6,99,9240,66,65,27257,65,5577,33,59,55363,59,3663
0.19,1,2,112,2,28,190,28,112,0,0,0,0,0
1773.591,6,181,15589,120,69,14904,69,8940,61,69,29551,69,6649
0.017,6,4,208,2,0,10,0,104,2,0,10,0,104
0.039,17,2,290,1,40,0,40,68,1,194,0,194,222
1771.301,6,133,17217,81,173,22141,809,11348,52,78,34728,192,5869
1787.395,6,102,8228,68,64,26677,64,4896,34,58,54159,58,3332
0.308,17,2,290,1,40,0,40,68,1,194,0,194,222
1620.824,1,7,392,7,28,270137,28,392,0,0,0,0,0
300.204,6,39,9955,21,593,15001,1360,4433,18,435,17647,2720,5522
11.542,6,1376,1079141,719,1401,15,1448,1035349,657,776,17,1448,43792
8.295,6,20,6001,11,287,829,562,1306,9,721,1025,1452,4695
1794.908,6,356,22589,207,69,8713,69,12420,149,69,12127,69,10169
0.021,17,2,363,1,29,0,29,57,1,278,0,278,306
372.419,6,25,1651,17,177,23276,177,1117,8,110,9251,110,534
32.926,6,26,6896,12,253,2989,517,1652,14,748,2529,2411,5244
4.019,17,3,180,3,32,2009,32,180,0,0,0,0,0
1779.518,6,353,22400,206,69,8680,69,12380,147,69,12188,69,10020
12.29,6,9,376,5,0,3070,0,204,4,0,4093,0,172
3.608,17,25,7862,10,306,400,1350,3342,15,273,229,1350,4520
1.181,6,23,7952,12,164,91,267,1288,11,1216,100,3825,6664
0.956,6,25,8633,14,203,73,458,1406,11,967,77,1460,7227
2.009,6,20,3833,11,234,200,564,1504,9,463,229,1343,2329
1.413,6,2,116,2,0,0,0,116,0,0,0,0,0
30.98,17,6,468,6,50,6196,50,468,0,0,0,0,0
1.054,6,2,92,1,0,0,0,40,1,0,0,0,52
280.451,6,29,7392,13,158,23370,267,1317,16,678,18692,3456,6075
21.448,17,8,1176,4,48,7145,48,304,4,190,7144,308,872
1.05,17,17,5535,8,314,150,1350,2740,9,282,120,1350,2795
376.028,6,18,1242,14,180,28925,180,916,4,110,20067,110,326
1789.95,6,368,23276,212,69,8483,69,12896,156,69,11548,69,10380
1.062,6,10,560,5,0,265,0,276,5,0,261,0,284
11.105,6,1687,1521662,1035,1417,10,1432,1491361,652,420,17,1432,30301
1743.633,6,98,7359,63,38,28123,205,4476,35,33,51276,98,2883
0.641,17,21,9600,10,560,67,1350,5884,11,309,60,1350,3716
1789.982,6,356,22520,208,69,8647,69,12460,148,69,12175,69,10060
1763.748,2,14,448,14,8,135672,8,448,0,0,0,0,0
1.057,6,24,8016,12,164,81,267,1300,12,1014,81,2411,6716
0.031,17,2,475,1,40,0,40,68,1,379,0,379,407
369.492,6,24,1575,15,177,26392,177,989,9,110,9445,110,586
661.751,2,6,192,6,8,132350,8,192,0,0,0,0,0
0.508,6,25,7486,13,318,41,600,1970,12,814,45,1471,5516
1.052,17,4,668,2,39,1039,39,134,2,239,13,239,534
0.278,17,2,144,1,36,0,36,64,1,52,0,52,80
279.475,17,4,352,2,60,279474,60,176,2,60,279474,60,176
599.982,6,9,546,6,31,119996,31,333,3,31,299830,31,213
3.235,6,2,88,2,0,0,0,88,0,0,0,0,0
1797.966,6,375,23763,215,69,8401,69,13223,160,69,11307,69,10540
586.773,1,6,336,6,28,117354,28,336,0,0,0,0,0
0.038,17,2,904,1,300,0,300,328,1,548,0,548,576
1414.225,17,16,4090,8,31,202031,37,478,8,423,202031,463,3612
922.438,1,44,2464,44,28,21452,28,2464,0,0,0,0,0
1782.244,6,105,8544,68,66,26600,66,4964,37,60,49504,60,3580
0.03,17,2,185,1,45,0,45,73,1,84,0,84,112
5.338,17,29,10138,12,446,485,1350,5690,17,233,233,1350,4448
0.092,6,9,1339,5,145,23,145,349,4,826,23,826,990
1797.916,17,448,39896,403,35,4472,288,25676,45,288,40020,288,14220
1.441,6,41,11378,22,547,68,1360,5842,19,433,69,1360,5536
257.872,1,2,750,2,347,257872,347,750,0,0,0,0,0
0.086,17,4,284,2,32,1,32,120,2,54,76,60,164
1797.18,6,356,22520,208,69,8682,69,12460,148,69,12225,69,10060
0.526,6,27,9157,13,277,43,747,1804,14,943,37,1368,7353
0.652,6,22,7312,13,325,54,626,1984,9,1210,77,1946,5328
1776.18,17,142,11360,71,48,25373,48,5396,71,56,25373,56,5964
1770.431,17,311,53619,311,144,5711,389,53619,0,0,0,0,0
1.763,17,3,1170,3,362,881,362,1170,0,0,0,0,0
16.08,17,30,13427,16,631,1069,1350,10552,14,177,1234,1350,2875
1798.84,17,447,39580,403,35,4474,288,25676,44,288,40949,288,13904
1738.734,1,84,7056,0,0,0,0,0,84,56,20948,56,7056
1797.423,6,379,26806,218,103,8283,469,15881,161,69,11232,69,10925
1740.73,17,28,6580,28,207,64471,207,6580,0,0,0,0,0
0.681,6,28,9003,13,232,56,567,1612,15,825,48,1408,7391
8.266,6,22,9370,11,275,826,275,723,11,1170,594,1414,8647
5.902,6,1688,1629899,1113,1390,5,1408,1595335,575,776,9,1408,34564
1788.142,6,240,36420,150,316,12000,316,26760,90,83,20091,83,9660
1743.973,6,138,8761,76,49,23252,208,5382,62,31,28584,31,3379
1739.51,1,15,870,15,30,124250,30,870,0,0,0,0,0
69.726,6,25,11490,12,397,68,884,1729,13,1025,5800,1360,9761
1.203,6,23,7952,12,164,92,267,1288,11,1216,101,2816,6664
1796.036,17,86,3606,85,14,21381,14,3570,1,8,0,8,36
376.727,6,27,1767,18,177,22160,177,1181,9,110,8827,110,586
0.406,6,13,1693,7,288,61,288,588,6,426,47,434,1105
4.169,6,38,7229,19,218,231,314,3383,19,440,217,1152,3846
39.031,17,22,1936,11,48,3902,48,836,11,72,3902,72,1100
24.987,6,35,8251,17,199,1561,722,2078,18,681,1454,2760,6173
1751.609,6,135,15007,86,81,20607,516,6636,49,156,36489,1452,8371
1.22,17,3,2906,3,940,610,1451,2906,0,0,0,0,0
65.094,6,29,7257,14,155,5007,267,1346,15,482,4648,2840,5911
1773.213,6,180,15480,120,69,14900,69,8940,60,69,30050,69,6540
1786.781,6,102,8296,68,65,26668,65,4930,34,59,54142,59,3366
0.128,17,2,380,1,39,0,39,67,1,285,0,285,313
300.741,6,44,15866,25,927,12530,1360,10304,19,435,476,2720,5562
300.796,6,42,13881,24,818,13078,1360,8359,18,435,506,2667,5522
6.686,6,493,390555,284,1305,22,1368,375023,209,776,31,1473,15532
1737.315,1,56,4704,0,0,0,0,0,56,56,31587,56,4704
0.426,17,21,11402,11,725,42,1350,8288,10,283,43,1350,3114
1.824,2,2,64,2,8,1824,8,64,0,0,0,0,0
4.928,6,38,7229,20,218,259,314,3423,18,513,275,1179,3806
0.121,17,2,166,1,39,0,39,67,1,71,0,71,99
119.272,17,4,240,2,32,119271,32,120,2,32,119271,32,120
7.915,6,522,397184,290,1295,26,1368,380456,232,776,33,1473,16728
0.08,17,2,354,2,149,80,149,354,0,0,0,0,0
0.654,17,2,266,1,41,0,41,69,1,169,0,169,197
1754.316,6,95,7203,63,38,28295,205,4476,32,33,56582,98,2727
3.319,6,2,88,2,0,0,0,88,0,0,0,0,0
281.795,6,28,7352,13,158,23482,267,1317,15,678,20108,2045,6035
280.42,6,27,7312,13,158,23368,267,1317,14,678,21567,2760,5995
1786.766,6,104,8376,68,65,26668,65,4930,36,59,51046,59,3446
1776.786,17,142,11360,71,48,25381,48,5396,71,56,25381,56,5964
1779.7,6,356,22589,208,69,8597,69,12460,148,69,12106,69,10129
0.446,1,5,420,5,56,111,56,420,0,0,0,0,0
5.061,6,38,7229,20,218,266,314,3423,18,513,281,1179,3806
5.004,17,4,558,2,36,4999,36,128,2,187,4999,187,430
0.063,17,2,138,1,33,0,33,61,1,49,0,49,77
0.815,6,29,9750,18,674,47,1360,4808,11,561,63,2744,4942
1799.608,17,449,39928,404,35,4465,288,25708,45,288,40019,288,14220
1792.252,17,87,3648,86,14,21085,14,3612,1,8,0,8,36
0.033,17,2,411,1,33,0,33,61,1,322,0,322,350
21.596,6,27,6388,14,117,1661,159,1337,13,727,1799,1418,5051
1796.996,6,419,25173,208,69,8681,69,12529,211,34,8557,64,12644
1564.215,2,12,384,12,8,142201,8,384,0,0,0,0,0
1785.973,6,106,8644,70,66,25883,66,5044,36,60,51025,60,3600
86.141,6,25,8672,13,158,7178,267,1317,12,1145,7830,4845,7355
1788.672,17,83,3480,82,14,22082,14,3444,1,8,0,8,36
1764.679,6,331,49943,180,304,9858,304,35072,151,83,11764,83,14871
0.419,6,23,5928,12,164,38,453,1442,11,781,39,2224,4486
370.828,6,110,15369,50,179,7442,469,6145,60,194,6285,1460,9224
1679.504,17,12,498,11,14,167950,14,462,1,8,0,8,36
0.368,6,36,8031,18,271,21,517,1837,18,495,19,1923,6194
1677.2,6,70,5066,47,31,36460,31,3157,23,31,76235,31,1909
100.367,6,18,13687,5,351,25050,722,1323,13,1299,8350,1408,12364
122.999,17,12,16512,12,1348,11181,1348,16512,0,0,0,0,0
13.01,6,24,6993,13,275,1084,275,1078,11,910,801,1440,5915
1795.812,17,490,43412,405,35,4445,288,25784,85,179,21071,308,17628
1650.181,1,8,448,8,28,235740,28,448,0,0,0,0,0
0.804,17,2,136,1,32,0,32,60,1,48,0,48,76
9.33,6,1540,1409944,973,1374,9,1408,1375796,567,776,16,1408,34148
396.061,6,48,9175,27,109,15233,720,2426,21,368,621,3488,6749
113.62,6,30,7432,13,158,9468,267,1317,17,543,7099,1400,6115
1771.125,6,100,9292,66,65,27248,65,5577,34,59,53667,59,3715
9.525,6,23,7811,12,283,865,721,1901,11,1093,778,1414,5910
1791.695,17,140,11200,70,48,25966,48,5320,70,56,25966,56,5880
1787.492,1,284,30104,284,78,6316,78,30104,0,0,0,0,0
1798.669,17,142,11360,71,48,25695,48,5396,71,56,25695,56,5964
0.884,6,24,6408,13,297,73,830,2011,11,988,87,1731,4397
1779.725,17,140,11200,70,48,25793,48,5320,70,56,25793,56,5880
27.124,6,6,328,4,0,9041,0,216,2,0,26611,0,112
0.28,6,25,6116,12,181,25,537,1526,13,651,22,1408,4590
1.484,17,57,13041,57,200,26,220,13041,0,0,0,0,0
141.482,17,7,532,7,48,23580,48,532,0,0,0,0,0
108.791,6,11,456,3,0,1871,0,124,8,0,15540,0,332
1785.863,6,356,22520,208,69,8627,69,12460,148,69,12148,69,10060
1764.049,6,183,11234,92,47,19383,208,6695,91,31,19598,31,4539
0.014,17,2,322,1,33,0,33,61,1,233,0,233,261
1749.009,6,101,7963,66,45,26907,205,4914,35,35,51433,98,3049
7.29,6,6,280,2,0,7290,0,88,4,0,2370,0,192
24.897,6,2,147,2,31,24897,31,147,0,0,0,0,0
9.024,6,78,24341,39,550,237,1152,18640,39,459,230,1179,5701
0.448,17,3,543,2,39,443,39,134,1,381,0,381,409
9.92,6,86,27277,44,568,230,1152,21099,42,449,235,1179,6178
113.705,17,10,3360,10,308,12633,308,3360,0,0,0,0,0
1797.236,17,449,39928,404,35,4459,288,25708,45,288,40018,288,14220
29.863,17,2652,2930622,537,63,55,1350,48997,2115,1334,13,1350,2881625
2.718,17,3,1167,3,361,1359,361,1167,0,0,0,0,0
8.66,6,160,123860,61,292,144,941,4957,99,1184,88,1418,118903
680.547,17,20,6856,20,314,35818,322,6856,0,0,0,0,0
1786.922,6,356,22520,208,69,8632,69,12460,148,69,12155,69,10060
735.39,1,9,1195,9,104,91923,207,1195,0,0,0,0,0
42.384,6,17,700,9,0,5298,0,364,8,0,5227,0,336
1787.053,6,104,8376,68,65,26672,65,4930,36,59,51054,59,3446
1749.589,17,12,498,11,14,174958,14,462,1,8,0,8,36
3.802,6,65,46505,28,767,140,1460,6524,37,1374,98,1591,39981
2.78,6,22,6418,10,268,304,517,1333,12,744,248,1418,5085
1787.701,6,104,8252,68,63,26682,64,4868,36,57,51075,58,3384
59.972,17,9,6111,9,651,7496,651,6111,0,0,0,0,0
1796.118,1,277,15512,277,28,6507,28,15512,0,0,0,0,0
131.209,17,4,304,4,48,43736,48,304,0,0,0,0,0
280.176,6,27,7312,13,158,23348,267,1317,14,775,21549,4836,5995
0.299,17,3,1164,3,360,149,360,1164,0,0,0,0,0
1774.086,6,183,15807,120,69,14908,69,8940,63,69,28611,69,6867
237.21,6,54,14392,26,397,9488,1360,6248,28,412,8778,1360,8144
0.511,6,6,248,4,0,170,0,164,2,0,293,0,84
1.312,6,48,19663,27,923,50,1360,14047,21,433,57,1360,5616
1785.858,6,380,24101,217,69,8267,69,13441,163,69,11023,69,10660
0.017,17,2,166,1,33,0,33,61,1,77,0,77,105
10.692,6,1693,1619843,1069,1437,9,1448,1582707,624,776,16,1448,37136
0.178,17,2,384,1,36,0,36,64,1,292,0,292,320
4.21,6,12,2271,7,188,701,245,660,5,1407,988,1407,1611
725.202,6,117,18735,56,122,13185,721,6422,61,394,12073,1420,12313
1771.308,6,99,9174,66,64,27250,64,5544,33,58,55350,58,3630
1786.149,6,106,8586,70,65,25886,65,5140,36,59,51029,59,3446
0.392,6,26,8868,13,227,32,547,1592,13,941,30,1438,7276
1755.982,6,105,6270,60,27,29762,27,3525,45,27,39907,27,2745
902.414,2,7,224,7,8,150402,8,224,0,0,0,0,0
0.102,6,10,1671,6,552,20,948,1348,4,159,34,159,323
1741.442,17,30,20190,30,645,60049,645,20190,0,0,0,0,0
16.054,6,14,820,6,0,3210,0,340,8,0,2148,0,480
0.054,6,32,19072,17,126,3,126,1018,15,1569,3,4344,18054
0.009,6,3,327,2,103,6,138,287,1,0,0,0,40
51.89,17,4,352,2,60,51889,60,176,2,60,51889,60,176
74.719,17,4,352,2,60,74718,60,176,2,60,74718,60,176
134.331,17,23,1748,23,48,6105,48,1748,0,0,0,0,0
0.262,1,2,112,2,28,262,28,112,0,0,0,0,0
1785.275,17,87,3648,86,14,21003,14,3612,1,8,0,8,36
5.972,6,29,8288,14,164,445,267,1400,15,869,414,1440,6888
1720.42,17,12,498,11,14,172042,14,462,1,8,0,8,36
1784.85,6,107,9018,70,71,25867,275,5285,37,64,49576,247,3733
1751.484,17,26,8736,26,308,70059,308,8736,0,0,0,0,0
15.97,17,10,1588,5,48,3990,48,380,5,213,3990,308,1208
1740.485,6,92,6668,60,31,29499,31,4062,32,31,56144,31,2606
191.865,6,29,9940,12,118,17442,267,1316,17,721,11989,1420,8624
1592.155,17,423,53905,185,185,8653,1350,39531,238,32,6717,63,14374
1.352,17,8,700,4,34,448,34,248,4,85,447,91,452
0.352,6,2,1520,1,0,0,0,40,1,1440,0,1440,1480
9.802,6,1681,1514100,1038,1379,9,1408,1476000,643,931,14,2801,38100
10.877,6,719,641073,453,1344,23,1368,622025,266,776,40,1473,19048
1783.827,6,367,25719,212,100,8454,469,14896,155,69,11583,69,10823
1795.431,1,58,4872,58,56,31498,56,4872,0,0,0,0,0
1.956,17,2,312,2,128,1956,128,312,0,0,0,0,0
0.001,17,4,1375,4,315,0,354,1375,0,0,0,0,0
1.373,6,47,18160,26,882,54,1440,12544,21,433,60,1440,5616
0.0,17,2,2128,2,1036,0,1036,2128,0,0,0,0,0
2.913,17,3,183,3,33,1456,33,183,0,0,0,0,0
1742.554,6,95,7203,63,38,28105,205,4476,32,33,56202,98,2727
1686.598,17,14,3815,7,30,281076,30,406,7,459,281096,463,3409
1792.539,17,87,3648,86,14,21088,14,3612,1,8,0,8,36
0.016,6,3,144,2,0,2,0,104,1,0,0,0,40
11.817,6,1864,1633088,1132,1388,10,1420,1599587,732,526,16,3303,33501
1792.505,6,127,12564,74,63,23062,722,6152,53,83,34468,1408,6412
0.122,17,2,154,1,33,0,33,61,1,65,0,65,93
2.419,6,15,2391,9,188,302,245,740,6,703,433,1152,1651
92.957,6,35,17442,20,488,260,1360,3311,15,1351,6630,3928,14131
1.027,6,14,2171,8,253,146,597,1417,6,147,165,346,754
18.585,6,32,8952,14,158,1429,267,1357,18,624,1088,1400,7595
2.208,6,13,2311,8,188,315,245,700,5,1407,485,1407,1611
1598.536,1,8,448,8,28,228362,28,448,0,0,0,0,0
735.715,1,4,224,4,28,245238,28,224,0,0,0,0,0
3.894,17,5,295,5,31,973,31,295,0,0,0,0,0
0.376,17,4,624,2,64,375,64,184,2,192,252,192,440
61.256,6,13,1079,12,43,5568,43,1019,1,0,0,0,60
1.32,6,54,21411,31,899,44,1360,15670,23,400,51,1360,5741
1794.673,6,170,13046,88,90,20628,208,8650,82,31,22153,31,4396
280.462,6,30,7432,14,158,21574,267,1357,16,678,18694,3456,6075
1799.713,17,768,46308,768,32,2346,37,46308,0,0,0,0,0
1787.115,1,274,15344,274,28,6546,28,15344,0,0,0,0,0
0.6,6,14,1745,7,288,68,288,600,7,426,71,434,1145
129.275,6,27,7652,11,154,12927,267,920,16,552,8612,1452,6732
0.06,6,10,767,5,186,11,186,454,5,45,15,45,313
1378.062,6,140,12017,92,69,15142,69,6923,48,69,29320,69,5094
1788.204,1,259,14504,259,28,6931,28,14504,0,0,0,0,0
0.465,6,12,1653,6,288,91,288,548,6,426,52,434,1105
17.968,6,15,2965,9,467,2246,834,1878,6,255,2977,591,1087
3.908,17,25,10241,11,485,390,1350,5649,14,300,285,1350,4592
165.612,17,4,240,2,32,165611,32,120,2,32,165611,32,120
27.38,17,8,2688,8,308,3911,308,2688,0,0,0,0,0
1781.881,6,115,13733,75,82,24079,519,5968,40,162,45686,1420,7765
148.259,17,14,1232,7,48,24708,48,532,7,72,24707,72,700
147.716,6,22,9126,12,304,73,597,1425,10,1214,16393,3081,7701
1797.087,17,449,39928,404,35,4459,288,25708,45,288,40019,288,14220
1679.54,1,7,392,7,28,279923,28,392,0,0,0,0,0
0.067,17,2,136,1,32,0,32,60,1,48,0,48,76
1799.531,1,71,5964,71,56,25707,56,5964,0,0,0,0,0
16.258,17,22,13970,13,869,1348,1350,11673,9,227,2018,1350,2297
0.221,6,10,1671,6,552,44,948,1348,4,159,73,159,323
0.225,6,18,3004,9,266,28,517,1542,9,493,25,828,1462
1790.801,17,214,47936,214,196,8407,422,47936,0,0,0,0,0
1794.076,17,66,2766,65,14,28032,14,2730,1,8,0,8,36
1774.834,17,140,11200,70,48,25722,48,5320,70,56,25722,56,5880
465.771,1,3,168,3,28,232885,28,168,0,0,0,0,0
162.18,6,68,45826,43,1185,3861,1448,37795,25,747,2566,1448,8031
300.638,6,37,8526,19,315,16702,882,2053,18,441,500,1440,6473
0.508,17,3,451,2,39,389,39,134,1,289,0,289,317
302.395,6,46,10689,22,460,14399,1360,4641,24,338,444,2667,6048
286.652,17,4,240,2,32,286651,32,120,2,32,286651,32,120
0.962,17,2,148,2,46,962,46,148,0,0,0,0,0
3.172,17,8,1856,8,204,453,204,1856,0,0,0,0,0
125.998,6,18,4150,9,296,15749,722,1353,9,465,15688,1448,2797
8.505,17,4,1344,4,308,2835,308,1344,0,0,0,0,0
1772.475,6,180,15480,120,69,14894,69,8940,60,69,30038,69,6540
3.361,17,5,295,5,31,840,31,295,0,0,0,0,0
39.454,17,20,1520,20,48,2076,48,1520,0,0,0,0,0
1740.963,6,87,6322,58,31,30543,31,3915,29,31,62176,31,2407
1785.84,6,102,8364,68,66,26654,66,4964,34,60,54113,60,3400
0.469,6,4,1037,2,0,230,0,104,2,853,249,853,933
1787.102,17,87,3648,86,14,21024,14,3612,1,8,0,8,36
8.449,6,514,543233,254,339,33,340,16073,260,2022,32,5472,527160
0.377,6,10,1992,5,288,94,288,508,5,424,50,434,1484
35.778,17,44,6468,22,48,1702,48,1672,22,190,1702,308,4796
280.685,6,31,7813,13,158,23390,267,1317,18,524,16498,1400,6496
18.124,17,27,10506,13,567,1510,1350,7743,14,169,1391,1350,2763
10.486,6,2150,2020938,1384,1384,7,1408,1976418,766,776,13,1408,44520
1680.936,1,15,840,15,28,120066,28,840,0,0,0,0,0
0.51,6,110,86895,49,131,10,232,2489,61,1490,8,5720,84406
290.92,6,53,8409,26,106,11635,517,2357,27,384,11187,1418,6052
0.013,6,2,251,1,159,0,159,211,1,0,0,0,40
65.087,6,51,10547,24,533,664,910,3199,27,312,2498,1460,7348
0.699,6,39,11710,22,588,33,1188,7611,17,320,37,524,4099
1776.373,17,73,3060,72,14,25019,14,3024,1,8,0,8,36
280.209,6,28,7352,13,158,23350,267,1317,15,678,20013,2800,6035
1774.256,6,183,15738,121,69,14785,69,8980,62,69,29085,69,6758
1799.719,6,370,25908,214,99,8449,469,15114,156,69,11611,69,10794
1741.28,17,30,31680,30,1028,60044,1028,31680,0,0,0,0,0
1261.055,6,93,5779,53,44,24251,208,3311,40,31,32328,31,2468
1799.452,6,164,17356,95,80,19143,722,8502,69,92,26459,1408,8854
1.683,6,20,3833,11,234,168,564,1504,9,463,184,1343,2329
22.619,6,29,7392,13,158,1884,267,1317,16,603,1505,2036,6075
39.1,17,24,2112,12,48,3549,48,912,12,72,3547,72,1200
1752.82,6,95,7203,63,38,28271,205,4476,32,33,56534,98,2727
120.942,6,38,5547,17,304,7558,304,3640,21,83,5966,83,1907
1699.908,1,8,448,8,28,242844,28,448,0,0,0,0,0
1.134,6,23,6515,13,334,94,1009,2195,10,979,125,1731,4320
300.835,6,38,8286,20,230,15833,575,1754,18,446,511,1360,6532
25.165,17,4,240,2,32,25164,32,120,2,32,25164,32,120
127.705,6,34,19217,16,708,48,1460,4226,18,1096,7504,1460,14991
3.211,17,5,295,5,31,802,31,295,0,0,0,0,0
0.448,6,13,1693,7,288,70,288,588,6,426,53,434,1105
1681.248,17,14,1036,7,30,280204,30,406,7,62,280204,62,630
322.946,6,183,66433,92,685,3548,1460,49684,91,374,3586,1638,16749
7.704,17,3,228,3,48,3852,48,228,0,0,0,0,0
1681.564,17,14,1036,7,30,280254,30,406,7,62,280255,62,630
0.066,17,2,144,1,36,0,36,64,1,52,0,52,80
180.445,2,2,64,2,8,180445,8,64,0,0,0,0,0
0.086,17,2,558,1,32,0,32,60,1,470,0,470,498
2.016,17,2,279,1,36,0,36,64,1,187,0,187,215
1774.546,1,227,12712,227,28,7851,28,12712,0,0,0,0,0
0.083,17,2,184,1,32,0,32,60,1,96,0,96,124
11.675,6,7,388,4,0,3891,0,216,3,0,5664,0,172
1741.736,6,99,7814,65,45,27214,205,4850,34,35,52766,98,2964
15.971,17,13,6632,6,491,3179,1350,3119,7,473,2648,1350,3513
366.38,6,25,1651,17,177,22898,177,1117,8,110,9170,110,534
5.01,17,4,530,2,36,5006,36,128,2,173,5004,187,402
1.397,6,49,19311,27,895,53,1440,13655,22,433,57,1440,5656
1140.179,6,96,10302,54,77,21509,722,4834,42,109,27804,1408,5468
1.163,6,22,7900,11,164,98,267,1236,11,1216,98,3819,6664
0.005,17,3,436,2,30,0,30,116,1,292,0,292,320
1790.79,6,106,6848,65,46,27981,208,4216,41,31,44758,31,2632
5.158,17,4,288,2,36,5140,36,128,2,52,5144,52,160
0.241,1,2,112,2,28,241,28,112,0,0,0,0,0
138.831,6,89,56361,45,879,94,1360,21206,44,1011,3225,1548,35155
1783.819,6,373,25959,215,98,8335,469,15223,158,69,11361,69,10736
43.627,17,4,352,2,60,43626,60,176,2,60,43625,60,176
1771.737,6,101,9410,66,66,27257,66,5610,35,60,52107,60,3800
1686.776,17,14,1036,7,30,281105,30,406,7,62,281109,62,630
1774.258,1,124,6944,124,28,14424,28,6944,0,0,0,0,0
0.956,6,29,10103,15,239,68,597,1758,14,951,71,1438,8345
0.32,17,2,204,1,34,0,34,62,1,114,0,114,142
20.1,17,11,803,8,40,2845,41,549,3,56,84,57,254
11.579,6,25,8473,13,275,964,275,1078,12,986,754,1440,7395
0.151,17,2,904,2,424,151,548,904,0,0,0,0,0
238.027,6,8,2017,5,355,59506,413,1267,3,210,118874,269,750
1.632,6,44,16968,26,800,65,1360,11472,18,476,83,2715,5496
1.948,6,30,10994,17,350,121,1041,2136,13,925,130,1460,8858
1788.502,6,325,28922,191,93,9413,469,13973,134,133,13445,3417,14949
256.074,17,2,386,2,165,256074,165,386,0,0,0,0,0
517.431,6,59,9036,32,111,16691,501,2735,27,237,19519,1420,6301
1786.301,17,87,3648,86,14,21015,14,3612,1,8,0,8,36
5.432,6,44,8369,21,227,271,314,4022,23,489,235,1179,4347
1766.643,6,76,3952,38,0,47739,0,1976,38,0,47739,0,1976
1.241,6,8,342,4,0,413,0,164,4,7,269,7,178
0.534,17,2,476,1,39,0,39,67,1,381,0,381,409
1.775,6,52,19139,26,942,71,1440,13323,26,433,63,1440,5816
44.661,6,27,7177,13,155,3721,267,1306,14,530,3434,3417,5871
1799.934,1,78,6552,0,0,0,0,0,78,56,23375,56,6552
2.665,17,6,501,3,39,668,39,201,3,72,0,72,300
1773.013,6,180,15480,120,69,14899,69,8940,60,69,30048,69,6540
38.22,17,22,1936,11,48,3820,48,836,11,72,3820,72,1100
674.042,6,58,8947,30,108,20892,501,2720,28,212,24960,1420,6227
35.247,6,4716,4459795,3099,1362,11,1408,4371047,1617,931,21,2816,88748
1787.992,6,365,25501,212,100,8473,469,14896,153,69,11759,69,10605
280.614,6,29,7392,13,158,23384,267,1317,16,603,18700,2036,6075
0.025,6,10,1510,5,657,6,657,925,5,317,6,317,585
141.689,6,25,10208,12,549,66,1360,2709,13,995,11796,1360,7499
40.2,2,2,64,2,8,40200,8,64,0,0,0,0,0
13.357,6,11,588,4,0,4451,0,228,7,0,2225,0,360
161.21,17,4,352,2,60,161209,60,176,2,60,161209,60,176
18.181,17,31,16363,14,478,1396,1350,7096,17,517,1134,1350,9267
1788.083,6,436,69187,241,365,7450,1093,37396,195,224,9216,645,31791
0.016,17,2,389,1,34,0,34,62,1,299,0,299,327
0.012,17,4,344,2,47,0,47,150,2,69,0,75,194
283.194,17,4,352,2,60,283193,60,176,2,60,283193,60,176
0.254,17,3,451,2,39,155,39,134,1,289,0,289,317
375.948,6,23,1538,16,180,25063,180,1056,7,110,10422,110,482
375.225,17,76,5776,76,48,5003,48,5776,0,0,0,0,0
1776.403,17,140,11200,70,48,25744,48,5320,70,56,25744,56,5880
504.289,17,5,320,5,36,126072,36,320,0,0,0,0,0
1787.91,6,452,26424,243,69,7388,69,13860,209,34,8595,64,12564
1796.832,6,375,26177,217,98,8318,469,15372,158,69,11442,69,10805
902.394,2,9,288,9,8,112799,8,288,0,0,0,0,0
1795.629,17,447,39864,402,35,4477,288,25644,45,288,40016,288,14220
1743.207,6,95,7203,63,38,28116,205,4476,32,33,56223,98,2727
1740.601,17,30,7050,30,207,60020,207,7050,0,0,0,0,0
5.647,6,15,3018,6,92,1129,92,400,9,706,664,1408,2618
2.952,6,2,88,2,0,0,0,88,0,0,0,0,0
560.406,17,6,1615,3,30,280197,30,174,3,452,280197,463,1441
44.073,6,33,10378,13,327,125,1189,2495,20,544,2319,1420,7883
1.011,17,2,421,1,47,0,47,75,1,318,0,318,346
300.608,6,35,8532,19,336,16700,999,2138,16,522,564,3488,6394
1746.132,6,94,7151,62,38,28625,205,4424,32,33,56315,98,2727
1787.916,6,354,22440,207,69,8679,69,12420,147,69,12245,69,10020
66.94,6,22,8961,11,514,80,1236,2014,11,927,6676,1460,6947
0.013,17,2,196,1,46,0,46,74,1,94,0,94,122
1795.57,17,447,39296,403,35,4466,288,25392,44,288,40950,288,13904
0.153,6,15,4640,9,290,19,517,1057,6,1087,26,1402,3583
1.254,6,51,18963,29,861,44,1360,13262,22,400,51,1360,5701
1.367,6,10,1687,7,100,227,100,384,3,1179,550,1179,1303
0.225,6,19,4286,11,165,22,456,1394,8,493,30,888,2892
287.233,17,4,240,2,32,287232,32,120,2,32,287232,32,120
20.581,6,2850,2655526,1784,1408,11,1448,2595382,1066,776,19,1448,60144
94.783,6,85,58467,54,1238,1788,1448,48660,31,682,2854,2359,9807
1775.989,17,140,11200,70,48,25738,48,5320,70,56,25738,56,5880
0.134,17,4,420,2,33,1,33,122,2,121,86,145,298
1681.259,17,14,3827,7,30,280209,30,406,7,460,280209,463,3421
1758.444,6,121,7541,70,44,25484,208,4571,51,31,35159,31,2970
1.178,6,10,1687,7,100,196,100,384,3,1179,461,1179,1303
1786.575,6,106,8524,68,66,26665,66,4964,38,60,48283,60,3560
1.231,6,42,10077,23,440,55,1360,4496,19,400,59,1360,5581
3.744,17,5,290,5,30,936,30,290,0,0,0,0,0
1796.325,6,411,36550,182,67,9923,681,13700,229,88,7878,3298,22850
280.502,6,28,7352,12,158,25500,267,1277,16,678,18692,2085,6075
1.322,6,47,18682,27,856,50,1360,13106,20,476,60,2715,5576
0.223,17,4,352,2,60,221,60,176,2,60,216,60,176
1.614,6,52,19376,29,887,57,1360,13635,23,437,63,2715,5741
1.92,17,2,122,2,33,1920,33,122,0,0,0,0,0
0.013,6,2,84,1,0,0,0,44,1,0,0,0,40
1799.579,17,448,39896,403,35,4476,288,25676,45,288,40018,288,14220
957.753,2,7,224,7,8,159625,8,224,0,0,0,0,0
0.02,17,4,420,2,33,14,33,122,2,121,9,145,298
0.301,17,2,152,1,48,0,48,76,1,48,0,48,76
1770.049,6,99,9306,66,66,27231,66,5610,33,60,55311,60,3696
4.244,17,5,295,5,31,1061,31,295,0,0,0,0,0
17.468,17,4,1344,4,308,5822,308,1344,0,0,0,0,0
61.205,6,11,936,6,226,12241,226,558,5,110,15172,110,378
81.52,6,35,9061,15,280,5819,517,2492,20,612,4288,1418,6569
1.299,6,51,21326,29,904,46,1360,15670,22,433,53,1360,5656
364.257,6,25,1651,17,177,22766,177,1117,8,110,9158,110,534
0.329,6,9,527,5,43,82,43,311,4,0,106,0,216
144.757,1,40,3360,40,56,3711,56,3360,0,0,0,0,0
74.561,6,21,6780,5,106,18637,106,314,16,527,4970,1460,6466
1692.269,1,71,3976,71,28,24175,28,3976,0,0,0,0,0
15.837,17,4,2860,4,687,5279,687,2860,0,0,0,0,0
300.616,6,44,8747,22,291,14315,786,2113,22,441,475,1360,6634
45.434,6,38,9883,15,294,203,1189,2672,23,448,2064,1917,7211
1796.642,17,483,42380,405,35,4447,288,25784,78,184,22921,288,16596
0.297,6,17,4818,9,135,37,136,759,8,729,42,1448,4059
1792.32,6,183,16138,122,75,14812,469,9489,61,69,29866,69,6649
1787.54,6,104,8376,68,65,26679,65,4930,36,59,51069,59,3446
240.167,6,55,15765,28,671,8894,1402,12883,27,183,9236,580,2882
0.181,6,46,21681,27,1040,6,1420,16700,19,467,9,1883,4981
1786.139,6,104,8444,68,66,26658,66,4964,36,60,51029,60,3480
240.19,6,53,17811,28,802,8895,1402,15113,25,173,10007,580,2698
1382.582,6,140,12017,92,69,15193,69,6923,48,69,29416,69,5094
0.999,17,3,201,3,39,499,39,201,0,0,0,0,0
3.911,6,23,7395,14,266,300,626,2067,9,1210,484,1946,5328
1784.469,17,136,10880,68,48,26633,48,5168,68,56,26633,56,5712
0.039,6,6,240,2,0,1,0,80,4,0,12,0,160
0.404,6,10,968,5,256,95,256,460,5,304,95,304,508
19.965,17,4,352,2,60,19964,60,176,2,60,19964,60,176
1.034,17,4,978,2,40,1020,40,136,2,393,6,423,842
46.153,1,16,896,16,28,3076,28,896,0,0,0,0,0
0.011,6,2,214,1,134,0,134,174,1,0,0,0,40
1082.885,2,10,320,10,8,120320,8,320,0,0,0,0,0
1.871,17,6,552,3,32,919,32,180,3,96,915,96,372
299.664,6,6,364,4,31,99888,31,222,2,31,299642,31,142
11.884,6,43,8840,22,320,565,933,2216,21,412,443,1460,6624
0.818,6,2,80,1,0,0,0,40,1,0,0,0,40
1758.098,1,105,5880,105,28,16904,28,5880,0,0,0,0,0
59.965,6,36,9357,20,155,3156,470,1764,16,694,3228,3302,7593
0.513,17,3,543,2,39,428,39,134,1,381,0,381,409
1.053,6,29,8303,15,225,64,561,1985,14,820,67,1440,6318
123.618,6,24,10049,12,531,58,1360,2637,12,1153,11226,2574,7412
1786.777,6,103,8404,68,66,26668,66,4964,35,60,52547,60,3440
1792.135,17,180,14040,180,50,10011,50,14040,0,0,0,0,0
3.366,6,2,88,2,0,0,0,88,0,0,0,0,0
0.57,6,14,1745,7,288,67,288,600,7,426,67,434,1145
1799.307,17,448,39384,403,35,4475,288,25412,45,282,40018,288,13972
13.765,6,23,5822,13,275,1147,275,1082,10,1440,972,1440,4740
1770.748,6,103,9514,66,66,27242,66,5610,37,60,49184,60,3904
270.388,1,8,448,8,28,38626,28,448,0,0,0,0,0
0.204,6,3,182,2,31,204,31,111,1,31,0,31,71
115.183,17,2,72,1,8,0,8,36,1,8,0,8,36
629.839,2,5,160,5,8,157459,8,160,0,0,0,0,0
1.093,17,6,936,3,64,520,64,276,3,192,495,192,660
0.375,6,12,3704,6,171,69,171,491,6,964,73,1448,3213
1772.274,6,180,15480,120,69,14893,69,8940,60,69,30037,69,6540
165.499,6,18,1573,5,63,14381,63,452,13,54,13785,57,1121
1681.505,17,14,1036,7,30,280248,30,406,7,62,280248,62,630
1791.692,6,356,22520,208,69,8655,69,12460,148,69,12188,69,10060
1795.4,17,73,3060,72,14,25287,14,3024,1,8,0,8,36
3.476,6,2,88,2,0,0,0,88,0,0,0,0,0
1.257,17,2,144,1,36,0,36,64,1,52,0,52,80
0.045,6,10,1514,5,503,11,503,771,5,475,10,475,743
1.336,6,48,19092,27,883,51,1360,13476,21,433,57,1360,5616
159.606,6,21,8523,11,549,85,1308,2119,10,998,17714,1791,6404
0.425,1,2,112,2,28,425,28,112,0,0,0,0,0
1740.83,6,87,6322,58,31,30540,31,3915,29,31,62172,31,2407
1772.56,6,203,22290,130,75,13740,267,10057,73,134,24611,1997,12233
377.497,2,3,96,3,8,188748,8,96,0,0,0,0,0
0.91,6,24,6461,14,312,69,901,2127,10,982,100,1731,4334
1787.612,17,354,56161,354,130,5064,386,56161,0,0,0,0,0
1.082,6,24,8016,12,164,98,267,1300,12,869,81,1408,6716
211.559,1,2,120,2,32,211559,32,120,0,0,0,0,0
1740.308,6,87,6322,58,31,30531,31,3915,29,31,62152,31,2407
0.177,6,23,7325,12,177,16,337,1342,11,1080,16,1588,5983
55.054,17,6,2022,6,309,11010,322,2022,0,0,0,0,0
63.858,17,4,352,2,60,63857,60,176,2,60,63857,60,176
1.434,17,13,7941,7,802,238,1350,5815,6,326,280,1350,2126
61.309,6,35,15922,22,809,2919,1408,9248,13,855,5087,3847,6674
191.9,6,21,7588,7,154,31983,267,752,14,626,14750,1420,6836
0.356,6,3,189,1,0,0,0,40,2,69,356,69,149
300.53,6,36,8603,19,335,16696,994,2169,17,478,525,2720,6434
39.238,2,4,128,4,8,13079,8,128,0,0,0,0,0
0.779,6,10,924,5,283,150,283,551,5,105,150,105,373
1.312,6,57,14587,27,551,50,1429,4984,30,419,44,1460,9603
0.124,17,2,198,1,63,0,63,91,1,79,0,79,107
0.16,17,2,672,2,308,160,308,672,0,0,0,0,0
0.021,6,11,913,6,182,4,182,490,5,77,5,134,423
6.221,6,23,7956,8,154,888,267,792,15,655,416,1460,7164
10.773,6,19,4402,10,275,1197,275,958,9,768,749,1440,3444
1772.374,6,180,15480,120,69,14893,69,8940,60,69,30032,69,6540
11.035,6,20,4442,11,275,1103,275,998,9,768,772,1440,3444
240.334,6,42,8849,21,519,12016,1402,5774,21,219,12016,618,3075
11.851,6,25,8453,13,275,987,275,1078,12,983,870,1420,7375
1789.036,17,142,11360,71,48,25557,48,5396,71,56,25557,56,5964
240.524,6,35,7200,19,171,13362,517,1842,16,645,16031,2417,5358
1.385,6,20,3833,11,234,138,564,1504,9,463,151,1343,2329
1.061,17,2,312,2,128,1061,128,312,0,0,0,0,0
0.095,17,2,268,1,33,0,33,61,1,179,0,179,207
90.136,6,47,9120,22,401,611,889,2212,25,327,3750,1360,6908
2.686,6,13,1466,8,304,383,304,1032,5,83,660,83,434
0.656,6,7,423,4,43,204,43,259,3,0,25,0,164
280.458,6,30,7432,14,158,21573,267,1357,16,678,18694,3456,6075
0.879,17,2,312,2,128,879,128,312,0,0,0,0,0
36.826,6,15,660,5,0,1492,0,220,10,0,4063,0,440
1772.222,6,99,9240,66,65,27264,65,5577,33,59,55378,59,3663
0.421,6,10,968,5,256,100,256,460,5,304,100,304,508
272.1,17,4,240,2,32,272099,32,120,2,32,272099,32,120
0.25,6,25,6098,12,181,22,537,1526,13,648,20,1542,4572
0.055,17,2,180,1,30,0,30,58,1,94,0,94,122
6.071,6,39,7269,20,218,319,314,3423,19,513,323,1179,3846
0.267,6,4,263,1,31,0,31,83,3,0,133,0,180
1799.263,1,191,20246,191,78,9469,78,20246,0,0,0,0,0
0.588,6,14,1745,7,288,68,288,600,7,426,64,434,1145
280.283,6,30,7432,13,158,23356,267,1317,17,543,17511,1400,6115
280.201,6,30,7432,13,158,23350,267,1317,17,543,17511,1400,6115
4.144,6,39,7269,19,218,230,314,3383,20,440,205,1152,3886
87.647,6,20,9182,11,514,75,1237,2015,9,1359,10935,3639,7167
0.137,17,2,672,2,308,137,308,672,0,0,0,0,0
276.931,6,80,13437,32,181,8933,1189,4004,48,227,5887,1420,9433
1331.43,1,66,3696,66,28,20483,28,3696,0,0,0,0,0
9.43,6,1185,1019010,715,1347,12,1402,989906,470,931,19,2807,29104
4.236,6,22,9745,12,487,385,1448,2580,10,1104,355,1448,7165
1764.888,2,15,480,15,8,126063,8,480,0,0,0,0,0
1738.172,17,346,55659,346,132,5038,389,55659,0,0,0,0,0
1786.189,6,102,8296,68,65,26659,65,4930,34,59,54124,59,3366
4.551,6,23,4490,12,213,413,597,1689,11,552,434,1767,2801
9.019,2,2,64,2,8,9019,8,64,0,0,0,0,0
1741.867,6,87,6322,58,31,30559,31,3915,29,31,62209,31,2407
7.742,6,19,9695,9,275,967,275,643,10,1440,753,1440,9052
0.27,17,2,154,1,33,0,33,61,1,65,0,65,93
182.028,17,70,6420,47,42,3957,288,3312,23,107,7362,288,3108
0.23,6,14,5045,7,170,37,170,554,7,1029,38,1448,4491
1796.787,17,448,39896,403,35,4469,288,25676,45,288,40021,288,14220
1656.138,1,7,392,7,28,276023,28,392,0,0,0,0,0
1763.817,2,12,384,12,8,160347,8,384,0,0,0,0,0
314.162,6,45,25686,18,559,122,1360,4122,27,974,12075,2137,21564
1745.874,6,95,7203,63,38,28159,205,4476,32,33,56306,98,2727
10.986,6,18,5610,10,275,1220,275,958,8,1440,866,1440,4652
1787.351,6,102,8296,68,65,26676,65,4930,34,59,54160,59,3366
31.599,17,48,14908,21,331,1578,1350,7539,27,244,1214,1350,7369
0.232,6,27,7296,13,155,19,267,1301,14,603,17,2036,5995
0.084,17,4,414,2,50,0,50,156,2,101,79,107,258
6.304,6,5,232,2,0,6304,0,88,3,0,1519,0,144
1785.564,6,356,22520,208,69,8625,69,12460,148,69,12146,69,10060
1741.276,17,29,6815,29,207,62188,207,6815,0,0,0,0,0
294.501,6,33,6986,15,169,11643,516,1618,18,309,17317,1452,5368
0.251,6,27,7296,13,155,20,267,1301,14,603,15,2036,5995
0.196,6,27,7296,13,155,16,267,1301,14,603,12,2800,5995
1782.467,6,359,22778,209,69,8569,69,12638,150,69,11962,69,10140
0.025,6,12,3645,6,100,4,100,420,6,968,3,1448,3225
0.053,17,2,180,1,30,0,30,58,1,94,0,94,122
1799.524,6,1263,134051,547,115,3295,309,61061,716,110,2516,110,72990
1681.958,17,16,1265,8,30,240275,37,471,8,71,240275,136,794
12.71,17,2,152,2,48,12710,48,152,0,0,0,0,0
0.987,6,20,5966,11,287,98,562,1306,9,716,110,1420,4660
6.126,6,44,8369,23,227,278,314,4102,21,489,291,1179,4267
73.387,6,27,7651,7,174,656,267,1333,20,367,3861,1452,6318
71.165,6,22,9754,12,410,57,922,1742,10,1266,7892,2720,8012
1794.198,17,140,11200,70,48,26002,48,5320,70,56,26002,56,5880
280.076,6,27,7312,13,158,23339,267,1317,14,775,21538,4836,5995
1781.766,6,366,25541,213,100,8404,469,14936,153,69,11722,69,10605
0.37,6,4,196,3,0,85,0,156,1,0,0,0,40
1680.705,17,13,534,11,14,168052,14,462,2,8,1680520,8,72
541.476,2,7,224,7,8,90246,8,224,0,0,0,0,0
7.509,17,6,528,3,48,3745,48,228,3,72,3746,72,300
1741.412,6,87,6322,58,31,30551,31,3915,29,31,62184,31,2407
251.903,2,3,96,3,8,125951,8,96,0,0,0,0,0
599.087,6,9,546,6,31,119817,31,333,3,31,299537,31,213
4.997,17,4,288,2,36,4995,36,128,2,52,4996,52,160
252.401,2,2,64,2,8,252401,8,64,0,0,0,0,0
1792.859,17,175,11200,175,36,10303,36,11200,0,0,0,0,0
0.19,6,20,4893,11,89,19,147,936,9,870,22,1668,3957
1785.807,17,87,3648,86,14,21009,14,3612,1,8,0,8,36
47.979,17,18,3000,9,48,5996,48,684,9,229,5996,308,2316
1244.666,1,6,336,6,28,248933,28,336,0,0,0,0,0
87.174,6,61,38666,38,1149,2356,1448,30716,23,749,2866,1448,7950
300.767,6,36,8261,20,258,15829,688,1867,16,522,565,3488,6394
15.257,17,30,13999,15,680,1087,1350,10620,15,197,1087,1350,3379
968.878,17,53,17808,53,308,18632,308,17808,0,0,0,0,0
1739.255,6,91,6604,59,31,29987,31,3998,32,31,56104,31,2606
1743.315,6,95,7203,63,38,28117,205,4476,32,33,56225,98,2727
0.022,17,4,284,2,32,0,32,120,2,54,5,60,164
0.052,17,4,352,2,37,0,37,130,2,83,13,89,222
12.326,1,4,224,4,28,4108,28,224,0,0,0,0,0
1791.142,6,149,9212,78,26,23261,26,4774,71,26,25587,26,4438
0.822,17,26,13392,12,512,74,1350,6481,14,465,60,1350,6911
282.931,6,28,7352,12,158,25721,267,1277,16,603,18859,1400,6075
864.26,6,189,15066,94,131,9293,469,7968,95,61,9194,69,7098
1.335,6,51,19378,27,895,51,1460,13642,24,433,49,1460,5736
1681.384,17,14,3843,7,30,280230,30,406,7,463,280229,463,3437
1.248,6,37,8214,19,321,69,1164,2718,18,476,64,2715,5496
300.247,6,35,17641,21,1008,15012,1402,12193,14,673,4709,1402,5448
280.455,6,28,7352,12,158,25495,267,1277,16,678,18693,2760,6075
499.893,17,6,528,3,60,249946,60,264,3,60,249946,60,264
1777.994,1,60,5040,0,0,0,0,0,60,56,30135,56,5040
13.53,6,17,6016,5,106,3382,106,314,12,578,944,1420,5702
121.047,6,27,2782,14,196,9298,196,1056,13,398,10072,419,1726
1746.444,6,95,7203,63,38,28168,205,4476,32,33,56325,98,2727
11.923,1,16,1664,0,0,0,0,0,16,76,794,76,1664
1738.673,6,87,6322,58,31,30503,31,3915,29,31,62095,31,2407
0.383,6,11,1007,6,256,73,256,500,5,303,90,303,507
1681.89,17,14,1036,7,30,280307,30,406,7,62,280307,62,630
1783.119,17,83,3480,82,14,22013,14,3444,1,8,0,8,36
289.096,6,41,10743,20,1179,15214,1418,9362,21,293,14454,293,1381
0.148,1,2,112,2,28,148,28,112,0,0,0,0,0
1758.505,17,292,59760,292,176,6042,422,59760,0,0,0,0,0
1745.896,6,95,7203,63,38,28159,205,4476,32,33,56311,98,2727
1772.096,6,181,15589,120,69,14891,69,8940,61,69,29531,69,6649
1.487,6,30,6427,15,164,106,267,1922,15,650,92,1380,4505
4.974,17,4,288,2,36,4943,36,128,2,52,4942,52,160
1786.307,6,102,8296,68,65,26661,65,4930,34,59,54127,59,3366
1773.074,6,180,15480,120,69,14899,69,8940,60,69,30051,69,6540
1785.287,6,366,25541,213,100,8421,469,14936,153,69,11742,69,10605
1788.914,6,356,22520,208,69,8642,69,12460,148,69,12169,69,10060
132.725,6,123,91303,77,1255,1746,1408,79384,46,793,1734,2439,11919
1774.259,6,181,15589,120,69,14909,69,8940,61,69,29565,69,6649
0.505,6,22,5010,12,89,45,147,1000,10,696,54,1418,4010
6.464,6,39,7269,19,218,359,314,3383,20,513,324,1179,3886
0.039,17,4,1232,2,60,25,60,176,2,500,24,500,1056
0.084,17,2,464,1,64,0,64,92,1,344,0,344,372
8.214,6,39,7674,20,218,432,314,3423,19,498,441,1179,4251
28.99,2,2,64,2,8,28990,8,64,0,0,0,0,0
1.354,6,49,18921,26,934,54,1440,13225,23,433,52,1440,5696
0.468,6,21,7290,13,335,39,668,2026,8,968,62,1946,5264
0.14,6,9,1340,5,145,35,145,349,4,827,26,827,991
8.184,6,19,9695,9,275,1023,275,643,10,1440,799,1440,9052
0.399,17,2,780,2,362,399,362,780,0,0,0,0,0
0.867,17,4,332,2,39,866,39,134,2,71,853,71,198
0.092,17,3,1167,3,361,46,361,1167,0,0,0,0,0
0.066,17,2,152,1,40,0,40,68,1,56,0,56,84
1782.968,1,156,8736,156,28,11503,28,8736,0,0,0,0,0
12.539,6,39,7662,19,218,696,314,3383,20,495,646,1179,4279
90.789,6,33,8110,17,334,537,688,1716,16,574,6043,4848,6394
1.294,6,50,19625,27,915,49,1360,13929,23,433,50,1360,5696
61.629,6,55,34662,35,1089,1812,1408,26882,20,748,3232,1408,7780
5.105,6,38,7229,19,218,283,314,3383,19,513,269,1179,3846
1086.519,1,22,1232,22,28,51739,28,1232,0,0,0,0,0
0.852,6,10,1687,7,100,142,100,384,3,1179,302,1179,1303
0.446,6,21,7203,13,318,37,600,1958,8,964,60,1471,5245
1756.379,6,109,6544,61,27,29272,27,3604,48,27,37368,27,2940
0.083,1,2,112,2,28,83,28,112,0,0,0,0,0
0.962,6,23,6570,13,345,79,1063,2250,10,979,106,1731,4320
1786.364,6,155,19626,92,302,19630,302,13852,63,83,28812,83,5774
2.891,17,6,462,3,33,1444,33,183,3,65,1444,65,279
1741.439,17,30,20190,30,645,60049,645,20190,0,0,0,0,0
5.034,17,4,288,2,36,5022,36,128,2,52,5023,52,160
628.462,17,10,880,5,48,157112,48,380,5,72,157112,72,500
1787.066,6,105,8412,69,64,26280,64,5000,36,58,51055,58,3412
1798.108,1,345,28980,345,56,5227,56,28980,0,0,0,0,0
1782.012,17,73,3060,72,14,25098,14,3024,1,8,0,8,36
0.562,6,6,324,4,0,187,0,216,2,0,321,0,108
1778.155,1,56,4704,56,56,32330,56,4704,0,0,0,0,0
365.957,6,27,1767,18,177,21526,177,1181,9,110,8604,110,586
190.464,17,4,240,2,32,190463,32,120,2,32,190463,32,120
1.341,17,6,552,3,32,670,32,180,3,96,270,96,372
7.296,6,18,5180,8,150,1042,174,624,10,828,799,1420,4556
0.178,1,2,163,2,53,178,78,163,0,0,0,0,0
534.182,6,55,7175,31,102,14808,722,3164,24,197,23218,2329,4011
12.407,6,25,8473,13,275,1033,275,1078,12,986,1054,1440,7395
11.888,6,1792,1637973,1112,1421,10,1432,1606552,680,420,17,1432,31421
44.994,17,12,570,11,16,4499,58,486,1,56,0,56,84
84.093,6,112,81765,68,1279,1255,1448,71372,44,674,1950,1448,10393
11.043,6,17,4226,9,275,1380,275,918,8,992,856,1440,3308
5.086,6,41,7349,20,218,267,314,3423,21,440,241,1152,3926
1792.606,17,142,11360,71,48,25608,48,5396,71,56,25607,56,5964
0.023,6,9,1878,5,908,5,908,1176,4,486,6,486,702
1796.085,17,142,11360,71,48,25658,48,5396,71,56,25658,56,5964
1622.691,1,8,448,8,28,231813,28,448,0,0,0,0,0
47.903,6,25,4048,15,179,3421,517,1876,10,411,5321,499,2172
0.869,17,2,172,1,50,0,50,78,1,66,0,66,94
0.246,6,14,2724,7,503,40,503,1390,7,475,40,475,1334
141.212,17,4,240,2,32,141211,32,120,2,32,141211,32,120
380.483,6,6,368,4,112,126823,112,280,2,0,380470,0,88
38.086,17,22,1672,22,48,1813,48,1672,0,0,0,0,0
0.004,17,2,410,1,46,0,46,74,1,308,0,308,336
39.788,6,10,600,0,0,0,0,0,10,0,0,0,600
2.187,17,4,580,2,40,2148,40,136,2,194,2163,194,444
1771.199,6,99,9240,66,65,27249,65,5577,33,59,55347,59,3663
9.962,17,4,272,2,40,9960,47,136,2,40,9961,47,136
64.417,17,4,240,2,32,64416,32,120,2,32,64416,32,120
1795.144,17,80,3354,79,14,23014,14,3318,1,8,0,8,36
280.287,6,29,7392,13,158,23357,267,1317,16,603,18681,2036,6075
1785.849,6,104,8376,68,65,26654,65,4930,36,59,51021,59,3446
1776.037,1,264,14784,264,28,6752,28,14784,0,0,0,0,0
4.414,6,37,7189,19,218,245,314,3383,18,513,243,1179,3806
10.821,6,83,24893,44,544,251,1152,19176,39,461,277,1179,5717
0.793,6,17,5132,9,150,99,174,664,8,828,100,1420,4468
1542.222,6,91,7171,54,63,26572,64,3867,37,50,42837,58,3304
336.74,6,22,6694,3,106,1785,106,234,19,355,18707,1420,6460
37.257,17,22,1672,22,48,1774,48,1672,0,0,0,0,0
4.276,6,22,6427,10,268,462,517,1334,12,893,380,2736,5093
1788.588,17,87,3648,86,14,21042,14,3612,1,8,0,8,36
0.111,17,2,415,1,43,0,43,71,1,316,0,316,344
2.192,17,23,16817,10,571,243,1350,5998,13,804,175,1350,10819
0.014,17,3,634,2,32,10,32,120,1,486,0,486,514
38.51,17,8,2688,8,308,5501,308,2688,0,0,0,0,0
1770.846,1,59,4956,59,56,30531,56,4956,0,0,0,0,0
1775.12,6,180,15480,120,69,14916,69,8940,60,69,30085,69,6540
6.008,6,599,520848,371,1336,15,1368,504328,228,931,25,2841,16520
1727.841,17,12,498,11,14,172784,14,462,1,8,0,8,36
4.031,17,4,488,4,94,1343,94,488,0,0,0,0,0
1792.308,1,58,4872,58,56,31444,56,4872,0,0,0,0,0
1792.812,17,66,2766,65,14,28012,14,2730,1,8,0,8,36
1770.29,6,99,9240,66,65,27235,65,5577,33,59,55318,59,3663
0.231,17,2,154,1,33,0,33,61,1,65,0,65,93
1795.912,6,258,26044,102,67,17779,659,9518,156,125,11585,1360,16526
280.073,6,30,7432,13,158,23339,267,1317,17,543,17501,1400,6115
749.593,6,38,3450,19,1208,41643,1208,2172,19,259,41643,517,1278
0.362,17,2,198,1,39,0,39,67,1,103,0,103,131
369.537,6,18,1242,14,180,28425,180,916,4,110,20064,110,326
0.423,6,12,1653,6,288,83,288,548,6,426,48,434,1105
1798.711,6,376,26286,218,98,8288,469,15343,158,69,11454,69,10943
1720.419,17,12,498,11,14,172041,14,462,1,8,0,8,36
1792.407,6,369,28983,213,114,8454,789,15747,156,102,11563,645,13236
58.411,6,22,6411,11,262,5836,517,1378,11,744,5836,1408,5033
1.307,6,50,18861,27,860,50,1360,13165,23,433,51,1360,5696
0.018,17,2,166,1,39,0,39,67,1,71,0,71,99
1780.612,17,138,11040,69,48,26185,48,5244,69,56,26185,56,5796
14.176,6,1587,1438848,1006,1352,13,1408,1403948,581,931,24,2801,34900
1771.528,6,101,9344,66,65,27254,65,5577,35,59,52101,59,3767
1779.173,17,140,11200,70,48,25784,48,5320,70,56,25785,56,5880
1203.27,2,11,352,11,8,120327,8,352,0,0,0,0,0
301.224,6,17,1758,10,180,33449,180,1068,7,110,50174,110,690
0.827,17,4,344,2,47,819,47,150,2,69,820,75,194
350.661,6,21,6644,5,186,87665,267,581,16,416,23371,1452,6063
0.806,6,10,1687,7,100,134,100,384,3,1179,271,1179,1303
0.436,17,7,2429,7,319,72,354,2429,0,0,0,0,0
33.393,6,29,4989,14,180,2568,722,1806,15,342,2370,1440,3183
0.014,6,10,1901,5,657,3,657,925,5,708,3,708,976
11.272,6,26,9833,13,275,939,275,1078,13,1027,689,1380,8755
1681.785,17,14,1036,7,30,280294,30,406,7,62,280294,62,630
281.791,6,29,7392,13,158,23482,267,1317,16,603,18768,2036,6075
1790.732,6,356,22520,208,69,8650,69,12460,148,69,12181,69,10060
0.219,17,2,144,1,36,0,36,64,1,52,0,52,80
10.176,6,23,8274,12,482,925,721,2412,11,903,920,2007,5862
0.4,6,27,9112,13,271,33,726,1771,14,943,28,1408,7341
4.07,17,2,656,2,300,4070,300,656,0,0,0,0,0
1797.044,6,126,14651,76,81,23743,519,6073,50,146,36672,1420,8578
1.818,17,18,8017,8,468,259,1350,3971,10,376,135,1350,4046
15.114,6,15,5673,5,106,3776,106,314,10,823,1678,1420,5359
4.511,6,26,4442,13,112,375,112,784,13,619,375,1414,3658
1.001,17,2,677,1,300,0,300,328,1,321,0,321,349
11.837,6,1874,1635479,1136,1385,10,1420,1601738,738,467,16,1883,33741
0.842,17,2,157,1,31,0,31,59,1,70,0,70,98
0.504,6,10,968,5,256,123,256,460,5,304,122,304,508
0.05,17,2,182,1,44,0,44,72,1,82,0,82,110
1.488,17,24,16256,10,381,165,1350,4099,14,840,109,1350,12157
0.692,17,4,1344,4,308,230,308,1344,0,0,0,0,0
1798.852,6,356,22520,208,69,8690,69,12460,148,69,12235,69,10060
1795.386,17,449,39928,404,35,4455,288,25708,45,288,40021,288,14220
27.757,6,45,13934,21,315,1387,721,3371,24,599,1116,1414,10563
1772.124,6,180,15480,120,69,14891,69,8940,60,69,30033,69,6540
0.238,6,9,1002,5,213,59,213,417,4,421,61,421,585
1796.975,1,58,4872,58,56,31525,56,4872,0,0,0,0,0
0.011,17,2,548,2,246,11,246,548,0,0,0,0,0
14.445,17,42,10899,42,231,352,389,10899,0,0,0,0,0
1786.269,17,87,3648,86,14,21014,14,3612,1,8,0,8,36
127.65,6,20,8239,11,525,84,1237,2048,9,1163,15934,3151,6191
1678.22,1,7,392,7,28,279703,28,392,0,0,0,0,0
0.977,6,26,6092,14,108,75,147,999,12,768,85,1581,5093
109.838,6,945,467848,514,842,214,1152,445135,431,420,254,1179,22713
0.387,17,8,2750,8,315,55,354,2750,0,0,0,0,0
0.023,6,2,116,1,0,0,0,64,1,0,0,0,52
45.294,6,13,3117,4,92,15098,92,296,9,1164,5601,1448,2821
3.585,6,2,88,2,0,0,0,88,0,0,0,0,0
30.86,6,11,5498,4,106,10286,106,274,7,987,5067,1933,5224
0.156,17,2,268,1,54,0,54,82,1,158,0,158,186
809.154,1,98,10388,98,78,8341,78,10388,0,0,0,0,0
1.328,17,6,785,3,31,654,31,177,3,174,653,196,608
9.064,1,3,309,3,75,4532,111,309,0,0,0,0,0
148.243,6,24,11718,13,741,58,1460,3518,11,1291,14810,2868,8200
10.609,1,8,832,0,0,0,0,0,8,76,1515,76,832
1751.133,1,136,7616,136,28,12971,28,7616,0,0,0,0,0
0.51,6,51,21704,29,961,18,1380,16582,22,421,22,1923,5122
1750.352,17,11,462,11,14,175035,14,462,0,0,0,0,0
1798.733,6,369,25330,214,93,8444,469,14645,155,69,11677,69,10685
152.982,17,4,240,2,32,152981,32,120,2,32,152981,32,120
5.133,17,4,304,4,48,1711,48,304,0,0,0,0,0
20.696,6,1998,1774074,1241,1373,16,1380,1736220,757,421,27,1923,37854
0.579,6,20,6457,12,141,52,275,766,8,894,39,2760,5691
1.372,6,41,12463,22,668,65,1460,6927,19,433,66,1460,5536
1800.0,6,220,16830,83,68,21585,298,7984,137,48,13235,78,8846
1.67,6,47,19027,26,949,66,1460,13411,21,433,73,1460,5616
61.764,6,68,45886,42,1186,1506,1408,37800,26,960,2461,3847,8086
0.541,6,10,924,5,283,91,283,551,5,105,91,105,373
170.617,6,42,6072,21,132,8530,722,2413,21,213,8521,1408,3659
14.176,6,45,10713,21,227,708,314,4022,24,636,604,1179,6691
193.059,6,30,8872,13,158,16088,267,1317,17,687,12065,1400,7555
1781.766,6,361,22858,209,69,8566,69,12638,152,69,11799,69,10220
15.515,17,32,16533,17,779,967,1350,13722,15,159,1105,1350,2811
1764.363,2,15,480,15,8,126025,8,480,0,0,0,0,0
280.578,6,27,7312,13,158,23381,267,1317,14,775,21580,2800,5995
0.128,17,2,152,1,48,0,48,76,1,48,0,48,76
1751.166,17,174,39848,174,201,10122,422,39848,0,0,0,0,0
64.651,6,11,452,5,0,6073,0,204,6,0,12927,0,248
13.797,6,27,4869,13,154,1130,722,1768,14,394,1047,1448,3101
0.102,6,9,1340,5,145,25,145,349,4,827,30,827,991
11.444,6,33,10392,15,158,817,267,1397,18,751,671,1781,8995
145.58,17,12,2472,6,48,29114,48,456,6,308,29114,308,2016
1781.697,6,353,22400,206,69,8691,69,12380,147,69,12203,69,10020
13.458,6,8,440,5,0,3364,0,268,3,0,6480,0,172
1798.162,6,359,23178,210,75,8603,469,13009,149,69,12146,69,10169
0.008,17,3,394,2,32,1,32,120,1,246,0,246,274
0.026,17,3,704,2,60,0,60,176,1,500,0,500,528
0.589,6,2,135,1,0,0,0,52,1,31,0,31,83
53.039,6,18,3736,6,152,2605,267,702,12,255,4799,1179,3034
16.069,6,1000,879791,638,1306,24,1368,856303,362,776,43,1473,23488
381.018,6,18,1242,14,180,29309,180,916,4,110,20059,110,326
156.058,6,43,8862,22,174,7431,721,2279,21,441,7781,2840,6583
0.072,17,2,198,1,63,0,63,91,1,79,0,79,107
240.518,6,45,9118,21,519,12025,1402,5773,24,232,10457,618,3345
1188.749,6,25,3139,18,101,69926,138,2445,7,69,9577,69,694
0.108,6,13,1749,7,253,18,500,878,6,275,21,500,871
2.18,6,28,10325,17,367,136,833,1785,11,1156,210,2840,8540
22.326,6,37,8342,18,359,514,761,1829,19,441,1232,1440,6513
1796.97,17,142,11360,71,48,25670,48,5396,71,56,25670,56,5964
1798.524,6,372,38797,183,373,9882,842,14131,189,83,9555,1418,24666
38.729,17,44,6468,22,48,1843,48,1672,22,190,1843,308,4796
7.546,6,40,7325,21,218,377,314,3463,19,516,404,1179,3862
598.791,2,4,128,4,8,199597,8,128,0,0,0,0,0
79.256,17,4,352,2,60,79255,60,176,2,60,79254,60,176
1798.447,17,446,39264,403,35,4473,288,25676,43,288,41919,288,13588
1772.779,6,180,15480,120,69,14897,69,8940,60,69,30039,69,6540
91.041,6,22,5860,12,217,8276,504,1352,10,586,10105,1420,4508
0.491,17,3,451,2,39,407,39,134,1,289,0,289,317
1770.745,6,99,9306,66,66,27242,66,5610,33,60,55333,60,3696
1676.41,6,94,6820,60,31,28413,31,4086,34,31,50799,31,2734
11.982,1,4,224,4,28,3994,28,224,0,0,0,0,0
1782.72,17,19,6266,19,301,99040,1328,6266,0,0,0,0,0
1798.344,17,448,39896,403,35,4473,288,25676,45,288,40022,288,14220
32.069,6,269,342544,53,108,616,321,3190,216,1540,149,4206,339354
0.465,17,2,152,1,48,0,48,76,1,48,0,48,76
0.689,6,16,5759,8,784,98,1360,3458,8,247,60,272,2301
89.201,6,19,780,10,0,9911,0,404,9,0,11138,0,376
1511.692,2,9,288,9,8,188961,8,288,0,0,0,0,0
0.132,1,2,163,2,53,132,78,163,0,0,0,0,0
1671.342,1,8,448,8,28,238763,28,448,0,0,0,0,0
0.96,6,24,6469,14,314,73,909,2135,10,982,106,1731,4334
0.043,6,4,222,2,31,43,31,111,2,31,0,31,111
61.86,6,73,50687,45,1216,1405,1448,42500,28,747,2282,1448,8187
0.102,1,5,140,5,0,0,0,140,0,0,0,0,0
0.072,6,10,1514,5,503,17,503,771,5,475,18,475,743
1756.435,6,95,7203,63,38,28329,205,4476,32,33,56648,98,2727
0.011,17,2,516,1,60,0,60,88,1,400,0,400,428
0.043,17,2,290,1,40,0,40,68,1,194,0,194,222
1.438,6,37,8236,19,320,79,1162,2740,18,476,73,2720,5496
1795.409,17,142,11360,71,48,25648,48,5396,71,56,25648,56,5964
0.346,17,2,412,1,33,0,33,61,1,323,0,323,351
1.509,17,4,424,2,46,1000,46,148,2,110,1,110,276
4.301,6,38,7229,19,218,238,314,3383,19,440,224,1152,3846
44.212,6,6,240,3,0,204,0,120,3,0,22100,0,120
1.335,6,41,9968,21,440,66,1360,4392,20,433,59,1360,5576
76.295,17,9,684,9,48,9536,48,684,0,0,0,0,0
0.285,6,26,9003,13,247,23,624,1684,13,947,22,1408,7319
0.131,17,2,2384,2,1164,131,1164,2384,0,0,0,0,0
9.816,6,24,10889,11,275,981,275,723,13,1070,755,1420,10166
0.235,17,2,196,1,62,0,62,90,1,78,0,78,106
317.04,6,64,18505,36,353,9058,1360,9634,28,552,11737,1929,8871
0.633,17,14,9080,7,935,89,1350,6747,7,305,93,1350,2333
1799.617,17,449,39928,404,35,4465,288,25708,45,288,40020,288,14220
1780.655,17,134,10720,67,48,26979,48,5092,67,56,26979,56,5628
1.004,6,2,92,1,0,0,0,40,1,0,0,0,52
0.492,6,7,288,4,0,164,0,164,3,0,117,0,124
6.418,6,48,8529,25,227,267,314,4182,23,427,280,1152,4347
0.117,6,2,100,1,0,0,0,60,1,0,0,0,40
0.08,17,3,234,2,39,58,39,134,1,72,0,72,100
1781.701,17,73,3060,72,14,25094,14,3024,1,8,0,8,36
95.47,6,32,7674,13,141,7955,267,1375,19,368,5293,1452,6299
29.015,17,4,240,2,32,29014,32,120,2,32,29015,32,120
0.583,6,10,924,5,283,98,283,551,5,105,98,105,373
0.948,6,10,1687,7,100,158,100,384,3,1179,346,1179,1303
7.228,6,36,6435,19,204,401,314,3010,17,548,434,1179,3425
1793.369,6,1036,184393,677,304,2652,304,137476,359,83,5008,83,46917
1.367,6,4,253,0,0,0,0,0,4,31,455,31,253
1744.7,2,16,512,16,8,116313,8,512,0,0,0,0,0
240.242,6,57,21272,31,873,8007,1418,18222,26,211,9609,580,3050
1.222,6,53,22056,30,1040,42,1380,16849,23,387,43,1923,5207
1.609,17,6,360,3,32,804,32,180,3,32,804,32,180
9.42,6,31,5920,14,140,724,267,1272,17,564,564,1420,4648
1795.426,17,29,9512,29,300,64122,300,9512,0,0,0,0,0
1.013,6,28,8160,15,222,60,540,1964,13,944,68,1591,6196
1720.408,17,12,498,11,14,172040,14,462,1,8,0,8,36
11.456,6,14,2242,8,210,1631,210,844,6,545,2290,904,1398
2.881,17,3,468,3,128,1440,128,468,0,0,0,0,0
1789.954,6,371,25272,214,93,8403,469,14645,157,69,11474,69,10627
10.956,6,20,4442,11,275,1095,275,998,9,768,763,1440,3444
754.448,6,12,728,8,31,107778,31,444,4,31,251376,31,284
13.877,6,5,482,2,0,4122,0,92,3,210,6563,210,390
19.223,17,28,17064,12,299,1745,1350,3924,16,793,1279,1350,13140
174.157,6,13,1807,4,100,246,100,264,9,1179,21737,1179,1543
1793.648,17,144,11520,72,48,25262,48,5472,72,56,25262,56,6048
1741.409,17,30,20190,30,645,60048,645,20190,0,0,0,0,0
0.506,17,2,255,1,43,0,43,71,1,156,0,156,184
1786.704,6,355,22480,207,69,8673,69,12420,148,69,12154,69,10060
1746.079,1,56,4704,56,56,31746,56,4704,0,0,0,0,0
1.025,17,4,963,2,33,1014,37,123,2,392,1012,463,840
0.454,6,29,7376,13,155,37,267,1301,16,603,27,2760,6075
1.644,6,13,2311,8,188,234,245,700,5,1407,344,1407,1611
617.7,6,151,39662,70,470,8952,1360,25967,81,197,7719,2720,13695
1783.108,6,242,20874,95,79,18967,337,9742,147,70,12211,1062,11132
1770.985,6,101,6032,58,26,31069,26,3406,43,26,42165,26,2626
7.449,6,6,324,2,0,7449,0,100,4,0,2418,0,224
300.709,6,9,515,5,31,75177,31,293,4,31,99640,31,222
4.973,17,4,558,2,36,4969,36,128,2,187,4967,187,430
0.128,6,9,1002,5,213,32,213,417,4,421,26,421,585
43.877,6,34,8035,13,144,77,267,1397,21,482,2193,1460,6638
0.158,6,13,3041,7,695,26,860,1763,6,479,30,939,1278
0.517,6,22,7345,13,334,43,663,2021,9,1209,57,1946,5324
0.787,17,2,144,1,36,0,36,64,1,52,0,52,80
0.481,6,12,1653,6,288,91,288,548,6,426,49,434,1105
280.516,6,30,7432,13,158,23376,267,1317,17,543,17526,1400,6115
1771.614,6,101,9410,66,66,27255,66,5610,35,60,52103,60,3800
1779.192,6,217,17518,81,79,22238,376,8669,136,50,13178,143,8849
20.14,6,21,5406,13,107,1678,159,1114,8,967,2875,1675,4292
1786.799,6,106,8456,68,65,26668,65,4930,38,59,48288,59,3526
1799.617,1,57,4788,57,56,32136,56,4788,0,0,0,0,0
167.443,6,27,6167,16,189,11162,516,1590,11,516,16734,1452,4577
1760.563,1,246,13776,246,28,7185,28,13776,0,0,0,0,0
9.542,6,27,7263,9,146,1192,267,1098,18,418,557,1420,6165
15.264,6,20,3810,11,129,1525,131,836,9,1301,1907,1430,2974
0.871,6,10,1687,7,100,145,100,384,3,1179,310,1179,1303
0.074,6,10,1514,5,503,18,503,771,5,475,18,475,743
50.723,6,27,7177,13,155,4226,267,1306,14,530,3900,3417,5871
37.619,17,22,1672,22,48,1791,48,1672,0,0,0,0,0
1794.082,1,58,4872,58,56,31475,56,4872,0,0,0,0,0
503.587,2,4,128,4,8,167862,8,128,0,0,0,0,0
3.716,6,71,24720,36,657,106,857,10023,35,603,104,1360,14697
0.064,17,2,239,1,59,0,59,87,1,124,0,124,152
0.405,17,15,7255,7,532,67,1350,3925,8,388,49,1350,3330
401.966,6,33,7038,14,168,12572,516,1575,19,293,22326,1452,5463
291.682,6,174,26847,98,304,3007,304,18380,76,83,3875,83,8467
1794.153,17,80,3354,79,14,23001,14,3318,1,8,0,8,36
14.702,17,6,528,3,48,7346,48,228,3,72,7346,72,300
6.351,6,542,483819,350,1317,17,1368,468735,192,776,32,2736,15084
1795.961,17,449,39928,404,35,4456,288,25708,45,288,40018,288,14220
240.204,6,57,18412,31,812,8006,1408,15450,26,178,9608,580,2962
13.753,6,6,328,4,0,4584,0,216,2,0,13731,0,112
1799.061,1,56,4704,56,56,32710,56,4704,0,0,0,0,0
7.82,6,46,9131,22,227,372,314,4062,24,456,328,1179,5069
2.768,6,22,6438,10,268,302,517,1333,12,744,247,1418,5105
1780.852,17,140,11200,70,48,25809,48,5320,70,56,25809,56,5880
124.287,6,9,514,3,106,62139,106,234,6,0,24855,0,280
0.43,6,48,21071,27,1060,16,1380,15989,21,421,19,1923,5082
145.661,1,6,336,6,28,29132,28,336,0,0,0,0,0
1772.312,6,180,15480,120,69,14893,69,8940,60,69,30034,69,6540
87.434,17,10,585,10,30,9714,31,585,0,0,0,0,0
4.017,17,8,616,4,33,1333,33,244,4,65,1332,65,372
1.875,6,24,8004,12,164,142,267,1288,12,1014,145,2331,6716
1785.972,6,110,8684,68,66,26656,66,4964,42,60,43558,60,3720
2.599,17,4,240,2,32,2598,32,120,2,32,2598,32,120
133.01,6,26,9092,7,182,22168,267,1019,19,521,7380,1420,8073
1795.736,17,449,39928,404,35,4455,288,25708,45,288,40016,288,14220
1765.705,1,56,4704,56,56,32103,56,4704,0,0,0,0,0
143.453,17,4,352,2,60,143451,60,176,2,60,143452,60,176
1799.542,1,57,4788,57,56,32134,56,4788,0,0,0,0,0
1784.358,17,142,11360,71,48,25490,48,5396,71,56,25490,56,5964
0.228,6,21,5000,10,137,25,267,1092,11,577,21,1400,3908
0.339,17,2,2382,2,1163,339,1163,2382,0,0,0,0,0
5.535,6,39,7269,21,218,276,314,3463,18,513,310,1179,3806
1788.311,6,359,22709,209,69,8597,69,12569,150,69,12002,69,10140
9.311,6,22,5040,11,137,931,267,1132,11,692,668,1467,3908
1793.291,17,164,10496,164,36,11001,36,10496,0,0,0,0,0
0.027,17,2,204,1,43,0,43,71,1,105,0,105,133
0.081,17,2,255,1,43,0,43,71,1,156,0,156,184
21.283,6,6,328,4,0,7094,0,216,2,0,21264,0,112
1756.135,1,56,4704,56,56,31929,56,4704,0,0,0,0,0
1.348,17,23,14565,13,881,112,1350,11820,10,246,144,1350,2745
1781.857,6,356,22520,208,69,8607,69,12460,148,69,12121,69,10060
0.021,17,2,390,1,46,0,46,74,1,288,0,288,316
1.559,17,23,11871,11,739,155,1350,8441,12,257,73,1350,3430
15.009,6,8,642,8,46,2144,46,642,0,0,0,0,0
0.088,6,10,1669,6,551,17,947,1346,4,159,29,159,323
126.441,6,4954,4577762,2724,632,46,1396,156467,2230,1940,56,16752,4421295
2.857,6,14,2351,8,188,408,245,700,6,703,518,1152,1651
1770.125,6,213,16953,78,75,22987,338,8222,135,49,13209,143,8731
0.019,6,3,182,2,31,19,31,111,1,31,0,31,71
400.559,17,22,7392,22,308,19074,308,7392,0,0,0,0,0
1799.354,1,57,4788,0,0,0,0,0,57,56,32131,56,4788
367.016,6,18,1242,14,180,28232,180,916,4,110,20058,110,326
14.027,6,6,328,4,0,4675,0,216,2,0,14014,0,112
0.015,17,2,160,1,36,0,36,64,1,68,0,68,96
0.012,17,2,371,1,65,0,65,93,1,250,0,250,278
3.869,17,4,352,2,48,3861,48,152,2,72,3860,72,200
1794.066,1,75,6300,75,56,24244,56,6300,0,0,0,0,0
20.623,6,24,6232,14,117,1586,159,1337,10,727,2290,1418,4895
0.334,17,495,551475,100,79,3,1350,10743,395,1340,0,1350,540732
0.098,17,2,197,1,41,0,41,69,1,100,0,100,128
6.561,6,16,1555,9,283,810,283,1050,7,105,1064,105,505
259.291,17,6,2016,6,308,51858,308,2016,0,0,0,0,0
1.285,6,21,9245,11,514,128,1236,2038,10,970,112,1360,7207
0.922,6,11,1727,7,100,153,100,384,4,589,217,1152,1343
4.913,17,4,288,2,36,4869,36,128,2,52,4864,52,160
5.502,6,41,7349,21,218,275,314,3463,20,440,276,1152,3886
280.29,6,30,7432,13,158,23357,267,1317,17,543,17515,1400,6115
1791.9,1,268,15008,268,28,6711,28,15008,0,0,0,0,0
1772.906,6,180,15480,120,69,14898,69,8940,60,69,30047,69,6540
1.254,6,10,1687,7,100,209,100,384,3,1179,506,1179,1303
1783.412,6,219,17345,82,75,22015,337,8456,137,50,13112,143,8889
1790.546,6,356,22520,208,69,8649,69,12460,148,69,12180,69,10060
1774.604,6,180,15480,120,69,14912,69,8940,60,69,30071,69,6540
0.229,6,3,453,2,241,229,241,321,1,92,0,92,132
126.077,6,34,7935,12,155,29,267,1266,22,340,6003,3417,6669
300.974,6,42,10699,22,682,14332,1460,5017,20,347,460,1460,5682
2.568,6,48,20173,27,960,98,1440,14557,21,433,114,1440,5616
1741.226,6,92,6668,60,31,29512,31,4062,32,31,56168,31,2606
1797.509,17,142,11360,71,48,25678,48,5396,71,56,25678,56,5964
1786.858,6,102,8228,68,64,26669,64,4896,34,58,54144,58,3332
1792.056,6,374,26537,216,104,8335,469,15663,158,69,11411,69,10874
56.468,6,27,7177,13,155,4705,267,1306,14,530,4343,3417,5871
197.447,17,4,240,2,32,197446,32,120,2,32,197446,32,120
0.195,6,10,1669,6,551,38,947,1346,4,159,64,159,323
0.394,17,3,618,2,32,208,32,120,1,470,0,470,498
712.75,6,68,8027,36,88,20364,722,3380,32,140,22985,1408,4647
1780.823,17,142,11360,71,48,25440,48,5396,71,56,25440,56,5964
1681.82,17,14,1036,7,30,280247,30,406,7,62,280300,62,630
1799.893,6,1237,130408,531,111,3396,309,59030,706,110,2553,110,71378
170.603,6,6,342,2,0,1208,0,112,4,7,56807,7,230
161.527,6,80,52118,47,1212,3511,1448,43677,33,839,1931,2359,8441
1774.847,17,137,10956,69,48,26100,48,5244,68,56,26489,56,5712
221.849,17,4,352,2,60,221848,60,176,2,60,221848,60,176
160.844,6,154,125302,104,1267,1561,1408,113193,50,730,3089,3847,12109
1.615,6,49,19349,27,898,62,1360,13693,22,433,66,1360,5656
1798.327,17,470,157920,470,308,3834,308,157920,0,0,0,0,0
19.16,1,8,832,0,0,0,0,0,8,76,2737,76,832
0.326,6,27,9098,13,261,27,683,1728,14,829,24,1438,7370
1754.893,6,192,11895,96,49,18472,208,7125,96,31,18469,31,4770
9.209,6,68,20222,36,562,263,1152,15515,32,489,288,1179,4707
1798.962,17,142,11360,71,48,25699,48,5396,71,56,25699,56,5964
5.454,6,40,7325,21,218,272,314,3463,19,516,287,1179,3862
103.531,6,25,6318,9,272,95,516,1180,16,345,6896,1452,5138
14.774,6,14,1025,7,222,2461,222,506,7,231,2461,231,519
0.232,6,27,7296,13,155,19,267,1301,14,603,15,2036,5995
300.91,6,61,27058,36,805,8597,1408,9277,25,969,1703,6255,17781
69.13,17,4,240,2,32,69129,32,120,2,32,69129,32,120
568.533,17,9,3132,9,320,71066,382,3132,0,0,0,0,0
1753.542,6,95,7203,63,38,28282,205,4476,32,33,56559,98,2727
5.834,17,39,23081,19,542,322,1350,10847,20,583,305,1350,12234
280.2,6,28,7352,12,158,25472,267,1277,16,603,18676,1400,6075
0.091,6,10,1677,6,555,17,951,1354,4,159,29,159,323
0.062,6,13,1053,8,182,8,182,630,5,77,13,134,423
0.079,17,2,176,1,60,0,60,88,1,60,0,60,88
1782.447,17,83,3480,82,14,22005,14,3444,1,8,0,8,36
1790.564,17,179,13962,179,50,10059,50,13962,0,0,0,0,0
1746.986,6,98,7521,64,38,27729,205,4528,34,36,52930,131,2993
1792.069,17,179,13962,179,50,10067,50,13962,0,0,0,0,0
128.296,6,49,11061,17,127,3923,267,1710,32,310,4138,1420,9351
120.619,6,56,15369,22,249,5743,1189,3131,34,494,3654,1460,12238
0.416,6,10,968,5,256,102,256,460,5,304,102,304,508
0.029,17,4,859,2,37,0,37,130,2,336,4,348,729
33.477,6,29,5014,15,180,2391,721,1883,14,399,2559,2026,3131
0.023,17,2,138,1,33,0,33,61,1,49,0,49,77
1772.867,6,180,15480,120,69,14898,69,8940,60,69,30047,69,6540
150.778,6,37,15984,23,805,6853,1408,9258,14,748,4694,2439,6726
1790.631,6,361,22858,210,69,8567,69,12609,151,69,11937,69,10249
1751.098,17,12,498,11,14,175109,14,462,1,8,0,8,36
116.338,17,14,19170,14,1341,8949,1347,19170,0,0,0,0,0
0.09,17,2,146,1,37,0,37,65,1,53,0,53,81
0.059,6,2,364,1,0,0,0,40,1,272,0,272,324
0.098,6,10,1671,6,552,19,948,1348,4,159,32,159,323
560.541,17,6,444,3,30,280254,30,174,3,62,280246,62,270
1799.625,1,230,12880,230,28,7858,28,12880,0,0,0,0,0
1.371,6,47,19211,27,894,52,1360,13635,20,476,62,2715,5576
1778.763,1,162,17172,162,78,11048,78,17172,0,0,0,0,0
11.914,6,1873,1644703,1140,1389,10,1420,1611162,733,467,16,1883,33541
280.562,6,29,7392,13,158,23380,267,1317,16,678,18700,3456,6075
288.635,17,4,352,2,60,288634,60,176,2,60,288634,60,176
1787.371,6,104,8444,68,66,26677,66,4964,36,60,51064,60,3480
1752.951,1,71,5964,71,56,25042,56,5964,0,0,0,0,0
1785.178,17,87,3648,86,14,21002,14,3612,1,8,0,8,36
0.057,6,9,1002,5,213,14,213,417,4,421,15,421,585
12.869,6,30,8872,13,158,1072,267,1317,17,687,801,1400,7555
0.013,17,2,391,1,44,0,44,72,1,291,0,291,319
1787.094,17,142,11360,71,48,25529,48,5396,71,56,25528,56,5964
5.016,17,4,288,2,36,5000,36,128,2,52,4999,52,160
9.754,6,93,30702,47,592,212,1152,24380,46,407,210,1152,6322
280.2,6,28,7352,13,158,23350,267,1317,15,678,20010,4200,6035
12.628,17,4,824,2,48,12611,48,152,2,308,12609,308,672
10.782,6,20,4442,11,275,1078,275,998,9,768,744,1440,3444
0.015,17,4,344,2,47,5,47,150,2,69,4,75,194
1782.295,6,102,8296,68,65,26601,65,4930,34,59,54006,59,3366
85.015,6,56,34129,35,1111,2500,1448,26283,21,749,3070,1448,7846
1796.364,17,449,39928,404,35,4457,288,25708,45,288,40019,288,14220
0.08,6,9,1002,5,213,20,213,417,4,421,20,421,585
0.299,17,2,167,1,39,0,39,67,1,72,0,72,100
1781.245,6,354,22440,207,69,8646,69,12420,147,69,12199,69,10020
813.317,17,160,12160,160,48,5115,48,12160,0,0,0,0,0
1729.197,6,60,4400,40,33,44338,33,2740,20,31,90998,31,1660
2.629,6,25,8056,12,164,200,267,1288,13,869,180,1448,6768
1700.427,17,12,498,11,14,170042,14,462,1,8,0,8,36
1777.635,17,73,3060,72,14,25037,14,3024,1,8,0,8,36
1779.692,6,353,22400,206,69,8681,69,12380,147,69,12189,69,10020
0.187,6,9,1340,5,145,46,145,349,4,827,28,827,991
240.243,6,59,18599,28,817,8897,1418,15367,31,201,8007,580,3232
0.51,6,8,335,4,0,170,0,164,4,7,74,7,171
624.043,17,6,2016,6,308,124808,308,2016,0,0,0,0,0
650.391,17,78,5928,78,48,8446,48,5928,0,0,0,0,0
1680.148,17,12,498,11,14,168014,14,462,1,8,0,8,36
1787.914,6,376,26217,217,98,8277,469,15372,159,69,11315,69,10845
3.839,17,4,352,2,48,3825,48,152,2,72,3825,72,200
129.618,6,18,2107,11,302,12961,302,1486,7,83,21600,83,621
1.663,6,42,10065,23,440,75,1360,4484,19,400,81,1360,5581
300.582,6,132,132616,53,173,5778,230,3804,79,1640,3853,4344,128812
1793.006,6,256,37643,157,302,11493,302,27222,99,83,18295,83,10421
0.256,6,9,1050,5,261,64,261,465,4,421,69,421,585
8.65,6,12,5538,4,106,2883,106,274,8,822,1194,1460,5264
1777.303,17,142,11360,71,48,25389,48,5396,71,56,25389,56,5964
1133.118,6,149,16878,78,95,14691,721,7720,71,210,16185,1414,9158
1608.177,6,21,3171,14,241,123705,241,2247,7,92,267997,92,924
1759.932,6,118,9711,74,70,24108,274,5639,44,64,40926,247,4072
1.248,6,49,18718,27,853,48,1360,13062,22,476,50,2715,5656
1786.084,1,336,28224,336,56,5331,56,28224,0,0,0,0,0
83.489,6,140,98455,81,1258,1043,1368,87257,59,738,1435,2519,11198
1788.087,6,356,22520,208,69,8638,69,12460,148,69,12163,69,10060
1798.743,17,142,11360,71,48,25696,48,5396,71,56,25696,56,5964
363.789,6,22,1746,16,177,24252,177,1206,6,110,12170,110,540
0.012,17,2,195,1,48,0,48,76,1,91,0,91,119
280.446,6,29,7392,13,158,23370,267,1317,16,603,18693,2076,6075
0.481,17,15,6713,7,505,80,1350,3734,8,344,53,1350,2979
830.28,6,48,4375,31,65,27676,65,2575,17,57,51886,59,1800
1779.188,17,140,11200,70,48,25785,48,5320,70,56,25785,56,5880
0.121,17,2,152,1,48,0,48,76,1,48,0,48,76
0.579,6,28,10122,14,263,44,691,1800,14,948,43,1448,8322
1740.07,6,127,7874,72,43,24508,208,4744,55,31,32219,31,3130
198.002,6,31,2271,12,75,15272,293,1080,19,47,11000,78,1191
1762.71,6,145,14767,86,73,20737,722,7511,59,82,30384,1408,7256
1.352,6,49,19254,27,891,52,1360,13598,22,476,55,2715,5656
1783.168,6,102,8296,68,65,26614,65,4930,34,59,54030,59,3366
2.853,6,36,11562,19,270,152,561,2193,17,964,167,1631,9369
15.764,17,19,12232,11,890,1569,1350,10108,8,237,2241,1350,2124
301.031,6,47,10052,24,398,13088,822,3019,23,406,502,1460,7033
1785.832,6,104,8308,68,64,26654,64,4896,36,58,51021,58,3412
179.434,6,86,56819,51,1200,3588,1368,48262,35,841,1822,2736,8557
56.818,17,4,352,2,60,56817,60,176,2,60,56817,60,176
187.369,6,38,8212,15,130,13383,267,1524,23,338,8515,3417,6688
1770.681,1,152,8512,152,28,11726,28,8512,0,0,0,0,0
0.02,17,4,284,2,32,8,32,120,2,54,7,60,164
1799.69,1,345,28980,345,56,5231,56,28980,0,0,0,0,0
1779.088,17,140,11200,70,48,25783,48,5320,70,56,25783,56,5880
0.159,6,24,7176,12,155,14,267,1261,12,775,13,3445,5915
280.546,6,30,7432,13,158,23378,267,1317,17,543,17525,1400,6115
5.409,6,15,15503,4,229,631,229,409,11,1830,524,2720,15094
1772.415,6,180,15480,120,69,14894,69,8940,60,69,30039,69,6540
26.918,6,3558,3351668,2262,1402,11,1448,3279612,1296,776,20,1448,72056
0.0,1,1,372,1,344,0,344,372,0,0,0,0,0
0.075,17,4,284,2,32,1,32,120,2,54,0,60,164
1775.173,17,73,3060,72,14,25002,14,3024,1,8,0,8,36
1780.011,6,354,22440,207,69,8640,69,12420,147,69,12191,69,10020
1797.75,17,178,13884,178,50,10156,50,13884,0,0,0,0,0
1775.08,17,140,11200,70,48,25725,48,5320,70,56,25725,56,5880
0.027,6,4,160,2,0,12,0,80,2,0,21,0,80
1797.308,17,448,39896,403,35,4470,288,25676,45,288,40018,288,14220
1791.857,1,58,4872,58,56,31436,56,4872,0,0,0,0,0
1743.601,6,100,7729,66,42,26824,205,4786,34,34,52824,98,2943
1760.402,1,45,3780,45,56,40009,56,3780,0,0,0,0,0
12.192,17,10,830,5,47,3046,47,375,5,63,3046,63,455
5.906,6,3,180,3,0,0,0,180,0,0,0,0,0
0.016,17,2,378,1,30,0,30,58,1,292,0,292,320
1776.888,17,73,3060,72,14,25026,14,3024,1,8,0,8,36
0.255,6,22,4442,11,165,25,456,1394,11,493,24,888,3048
0.123,17,2,386,1,46,0,46,74,1,284,0,284,312
1795.882,17,449,39928,404,35,4456,288,25708,45,288,40022,288,14220
0.028,17,2,409,1,58,0,58,86,1,295,0,295,323
1799.993,6,225,23013,86,129,21176,1460,12768,139,66,13043,929,10245
38.908,17,42,6292,21,48,1945,48,1596,21,195,1944,308,4696
31.608,6,7,308,1,0,0,0,44,6,0,6275,0,264
0.086,17,2,2380,2,1162,86,1162,2380,0,0,0,0,0
1.382,6,236,182035,137,1335,10,1420,173784,99,475,14,2840,8251
1744.344,2,25,800,25,8,72681,8,800,0,0,0,0,0
0.058,6,10,1796,6,614,11,1071,1473,4,159,19,159,323
1680.463,1,15,840,15,28,120033,28,840,0,0,0,0,0
1772.549,6,180,15480,120,69,14895,69,8940,60,69,30034,69,6540
0.44,6,20,7151,11,318,42,600,1854,9,964,52,1471,5297
0.068,17,2,170,1,37,0,37,65,1,77,0,77,105
3.189,6,38,18791,22,707,151,1360,5863,16,1364,201,2720,12928
157.457,2,4,128,4,8,52485,8,128,0,0,0,0,0
1773.499,6,186,15927,123,69,14536,69,9129,63,69,28598,69,6798
0.732,6,27,5927,13,156,61,267,1462,14,650,51,1304,4465
1794.794,1,58,4872,58,56,31487,56,4872,0,0,0,0,0
1786.143,17,87,3648,86,14,21013,14,3612,1,8,0,8,36
418.191,2,3,96,3,8,209095,8,96,0,0,0,0,0
1.703,6,25,8777,15,287,121,594,1466,10,986,169,1420,7311
1745.512,6,99,7411,63,38,28153,205,4476,36,33,49859,98,2935
1799.134,17,3928,188544,1964,20,916,20,94272,1964,20,916,20,94272
240.206,6,53,17473,28,778,8896,1418,14706,25,182,10008,580,2767
1785.861,6,418,25096,210,69,8543,69,12540,208,35,8627,69,12556
0.013,17,2,283,1,31,0,31,59,1,196,0,196,224
3.919,6,6,340,3,0,1959,0,160,3,0,1046,0,180
0.617,6,4,220,2,0,617,0,100,2,0,309,0,120
297.398,6,177,59997,72,759,4188,1418,39515,105,318,2859,1418,20482
1771.231,6,104,9566,66,66,27249,66,5610,38,60,47868,60,3956
1.58,6,38,9848,20,502,83,1440,4352,18,433,82,1440,5496
8.637,6,15,4027,9,171,1079,171,854,6,947,1689,1368,3173
1.03,17,9,8444,5,821,257,1350,4246,4,1021,166,1350,4198
0.233,6,4,232,1,0,0,0,52,3,0,116,0,180
100.857,6,25,11478,12,397,81,884,1717,13,1025,8392,1360,9761
1779.013,6,117,13465,77,80,23408,503,5966,40,155,45613,1420,7499
0.018,17,2,290,1,40,0,40,68,1,194,0,194,222
53.438,17,4,1344,4,308,17812,308,1344,0,0,0,0,0
0.008,17,2,435,1,44,0,44,72,1,335,0,335,363
280.319,6,29,7392,14,158,21563,267,1357,15,678,20017,3436,6035
1795.936,17,142,11360,71,48,25656,48,5396,71,56,25656,56,5964
3.868,17,2,152,2,48,3868,48,152,0,0,0,0,0
18.994,6,16,680,7,0,3165,0,292,9,0,2373,0,388
1794.924,1,56,3136,56,28,32634,28,3136,0,0,0,0,0
0.111,6,10,1514,5,503,27,503,771,5,475,27,475,743
582.012,6,128,17123,58,190,10210,1189,6519,70,210,8434,1420,10604
130.09,6,82,58024,52,1203,2550,1368,49645,30,840,2143,2519,8379
1.916,17,2,312,2,128,1916,128,312,0,0,0,0,0
240.532,6,131,81828,61,548,4008,1418,7567,70,1238,3485,1509,74261
280.263,6,29,7392,13,158,23355,267,1317,16,603,18678,2036,6075
1793.261,6,367,23236,212,69,8498,69,12896,155,69,11644,69,10340
1.155,6,57,18006,29,707,41,1360,8977,28,438,42,1360,9029
120.288,2,3,96,3,8,60144,8,96,0,0,0,0,0
11.828,6,25,8453,13,275,985,275,1078,12,983,850,1420,7375
1682.542,17,18,1494,9,31,210311,37,536,9,78,210311,136,958
15.662,17,10,880,5,48,3912,48,380,5,72,3912,72,500
115.283,17,6,2152,6,330,23056,382,2152,0,0,0,0,0
27.481,17,16,1408,8,48,3924,48,608,8,72,3923,72,800
36.148,1,39,4056,0,0,0,0,0,39,76,951,76,4056
0.525,6,25,8398,12,274,47,720,1743,13,995,43,1408,6655
60.273,6,8,432,5,0,15068,0,268,3,0,30017,0,164
89.75,17,4,352,2,60,89749,60,176,2,60,89749,60,176
1383.713,2,12,384,12,8,125792,8,384,0,0,0,0,0
1795.094,17,80,3354,79,14,23014,14,3318,1,8,0,8,36
1.314,6,38,9849,20,503,69,1460,4353,18,433,67,1460,5496
11.635,6,1838,1603327,1112,1385,10,1414,1568511,726,512,15,1889,34816
0.25,6,22,4442,11,165,25,456,1394,11,493,24,888,3048
1739.893,6,87,6322,58,31,30524,31,3915,29,31,62138,31,2407
20.49,6,21,3968,12,240,1862,517,1848,9,411,2560,499,2120
0.009,17,2,548,2,246,9,246,548,0,0,0,0,0
24.459,6,16,2370,10,210,2713,210,972,6,545,4883,904,1398
1.359,6,41,11967,22,613,64,1440,6431,19,433,65,1440,5536
1795.943,6,132,13167,81,67,22449,722,6849,51,85,35915,2026,6318
1787.659,6,102,8228,68,64,26681,64,4896,34,58,54169,58,3332
5.281,6,548,461608,328,1338,15,1368,445504,220,931,23,2736,16104
1786.986,6,102,8296,68,65,26671,65,4930,34,59,54148,59,3366
1790.241,17,87,3648,86,14,21061,14,3612,1,8,0,8,36
10.99,6,20,4442,11,275,1099,275,998,9,768,760,1440,3444
0.075,6,13,5599,8,134,10,134,474,5,4913,18,4913,5125
2.043,17,4,314,2,31,2029,31,118,2,70,2023,70,196
1754.268,6,186,11385,93,47,19068,208,6766,93,31,19065,31,4619
1743.058,1,57,4788,0,0,0,0,0,57,56,31126,56,4788
1783.148,17,83,3480,82,14,22014,14,3444,1,8,0,8,36
0.491,17,3,451,2,39,425,39,134,1,289,0,289,317
0.012,17,2,461,1,34,0,34,62,1,371,0,371,399
240.269,6,45,9082,23,523,10921,1408,5912,22,224,11441,618,3170
1656.407,1,7,392,7,28,276067,28,392,0,0,0,0,0
1754.93,6,95,7203,63,38,28305,205,4476,32,33,56597,98,2727
1791.935,6,373,23614,214,69,8412,69,13114,159,69,11339,69,10500
1742.715,1,72,6048,72,56,24545,56,6048,0,0,0,0,0
0.18,6,48,21399,27,1084,6,1420,16293,21,425,8,1883,5106
563.04,6,59,10230,29,161,20105,517,2981,30,472,19413,1368,7249
300.907,6,36,8316,20,272,15837,744,1922,16,522,583,3488,6394
131.237,6,29,7507,10,155,14581,267,1186,19,396,7290,3417,6321
6.165,6,998,855470,598,1386,10,1420,835249,400,526,15,3303,20221
0.114,6,2,80,1,0,0,0,40,1,0,0,0,40
332.0,17,6,1997,6,304,66400,312,1997,0,0,0,0,0
1787.543,6,367,26685,199,98,9027,469,14652,168,69,10703,69,12033
3.572,17,30,17053,15,698,255,1350,10892,15,382,214,1350,6161
14.732,6,2128,1907803,1316,1363,11,1368,1852483,812,776,17,1473,55320
14.59,6,99,28650,49,545,303,1152,22152,50,408,292,1152,6498
0.388,17,2,212,1,46,0,46,74,1,110,0,110,138
10.022,17,4,300,2,47,10011,47,150,2,47,10011,47,150
297.479,17,4,240,2,32,297477,32,120,2,32,297478,32,120
1740.672,17,29,30624,29,1028,62166,1028,30624,0,0,0,0,0
1789.959,17,137,35141,137,228,13161,422,35141,0,0,0,0,0
373.705,6,23,1535,16,177,24913,177,1053,7,110,10396,110,482
1767.291,1,58,4872,58,56,31005,56,4872,0,0,0,0,0
0.142,6,6,328,4,0,47,0,216,2,0,71,0,112
19.847,6,150,85598,71,1362,283,1440,72437,79,443,233,1440,13161
0.146,17,2,152,1,48,0,48,76,1,48,0,48,76
1796.179,17,142,11360,71,48,25659,48,5396,71,56,25659,56,5964
1.353,6,41,10025,22,502,64,1460,4444,19,400,65,1460,5581
8.373,6,6,340,2,0,8373,0,100,4,0,2126,0,240
0.406,6,7,716,4,226,135,226,442,3,110,105,110,274
6.513,17,2,672,2,308,6513,308,672,0,0,0,0,0
1.024,17,5,332,3,32,511,32,180,2,48,941,48,152
1.002,6,30,12906,17,529,62,1440,3370,13,1000,68,3841,9536
300.56,6,17,1175,6,177,60077,177,497,11,110,30038,110,678
0.059,17,2,144,1,36,0,36,64,1,52,0,52,80
0.396,17,24,15628,13,795,30,1350,10700,11,420,36,1350,4928
3.927,6,34,6169,18,206,231,314,2784,16,548,242,1179,3385
1763.062,17,70,23488,70,307,25551,308,23488,0,0,0,0,0
1798.062,17,142,11360,71,48,25686,48,5396,71,56,25686,56,5964
279.991,1,4,224,4,28,93330,28,224,0,0,0,0,0
1.239,6,35,8063,20,456,65,1408,5624,15,206,88,580,2439
1718.731,1,32,1792,32,28,55442,28,1792,0,0,0,0,0
0.565,6,28,9113,13,253,47,653,1710,15,825,36,1368,7403
280.616,6,28,7352,12,158,25510,267,1277,16,603,18702,1400,6075
1799.444,1,345,28980,345,56,5230,56,28980,0,0,0,0,0
112.504,6,107,74017,64,1255,1785,1448,63621,43,679,2674,1448,10396
0.17,17,5,1766,5,325,42,354,1766,0,0,0,0,0
1.683,6,867,681288,419,183,4,230,23161,448,1423,3,4224,658127
37.944,17,22,1672,22,48,1806,48,1672,0,0,0,0,0
39.968,17,12,912,12,48,3633,48,912,0,0,0,0,0
148.29,1,36,3744,0,0,0,0,0,36,76,4236,76,3744
0.055,17,2,396,1,32,0,32,60,1,308,0,308,336
0.249,6,20,4960,10,137,27,267,1092,10,692,25,1467,3868
86.831,17,4,352,2,60,86830,60,176,2,60,86830,60,176
1787.578,6,108,8536,68,65,26680,65,4930,40,59,45832,59,3606
2.374,6,22,9438,10,371,263,517,1686,12,888,207,1303,7752
0.628,6,14,1745,7,288,73,288,600,7,426,73,434,1145
0.02,17,2,156,1,42,0,42,70,1,58,0,58,86
6.486,6,15,6018,4,106,2162,106,274,11,588,647,1997,5744
1.823,17,49,36935,20,438,95,1350,9338,29,923,58,1350,27597
1738.791,6,135,8464,74,47,23819,208,5032,61,31,28974,31,3432
1790.199,17,496,72706,242,189,7428,1350,52703,254,50,7070,1350,20003
1.274,6,12,1048,6,256,251,256,500,6,304,251,304,548
935.969,1,20,1120,20,28,49261,28,1120,0,0,0,0,0
1784.775,6,265,36662,109,178,16524,1360,20280,156,133,11513,2720,16382
15.866,17,19,12289,11,903,1580,1350,10250,8,226,2255,1350,2039
3.804,6,2,88,2,0,0,0,88,0,0,0,0,0
1786.381,6,109,8729,69,48,26270,205,5250,40,36,45796,98,3479
0.974,17,16,6713,8,480,139,1350,4066,8,302,124,1350,2647
440.179,6,57,3810,23,46,20008,46,1668,34,46,13334,46,2142
2.934,17,2,1430,2,687,2934,687,1430,0,0,0,0,0
0.989,6,10,1687,7,100,164,100,384,3,1179,362,1179,1303
3.015,6,11,2247,6,145,603,145,389,5,827,751,827,1858
1.948,6,5,338,1,0,0,0,40,4,69,609,69,298
1786.497,6,233,24114,116,105,15534,1040,13021,117,182,15398,1440,11093
2.01,17,2,116,2,30,2010,30,116,0,0,0,0,0
300.118,6,39,9638,20,648,15786,1440,4076,19,399,16663,1440,5562
251.37,6,104,10494,86,138,515,174,3996,18,412,14781,1420,6498
2.122,6,29,10365,17,367,132,833,1785,12,1012,184,1420,8580
1776.298,17,73,3060,72,14,25018,14,3024,1,8,0,8,36
1681.387,17,16,1274,8,30,240197,37,471,8,72,240197,136,803
1.101,17,8,704,4,37,364,37,260,4,83,364,89,444
0.016,6,12,3704,6,171,3,171,491,6,964,2,1448,3213
1.451,6,49,18829,29,856,51,1360,13208,20,437,64,2715,5621
0.259,17,3,451,2,39,96,39,134,1,289,0,289,317
1798.832,6,377,26257,217,98,8327,469,15303,160,69,11310,69,10954
1.537,6,40,14372,22,806,73,1188,10013,18,341,85,524,4359
87.461,6,20,2521,11,324,8746,585,1237,9,396,10927,580,1284
280.395,6,28,7352,13,158,23366,267,1317,15,603,20025,2076,6035
0.011,17,2,322,1,33,0,33,61,1,233,0,233,261
81.18,6,20,820,9,0,5893,0,364,11,0,8117,0,456
1719.447,17,12,498,11,14,171944,14,462,1,8,0,8,36
301.364,6,99,69787,63,1270,4860,1360,63545,36,435,260,2720,6242
11.562,6,25,8453,13,275,963,275,1078,12,983,749,1420,7375
115.179,17,6,528,3,48,57585,48,228,3,72,57585,72,300
1789.747,6,139,10664,78,86,23243,208,7263,61,31,29825,31,3401
1.201,6,25,8056,12,164,92,267,1288,13,869,85,1408,6768
0.044,17,2,180,1,30,0,30,58,1,94,0,94,122
1.38,6,2,303,1,211,0,211,263,1,0,0,0,40
14.993,6,12,978,4,106,4997,106,274,8,90,2133,90,704
1783.806,6,356,22920,208,75,8617,469,12860,148,69,12134,69,10060
0.16,6,12,3462,6,75,32,75,395,6,1373,31,1448,3067
0.219,6,10,1379,5,145,54,145,349,5,826,35,826,1030
1777.908,1,75,6300,0,0,0,0,0,75,56,24025,56,6300
4.521,6,38,7229,19,218,251,314,3383,19,440,237,1152,3846
1770.838,6,101,9410,66,66,27243,66,5610,35,60,52080,60,3800
6.327,17,4,352,2,60,6326,60,176,2,60,6326,60,176
1799.677,6,372,27464,217,116,8331,469,16572,155,69,11686,69,10892
197.63,17,4,352,2,60,197629,60,176,2,60,197629,60,176
80.336,6,75,49126,45,1202,1825,1448,40836,30,746,2124,1448,8290
1758.039,6,4595,4430024,1545,133,1138,346,92310,3050,1404,576,2836,4337714
0.047,6,7,423,4,43,3,43,259,3,0,22,0,164
1.369,6,24,8004,12,164,105,267,1288,12,1014,107,2491,6716
240.226,6,53,17523,28,780,8897,1402,14739,25,184,10009,580,2784
0.434,6,12,1653,6,288,80,288,548,6,426,47,434,1105
443.885,1,21,1176,21,28,22194,28,1176,0,0,0,0,0
0.413,6,28,7482,17,306,25,1089,2828,11,701,40,2840,4654
13.718,17,8,704,4,48,4568,48,304,4,72,4568,72,400
1787.1,17,87,3648,86,14,21024,14,3612,1,8,0,8,36
1788.198,17,87,3648,86,14,21037,14,3612,1,8,0,8,36
280.386,6,30,7432,13,158,23365,267,1317,17,543,17517,1400,6115
0.035,17,2,303,1,53,0,53,81,1,194,0,194,222
1787.145,6,104,8376,68,65,26673,65,4930,36,59,51057,59,3446
2.07,6,29,10388,17,373,129,851,1803,12,1012,180,1420,8585
1791.494,1,342,28728,342,56,5253,56,28728,0,0,0,0,0
49.373,6,47,7605,19,201,705,314,3383,28,516,1819,1179,4222
161.113,17,4,530,2,36,161108,36,128,2,173,161109,187,402
25.627,17,38,7884,18,228,1505,1350,4617,20,135,1347,1350,3267
6.119,6,41,7349,21,218,305,314,3463,20,513,308,1179,3886
11.267,6,26,11958,13,275,938,275,1078,13,1293,893,1414,10880
1775.063,1,61,5124,0,0,0,0,0,61,56,29584,56,5124
0.598,6,26,9059,13,268,49,711,1756,13,945,45,1368,7303
1772.289,6,180,15480,120,69,14893,69,8940,60,69,30037,69,6540
1746.044,6,97,7307,63,38,28162,205,4476,34,33,52898,98,2831
1019.313,2,9,288,9,8,127414,8,288,0,0,0,0,0
15.002,17,4,304,2,48,14994,48,152,2,48,14994,48,152
147.316,17,4,272,2,40,147315,47,136,2,40,147314,47,136
2.986,6,38,20612,20,686,157,1440,5651,18,1185,160,1440,14961
69.043,17,4,558,2,36,69034,36,128,2,187,69038,187,430
0.162,6,25,7216,12,155,14,267,1261,13,678,12,2045,5955
1799.587,17,765,46134,765,32,2355,37,46134,0,0,0,0,0
0.629,6,14,1745,7,288,75,288,600,7,426,75,434,1145
1786.413,6,102,8364,68,66,26662,66,4964,34,60,54131,60,3400
0.298,17,2,167,1,39,0,39,67,1,72,0,72,100
1.773,17,2,241,1,36,0,36,64,1,149,0,149,177
316.981,6,103,34376,55,518,5870,1360,23519,48,343,6741,3289,10857
5.524,6,527,465639,332,1338,16,1368,450823,195,931,27,2736,14816
130.356,6,21,6511,9,275,16294,275,639,12,598,11650,1420,5872
6.247,6,41,7349,22,218,297,314,3503,19,513,332,1179,3846
543.347,1,16,896,16,28,36223,28,896,0,0,0,0,0
1779.557,17,140,11200,70,48,25790,48,5320,70,56,25790,56,5880
280.627,6,30,7432,13,158,23385,267,1317,17,603,17534,2076,6115
74.865,6,23,9929,11,433,67,990,1771,12,958,6793,1460,8158
1794.922,1,58,4872,58,56,31489,56,4872,0,0,0,0,0
1770.798,6,152,20724,90,185,19896,827,13060,62,94,29028,234,7664
0.321,6,28,9123,13,247,26,624,1672,15,832,20,1408,7451
1798.144,17,448,39896,403,35,4472,288,25676,45,288,40017,288,14220
1.657,6,27,10174,16,284,110,584,1496,11,1029,149,1420,8678
4.609,17,2,2195,2,1069,4609,1444,2195,0,0,0,0,0
280.425,6,29,7392,13,158,23368,267,1317,16,603,18692,2076,6075
1788.866,6,357,22629,209,69,8600,69,12569,148,69,12169,69,10060
0.281,17,8,2758,8,316,40,355,2758,0,0,0,0,0
1.685,6,49,18702,27,852,64,1360,13046,22,433,70,1360,5656
0.09,17,2,158,1,34,0,34,62,1,68,0,68,96
1776.069,6,99,9174,66,64,27324,64,5544,33,58,55499,58,3630
12.113,6,1906,1668149,1156,1387,10,1420,1633928,750,420,16,1420,34221
1798.935,17,142,11360,71,48,25698,48,5396,71,56,25698,56,5964
4.92,17,4,530,2,36,4915,36,128,2,173,4915,187,402
3.711,1,2,163,2,53,3711,78,163,0,0,0,0,0
194.132,17,4,240,2,32,194131,32,120,2,32,194131,32,120
0.321,6,23,5928,12,164,29,453,1442,11,781,31,2224,4486
1796.804,17,448,39896,403,35,4469,288,25676,45,288,40017,288,14220
398.784,17,8,2045,4,31,132926,37,239,4,423,132926,463,1806
565.38,6,119,13209,64,88,8111,267,4594,55,228,10469,1420,8615
2.638,6,11,631,5,43,659,43,311,6,0,519,0,320
0.015,6,9,12040,1,0,0,0,40,8,1448,2,1448,12000
1799.981,17,449,39928,404,35,4466,288,25708,45,288,40018,288,14220
1745.653,6,95,7203,63,38,28155,205,4476,32,33,56304,98,2727
1785.253,6,102,8296,68,65,26645,65,4930,34,59,54095,59,3366
13.013,17,4,352,2,48,12999,48,152,2,72,12992,72,200
48.69,17,4,352,2,60,48689,60,176,2,60,48689,60,176
0.399,6,7,295,4,0,133,0,164,3,7,105,7,131
1797.82,1,16,896,16,28,119854,28,896,0,0,0,0,0
1793.568,1,58,4872,0,0,0,0,0,58,56,31466,56,4872
182.318,6,3054,3079538,988,714,184,1396,64988,2066,1420,88,4188,3014550
10.117,6,1509,1385670,979,1364,10,1420,1360167,530,427,19,1420,25503
1772.511,6,180,15480,120,69,14895,69,8940,60,69,30036,69,6540
6.289,6,27,9103,15,261,449,672,1688,12,865,555,1460,7415
68.768,6,697,333774,374,826,184,1152,315690,323,396,212,1152,18084
40.754,6,28,7217,13,155,3396,267,1306,15,482,2910,1997,5911
8.207,6,98,34111,58,555,140,1360,24610,40,375,206,1360,9501
719.032,2,5,160,5,8,179758,8,160,0,0,0,0,0
12.098,6,6,328,4,0,4032,0,216,2,0,11867,0,112
515.547,1,30,1680,30,28,17777,28,1680,0,0,0,0,0
289.043,1,8,448,8,28,41291,28,448,0,0,0,0,0
5.033,17,4,288,2,36,5002,36,128,2,52,4985,52,160
1785.151,6,359,22709,209,69,8582,69,12569,150,69,11979,69,10140
1798.194,17,365,103854,365,256,4940,422,103854,0,0,0,0,0
7.833,17,4,1344,4,308,2611,308,1344,0,0,0,0,0
5.102,6,38,7229,19,218,283,314,3383,19,513,268,1179,3846
0.551,6,23,7397,13,334,45,663,2033,10,967,56,1471,5364
92.836,17,6,528,3,48,46413,48,228,3,72,46413,72,300
0.974,6,31,12846,16,522,64,1460,3298,15,812,56,1460,9548
1779.741,17,140,11200,70,48,25793,48,5320,70,56,25793,56,5880
0.084,17,2,218,1,65,0,65,93,1,97,0,97,125
7.639,6,18,1415,9,222,947,222,808,9,231,948,231,607
1786.473,6,363,24345,211,88,8507,469,13987,152,69,11830,69,10358
0.066,6,3,156,0,0,0,0,0,3,0,0,0,156
8.482,6,77,24573,40,559,217,1152,18936,37,461,228,1179,5637
185.543,17,4,240,2,32,185542,32,120,2,32,185542,32,120
1769.81,6,101,9410,66,66,27227,66,5610,35,60,52050,60,3800
42.871,17,37,2793,21,40,2133,41,1439,16,56,2849,57,1354
0.998,17,4,764,2,36,984,36,128,2,290,972,318,636
1770.972,6,105,6270,60,27,30015,27,3525,45,27,40248,27,2745
2.818,17,2,178,1,29,0,29,57,1,93,0,93,121
76.03,6,29,7392,14,158,5848,267,1357,15,678,5427,3436,6035
2.255,17,2,142,1,35,0,35,63,1,51,0,51,79
0.97,6,105,128928,48,288,20,912,4330,57,2338,17,5632,124598
1779.559,1,342,28728,342,56,5218,56,28728,0,0,0,0,0
183.753,6,95,67852,58,1242,3223,1368,58934,37,840,1742,2519,8918
0.295,6,21,5000,9,137,36,267,1052,12,577,26,1400,3948
1787.144,6,103,8336,68,65,26673,65,4930,35,59,52559,59,3406
1782.47,6,369,24723,213,87,8407,469,14205,156,69,11496,69,10518
50.495,6,45,8848,22,345,694,720,2019,23,368,2289,3488,6829
1796.96,17,448,39896,403,35,4470,288,25676,45,288,40017,288,14220
68.906,6,85,7809,67,188,1044,516,4004,18,308,4046,1452,3805
1787.801,1,285,15960,285,28,6295,28,15960,0,0,0,0,0
16.069,6,2007,1760818,1232,1372,13,1380,1722284,775,421,20,1923,38534
280.198,6,26,7272,13,158,23349,267,1317,13,905,23346,4845,5955
271.033,6,23,6879,6,154,54206,267,712,17,421,16935,1420,6167
240.421,6,60,18537,31,814,8013,1418,15462,29,194,8584,580,3075
1.511,6,41,11378,22,547,71,1360,5842,19,476,71,2715,5536
1785.044,6,128,9716,75,64,24122,64,5624,53,58,34303,58,4092
41.904,17,24,1824,24,48,1821,48,1824,0,0,0,0,0
1787.91,6,362,23105,208,69,8637,69,12598,154,69,11685,69,10507
178.52,6,271,425091,88,235,2051,905,6689,183,2349,920,9814,418402
1740.595,6,140,9049,77,53,22902,208,5630,63,31,28068,31,3419
1798.681,17,448,39896,403,35,4474,288,25676,45,288,40018,288,14220
1744.309,6,96,9217,69,81,25651,138,6279,27,68,31495,69,2938
11.356,6,1658,1543022,1089,1365,10,1432,1515971,569,475,19,1871,27051
1690.977,17,18,6080,18,309,99469,1438,6080,0,0,0,0,0
1763.923,2,15,480,15,8,125994,8,480,0,0,0,0,0
1778.581,6,180,15480,120,69,14946,69,8940,60,69,30137,69,6540
1790.831,1,339,28476,339,56,5298,56,28476,0,0,0,0,0
3.234,6,2,88,2,0,0,0,88,0,0,0,0,0
0.022,6,10,1796,6,614,4,1071,1473,4,159,7,159,323
8.913,17,4,1344,4,308,2971,308,1344,0,0,0,0,0
252.574,2,2,64,2,8,252574,8,64,0,0,0,0,0
0.313,17,8,2766,8,317,44,356,2766,0,0,0,0,0
155.407,17,4,240,2,32,155406,32,120,2,32,155406,32,120
1771.242,6,105,9552,66,65,27249,65,5577,39,59,46609,59,3975
300.312,6,106,106493,73,145,4171,230,4544,33,3456,9384,14080,101949
16.146,17,23,16349,10,571,1783,1350,5994,13,768,1336,1350,10355
142.543,6,22,8232,11,538,95,1309,2088,11,948,14235,1591,6144
0.122,17,2,2382,2,1163,122,1163,2382,0,0,0,0,0
2.684,17,4,624,4,128,894,128,624,0,0,0,0,0
1.09,6,30,10120,15,232,76,569,1730,15,950,76,1438,8390
1319.763,6,112,12744,61,76,20145,722,5562,51,113,26391,1448,7182
1.183,6,25,8080,12,164,91,267,1312,13,869,84,1408,6768
1690.3,1,8,848,8,78,241471,78,848,0,0,0,0,0
16.072,6,2073,1637195,1143,1376,14,1420,1591911,930,474,17,1420,45284
17.832,6,1405,1164804,812,1377,21,1420,1135917,593,475,30,1883,28887
69.664,17,4,1344,4,308,23221,308,1344,0,0,0,0,0
1781.176,6,102,8296,68,65,26584,65,4930,34,59,53972,59,3366
1.31,17,12,6381,6,615,262,1350,3860,6,392,196,1350,2521
5.261,6,11,2070,8,241,751,241,1766,3,92,94,92,304
48.12,6,28,7217,13,155,4010,267,1306,15,482,3436,2840,5911
644.907,17,7,845,7,92,107484,355,845,0,0,0,0,0
300.682,6,38,8566,20,315,15825,882,2093,18,441,501,1460,6473
0.901,6,10,1687,7,100,150,100,384,3,1179,310,1179,1303
1786.258,17,73,3060,72,14,25158,14,3024,1,8,0,8,36
1053.888,6,216,13884,119,69,8931,69,7313,97,69,10977,69,6571
1741.366,6,87,6322,58,31,30550,31,3915,29,31,62191,31,2407
5.143,17,3,208,2,36,5002,36,128,1,52,0,52,80
0.512,17,15,8133,7,657,78,1350,4796,8,389,61,1350,3337
0.927,6,10,1687,7,100,154,100,384,3,1179,338,1179,1303
1.451,6,25,8056,12,164,108,267,1288,13,869,104,1448,6768
356.726,6,203,54506,102,509,3530,509,29574,101,435,3565,435,24932
1.282,17,17,8547,8,657,183,1350,5481,9,312,120,1350,3066
1.918,17,3,1167,3,361,959,361,1167,0,0,0,0,0
1799.038,6,362,22898,210,69,8607,69,12678,152,69,11914,69,10220
1.012,17,4,678,3,32,499,32,180,1,470,0,470,498
240.267,6,50,9625,25,523,10010,1408,6029,25,228,10010,617,3596
0.259,17,4,352,2,60,258,60,176,2,60,258,60,176
228.841,6,181,137845,112,1318,2061,1448,123213,69,612,3309,2359,14632
1.339,6,37,9808,21,440,66,1360,4392,16,529,77,4075,5416
0.805,6,17,5132,9,150,100,174,664,8,828,103,1420,4468
1.864,6,42,8642,22,321,88,1168,2866,20,413,86,2720,5776
2.159,6,5,284,2,0,9,0,104,3,0,1079,0,180
1798.454,1,345,28980,345,56,5228,56,28980,0,0,0,0,0
42.697,17,46,3493,25,40,1771,41,1715,21,56,2132,57,1778
1796.934,17,448,39896,403,35,4469,288,25676,45,288,40015,288,14220
96.609,6,18,1532,6,180,134,180,680,12,110,8765,110,852
0.502,6,14,1733,7,288,80,288,588,7,426,45,434,1145
1791.785,6,112,10556,72,71,25236,233,6317,40,59,45940,82,4239
0.005,6,4,483,3,143,0,256,443,1,0,0,0,40
7.036,6,12,3713,5,171,1757,171,439,7,964,1172,1448,3274
1791.579,6,360,24156,210,88,8572,469,13878,150,69,12022,69,10278
1.94,17,25,10241,11,485,194,1350,5649,14,300,132,1350,4592
0.156,17,2,304,1,60,0,60,88,1,188,0,188,216
1799.925,17,136,10880,68,48,26864,48,5168,68,56,26864,56,5712
0.056,17,3,196,2,32,0,32,120,1,48,0,48,76
1773.392,6,180,15480,120,69,14902,69,8940,60,69,30049,69,6540
284.635,6,38,8434,16,158,18975,267,1437,22,509,13553,1400,6997
17.731,6,2895,2659382,1836,1368,9,1408,2599650,1059,931,16,2801,59732
0.818,6,2,92,1,0,0,0,40,1,0,0,0,52
5.807,6,44,8385,22,227,276,314,4062,22,491,264,1179,4323
69.088,6,30,7297,14,155,5314,267,1346,16,441,4605,1420,5951
6.796,6,14,3503,6,188,1359,245,620,8,1279,934,1407,2883
240.187,6,59,17980,30,784,8282,1402,14904,29,222,8577,580,3076
1783.167,17,83,3480,82,14,22014,14,3444,1,8,0,8,36
1787.362,6,4057,4074729,1395,131,1282,351,86578,2662,1486,671,4206,3988151
3.26,6,14,1822,9,304,407,304,1388,5,83,801,83,434
0.027,6,9,1880,5,910,6,910,1178,4,486,8,486,702
375.222,17,76,5776,76,48,5002,48,5776,0,0,0,0,0
834.284,6,64,9474,40,98,21391,501,3380,24,244,36269,1420,6094
4.226,6,38,7229,19,218,234,314,3383,19,513,220,1179,3846
1668.843,1,7,392,7,28,278140,28,392,0,0,0,0,0
11.46,6,2274,1927527,1264,1428,8,1448,1861351,1010,776,11,1448,66176
3.173,6,12,507,7,0,528,0,288,5,7,713,7,219
17.366,17,25,7644,11,357,1733,1350,4236,14,215,1333,1350,3408
265.422,6,19,4503,8,272,335,516,1140,11,364,26515,1452,3363
0.164,17,2,188,1,58,0,58,86,1,74,0,74,102
120.329,2,2,64,2,8,120329,8,64,0,0,0,0,0
15.214,17,17,11924,8,821,2168,1350,6798,9,541,1897,1350,5126
280.443,6,30,7432,13,158,23370,267,1317,17,603,17524,2076,6115
1787.651,6,358,22669,209,69,8594,69,12569,149,69,12078,69,10100
36.08,6,2,104,2,0,0,0,104,0,0,0,0,0
1786.54,6,104,8308,68,64,26664,64,4896,36,58,51041,58,3412
286.147,6,34,8956,13,158,23845,267,1317,21,485,14300,1400,7639
0.408,6,12,1653,6,288,78,288,548,6,426,48,434,1105
301.265,6,110,64973,59,1323,5194,1440,58038,51,325,192,1440,6935
12.144,17,10,845,5,34,3034,34,310,5,79,3034,79,535
1.956,17,22,5698,22,231,93,388,5698,0,0,0,0,0
280.028,6,28,7352,13,158,23335,267,1317,15,678,20000,4200,6035
81.306,6,24,9749,12,648,80,1460,3106,12,1025,7374,2035,6643
1.013,17,4,644,2,33,970,33,122,2,233,0,233,522
0.396,6,13,1693,7,288,64,288,588,6,426,44,434,1105
3.359,17,2,656,2,300,3359,300,656,0,0,0,0,0
1685.108,17,16,1265,8,30,240720,37,471,8,71,240723,136,794
0.286,17,3,660,2,46,4,46,148,1,484,0,484,512
0.612,6,28,9150,13,261,51,683,1728,15,829,38,1448,7422
9.474,6,29,7402,16,380,631,885,3491,13,645,774,1767,3911
1789.137,17,142,11360,71,48,25559,48,5396,71,56,25559,56,5964
0.02,17,2,167,1,39,0,39,67,1,72,0,72,100
94.642,6,138,104848,86,1279,1113,1368,94016,52,738,1738,2519,10832
125.425,6,16,3249,8,92,17917,92,504,8,387,17891,1408,2745
111.529,6,27,12890,13,659,92,1460,3880,14,937,8569,1460,9010
243.391,6,48,6940,20,290,12809,582,3395,28,229,9013,580,3545
24.44,1,2,208,2,76,24440,76,208,0,0,0,0,0
33.365,6,81,25277,39,582,878,1152,19040,42,413,807,1179,6237
192.551,17,4,352,2,60,192550,60,176,2,60,192550,60,176
1740.882,1,112,6272,112,28,15683,28,6272,0,0,0,0,0
1618.189,6,24,3624,16,241,107879,241,2568,8,92,231142,92,1056
1.527,17,22,13769,11,740,152,1350,8457,11,454,144,1350,5312
0.227,6,2,80,1,0,0,0,40,1,0,0,0,40
8.252,17,28,12154,12,321,750,1350,4198,16,469,337,1350,7956
1698.781,1,64,3584,64,28,26964,28,3584,0,0,0,0,0
20.209,6,177,116578,96,1094,212,1360,50087,81,1289,250,3593,66491
301.455,6,46,26440,26,804,12058,1408,8597,20,1399,1462,7023,17843
23.319,17,3,195,3,37,11659,47,195,0,0,0,0,0
4.053,6,2,88,2,0,0,0,88,0,0,0,0,0
168.495,17,4,352,2,60,168494,60,176,2,60,168494,60,176
2.87,2,2,64,2,8,2870,8,64,0,0,0,0,0
369.582,6,18,1242,14,180,28429,180,916,4,110,20066,110,326
13.462,6,20,4803,11,189,1346,453,1317,9,603,1336,1448,3486
0.073,17,2,650,1,308,0,308,336,1,286,0,286,314
0.2,6,16,5835,8,290,28,517,1005,8,1101,24,1418,4830
1779.17,1,230,12880,230,28,7769,28,12880,0,0,0,0,0
147.243,17,4,240,2,32,147242,32,120,2,32,147242,32,120
4.483,6,23,5271,12,351,407,1382,2242,11,430,420,1460,3029
1788.522,6,367,23374,213,69,8436,69,12867,154,69,11687,69,10507
0.975,6,10,861,5,222,240,222,426,5,231,240,231,435
1.824,6,72,55054,46,1261,40,1408,47797,26,1179,66,3819,7257
0.344,6,27,9069,13,261,28,683,1728,14,943,26,1408,7341
11.785,6,19,4362,11,275,1178,275,998,8,758,1537,1420,3364
0.497,6,10,968,5,256,113,256,460,5,304,115,304,508
0.385,17,2,136,1,32,0,32,60,1,48,0,48,76
180.452,2,3,96,3,8,90226,8,96,0,0,0,0,0
126.062,6,33,7826,12,155,29,267,1266,21,357,6302,3417,6560
1771.115,6,101,9278,66,64,27247,64,5544,35,58,52088,58,3734
0.176,6,11,1170,6,135,31,135,379,5,587,39,587,791
0.242,17,2,2384,2,1164,242,1164,2384,0,0,0,0,0
2.148,6,11,1095,5,177,537,177,445,6,110,339,110,650
143.778,6,52,12282,17,290,2855,469,3880,35,225,4228,1420,8402
1375.17,6,274,17377,159,69,8703,69,9603,115,69,12062,69,7774
5.093,6,40,7325,21,218,254,314,3463,19,516,268,1179,3862
1745.773,6,95,7203,63,38,28157,205,4476,32,33,56301,98,2727
0.282,17,2,588,1,39,0,39,67,1,493,0,493,521
1789.812,6,142,10700,78,83,23242,208,7055,64,31,28406,31,3645
300.772,6,39,16580,20,195,15830,431,1876,19,856,3646,1448,14704
1022.733,2,8,256,8,8,146104,8,256,0,0,0,0,0
82.249,17,4,352,2,60,82248,60,176,2,60,82248,60,176
1.015,17,4,1116,2,32,860,32,120,2,470,0,470,996
0.224,17,2,572,1,39,0,39,67,1,477,0,477,505
9.0,17,2,144,2,44,9000,44,144,0,0,0,0,0
280.045,6,32,7512,15,158,20003,267,1397,17,543,17499,1400,6115
1798.314,17,448,39896,403,35,4473,288,25676,45,288,40022,288,14220
1772.727,6,360,27695,204,111,8410,965,14961,156,92,11436,485,12734
280.057,6,30,7432,14,158,21542,267,1357,16,603,18666,2800,6075
1.135,6,28,7352,13,158,94,267,1317,15,603,80,2800,6035
512.001,6,6,861,6,103,102400,138,861,0,0,0,0,0
1772.422,6,180,15480,120,69,14894,69,8940,60,69,30033,69,6540
0.182,6,26,7256,13,155,15,267,1301,13,603,14,2036,5955
9.609,17,4,240,2,32,9608,32,120,2,32,9608,32,120
241.288,6,51,7193,23,250,10965,585,3736,28,165,8935,580,3457
1783.543,6,356,22520,208,69,8616,69,12460,148,69,12130,69,10060
1745.092,6,96,7286,63,38,28146,205,4476,33,33,54523,98,2810
1786.32,17,265,54876,265,179,6766,358,54876,0,0,0,0,0
10.923,6,20,4442,11,275,1092,275,998,9,768,766,1440,3444
3.003,17,2,237,1,72,0,72,100,1,109,0,109,137
0.095,6,13,3565,6,126,18,126,446,7,1373,15,1448,3119
20.308,6,20,5366,12,107,1846,159,1074,8,967,2894,1709,4292
154.152,6,29,15746,18,973,47,1360,8540,11,1350,15398,4445,7206
1792.198,17,142,11360,71,48,25602,48,5396,71,56,25602,56,5964
281.377,6,32,7650,13,158,23448,267,1317,19,464,15609,1400,6333
117.554,6,81,57546,51,1226,2351,1368,49251,30,747,2146,1368,8295
1772.233,6,180,15480,120,69,14892,69,8940,60,69,30036,69,6540
397.615,6,31,6759,13,186,9868,501,1455,18,305,23383,1420,5304
1699.513,17,12,498,11,14,169951,14,462,1,8,0,8,36
1.586,6,50,19073,27,876,61,1360,13377,23,433,62,1360,5696
0.174,6,10,582,5,42,43,42,310,5,0,38,0,272
0.994,17,4,314,2,31,962,31,118,2,70,963,70,196
1796.29,6,183,16138,122,75,14845,469,9489,61,69,29934,69,6649
11.612,6,1816,1597214,1105,1389,10,1420,1564553,711,467,16,1883,32661
1789.564,17,142,11360,71,48,25565,48,5396,71,56,25565,56,5964
1790.177,6,357,22629,208,69,8648,69,12460,149,69,12095,69,10169
1779.127,17,140,11200,70,48,25784,48,5320,70,56,25784,56,5880
99.111,6,21,8224,11,549,87,1309,2120,10,948,10993,1591,6104
48.784,6,44,10351,22,723,439,1360,4576,22,348,2315,2720,5775
0.046,17,2,136,1,32,0,32,60,1,48,0,48,76
88.03,6,131,102336,84,1285,1060,1368,91768,47,737,1808,2519,10568
12.065,6,9,376,5,0,3014,0,204,4,0,4015,0,172
1799.998,6,209,14444,77,46,23291,46,6082,132,46,13740,46,8362
1789.957,6,367,25581,214,100,8403,469,14976,153,69,11776,69,10605
165.793,17,6,525,3,32,82874,37,181,3,86,82855,136,344
2.512,17,4,1556,4,361,837,361,1556,0,0,0,0,0
1787.322,6,104,8308,68,64,26676,64,4896,36,58,51064,58,3412
1770.734,1,60,5040,60,56,30012,56,5040,0,0,0,0,0
4.981,17,4,558,2,36,4976,36,128,2,187,4976,187,430
1743.053,1,58,4872,0,0,0,0,0,58,56,30579,56,4872
212.176,6,28,6508,11,215,5573,500,1307,17,322,13256,1420,5201
656.97,6,64,7614,32,93,21192,721,3076,32,130,19258,1448,4538
1772.513,6,202,22250,130,75,13740,267,10057,72,136,24960,3417,12193
1729.486,6,60,4400,40,33,44345,33,2740,20,31,91010,31,1660
1791.43,1,178,9968,178,28,10121,28,9968,0,0,0,0,0
822.594,17,30,4292,15,48,58756,48,1140,15,182,58756,308,3152
3.279,6,2,88,2,0,0,0,88,0,0,0,0,0
357.782,6,71,11648,32,151,11535,721,4320,39,320,9410,1440,7328
163.12,6,114,127188,80,430,2064,647,5506,34,3867,2003,16896,121682
8.493,1,9,756,9,56,1061,56,756,0,0,0,0,0
0.933,6,11,1727,7,100,155,100,384,4,589,220,1152,1343
1.281,17,2,782,2,363,1281,363,782,0,0,0,0,0
1798.04,6,200,20810,104,83,17456,721,8999,96,153,18923,1440,11811
0.029,6,18,6108,10,88,3,88,556,8,1305,4,1880,5552
1279.016,1,14,784,14,28,98385,28,784,0,0,0,0,0
9.242,6,16,3269,6,92,1848,92,400,10,579,1002,2026,2869
17.88,6,12,1475,5,595,4470,595,875,7,212,2972,212,600
155.468,17,4,240,2,32,155467,32,120,2,32,155467,32,120
1800.0,6,211,16232,79,68,23076,293,7724,132,48,13739,78,8508
11.895,6,29,7402,16,380,793,885,3491,13,645,973,1767,3911
366.998,6,18,1242,14,180,28230,180,916,4,110,20055,110,326
1794.865,6,384,27144,220,102,8195,469,16099,164,69,11010,69,11045
32.321,6,497,492878,164,138,198,336,8942,333,1418,97,2836,483936
0.54,17,2,158,1,34,0,34,62,1,68,0,68,96
51.647,6,23,5323,9,179,6455,722,1562,14,431,3945,2026,3761
285.273,6,29,6554,16,290,19016,517,1421,13,1115,23770,2457,5133
280.437,6,31,7472,13,158,23369,267,1317,18,543,16493,1380,6155
1797.773,1,345,28980,345,56,5226,56,28980,0,0,0,0,0
22.866,17,4,352,2,48,22642,48,152,2,72,22852,72,200
1796.615,1,236,13216,236,28,7645,28,13216,0,0,0,0,0
0.297,6,13,2735,7,221,49,517,1270,6,381,42,499,1465
0.177,6,10,2046,6,739,35,1322,1723,4,159,58,159,323
1745.652,6,250,24234,126,136,13965,208,18313,124,31,14189,31,5921
76.777,6,35,10035,12,155,125,267,1266,23,435,3489,1420,8769
7.018,6,67,20646,34,559,212,1152,15899,33,489,211,1179,4747
1.293,6,24,6684,13,360,107,1137,2324,11,783,128,1420,4360
0.043,17,5,738,3,60,6,60,264,2,209,22,230,474
76.727,6,128,99707,82,1267,947,1368,89189,46,738,1699,2519,10518
78.581,6,65,13618,31,347,2619,1189,5767,34,270,2380,1420,7851
1793.128,17,180,11520,180,36,10017,36,11520,0,0,0,0,0
1771.336,6,99,9240,66,65,27251,65,5577,33,59,55351,59,3663
3.397,17,5,340,5,40,849,40,340,0,0,0,0,0
0.002,6,2,157,1,0,0,0,40,1,77,0,77,117
99.422,6,36,8441,12,155,234,267,1266,24,326,4321,1452,7175
0.009,17,2,456,1,60,0,60,88,1,340,0,340,368
21.213,17,12,1056,6,48,4240,48,456,6,72,4240,72,600
0.042,17,2,212,1,46,0,46,74,1,110,0,110,138
1773.942,6,180,15480,120,69,14907,69,8940,60,69,30060,69,6540
0.358,6,12,975,7,181,59,181,553,5,77,6,133,422
9.7,17,4,724,2,41,9685,41,138,2,265,9681,265,586
64.497,6,15,612,7,0,7890,0,284,8,0,9212,0,328
1775.939,6,181,15589,120,69,14923,69,8940,61,69,29596,69,6649
0.118,17,2,144,1,36,0,36,64,1,52,0,52,80
15.397,17,27,16854,13,620,1279,1350,8427,14,573,1181,1350,8427
1.699,6,25,8753,15,283,121,582,1454,10,985,169,1420,7299
1730.218,6,67,4899,43,33,41195,33,2995,24,31,75217,31,1904
1798.008,1,268,15008,268,28,6734,28,15008,0,0,0,0,0
1741.277,6,87,6322,58,31,30548,31,3915,29,31,62187,31,2407
6.588,6,567,478638,345,1318,18,1368,462430,222,776,28,1473,16208
16.948,17,28,11982,15,611,1207,1350,9597,13,155,1407,1350,2385
801.387,1,60,3360,60,28,13582,28,3360,0,0,0,0,0
1796.145,17,448,39896,403,35,4468,288,25676,45,288,40020,288,14220
33.194,6,8,2006,8,198,4742,247,2006,0,0,0,0,0
1770.971,6,99,9306,66,66,27245,66,5610,33,60,55339,60,3696
1.709,6,12,2271,7,188,284,245,660,5,1407,364,1407,1611
102.859,17,4,352,2,60,102858,60,176,2,60,102858,60,176
9.022,6,3,180,3,0,0,0,180,0,0,0,0,0
0.488,17,3,451,2,39,67,39,134,1,289,0,289,317
0.023,17,2,503,1,40,0,40,68,1,407,0,407,435
1772.22,6,181,15520,120,69,14892,69,8940,61,69,29533,69,6580
280.192,6,27,7312,13,158,23349,267,1317,14,775,21551,3445,5995
0.764,6,15,5052,7,150,127,174,584,8,828,97,1420,4468
280.97,6,30,7432,13,158,23414,267,1317,17,603,17557,2760,6115
0.773,6,27,5927,13,156,64,267,1462,14,650,54,1420,4465
1665.59,1,8,448,8,28,237941,28,448,0,0,0,0,0
0.921,6,26,9893,14,350,70,1042,1993,12,1058,68,1360,7900
0.079,6,9,1340,5,145,19,145,349,4,827,24,827,991
1770.25,6,101,9344,66,65,27234,65,5577,35,59,52063,59,3767
0.259,6,24,4571,12,165,23,456,1446,12,415,22,888,3125
366.868,6,27,1767,18,177,21580,177,1181,9,110,8558,110,586
3.581,6,14,2351,8,188,511,245,700,6,703,628,1152,1651
192.909,17,4,240,2,32,192908,32,120,2,32,192907,32,120
3.433,17,2,656,2,300,3433,300,656,0,0,0,0,0
0.166,17,2,196,1,43,0,43,71,1,97,0,97,125
0.206,17,2,144,1,36,0,36,64,1,52,0,52,80
1776.946,17,73,3060,72,14,25027,14,3024,1,8,0,8,36
280.711,6,30,7432,13,158,23392,267,1317,17,543,17529,1400,6115
0.057,6,10,767,5,186,11,186,454,5,45,14,45,313
104.113,17,4,240,2,32,104112,32,120,2,32,104112,32,120
1791.855,1,194,10864,194,28,9284,28,10864,0,0,0,0,0
1783.631,17,83,3480,82,14,22020,14,3444,1,8,0,8,36
230.391,1,4,224,4,28,76797,28,224,0,0,0,0,0
0.078,17,2,144,1,36,0,36,64,1,52,0,52,80
840.643,17,8,2196,4,30,280212,30,232,4,463,280212,463,1964
1786.784,6,103,8336,68,65,26668,65,4930,35,59,52549,59,3406
1406.271,17,12,888,6,30,281251,30,348,6,62,281207,62,540
1740.41,6,87,6322,58,31,30533,31,3915,29,31,62157,31,2407
12.154,6,110,40184,57,651,217,1152,33566,53,449,228,1179,6618
3.22,6,4,184,2,0,3220,0,88,2,0,867,0,96
0.176,6,27,7296,14,155,13,267,1341,13,678,13,3436,5955
1772.512,6,202,22250,130,75,13740,267,10057,72,136,24958,2840,12193
1794.081,6,370,25839,215,99,8383,469,15154,155,69,11649,69,10685
100.379,6,11,719,11,31,10037,31,719,0,0,0,0,0
1786.467,6,102,8296,68,65,26663,65,4930,34,59,54132,59,3366
3.008,17,2,1430,2,687,3008,687,1430,0,0,0,0,0
1750.569,17,12,498,11,14,175056,14,462,1,8,0,8,36
560.43,17,6,1647,3,30,280206,30,174,3,463,280210,463,1473
1796.644,6,241,16316,99,46,18079,46,7140,142,46,12741,46,9176
1497.55,6,92,12147,59,92,21504,498,4956,33,189,46795,1420,7191
10.763,6,20,4442,11,275,1076,275,998,9,768,739,1440,3444
71.598,6,27,11014,14,494,83,1360,2583,13,1128,5955,4080,8431
1787.253,6,102,8228,68,64,26675,64,4896,34,58,54155,58,3332
0.092,2,3,96,3,8,46,8,96,0,0,0,0,0
1.139,6,25,8080,12,164,88,267,1312,13,869,81,1408,6768
1795.777,6,283,33412,117,136,15479,1460,16211,166,124,10882,1642,17201
10.897,6,20,4402,11,275,1089,275,998,9,758,757,1420,3404
199.446,6,22,2601,12,324,18131,585,1281,10,396,22135,580,1320
280.275,6,28,7352,13,158,23356,267,1317,15,678,20014,2800,6035
35.464,6,30,9010,14,158,2728,267,1357,16,778,2337,2800,7653
1764.074,1,14,1141,14,53,135698,78,1141,0,0,0,0,0
1798.802,17,449,39928,404,35,4463,288,25708,45,288,40020,288,14220
5.508,6,39,7269,20,218,289,314,3423,19,513,290,1179,3846
1772.103,6,180,15480,120,69,14891,69,8940,60,69,30034,69,6540
128.651,6,24,6542,8,156,18378,267,798,16,566,8571,1420,5744
223.84,1,36,2016,36,28,6395,28,2016,0,0,0,0,0
19.05,1,10,560,10,28,2116,28,560,0,0,0,0,0
165.808,6,23,10989,12,380,74,832,1665,11,1267,16567,3928,9324
12.103,6,15,6440,6,407,2411,517,1134,9,1204,1507,1408,5306
3.713,6,8,460,4,0,1237,0,220,4,0,996,0,240
0.044,17,2,602,1,46,0,46,74,1,500,0,500,528
0.082,17,4,336,2,34,0,34,124,2,78,42,84,212
0.013,17,2,523,1,41,0,41,69,1,426,0,426,454
44.134,17,15,7808,8,655,6304,1350,5466,7,306,2515,1350,2342
1752.959,6,186,11385,93,47,19053,208,6766,93,31,19051,31,4619
1773.137,6,180,15480,120,69,14900,69,8940,60,69,30050,69,6540
0.048,17,4,420,2,33,4,33,122,2,121,0,145,298
62.708,6,37,8764,19,477,3480,1420,3705,18,332,3685,1420,5059
63.239,6,14,5625,5,106,15807,106,314,9,988,7903,1997,5311
11.972,6,91,26933,46,537,266,1152,20651,45,447,265,1179,6282
1680.775,17,12,498,11,14,168077,14,462,1,8,0,8,36
1744.599,2,30,960,30,8,60158,8,960,0,0,0,0,0
0.389,6,115,87361,63,131,6,232,3049,52,1787,7,6800,84312
106.199,17,4,240,2,32,106198,32,120,2,32,106198,32,120
1743.031,6,95,7203,63,38,28113,205,4476,32,33,56214,98,2727
1785.275,6,414,24840,208,69,8624,69,12460,206,35,8708,69,12380
0.149,17,2,237,1,72,0,72,100,1,109,0,109,137
1768.066,1,58,4872,0,0,0,0,0,58,56,31018,56,4872
0.399,6,10,968,5,256,96,256,460,5,304,95,304,508
3.016,17,8,1530,4,33,1000,33,244,4,293,1002,327,1286
0.065,6,10,1514,5,503,16,503,771,5,475,16,475,743
46.82,6,390,173564,201,807,234,1152,161522,189,447,247,1179,12042
300.28,6,41,17958,24,986,13055,1408,12169,17,489,2246,2899,5789
208.829,17,4,352,2,60,208828,60,176,2,60,208828,60,176
1788.594,1,234,13104,234,28,7676,28,13104,0,0,0,0,0
1560.449,17,25,5875,25,207,65018,207,5875,0,0,0,0,0
33.733,6,34,5297,16,154,2248,722,1912,18,271,1971,1408,3385
0.112,17,4,364,2,52,0,52,160,2,74,34,80,204
1699.467,17,12,498,11,14,169946,14,462,1,8,0,8,36
0.018,6,2,123,1,0,0,0,40,1,31,0,31,83
72.868,6,30,8872,13,158,6072,267,1317,17,687,4550,1400,7555
0.077,17,3,618,2,32,29,32,120,1,470,0,470,498
0.177,17,2,2384,2,1164,177,1164,2384,0,0,0,0,0
4.994,17,4,288,2,36,4993,36,128,2,52,4992,52,160
0.05,17,2,251,1,36,0,36,64,1,159,0,159,187
149.52,6,20,4920,5,92,556,92,360,15,314,10666,2026,4560
0.125,17,2,340,1,39,0,39,67,1,245,0,245,273
0.507,17,3,451,2,39,163,39,134,1,289,0,289,317
1680.483,2,18,576,18,8,98851,8,576,0,0,0,0,0
1681.826,17,14,1036,7,30,280302,30,406,7,62,280302,62,630
0.037,17,2,558,1,32,0,32,60,1,470,0,470,498
5.45,6,41,7349,21,218,272,314,3463,20,513,273,1179,3886
1798.662,6,371,25948,216,99,8365,469,15194,155,69,11676,69,10754
19.948,6,27,4987,12,232,1813,722,1781,15,299,1376,1448,3206
1786.111,6,102,8296,68,65,26658,65,4930,34,59,54121,59,3366
0.071,17,2,152,1,48,0,48,76,1,48,0,48,76
2.464,6,27,6095,14,338,189,1314,2254,13,414,204,1420,3841
0.238,6,10,861,5,222,57,222,426,5,231,57,231,435
300.82,6,38,8566,19,315,16712,882,2053,19,441,473,1440,6513
1796.35,17,764,46132,764,32,2354,37,46132,0,0,0,0,0
5.04,17,3,208,2,36,5001,36,128,1,52,0,52,80
1.523,6,48,20773,28,936,56,1360,15197,20,433,70,1360,5576
1.401,6,41,8443,21,321,70,1164,2822,20,400,63,1360,5621
299.108,6,40,34006,22,181,14243,299,2046,18,2067,17593,7010,31960
280.464,6,30,7432,14,158,21574,267,1357,16,678,18693,3456,6075
40.515,6,24,6717,11,181,4051,267,1172,13,717,3375,1400,5545
195.091,17,6,528,3,60,97545,60,264,3,60,97545,60,264
14.759,1,8,448,8,28,2108,28,448,0,0,0,0,0
1799.759,1,187,19822,187,78,9676,78,19822,0,0,0,0,0
15.916,6,16,1327,8,222,2272,222,768,8,231,2272,231,559
1.564,6,61,40434,37,1205,43,1408,33281,24,1179,60,3819,7153
0.099,17,2,339,1,33,0,33,61,1,250,0,250,278
19.605,17,13,1152,9,42,2450,288,632,4,102,1518,288,520
1700.547,17,12,498,11,14,170054,14,462,1,8,0,8,36
1.841,6,74,53845,45,1259,41,1368,46432,29,982,58,2491,7413
31.758,6,6,360,0,0,0,0,0,6,0,0,0,360
0.147,17,4,560,2,64,146,64,184,2,160,34,160,376
373.486,6,18,1242,14,180,28729,180,916,4,110,20073,110,326
6.078,6,1697,1613645,1099,1392,5,1408,1577885,598,931,9,2801,35760
0.514,6,21,7281,13,334,42,663,2021,8,967,68,1471,5260
0.588,6,6,324,4,0,196,0,216,2,0,329,0,108
0.907,6,11,1727,7,100,151,100,384,4,589,214,1152,1343
1.478,6,19,3781,10,234,164,564,1452,9,463,161,1343,2329
3.644,17,5,290,5,30,911,30,290,0,0,0,0,0
29.996,6,13,4983,6,171,5998,171,491,7,1030,4999,1448,4492
1771.197,6,101,9216,66,63,27249,64,5513,35,57,52091,58,3703
0.762,6,29,7519,17,305,47,1086,2825,12,601,68,1420,4694
1328.697,6,264,16701,153,69,8741,69,9225,111,69,12079,69,7476
15.784,17,20,13866,12,936,1428,1350,11579,8,257,2245,1350,2287
1786.785,6,365,23087,211,69,8508,69,12787,154,69,11677,69,10300
280.248,17,4,296,2,30,280236,30,116,2,62,280234,62,180
1751.038,6,105,13226,49,132,36478,517,3617,56,609,31835,1368,9609
300.63,6,40,8738,22,316,14315,889,2203,18,446,499,3488,6535
1797.564,6,361,23711,211,76,8559,501,13081,150,74,12063,421,10630
1203.158,2,12,384,12,8,109378,8,384,0,0,0,0,0
1790.938,17,141,11268,72,48,25224,48,5472,69,56,26337,56,5796
0.01,17,2,470,1,30,0,30,58,1,384,0,384,412
15.205,6,14,3144,5,92,3801,92,348,9,387,1875,1408,2796
61.309,6,37,15935,22,800,2919,1402,9157,15,665,4361,1402,6778
26.588,17,53,37084,22,400,1249,1350,9437,31,863,877,1350,27647
0.015,17,2,311,1,35,0,35,63,1,220,0,220,248
1786.306,6,356,22520,208,69,8629,69,12460,148,69,12151,69,10060
3.556,17,5,295,5,31,889,31,295,0,0,0,0,0
17.592,17,29,14223,16,704,1170,1350,11717,13,164,1463,1350,2506
1.623,6,50,19446,29,898,57,1360,13785,21,400,71,1360,5661
1680.447,1,15,840,15,28,120031,28,840,0,0,0,0,0
1771.682,6,99,9240,66,65,27256,65,5577,33,59,55361,59,3663
6.639,6,38,7249,19,218,368,314,3383,19,516,354,1179,3866
280.423,6,30,7432,13,158,23368,267,1317,17,678,17523,3456,6115
300.303,6,49,29657,22,190,14300,444,1925,27,1253,9242,1461,27732
11.107,6,86,26109,42,551,270,1152,19867,44,447,252,1179,6242
4.242,6,7,400,3,0,2121,0,160,4,0,1080,0,240
0.415,6,10,968,5,256,99,256,460,5,304,100,304,508
1312.678,1,28,1568,28,28,48617,28,1568,0,0,0,0,0
1776.889,1,58,4872,58,56,31173,56,4872,0,0,0,0,0
0.315,6,326,358840,188,194,1,230,10575,138,2526,2,9814,348265
550.611,6,99,14005,48,127,11711,721,6145,51,363,11008,1440,7860
2.772,6,5,264,3,0,1386,0,160,2,0,1011,0,104
1775.261,17,73,3060,72,14,25003,14,3024,1,8,0,8,36
153.675,6,25,10829,12,380,75,832,1665,13,959,12795,1440,9164
1.288,6,45,18080,26,882,51,1360,12544,19,476,62,2715,5536
1.211,6,12,949,6,222,239,222,470,6,231,239,231,479
1785.858,6,365,23087,211,69,8504,69,12787,154,69,11672,69,10300
1752.206,6,185,11314,93,47,19045,208,6735,92,31,19252,31,4579
1776.972,17,237,59161,237,221,7529,422,59161,0,0,0,0,0
52.854,17,24,8159,12,432,4802,1350,5522,12,191,4801,1350,2637
0.371,1,6,624,0,0,0,0,0,6,76,74,76,624
4.116,17,3,201,3,39,2058,39,201,0,0,0,0,0
1735.131,1,191,20246,191,78,9132,78,20246,0,0,0,0,0
1787.451,6,106,8388,68,64,26678,64,4896,38,58,48305,58,3492
6.528,6,43,8329,22,227,310,314,4062,21,489,312,1179,4267
1532.249,6,77,5573,51,31,30644,31,3415,26,31,61281,31,2158
1.046,6,59,15148,29,551,37,1429,5076,30,421,35,1460,10072
319.165,6,53,10364,24,181,13868,722,3328,29,293,11391,2760,7036
0.479,6,10,767,5,186,108,186,454,5,45,108,45,313
0.219,17,2,180,1,30,0,30,58,1,94,0,94,122
1.298,6,53,21243,30,950,44,1360,15502,23,437,51,2715,5741
21.463,6,8,475,2,131,21226,131,215,6,0,4245,0,260
3.114,6,24,8004,12,164,242,267,1288,12,1014,241,2331,6716
1786.956,6,104,8376,68,65,26670,65,4930,36,59,51051,59,3446
12.217,17,10,2105,5,47,3050,47,375,5,318,3050,318,1730
280.505,6,30,7432,13,158,23375,267,1317,17,603,17528,2760,6115
240.195,6,53,18030,28,803,8895,1402,15131,25,198,10007,580,2899
171.945,6,27,7312,13,158,14328,267,1317,14,775,13219,4836,5995
421.11,2,4,128,4,8,140370,8,128,0,0,0,0,0
61.768,17,2,152,2,48,61768,48,152,0,0,0,0,0
364.372,6,25,1651,17,177,22773,177,1117,8,110,9168,110,534
0.091,17,2,304,1,60,0,60,88,1,188,0,188,216
300.858,6,43,10040,23,564,13675,1360,4376,20,373,797,2667,5664
4.113,17,4,296,4,46,1371,46,296,0,0,0,0,0
7.987,6,16,1310,10,275,887,275,958,6,96,1204,96,352
174.832,6,22,8456,11,315,74,638,1419,11,940,17469,1460,7037
0.857,17,4,624,2,64,615,64,184,2,192,582,192,440
1740.762,17,30,7050,30,207,60026,207,7050,0,0,0,0,0
37.66,17,4,304,4,48,12553,48,304,0,0,0,0,0
1783.559,17,84,3516,82,14,22016,14,3444,2,8,1783351,8,72
1792.736,17,66,2766,65,14,28011,14,2730,1,8,0,8,36
44.25,17,19,10686,10,662,4916,1350,6908,9,391,1898,1350,3778
6.783,6,4,1616,2,0,6783,0,92,2,1408,6597,1408,1524
1794.105,17,142,11360,71,48,25629,48,5396,71,56,25629,56,5964
5.011,17,4,288,2,36,4999,36,128,2,52,4983,52,160
12.175,17,10,965,5,46,3042,46,370,5,91,3042,91,595
0.395,6,10,968,5,256,94,256,460,5,304,94,304,508
0.018,17,4,420,2,33,0,33,122,2,121,1,145,298
1747.276,1,61,5124,61,56,29121,56,5124,0,0,0,0,0
0.336,17,2,186,1,33,0,33,61,1,97,0,97,125
0.108,6,13,1749,7,253,17,500,878,6,275,21,500,871
79.295,1,4,224,4,28,26431,28,224,0,0,0,0,0
1684.477,2,16,512,16,8,112298,8,512,0,0,0,0,0
0.365,17,8,2758,8,316,52,355,2758,0,0,0,0,0
334.84,1,8,448,8,28,47834,28,448,0,0,0,0,0
1796.955,17,448,39896,403,35,4470,288,25676,45,288,40018,288,14220
299.531,6,6,364,4,31,99843,31,222,2,31,299514,31,142
0.101,6,57,76949,11,130,10,314,964,46,1711,2,5608,75985
1795.635,6,355,22480,207,69,8716,69,12420,148,69,12215,69,10060
0.947,6,27,8420,15,222,56,540,1964,12,1192,70,3151,6456
0.155,6,43,19468,25,1039,6,1414,14527,18,467,8,1889,4941
1740.436,17,27,6345,27,207,66939,207,6345,0,0,0,0,0
10.776,6,20,5804,10,275,1197,275,958,10,886,979,1414,4846
1734.388,17,147,25378,147,144,11879,392,25378,0,0,0,0,0
3.933,6,2,88,2,0,0,0,88,0,0,0,0,0
60.388,6,9,774,5,180,15097,180,448,4,110,20062,110,326
2.078,6,11,1731,7,100,346,100,384,4,1179,599,1179,1347
1794.2,6,24,3624,16,241,119613,241,2568,8,92,256286,92,1056
372.378,6,25,1651,17,177,23273,177,1117,8,110,9216,110,534
260.972,2,5,160,5,8,65243,8,160,0,0,0,0,0
11.678,6,1851,1616649,1129,1379,10,1420,1580245,722,751,16,3303,36404
15.871,17,12,5305,6,489,3159,1350,3107,6,338,3158,1350,2198
0.432,6,10,1992,5,288,104,288,508,5,424,59,434,1484
0.068,6,9,1002,5,213,17,213,417,4,421,15,421,585
57.809,1,5,823,5,136,14452,177,823,0,0,0,0,0
1786.707,6,104,8308,68,64,26667,64,4896,36,58,51045,58,3412
0.351,6,22,5442,12,125,31,212,986,10,810,38,1737,4456
6.601,17,4,352,2,60,6600,60,176,2,60,6600,60,176
1795.71,6,356,22520,208,69,8674,69,12460,148,69,12215,69,10060
1164.609,6,18,1061,11,31,116460,31,595,7,31,194098,31,466
1.645,6,38,8258,19,321,91,1168,2722,19,433,79,1360,5536
2.115,6,14,3592,7,150,352,174,584,7,681,278,1452,3008
0.027,6,25,60112,1,0,0,0,40,24,2451,0,6840,60072
0.406,6,6,324,4,0,135,0,216,2,0,224,0,108
1771.337,6,101,9344,66,65,27251,65,5577,35,59,52095,59,3767
6.85,6,537,475600,343,1322,19,1368,460848,194,776,34,1473,14752
7.44,6,58,10733,28,238,275,314,5420,30,410,247,1152,5313
114.097,17,4,240,2,32,114096,32,120,2,32,114096,32,120
1512.254,2,10,320,10,8,168028,8,320,0,0,0,0,0
0.242,6,42,17193,23,939,11,1420,12212,19,467,13,1883,4981
0.39,6,14,1733,7,288,59,288,588,7,284,36,434,1145
1786.324,6,107,8602,70,64,25888,64,4976,37,58,49617,58,3626
5.271,6,38,7229,20,218,277,314,3423,18,513,294,1179,3806
1744.455,1,60,5040,60,56,29567,56,5040,0,0,0,0,0
299.521,6,6,364,4,31,99840,31,222,2,31,299514,31,142
11.769,6,1831,1575435,1030,1433,11,1448,1519863,801,931,14,2896,55572
121.051,6,16,2270,9,196,15110,196,784,7,398,20147,419,1486
5.334,6,2,1520,1,0,0,0,40,1,1440,0,1440,1480
152.528,6,32,23785,19,840,36,1360,5835,13,2177,12699,5440,17950
280.237,6,27,7312,13,158,23353,267,1317,14,775,21555,3445,5995
1798.535,6,357,22629,208,69,8688,69,12460,149,69,12152,69,10169
29.201,6,6,332,3,46,14600,46,166,3,46,14520,46,166
7.986,17,4,240,2,32,7985,32,120,2,32,7984,32,120
288.793,6,374,59453,207,304,1401,304,41544,167,83,1739,83,17909
55.639,6,37,8507,18,410,542,882,1994,19,478,3083,2720,6513
1794.831,6,124,8108,71,52,25640,208,4996,53,31,34510,31,3112
1773.864,6,180,15480,120,69,14906,69,8940,60,69,30057,69,6540
1741.048,1,15,840,15,28,124360,28,840,0,0,0,0,0
3.384,17,20,7009,9,433,423,1350,4156,11,231,249,1350,2853
1770.828,6,101,9344,66,65,27243,65,5577,35,59,52078,59,3767
2.141,17,21,6700,8,306,305,1350,2678,13,281,133,1350,4022
839.28,1,6,684,6,86,167856,88,684,0,0,0,0,0
63.07,6,2477,2097154,1457,1376,43,1380,2046236,1020,421,61,1923,50918
301.844,6,172,151687,115,1339,2647,1408,142580,57,766,1122,2899,9107
1798.841,2,15,480,15,8,128488,8,480,0,0,0,0,0
216.259,17,6,2460,6,382,43251,392,2460,0,0,0,0,0
371.208,6,21,1419,15,177,26514,177,989,6,110,12247,110,430
1798.194,17,450,39960,405,35,4450,288,25740,45,288,40016,288,14220
1787.203,6,104,8376,68,65,26674,65,4930,36,59,51059,59,3446
2.078,17,3,174,3,30,1039,30,174,0,0,0,0,0
1.374,6,10,1060,5,517,343,517,785,5,7,343,7,275
1744.648,2,28,896,28,8,64616,8,896,0,0,0,0,0
5.029,17,4,288,2,36,4997,36,128,2,52,4992,52,160
0.026,17,2,417,1,44,0,44,72,1,317,0,317,345
0.0,17,1,1455,1,1427,0,1427,1455,0,0,0,0,0
73.221,6,170,79778,95,821,778,1440,63800,75,418,987,1440,15978
6.142,17,4,332,2,47,6140,47,150,2,63,6140,63,182
378.324,2,4,128,4,8,126108,8,128,0,0,0,0,0
1741.227,17,30,7050,30,207,60042,207,7050,0,0,0,0,0
6.487,6,29,6175,15,338,463,1314,2294,14,368,497,1460,3881
1.223,6,8,342,4,0,407,0,164,4,7,269,7,178
1681.467,17,14,1036,7,30,280242,30,406,7,62,280242,62,630
0.227,6,11,1737,6,125,45,125,385,5,1148,26,1148,1352
1772.532,6,180,15480,120,69,14895,69,8940,60,69,30034,69,6540
1781.76,6,420,40132,239,165,7486,485,22281,181,121,9898,453,17851
1786.046,6,107,9036,70,71,25884,293,5303,37,64,49609,247,3733
62.258,6,47,10588,23,723,1220,1360,4640,24,292,2698,2667,5948
1604.252,6,197,13516,74,46,21976,46,5744,123,46,13148,46,7772
0.086,17,4,284,2,32,37,32,120,2,54,50,60,164
61.349,6,36,15836,22,795,2921,1408,9110,14,748,4699,2439,6726
0.194,6,3,453,2,241,194,241,321,1,92,0,92,132
8.762,6,30,7046,12,157,796,189,827,18,422,500,1440,6219
1734.739,17,144,24390,144,141,12131,373,24390,0,0,0,0,0
326.116,6,128,103653,86,1269,3836,1368,93342,42,676,2379,1368,10311
1797.993,6,305,38145,151,139,11985,721,21362,154,216,11750,1414,16783
1793.018,17,144,11520,72,48,25253,48,5472,72,56,25253,56,6048
1.087,6,10,968,5,256,269,256,460,5,304,269,304,508
0.007,17,3,286,2,46,1,46,148,1,110,0,110,138
1776.092,17,142,11360,71,48,25372,48,5396,71,56,25372,56,5964
67.924,6,29,8832,14,158,5224,267,1357,15,858,4851,4836,7475
179.121,2,2,64,2,8,179121,8,64,0,0,0,0,0
1680.749,1,15,840,15,28,120053,28,840,0,0,0,0,0
0.087,6,4,208,0,0,0,0,0,4,0,0,0,208
6.099,17,6,579,3,46,3044,46,222,3,91,3046,91,357
1793.764,17,82,3438,81,14,22422,14,3402,1,8,0,8,36
197.585,17,8,704,4,48,65858,48,304,4,72,65858,72,400
0.082,1,2,112,2,28,82,28,112,0,0,0,0,0
1.374,6,50,20210,28,893,50,1360,14554,22,433,56,1360,5656
0.927,6,27,8420,15,222,54,540,1964,12,1192,69,3151,6456
25.433,6,33,8673,20,133,1338,159,2126,13,651,2118,1418,6547
29.287,17,18,1584,9,48,3653,48,684,9,72,3657,72,900
1130.159,6,77,10388,42,98,19820,501,3460,35,178,33237,1420,6928
0.391,6,12,1987,6,288,73,288,560,6,293,42,434,1427
374.827,6,19,1303,14,177,28832,177,925,5,110,17640,110,378
0.144,6,41,18182,24,1025,6,1420,13281,17,467,8,1883,4901
164.034,6,56,13148,27,541,6309,1418,9536,29,188,5857,580,3612
242.594,6,32,8952,14,158,18661,267,1357,18,624,14267,1400,7595
187.919,6,32,2144,13,46,15649,46,878,19,46,10439,46,1266
9.46,6,1631,1500683,1034,1374,8,1408,1464975,597,931,15,2801,35708
1774.536,1,56,4704,56,56,32264,56,4704,0,0,0,0,0
197.157,6,513,236500,254,842,779,1152,218189,259,397,763,1152,18311
1785.836,6,379,26806,218,103,8229,469,15881,161,69,11161,69,10925
0.321,6,61,53482,35,183,9,230,2449,26,2069,10,5632,51033
1786.453,6,356,22520,208,69,8630,69,12460,148,69,12152,69,10060
0.599,6,15,1785,8,288,59,288,640,7,426,69,434,1145
0.396,17,2,178,1,29,0,29,57,1,93,0,93,121
1799.297,17,142,11360,71,48,25704,48,5396,71,56,25704,56,5964
0.431,6,50,22354,28,1070,15,1380,17232,22,421,19,1923,5122
287.475,17,4,352,2,60,287474,60,176,2,60,287473,60,176
300.821,6,46,10280,24,433,13079,910,3194,22,364,728,2720,7086
1796.988,17,449,39928,404,35,4459,288,25708,45,288,40021,288,14220
1003.073,1,28,2968,28,78,37150,78,2968,0,0,0,0,0
127.401,6,19,4107,3,92,99,92,256,16,215,8481,1408,3851
1772.017,6,400,46197,205,165,8685,447,37529,195,31,9133,31,8668
0.689,6,57,24028,32,907,22,1380,16798,25,515,27,1923,7230
241.974,6,43,13701,27,387,9306,1360,6561,16,648,16119,2134,7140
184.286,6,5683,5118497,3530,1364,52,1368,4987903,2153,899,85,1473,130594
160.367,6,35,8775,20,245,8437,1258,3058,15,617,11451,1368,5717
1787.006,6,356,22520,208,69,8632,69,12460,148,69,12156,69,10060
280.511,6,27,7312,12,158,25501,267,1277,15,678,20031,2085,6035
1787.472,6,104,8376,68,65,26678,65,4930,36,59,51066,59,3446
0.075,17,4,284,2,32,46,32,120,2,54,30,60,164
1740.503,17,29,30624,29,1028,62160,1028,30624,0,0,0,0,0
25.735,17,4,1808,4,424,8578,548,1808,0,0,0,0,0
7.901,6,17,5211,9,275,987,275,643,8,1059,681,1380,4568
0.249,17,2,384,1,39,0,39,67,1,289,0,289,317
1798.487,1,345,28980,345,56,5228,56,28980,0,0,0,0,0
150.367,6,42,10008,17,263,4846,1189,2793,25,310,6264,1460,7215
1776.009,17,142,11360,71,48,25371,48,5396,71,56,25371,56,5964
300.699,6,38,8471,20,291,15826,786,1997,18,478,498,2720,6474
30.55,6,31,9677,12,155,2777,267,1266,19,509,1696,3426,8411
6.066,6,14,1855,6,100,1213,100,344,8,589,830,1152,1511
0.097,17,2,672,2,308,97,308,672,0,0,0,0,0
1748.125,6,95,7203,63,38,28195,205,4476,32,33,56381,98,2727
10.549,6,1858,1787912,1234,1374,8,1408,1750800,624,776,16,1408,37112
153.959,6,24,1759,18,43,9056,43,1399,6,0,30172,0,360
242.714,6,30,3235,15,193,17334,585,1560,15,219,17334,580,1675
26.231,6,26,8915,12,232,2384,502,1412,14,771,2010,1420,7503
31.278,17,36,5292,18,48,1839,48,1368,18,190,1839,308,3924
104.235,17,4,352,2,60,104234,60,176,2,60,104229,60,176
0.06,17,2,433,2,188,60,219,433,0,0,0,0,0
0.02,17,2,212,1,38,0,38,66,1,118,0,118,146
1.843,6,31,12073,18,517,108,1360,3351,13,910,136,2561,8722
345.608,17,8,2656,8,304,49372,308,2656,0,0,0,0,0
4.0,6,13,2383,8,231,571,231,651,5,1448,652,1448,1732
0.005,17,2,428,1,40,0,40,68,1,332,0,332,360
131.198,17,4,352,2,60,131197,60,176,2,60,131197,60,176
0.63,17,20,12087,11,726,63,1350,8296,9,393,69,1350,3791
9.887,6,80,24773,40,561,253,1152,19016,40,461,246,1179,5757
61.813,6,71,48602,44,1192,1437,1448,40469,27,746,2368,1448,8133
4.14,17,29,10824,12,447,376,1350,5705,17,273,206,1350,5119
1786.322,6,102,8364,68,66,26661,66,4964,34,60,54128,60,3400
184.216,6,148,51412,77,608,2423,1360,37238,71,341,2628,2089,14174
1758.609,6,4385,4204058,1490,149,1181,903,84801,2895,1407,607,2836,4119257
0.253,17,4,420,2,33,0,33,122,2,121,0,145,298
1.458,6,48,19610,27,920,56,1440,13994,21,433,64,1440,5616
300.837,6,51,10566,25,433,12534,910,3258,26,312,518,1460,7308
1648.477,1,14,784,14,28,126805,28,784,0,0,0,0,0
280.434,6,29,7392,13,158,23369,267,1317,16,603,18692,2036,6075
378.498,6,18,1242,14,180,29115,180,916,4,110,20064,110,326
8.412,6,39,21355,24,992,365,1368,15147,15,1072,581,2519,6208
1.279,6,50,19412,27,900,49,1360,13716,23,433,50,1360,5696
55.309,6,13,1807,5,100,380,100,304,8,1179,7866,1179,1503
15.571,17,19,9886,8,468,2214,1350,3975,11,509,1548,1350,5911
7.944,17,2,778,2,361,7944,361,778,0,0,0,0,0
272.479,17,7,2328,7,304,45413,308,2328,0,0,0,0,0
1795.838,1,57,6527,57,86,32068,173,6527,0,0,0,0,0
22.702,6,3303,3148965,2116,1410,10,1448,3082577,1187,776,18,1448,66388
0.152,17,2,176,1,48,0,48,76,1,72,0,72,100
300.116,6,39,10109,20,619,15785,1440,4547,19,399,16662,1440,5562
206.037,6,34,8514,13,225,478,314,2329,21,410,10288,1179,6185
2.937,6,26,8134,12,326,263,517,1949,14,778,222,1418,6185
1632.116,6,164,14145,104,69,15845,69,7748,60,68,27662,69,6397
0.498,6,20,4960,10,137,55,267,1092,10,692,49,1467,3868
7.941,6,576,508425,367,1319,21,1368,492893,209,776,37,2736,15532
15.504,17,20,13552,12,924,1402,1350,11425,8,237,2204,1350,2127
1729.186,6,60,4400,40,33,44338,33,2740,20,31,91000,31,1660
70.376,6,29,7395,12,155,6397,267,1266,17,418,4398,1420,6129
1790.554,6,362,25381,209,100,8608,469,14776,153,69,11779,69,10605
0.244,17,2,296,1,43,0,43,71,1,197,0,197,225
1772.386,6,180,15480,120,69,14894,69,8940,60,69,30034,69,6540
1794.114,17,144,11520,72,48,25269,48,5472,72,56,25269,56,6048
240.457,6,60,24775,26,548,9617,1418,6300,34,878,7286,1418,18475
141.013,17,4,240,2,32,141012,32,120,2,32,141012,32,120
1782.036,6,102,8296,68,65,26597,65,4930,34,59,53998,59,3366
0.965,17,4,560,2,64,964,64,184,2,160,765,160,376
300.293,6,43,26870,20,393,15804,1018,2633,23,1279,2811,6858,24237
0.159,6,23,7136,12,155,14,267,1261,11,775,15,2800,5875
88.65,6,23,10146,13,553,56,1360,2767,10,1393,9836,3934,7379
1799.055,17,737,44496,737,32,2444,37,44496,0,0,0,0,0
1787.903,6,374,26068,215,98,8354,469,15292,159,69,11315,69,10776
1786.647,6,415,24880,208,69,8631,69,12460,207,34,8672,69,12420
1788.587,1,277,15512,277,28,6480,28,15512,0,0,0,0,0
1787.403,6,104,8308,68,64,26677,64,4896,36,58,51065,58,3412
93.119,17,175,107774,100,962,940,1350,99054,75,88,1257,1350,8720
240.227,6,55,18348,29,813,8579,1402,15351,26,204,9608,580,2997
1795.878,6,263,25844,110,67,16474,659,9932,153,123,11814,1638,15912
0.432,17,2,780,2,362,432,362,780,0,0,0,0,0
5.892,6,45,7509,23,201,267,314,3543,22,513,264,1179,3966
1204.131,6,79,6395,49,54,25086,205,3792,30,35,41512,98,2603
1208.872,17,225,17100,225,48,5396,48,17100,0,0,0,0,0
1787.906,6,436,26055,234,69,7673,69,13569,202,39,8895,69,12486
4.386,6,38,7229,19,218,243,314,3383,19,513,228,1179,3846
1785.978,17,142,11360,71,48,25513,48,5396,71,56,25513,56,5964
0.925,6,48,13761,24,553,40,1429,4892,24,464,39,1986,8869
0.008,1,4,416,0,0,0,0,0,4,76,2,76,416
1.378,6,37,8214,19,321,76,1164,2718,18,476,70,2715,5496
131.986,6,38,15865,19,516,1749,1460,3914,19,859,7325,1460,11951
0.046,17,2,2752,2,1348,46,1348,2752,0,0,0,0,0
1783.104,17,83,3480,82,14,22013,14,3444,1,8,0,8,36
1734.902,17,144,23130,144,132,12132,373,23130,0,0,0,0,0
552.094,6,109,6982,64,69,8763,69,3871,45,69,12537,69,3111
167.355,6,33,5436,15,201,4294,517,1613,18,281,9839,1452,3823
5.001,17,4,288,2,36,5000,36,128,2,52,5001,52,160
2.492,17,4,1552,4,360,830,360,1552,0,0,0,0,0
5.047,17,4,396,2,37,5004,37,130,2,105,5009,105,266
1.99,6,13,2311,8,188,284,245,700,5,1407,435,1407,1611
2.904,17,4,1192,2,33,2892,33,122,2,507,2889,507,1070
284.178,17,3,1008,3,308,142089,308,1008,0,0,0,0,0
2.747,6,24,8004,12,164,212,267,1288,12,1014,208,2331,6716
2.566,17,2,136,1,32,0,32,60,1,48,0,48,76
1680.534,17,12,498,11,14,168053,14,462,1,8,0,8,36
0.447,6,12,1653,6,288,87,288,548,6,426,48,434,1105
280.279,6,27,7312,12,158,25479,267,1277,15,678,20010,2045,6035
0.374,6,26,8991,13,252,31,647,1692,13,945,30,1438,7299
1769.187,1,58,4872,0,0,0,0,0,58,56,31038,56,4872
0.853,6,56,23032,30,968,29,1380,15815,26,558,32,1923,7217
1772.734,6,180,15480,120,69,14896,69,8940,60,69,30045,69,6540
280.079,6,31,7472,14,158,21544,267,1357,17,543,17500,1400,6115
1684.535,6,159,21025,92,302,18511,302,14758,67,83,25521,83,6267
156.181,6,22,9783,12,410,52,922,1742,10,1271,17340,4416,8041
2.992,6,2,88,2,0,0,0,88,0,0,0,0,0
300.787,6,41,13413,23,867,13672,1360,7891,18,435,509,2667,5522
3.366,17,10,1450,5,40,833,40,340,5,194,832,194,1110
1762.368,6,217,28415,116,304,15324,304,19272,101,83,17623,83,9143
280.534,6,28,7352,13,158,23377,267,1317,15,775,20028,3465,6035
165.356,6,24,9749,12,531,62,1460,2637,12,1103,15018,2374,7112
1798.091,1,17,2725,17,132,112380,227,2725,0,0,0,0,0
0.251,17,2,586,1,46,0,46,74,1,484,0,484,512
1797.936,1,345,28980,345,56,5226,56,28980,0,0,0,0,0
1191.331,6,15,910,10,31,132370,31,555,5,31,297825,31,355
0.013,17,2,394,1,37,0,37,65,1,301,0,301,329
1.49,6,47,19317,27,902,57,1460,13741,20,476,66,2615,5576
704.471,6,126,9163,62,86,11544,86,3442,64,39,11182,63,5721
1780.813,17,190,39164,190,178,9422,358,39164,0,0,0,0,0
194.601,17,4,240,2,32,194600,32,120,2,32,194600,32,120
1760.652,1,102,10812,102,78,17432,78,10812,0,0,0,0,0
317.018,6,55,12715,26,245,12680,1305,3570,29,379,11317,4649,9145
30.697,6,23,6180,14,117,2361,159,1337,9,873,3835,1675,4843
0.577,17,4,336,2,48,432,48,152,2,64,533,64,184
179.945,6,154,23678,84,304,2168,304,16400,70,83,2605,83,7278
292.65,17,4,352,2,60,292649,60,176,2,60,292648,60,176
7.777,17,6,528,3,48,3883,48,228,3,72,3882,72,300
0.157,6,45,20069,27,1002,6,1420,15128,18,467,8,1883,4941
0.302,17,2,304,1,60,0,60,88,1,188,0,188,216
1679.541,17,12,498,11,14,167954,14,462,1,8,0,8,36
1.708,6,22,7437,12,159,155,192,830,10,885,82,1360,6607
5.483,6,39,7269,20,218,288,314,3423,19,513,290,1179,3846
0.103,17,2,672,2,308,103,308,672,0,0,0,0,0
57.783,6,28,7483,7,165,399,267,949,21,334,2888,1460,6534
1796.86,17,449,39928,404,35,4458,288,25708,45,288,40023,288,14220
1526.8,17,30,12136,30,376,52648,548,12136,0,0,0,0,0
0.775,17,2,144,1,36,0,36,64,1,52,0,52,80
0.01,17,3,474,2,36,4,36,128,1,318,0,318,346
0.1,17,2,144,1,36,0,36,64,1,52,0,52,80
1.612,6,13,2311,8,188,230,245,700,5,1407,341,1407,1611
0.051,6,18,6108,10,88,5,88,556,8,1305,7,1880,5552
1770.897,6,101,9344,66,65,27244,65,5577,35,59,52081,59,3767
0.007,17,2,904,2,424,7,548,904,0,0,0,0,0
1789.969,17,142,11360,71,48,25569,48,5396,71,56,25570,56,5964
2.405,17,33,7321,14,217,182,1350,3434,19,176,131,1350,3887
79.513,17,3,1008,3,308,39756,308,1008,0,0,0,0,0
182.906,17,4,1576,4,366,60968,548,1576,0,0,0,0,0
3.045,17,8,736,4,32,975,32,240,4,96,958,96,496
0.011,17,2,207,1,46,0,46,74,1,105,0,105,133
1784.796,17,140,11200,70,48,25866,48,5320,70,56,25866,56,5880
4.209,6,38,7229,19,218,233,314,3383,19,440,219,1152,3846
1743.948,1,52,4368,52,56,34195,56,4368,0,0,0,0,0
83.447,6,20,4550,11,215,8344,499,1306,9,480,10409,1420,3244
1794.811,6,245,36249,152,302,11886,302,26338,93,83,19508,83,9911
300.001,17,4,1344,4,308,100000,308,1344,0,0,0,0,0
98.213,6,22,10282,9,275,762,275,918,13,1104,8073,1440,9364
78.97,6,53,14446,23,168,3589,267,2445,30,599,2722,1400,12001
184.363,6,6,362,5,106,46090,106,314,1,0,0,0,48
1743.521,6,96,7286,63,38,28121,205,4476,33,33,54472,98,2810
1741.485,6,87,6322,58,31,30552,31,3915,29,31,62195,31,2407
1770.896,6,112,10334,71,64,25298,64,6020,41,58,44270,58,4314
0.062,17,2,266,1,41,0,41,69,1,169,0,169,197
0.598,6,29,10373,15,431,42,1438,2514,14,791,45,1438,7859
0.286,6,24,5980,12,164,26,453,1442,12,651,24,1440,4538
240.434,6,43,9072,21,523,12021,1408,5813,22,234,11449,618,3259
0.39,17,8,2758,8,316,55,355,2758,0,0,0,0,0
1.229,6,8,342,4,0,409,0,164,4,7,269,7,178
294.78,17,4,352,2,60,294779,60,176,2,60,294779,60,176
1783.333,17,83,3480,82,14,22016,14,3444,1,8,0,8,36
1797.611,17,346,26296,346,48,5210,48,26296,0,0,0,0,0
1744.923,6,102,7660,65,38,27264,205,4580,37,33,48457,98,3080
8.808,6,419,267405,210,339,42,339,14047,209,1171,42,1368,253358
37.535,17,44,6468,22,48,1786,48,1672,22,190,1786,308,4796
300.32,6,54,30046,25,190,12513,444,2117,29,1148,8643,1769,27929
20.494,6,30,7466,16,380,1366,885,3491,14,645,1560,1767,3975
13.132,6,1945,1799555,1269,1365,10,1432,1768200,676,475,19,1871,31355
0.049,17,2,128,1,36,0,36,64,1,36,0,36,64
1787.227,6,102,8364,68,66,26675,66,4964,34,60,54155,60,3400
127.097,6,40,8731,14,155,74,267,1346,26,301,5083,1460,7385
1788.955,6,289,51387,186,304,9670,304,38256,103,83,17537,83,13131
15.17,17,17,9558,8,541,2162,1350,4554,9,528,1892,1350,5004
4.594,17,26,7365,10,230,510,1350,2580,16,271,212,1350,4785
1788.802,6,354,22440,207,69,8683,69,12420,147,69,12251,69,10020
0.914,6,27,8506,15,229,53,583,2007,12,1201,67,3151,6499
16.83,17,4,352,2,60,16829,60,176,2,60,16829,60,176
1773.15,6,180,15480,120,69,14900,69,8940,60,69,30052,69,6540
1504.006,2,12,384,12,8,136727,8,384,0,0,0,0,0
0.022,17,2,235,1,36,0,36,64,1,143,0,143,171
600.007,6,129,8510,64,46,9502,46,3886,65,46,9375,46,4624
39.853,17,22,1672,22,48,1897,48,1672,0,0,0,0,0
240.178,6,59,17511,33,724,7505,1408,14778,26,152,9606,580,2733
1799.017,6,355,22480,207,69,8733,69,12420,148,69,12237,69,10060
1770.488,6,101,9410,66,66,27238,66,5610,35,60,52070,60,3800
56.236,6,7246,6978625,4862,1358,11,1408,6849993,2384,931,23,2801,128632
128.49,17,6,1236,3,48,64238,48,228,3,308,64238,308,1008
240.241,6,53,18291,28,816,8897,1418,15344,25,204,10009,580,2947
0.328,6,22,5340,12,115,29,206,1092,10,930,35,1852,4248
1.157,6,25,8080,12,164,89,267,1312,13,869,82,1408,6768
1772.879,6,180,15480,120,69,14898,69,8940,60,69,30046,69,6540
94.44,6,117,86205,73,1262,1311,1448,75770,44,626,2191,1448,10435
0.697,17,4,377,2,33,665,37,123,2,99,661,136,254
0.048,17,2,212,1,46,0,46,74,1,110,0,110,138
1.695,6,13,2311,8,188,242,245,700,5,1407,359,1407,1611
0.031,17,3,1007,1,137,0,137,165,2,393,30,393,842
0.42,6,28,9025,13,237,35,589,1634,15,825,28,1438,7391
280.692,6,30,7432,13,158,23391,267,1317,17,543,17536,1300,6115
1.374,6,51,18945,29,860,49,1360,13244,22,437,56,2715,5701
88.265,1,2,237,2,90,88265,105,237,0,0,0,0,0
6.152,6,1651,1545143,1056,1386,5,1408,1509539,595,776,10,1408,35604
2.578,6,19,4192,10,101,286,101,629,9,514,322,587,3563
1787.047,17,87,3648,86,14,21024,14,3612,1,8,0,8,36
1082.865,2,12,384,12,8,98442,8,384,0,0,0,0,0
1799.449,6,201,25872,111,304,16358,304,17756,90,83,20218,83,8116
8.906,6,28,5147,15,232,636,597,2183,13,378,625,1448,2964
0.012,6,6,718,3,304,5,304,460,3,102,3,102,258
1681.328,1,15,840,15,28,120094,28,840,0,0,0,0,0
266.367,1,14,784,14,28,20489,28,784,0,0,0,0,0
390.491,6,34,7688,15,158,27892,267,1397,19,460,21686,1400,6291
1786.228,6,105,8475,69,65,26268,65,4970,36,59,51015,59,3505
1788.63,6,268,32454,109,133,16560,1360,15341,159,134,11319,2720,17113
0.169,6,3,151,2,31,4,31,111,1,0,0,0,40
0.922,6,19,3105,10,324,102,585,1201,9,285,114,580,1904
0.179,6,31,17475,16,129,11,129,969,15,1309,12,1479,16506
1793.718,17,87,3648,86,14,21102,14,3612,1,8,0,8,36
1789.955,6,373,23614,214,69,8403,69,13114,159,69,11328,69,10500
300.263,6,25,8067,14,433,23097,1178,2482,11,834,3681,2899,5585
1796.933,17,339,56168,339,137,5316,363,56168,0,0,0,0,0
0.011,17,2,366,1,36,0,36,64,1,274,0,274,302
0.012,17,2,366,1,37,0,37,65,1,273,0,273,301
0.901,6,23,6448,13,320,74,942,2128,10,979,99,1791,4320
124.384,6,12,724,4,106,41459,106,274,8,90,17768,90,450
43.131,6,38,5780,17,180,2695,721,2010,21,222,2147,2026,3770
10.527,6,20,4442,11,275,1052,275,998,9,768,755,1440,3444
280.49,6,28,7352,13,158,23374,267,1317,15,678,20027,2760,6035
0.054,17,4,284,2,32,0,32,120,2,54,42,60,164
0.275,17,16,8854,7,506,45,1350,3742,9,540,26,1350,5112
14.396,6,21,6825,12,275,1308,275,1038,9,1353,1168,1440,5787
236.016,6,68,12392,30,214,4863,1189,3568,38,331,6378,3377,8824
0.119,6,11,1703,6,314,23,500,948,5,487,29,487,755
0.19,6,43,17901,24,995,8,1420,12920,19,467,9,1883,4981
0.554,6,12,1653,6,288,106,288,548,6,426,62,434,1105
1.504,6,9,482,4,0,501,0,204,5,7,315,7,278
1786.895,6,102,8296,68,65,26670,65,4930,34,59,54144,59,3366
204.077,17,3,222,3,46,102038,46,222,0,0,0,0,0
0.178,6,9,1340,5,145,44,145,349,4,827,28,827,991
87.715,17,4,1344,4,308,29238,308,1344,0,0,0,0,0
0.148,6,9,1144,5,145,37,145,349,4,631,34,631,795
135.144,6,24,1528,10,43,14998,46,661,14,43,10395,46,867
7.476,6,1748,1493846,976,1436,7,1448,1443102,772,776,9,1448,50744
1.084,2,2,64,2,8,1084,8,64,0,0,0,0,0
1789.2,6,344,22661,200,69,8990,69,12416,144,69,12511,69,10245
11.488,17,8,704,4,48,3826,48,304,4,72,3825,72,400
1746.815,6,97,7307,63,38,28174,205,4476,34,33,52920,98,2831
0.03,17,4,420,2,33,0,33,122,2,121,1,145,298
0.211,6,3,120,2,0,130,0,80,1,0,0,0,40
0.618,1,2,112,2,28,618,28,112,0,0,0,0,0
2.955,17,2,120,2,32,2955,32,120,0,0,0,0,0
0.198,6,35,13803,21,906,9,1420,9022,14,526,14,3303,4781
1791.597,6,244,35804,152,302,11864,302,26032,92,83,19687,83,9772
284.499,1,9,954,9,78,35562,78,954,0,0,0,0,0
1794.13,17,140,11200,70,48,26001,48,5320,70,56,26001,56,5880
1787.315,6,363,23076,208,69,8634,69,12667,155,69,11604,69,10409
199.188,6,40,9913,21,579,9950,1360,4351,19,399,11056,1360,5562
125.382,6,3398,3092947,1879,729,66,1396,108491,1519,1924,82,12564,2984456
464.584,6,118,14842,58,139,7421,1189,5399,60,226,7874,1917,9443
280.5,6,30,7432,13,158,23375,267,1317,17,603,17528,2076,6115
14.825,6,2283,2061370,1369,1420,10,1448,2005438,914,776,16,1448,55932
1795.546,17,447,39864,402,35,4477,288,25644,45,288,40017,288,14220
0.751,6,26,5680,14,121,57,267,1295,12,650,61,1420,4385
22.072,6,9,527,5,43,5518,43,311,4,0,7355,0,216
280.435,6,30,7432,13,158,23369,267,1317,17,603,17524,2760,6115
0.918,17,2,685,1,308,0,308,336,1,321,0,321,349
0.037,17,2,288,1,59,0,59,87,1,173,0,173,201
0.044,17,7,2102,7,272,7,316,2102,0,0,0,0,0
159.336,6,93,13902,45,304,3621,304,9120,48,83,3376,83,4782
1333.962,1,429,36036,429,56,3116,56,36036,0,0,0,0,0
1.748,17,25,6304,10,260,194,1350,2889,15,199,112,1350,3415
1.137,6,10,1687,7,100,189,100,384,3,1179,369,1179,1303
1741.334,17,30,7050,30,207,60046,207,7050,0,0,0,0,0
1.325,6,27,7180,15,121,94,267,1335,12,893,110,1460,5845
1780.227,17,348,83190,348,211,5130,356,83190,0,0,0,0,0
7.097,17,25,10311,6,864,18,1350,5353,19,232,392,1350,4958
15.355,6,2303,2216329,1495,1405,10,1448,2169649,808,776,18,1448,46680
1.36,6,11,1727,7,100,226,100,384,4,589,368,1152,1343
300.234,6,30,11783,17,592,18764,1408,4460,13,1106,20021,2816,7323
33.643,6,31,5094,15,154,2403,722,1859,16,342,2230,1448,3235
1.247,6,38,9848,20,502,65,1460,4352,18,433,63,1460,5496
1.049,17,7,667,4,33,344,33,244,3,113,515,145,423
1778.238,17,140,11200,70,48,25771,48,5320,70,56,25771,56,5880
0.026,6,12,3462,6,75,5,75,395,6,1373,4,1448,3067
0.121,17,2,904,2,424,121,548,904,0,0,0,0,0
4.547,17,2,656,2,300,4547,300,656,0,0,0,0,0
1798.586,6,152,16187,89,80,20438,519,6853,63,138,29007,1420,9334
0.221,6,25,7216,13,155,18,267,1301,12,678,19,2045,5915
162.806,17,2,148,2,46,162806,46,148,0,0,0,0,0
280.464,6,28,7352,13,158,23372,267,1317,15,678,20030,3456,6035
0.321,6,10,1671,6,552,64,948,1348,4,159,107,159,323
0.104,17,2,158,1,34,0,34,62,1,68,0,68,96
0.483,6,11,440,6,0,95,0,240,5,0,119,0,200
240.196,6,54,17834,30,782,8282,1402,14905,24,209,10442,580,2929
1794.522,6,358,22669,209,69,8627,69,12500,149,69,12122,69,10169
0.015,17,2,440,1,39,0,39,67,1,345,0,345,373
32.351,6,448,372147,208,127,156,304,11414,240,1469,135,2816,360733
195.356,6,13,732,3,0,97678,0,152,10,7,21685,7,580
40.871,6,28,7217,13,155,3405,267,1306,15,482,2918,1997,5911
0.128,17,4,344,2,47,0,47,150,2,69,124,75,194
61.66,6,65,42025,39,1180,1622,1408,33939,26,747,2456,1408,8086
147.137,17,6,3907,6,623,29427,894,3907,0,0,0,0,0
291.824,1,4,224,4,28,97274,28,224,0,0,0,0,0
3.065,17,4,272,2,32,3059,32,120,2,48,3057,48,152
5.018,17,4,288,2,36,4999,36,128,2,52,4999,52,160
15.852,17,15,5040,7,360,2631,1350,2717,8,262,2253,1350,2323
11.892,6,87,26821,46,554,264,1152,20699,41,447,290,1179,6122
186.781,6,238,37632,128,304,1470,304,26032,110,83,1700,83,11600
0.281,17,2,152,1,48,0,48,76,1,48,0,48,76
73.078,1,6,336,6,28,14615,28,336,0,0,0,0,0
1721.154,17,13,534,11,14,172097,14,462,2,8,1720975,8,72
300.654,6,39,8606,20,315,15823,882,2093,19,441,472,1440,6513
628.008,6,65,7729,31,93,16546,722,3027,34,122,19025,1408,4702
246.286,17,3,365,2,114,246286,156,284,1,53,0,53,81
0.249,17,2,152,1,48,0,48,76,1,48,0,48,76
0.41,6,42,16544,23,958,18,1420,11512,19,355,22,1420,5032
67.651,6,22,8137,12,429,61,953,1836,10,981,7503,4080,6301
1796.408,6,358,22669,209,69,8636,69,12500,149,69,12137,69,10169
24.532,6,33,8849,15,340,1752,721,2645,18,548,1414,1440,6204
0.11,1,2,112,2,28,110,28,112,0,0,0,0,0
1792.609,1,272,15232,272,28,6614,28,15232,0,0,0,0,0
1779.85,17,142,11360,71,48,25426,48,5396,71,56,25426,56,5964
0.219,17,2,348,1,39,0,39,67,1,253,0,253,281
1796.696,6,126,7803,72,43,25305,208,4682,54,31,33896,31,3121
3.335,17,32,14636,16,634,222,1350,10595,16,224,211,1350,4041
1780.698,1,96,10176,96,78,18744,78,10176,0,0,0,0,0
280.531,6,32,7853,14,158,21579,267,1357,18,524,16500,1400,6496
280.242,6,27,7312,12,158,25476,267,1277,15,678,20016,2045,6035
627.477,6,173,12715,84,137,7559,469,7361,89,34,6874,48,5354
789.503,6,81,7035,50,69,14711,69,3725,31,69,26316,69,3310
1067.93,6,215,13637,122,69,8825,69,7364,93,69,11607,69,6273
3.93,6,15,3203,8,49,561,92,511,7,464,604,1448,2692
717.551,2,8,256,8,8,102507,8,256,0,0,0,0,0
1.592,6,62,41302,36,1237,45,1408,34045,26,1179,56,3819,7257
0.073,6,15,4072,8,88,10,88,440,7,1670,12,1880,3632
41.793,6,43,8924,21,401,701,889,2136,22,368,1983,3488,6788
1745.493,1,214,11984,214,28,8194,28,11984,0,0,0,0,0
0.179,6,28,7336,14,155,13,267,1341,14,603,12,2800,5995
1774.698,6,190,11669,94,47,19082,208,6837,96,31,18678,31,4832
2.131,17,2,136,1,32,0,32,60,1,48,0,48,76
0.089,6,9,1002,5,213,22,213,417,4,421,27,421,585
842.292,6,21,23992,3,174,75,174,298,18,1435,49540,1452,23694
1.687,17,6,432,3,36,827,36,192,3,52,828,52,240
3.172,17,2,374,1,47,0,47,75,1,271,0,271,299
0.929,6,24,6438,13,310,77,892,2078,11,783,92,1420,4360
300.588,6,49,9128,24,286,13069,766,2220,25,327,623,1460,6908
25.233,6,37,8495,18,410,509,882,1982,19,441,1394,1440,6513
1.389,6,50,18829,27,858,53,1360,13133,23,433,54,1360,5696
1790.011,17,178,26522,178,121,10113,121,26522,0,0,0,0,0
0.54,6,62,27777,35,1042,15,1380,22286,27,387,19,1923,5491
37.727,17,22,1936,11,48,3768,48,836,11,72,3767,72,1100
0.41,6,13,1693,7,288,62,288,588,6,426,48,434,1105
3.011,17,4,272,2,32,3008,32,120,2,48,3006,48,152
1799.884,17,144,11520,72,48,25350,48,5472,72,56,25350,56,6048
0.288,6,29,12731,15,676,20,1408,3531,14,940,17,1408,9200
9.307,6,89,28394,45,565,211,1152,22152,44,407,210,1152,6242
280.181,6,29,7392,13,158,23348,267,1317,16,603,18676,2800,6075
11.337,6,27,11433,13,275,944,275,1078,14,1087,829,1440,10355
156.31,17,22,3588,11,48,15624,48,836,11,222,15622,308,2752
1792.184,6,373,25959,215,98,8374,469,15223,158,69,11414,69,10736
117.087,6,20,820,8,0,5230,0,324,12,0,10643,0,496
1798.455,6,369,25799,215,99,8403,469,15154,154,69,11753,69,10645
1787.765,6,367,24643,212,87,8472,469,14096,155,69,11606,69,10547
84.915,6,36,23922,19,840,32,1360,5835,17,1739,5299,4080,18087
0.052,17,4,368,2,32,11,32,120,2,96,6,96,248
350.412,17,17,711,16,13,23360,14,667,1,16,0,16,44
20.484,6,3,120,1,0,0,0,40,2,0,20482,0,80
0.162,17,2,157,1,31,0,31,59,1,70,0,70,98
1748.76,6,96,7286,63,38,28205,205,4476,33,33,54640,98,2810
1774.75,6,274,33798,111,139,16132,1360,16346,163,131,10954,2720,17452
1798.999,17,449,39928,404,35,4464,288,25708,45,288,40017,288,14220
0.177,6,10,1514,5,503,44,503,771,5,475,44,475,743
1767.21,6,152,15828,78,71,22949,517,5917,74,221,24207,1418,9911
0.942,6,11,1727,7,100,157,100,384,4,589,226,1152,1343
1786.952,6,104,8504,69,66,26278,66,5004,35,60,52554,60,3500
1741.423,6,100,7256,64,31,27641,31,4356,36,31,49754,31,2900
240.207,6,53,15670,28,663,8896,1402,12742,25,202,10008,580,2928
1713.865,6,120,9234,71,63,24483,63,5108,49,57,35702,57,4126
1783.461,6,354,22440,207,69,8657,69,12420,147,69,12215,69,10020
7.432,17,4,352,2,60,7431,60,176,2,60,7431,60,176
65.094,6,12,500,6,0,2594,0,248,6,0,13012,0,252
53.634,6,28,12183,16,713,3575,1408,4405,12,1429,4874,4981,7778
0.277,6,23,5080,11,137,27,267,1132,12,577,24,1400,3948
280.197,6,29,7392,13,158,23349,267,1317,16,603,18677,2800,6075
34.578,17,10,760,10,48,3842,48,760,0,0,0,0,0
251.952,2,3,96,3,8,125976,8,96,0,0,0,0,0
73.65,6,22,8764,11,314,75,634,1427,11,983,7349,1360,7337
421.121,2,4,128,4,8,140373,8,128,0,0,0,0,0
1793.624,6,356,22520,208,69,8664,69,12460,148,69,12201,69,10060
0.129,17,2,404,1,44,0,44,72,1,304,0,304,332
0.263,6,9,1339,5,145,65,145,349,4,826,60,826,990
280.455,6,28,7352,13,158,23371,267,1317,15,678,20027,2760,6035
0.11,6,7,423,4,43,22,43,259,3,0,25,0,164
1786.695,6,106,8456,68,65,26667,65,4930,38,59,48286,59,3526
0.505,17,3,451,2,39,402,39,134,1,289,0,289,317
125.423,6,14,3143,7,92,20903,92,452,7,464,20869,1440,2691
274.329,17,4,240,2,32,274328,32,120,2,32,274328,32,120
1747.52,6,96,7286,63,38,28185,205,4476,33,33,54597,98,2810
44.749,17,22,1672,22,48,2130,48,1672,0,0,0,0,0
1798.166,1,164,9184,164,28,11031,28,9184,0,0,0,0,0
1741.206,6,96,6950,61,31,29020,31,4145,35,31,51211,31,2805
14.804,6,19,4131,10,275,1644,275,683,9,768,1232,1440,3448
3.133,17,8,704,4,37,998,37,260,4,83,110,89,444
1792.862,6,351,22665,198,69,9100,69,12060,153,69,11794,69,10605
144.3,6,14,1238,4,106,48100,106,274,10,90,16029,90,964
300.798,6,17,2485,10,327,33422,327,1401,7,264,50107,276,1084
638.462,17,12,912,12,48,58042,48,912,0,0,0,0,0
1751.957,6,185,11314,93,47,19043,208,6735,92,31,19249,31,4579
0.773,17,2,152,1,48,0,48,76,1,48,0,48,76
184.38,6,10,562,3,106,92185,106,234,7,0,30727,0,328
1.771,6,146,147373,96,225,18,255,8392,50,2901,35,13666,138981
1.472,6,17,2355,9,325,184,587,1123,8,396,207,580,1232
131.175,6,69,15696,31,185,4372,721,4574,38,479,3517,1440,11122
0.396,6,6,328,4,0,132,0,216,2,0,217,0,112
21.848,6,9,527,5,43,5462,43,311,4,0,7281,0,216
5.539,6,43,7429,23,218,251,314,3543,20,513,276,1179,3886
276.656,6,30,7432,13,158,23054,267,1317,17,543,17288,1400,6115
20.13,6,21,5417,12,107,1830,159,1074,9,966,2514,1674,4343
1.006,17,3,196,2,32,972,32,120,1,48,0,48,76
10.02,17,2,124,2,34,10020,34,124,0,0,0,0,0
1788.332,6,123,14675,80,84,22637,498,6426,43,159,42577,1420,8249
6.305,6,1033,875451,617,1373,10,1420,854578,416,467,15,1883,20873
72.18,6,32,14754,16,488,319,1360,3151,16,1095,4803,2522,11603
11.016,6,18,5610,10,275,1224,275,958,8,1440,860,1440,4652
2.408,6,14,2351,8,188,344,245,700,6,703,430,1152,1651
7.908,6,17,6016,6,98,1580,112,542,11,718,789,1460,5474
271.701,6,42,21423,24,190,11813,190,1498,18,1355,14143,1438,19925
240.211,6,57,17767,29,736,8578,1408,14770,28,191,8896,580,2997
191.137,17,18,20584,18,1115,11243,1451,20584,0,0,0,0,0
0.196,1,2,112,2,28,196,28,112,0,0,0,0,0
1786.331,6,102,8364,68,66,26661,66,4964,34,60,54128,60,3400
1787.387,6,356,22520,208,69,8634,69,12460,148,69,12158,69,10060
0.037,17,4,284,2,32,18,32,120,2,54,20,60,164
1785.07,6,356,22520,208,69,8623,69,12460,148,69,12140,69,10060
0.368,6,28,7038,17,242,23,646,2384,11,701,36,1728,4654
6.334,6,38,7229,20,218,333,314,3423,18,513,357,1179,3806
1783.189,6,355,22549,207,69,8656,69,12420,148,69,12130,69,10129
0.344,6,28,7336,14,155,26,267,1341,14,603,26,2800,5995
280.033,6,29,7392,13,158,23336,267,1317,16,603,18666,2036,6075
1779.949,17,142,11360,71,48,25427,48,5396,71,56,25427,56,5964
1791.757,6,115,7509,68,50,26742,208,4575,47,31,38942,31,2934
0.205,6,4,251,2,31,0,31,135,2,0,0,0,116
40.574,6,40,9841,24,545,1764,1244,6156,16,203,2704,1282,3685
3.015,17,7,1544,4,30,1001,30,232,3,409,1501,468,1312
12.185,6,39,18944,21,702,609,1360,5099,18,1008,708,1696,13845
12.026,6,11,460,6,0,2403,0,244,5,0,3003,0,216
1771.693,6,100,9292,66,65,27256,65,5577,34,59,53685,59,3715
14.36,6,14,3614,6,75,2872,75,427,8,1373,1906,1448,3187
1799.369,17,142,11360,71,48,25705,48,5396,71,56,25705,56,5964
9.491,6,15,3213,7,92,1581,92,460,8,581,1210,1408,2753
1790.397,1,278,15568,278,28,6463,28,15568,0,0,0,0,0
145.742,6,2,172,2,46,145742,46,172,0,0,0,0,0
1750.598,17,12,498,11,14,175059,14,462,1,8,0,8,36
0.01,17,2,426,1,37,0,37,65,1,333,0,333,361
7.135,6,39,7269,20,218,375,314,3423,19,513,381,1179,3846
1669.71,1,8,448,8,28,238530,28,448,0,0,0,0,0
175.263,17,2,72,1,8,0,8,36,1,8,0,8,36
1794.0,6,378,24021,216,69,8344,69,13125,162,69,11142,69,10896
280.333,6,28,7352,12,158,25484,267,1277,16,603,18680,1400,6075
39.02,6,32,5153,16,136,2601,722,1917,16,342,2566,1448,3236
33.572,6,35,5522,17,154,2098,722,1986,18,288,1963,2026,3536
0.014,17,2,367,1,33,0,33,61,1,278,0,278,306
1796.921,17,448,39896,403,35,4469,288,25676,45,288,40019,288,14220
1767.437,6,198,25179,109,304,16365,304,17040,89,83,20084,83,8139
24.631,6,3814,3618435,2498,1371,9,1408,3545339,1316,931,18,2801,73096
1776.52,1,60,5040,0,0,0,0,0,60,56,30110,56,5040
5.974,6,46,8465,24,227,259,314,4142,22,491,272,1179,4323
1.344,6,25,9071,13,164,98,267,1352,12,1181,107,3819,7719
8.122,1,9,756,9,56,1015,56,756,0,0,0,0,0
1777.816,17,142,11360,71,48,25396,48,5396,71,56,25396,56,5964
1772.235,6,180,15480,120,69,14892,69,8940,60,69,30032,69,6540
1757.745,2,18,576,18,8,103396,8,576,0,0,0,0,0
0.01,17,2,366,1,36,0,36,64,1,274,0,274,302
1.633,6,29,10388,17,373,102,851,1803,12,1012,140,1420,8585
1640.322,1,8,448,8,28,234331,28,448,0,0,0,0,0
0.21,17,2,172,1,50,0,50,78,1,66,0,66,94
1383.153,6,112,11383,63,70,22306,721,5393,49,90,28811,1448,5990
5.324,6,39,7269,19,218,295,314,3383,20,513,264,1179,3886
3.435,6,2,88,2,0,0,0,88,0,0,0,0,0
248.231,17,4,352,2,60,248230,60,176,2,60,248230,60,176
1766.97,1,230,24380,230,78,7716,78,24380,0,0,0,0,0
300.671,6,49,9333,25,315,12527,882,2365,24,333,505,1460,6968
1787.906,6,407,25076,217,69,8277,69,13027,190,45,9459,69,12049
1.313,6,48,18978,26,942,52,1460,13322,22,433,54,1460,5656
150.714,6,28,12051,14,518,57,1360,2664,14,1101,11582,2720,9387
23.739,17,14,1064,14,48,1826,48,1064,0,0,0,0,0
1799.863,17,255,65933,255,230,7086,422,65933,0,0,0,0,0
1767.309,1,58,4872,58,56,31005,56,4872,0,0,0,0,0
36.091,17,20,1760,10,48,4008,48,760,10,72,4008,72,1000
10.647,6,20,4442,11,275,1064,275,998,9,768,746,1440,3444
31.0,17,6,670,6,83,6200,84,670,0,0,0,0,0
10.425,6,6,328,4,0,3475,0,216,2,0,10196,0,112
1785.859,6,373,25959,215,98,8345,469,15223,158,69,11374,69,10736
1788.949,6,356,22520,208,69,8642,69,12460,148,69,12169,69,10060
11.683,6,1870,1614741,1127,1378,10,1420,1580800,743,467,15,1883,33941
1783.318,17,83,3480,82,14,22016,14,3444,1,8,0,8,36
1792.056,17,180,14040,180,50,10011,50,14040,0,0,0,0,0
165.072,17,4,240,2,32,165071,32,120,2,32,165071,32,120
58.798,6,23,6499,12,274,5341,517,1466,11,744,5874,1408,5033
8.23,6,1645,1503142,1032,1377,7,1408,1466602,613,931,13,2816,36540
1771.759,6,101,9410,66,66,27257,66,5610,35,60,52107,60,3800
1799.893,1,57,4788,0,0,0,0,0,57,56,32140,56,4788
31.885,6,21,6347,9,154,3985,267,832,12,718,2896,1917,5515
1799.979,17,449,39928,404,35,4466,288,25708,45,288,40017,288,14220
0.357,6,20,7151,12,318,31,600,1906,8,1205,50,1891,5245
0.079,6,10,767,5,186,17,186,454,5,45,14,45,313
1789.403,6,375,27927,217,109,8284,1189,15805,158,87,11396,485,12122
29.287,6,38,8732,18,194,1722,721,2475,20,681,1487,1414,6257
1772.553,6,103,9525,67,65,26856,65,5694,36,59,50629,59,3831
1781.774,6,355,22480,207,69,8649,69,12420,148,69,12120,69,10060
0.312,17,2,188,1,37,0,37,65,1,95,0,95,123
124.625,6,32,10147,13,216,312,314,2036,19,667,6909,1179,8111
1681.44,17,14,3815,7,30,280238,30,406,7,459,280238,463,3409
0.088,17,4,608,2,60,0,60,176,2,188,0,188,432
1792.743,1,208,11648,208,28,8660,28,11648,0,0,0,0,0
0.027,17,5,1320,3,60,10,60,264,2,500,14,500,1056
1786.636,6,134,20469,83,276,21788,1302,14642,51,90,35730,241,5827
5.061,6,39,7269,20,218,266,314,3423,19,513,266,1179,3846
0.013,6,2,281,1,0,0,0,40,1,189,0,189,241
232.607,17,4,352,2,60,232605,60,176,2,60,232606,60,176
280.195,6,30,7432,13,158,23349,267,1317,17,543,17509,1400,6115
1740.414,17,30,31680,30,1028,60014,1028,31680,0,0,0,0,0
0.181,17,2,152,1,48,0,48,76,1,48,0,48,76
385.008,6,18,1242,14,180,29616,180,916,4,110,20069,110,326
1.438,6,24,6408,13,297,119,830,2011,11,988,142,1731,4397
4.429,17,2,656,2,300,4429,300,656,0,0,0,0,0
1.22,6,4,184,2,0,1220,0,88,2,0,1022,0,96
1680.584,17,12,498,11,14,168058,14,462,1,8,0,8,36
539.638,17,15,5228,15,320,38545,548,5228,0,0,0,0,0
235.099,6,21,11262,4,106,20,106,274,17,686,14693,1420,10988
145.761,17,5,1672,5,306,36440,308,1672,0,0,0,0,0
1799.925,17,449,39928,404,35,4466,288,25708,45,288,40017,288,14220
19.838,6,3280,2938753,1947,1420,10,1448,2857291,1333,792,14,1448,81462
300.24,6,33,12030,19,593,16680,1408,4594,14,837,18534,2816,7436
1745.057,6,97,7307,63,38,28146,205,4476,34,33,52867,98,2831
280.454,6,30,7432,14,158,21573,267,1357,16,678,18693,3456,6075
60.367,6,156,12884,138,134,440,174,6328,18,583,3541,1452,6556
300.911,6,38,9578,21,537,15045,1360,4096,17,435,540,2720,5482
0.835,6,26,5887,14,156,64,267,1502,12,650,69,1452,4385
11.393,6,76,22342,40,534,292,1152,17118,36,472,317,1179,5224
1078.691,17,82,6544,43,48,25683,48,3268,39,56,25707,56,3276
1775.242,6,183,15738,122,69,14671,69,9158,61,69,29579,69,6580
280.384,6,30,7432,13,158,23365,267,1317,17,543,17522,1300,6115
484.465,6,9,546,6,31,96893,31,333,3,31,242228,31,213
11.74,6,1775,1618878,1144,1363,10,1432,1589062,631,389,18,1432,29816
5.022,17,4,288,2,36,5008,36,128,2,52,5009,52,160
1681.339,17,16,4137,8,30,240189,37,471,8,430,240189,463,3666
0.088,1,2,112,2,28,88,28,112,0,0,0,0,0
111.152,17,3,195,3,37,55576,47,195,0,0,0,0,0
0.017,17,2,253,1,43,0,43,71,1,154,0,154,182
230.319,6,32,8952,14,158,17716,267,1357,18,624,13547,1400,7595
3.408,17,10,2595,5,40,849,40,340,5,423,849,423,2255
2.093,6,53,13930,25,551,87,1429,4892,28,439,73,1986,9038
88.12,17,4,352,2,60,88119,60,176,2,60,88119,60,176
0.82,6,28,5967,13,156,68,267,1462,15,650,53,1420,4505
1.64,6,3,151,1,0,0,0,40,2,7,0,7,111
5.998,6,1331,1211242,829,1383,7,1408,1180474,502,931,11,2816,30768
1770.657,1,67,5628,67,56,26828,56,5628,0,0,0,0,0
60.037,6,8,432,5,0,15009,0,268,3,0,30008,0,164
300.872,6,38,9639,21,547,15043,1360,4157,17,435,538,2667,5482
1785.338,6,104,8376,68,65,26646,65,4930,36,59,51007,59,3446
9.427,6,1915,1609675,1054,1428,8,1448,1550191,861,776,10,1448,59484
281.756,6,29,7392,13,158,23479,267,1317,16,603,18782,2036,6075
160.798,17,4,352,2,60,160797,60,176,2,60,160797,60,176
7.956,6,64,20062,33,541,248,1152,15395,31,489,255,1179,4667
1680.739,17,13,534,11,14,168055,14,462,2,8,1680549,8,72
1741.287,6,87,6322,58,31,30548,31,3915,29,31,62188,31,2407
303.592,6,8,475,6,31,60718,31,333,2,31,299518,31,142
280.474,6,30,7432,13,158,23372,267,1317,17,543,17527,1400,6115
1784.047,17,83,3480,82,14,22025,14,3444,1,8,0,8,36
86.725,6,44,10120,21,677,483,1360,4305,23,325,3934,1360,5815
0.003,6,2,92,1,0,0,0,40,1,0,0,0,52
0.193,6,26,7256,13,155,16,267,1301,13,678,14,2800,5955
1.338,6,53,22537,29,975,47,1440,16801,24,433,50,1440,5736
0.182,17,2,631,2,287,182,292,631,0,0,0,0,0
10.591,6,19,6450,7,213,1763,267,928,12,718,961,1460,5522
300.637,6,38,8341,20,258,15823,688,1867,18,441,499,1440,6474
0.896,6,10,1687,7,100,149,100,384,3,1179,319,1179,1303
0.185,17,2,2756,2,1350,185,1350,2756,0,0,0,0,0
1782.593,1,61,5124,0,0,0,0,0,61,56,29709,56,5124
383.456,6,12,928,10,106,42606,106,832,2,0,1024,0,96
0.518,17,3,451,2,39,502,39,134,1,289,0,289,317
1785.277,6,257,38426,181,372,9918,1290,25862,76,173,23802,1420,12564
1786.994,1,79,6636,0,0,0,0,0,79,56,22910,56,6636
201.358,1,30,840,30,0,0,0,840,0,0,0,0,0
1798.138,17,448,39896,403,35,4472,288,25676,45,288,40017,288,14220
13.471,1,5,280,5,28,3367,28,280,0,0,0,0,0
41.344,17,4,1344,4,308,13781,308,1344,0,0,0,0,0
62.15,6,44,17545,23,828,2825,1408,10334,21,554,3097,1408,7211
10.716,6,20,4442,11,275,1071,275,998,9,768,742,1440,3444
0.496,17,3,451,2,39,15,39,134,1,289,0,289,317
65.866,6,26,2851,12,177,190,177,1541,14,110,5053,110,1310
416.83,6,36,7192,14,165,9708,501,1557,22,263,19845,1420,5635
1780.359,1,74,6216,74,56,24388,56,6216,0,0,0,0,0
0.536,6,27,9141,13,268,44,710,1770,14,947,37,1368,7371
1788.29,6,356,22520,208,69,8639,69,12460,148,69,12165,69,10060
276.802,17,4,240,2,32,276801,32,120,2,32,276801,32,120
1740.416,6,87,6322,58,31,30533,31,3915,29,31,62155,31,2407
300.73,6,36,8434,18,286,17682,800,1898,18,446,17682,3488,6536
12.47,6,7,388,4,0,4156,0,216,3,0,5873,0,172
9.704,6,24,8484,12,498,882,721,2479,12,919,859,1440,6005
3.616,6,6,1257,4,327,1205,414,815,2,181,3392,270,442
280.065,6,29,7392,14,158,21543,267,1357,15,678,19999,3436,6035
0.496,6,59,24577,33,966,15,1380,15947,26,630,18,3303,8630
13.27,17,576,368033,573,614,23,1472,367913,3,12,4989,12,120
0.311,17,2,304,1,60,0,60,88,1,188,0,188,216
1785.856,6,377,26257,217,97,8267,469,15441,160,69,11231,69,10816
302.162,6,33,6397,17,286,18885,1314,2405,16,334,20143,1420,3992
290.712,6,71,8971,33,130,6046,722,3593,38,121,7852,2026,5378
33.695,6,32,5145,15,180,2406,722,1858,17,266,2091,1408,3287
1772.586,6,182,15629,121,69,14771,69,8980,61,69,29535,69,6649
1786.054,6,491,87189,311,304,5761,304,64516,180,83,9977,83,22673
1619.346,17,18,4790,9,30,202417,37,529,9,445,202417,463,4261
21.611,17,38,8029,17,241,1348,1350,4574,21,136,1078,1350,3455
0.057,17,2,640,2,292,57,298,640,0,0,0,0,0
5.018,17,4,384,2,37,5007,37,130,2,99,5010,99,254
1747.655,6,163,10040,85,46,20805,208,6021,78,31,22693,31,4019
160.591,1,30,3120,0,0,0,0,0,30,76,5537,76,3120
1785.273,17,142,11360,71,48,25503,48,5396,71,56,25503,56,5964
1705.449,17,16,4127,16,229,113696,682,4127,0,0,0,0,0
0.86,6,2,87,1,0,0,0,40,1,7,0,7,47
8.327,6,7,300,3,0,4163,0,124,4,0,2743,0,176
15.779,17,15,8901,9,736,1965,1350,6883,6,308,3141,1350,2018
1.299,6,10,1687,7,100,216,100,384,3,1179,527,1179,1303
4.161,17,2,656,2,300,4161,300,656,0,0,0,0,0
1795.486,17,449,39928,404,35,4455,288,25708,45,288,40019,288,14220
110.133,17,143,10704,17,39,3770,288,1152,126,47,879,288,9552
1.926,6,14,2351,8,188,275,245,700,6,703,333,1152,1651
6.09,6,613,558230,396,1344,14,1368,542270,217,776,27,1473,15960
1.476,6,25,8056,12,164,114,267,1288,13,1014,105,2491,6768
1772.464,6,180,15480,120,69,14894,69,8940,60,69,30034,69,6540
102.349,17,10,800,5,48,25584,48,380,5,56,25583,56,420
55.137,6,30,7552,11,155,8,267,1226,19,370,3062,1997,6326
3.241,17,68,54776,28,463,120,1350,13762,40,997,82,1350,41014
1.187,6,25,8080,12,164,91,267,1312,13,869,83,1408,6768
300.86,6,48,10403,24,433,13080,910,3206,24,327,428,1460,7197
0.075,17,2,164,1,46,0,46,74,1,62,0,62,90
85.231,6,40,11102,17,279,2434,1189,2921,23,604,3873,4837,8181
0.007,17,2,460,1,64,0,64,92,1,340,0,340,368
2.876,17,3,186,3,34,1438,34,186,0,0,0,0,0
369.61,6,53,7101,27,304,14215,304,4780,26,83,14772,83,2321
75.504,6,84,57011,51,1207,1510,1368,48561,33,747,1934,1368,8450
1744.739,2,15,480,15,8,124624,8,480,0,0,0,0,0
1723.81,17,142,23891,142,140,12225,377,23891,0,0,0,0,0
128.905,17,4,240,2,32,128904,32,120,2,32,128904,32,120
174.316,6,26,12000,12,549,55,1460,2709,14,1089,13399,1460,9291
31.065,17,6,468,6,50,6213,50,468,0,0,0,0,0
2.953,6,12,3705,6,171,590,171,491,6,964,590,1448,3214
6.744,6,44,8369,23,227,306,314,4102,21,489,323,1179,4267
5.019,17,4,530,2,36,5004,36,128,2,173,5006,187,402
1800.0,6,211,16466,78,72,22986,332,7872,133,48,13636,78,8594
1670.442,1,9,504,9,28,208805,28,504,0,0,0,0,0
1799.689,17,448,39896,403,35,4476,288,25676,45,288,40018,288,14220
1756.655,17,331,59097,331,150,5323,386,59097,0,0,0,0,0
15.109,17,11,4800,5,505,3769,1350,2665,6,327,3015,1350,2135
240.274,6,43,8983,21,523,12013,1408,5808,22,224,11441,617,3175
1785.261,6,184,21655,98,66,18404,721,7758,86,243,21000,1414,13897
168.556,6,32,8952,15,158,12039,267,1397,17,687,10528,1781,7555
1798.414,1,345,28980,345,56,5227,56,28980,0,0,0,0,0
240.297,6,42,8714,20,524,12646,1418,5766,22,256,11442,618,2948
1783.811,6,365,25432,213,100,8414,469,14936,152,69,11813,69,10496
2.669,17,27,21094,13,722,222,1350,9757,14,781,191,1350,11337
284.963,6,8,2017,5,355,71240,413,1267,3,210,142341,269,750
0.199,6,23,7325,12,177,18,337,1342,11,1080,17,1588,5983
300.802,2,4,128,4,8,100267,8,128,0,0,0,0,0
44.469,6,30,7297,14,155,3420,267,1346,16,441,2964,1420,5951
1788.984,17,142,11360,71,48,25556,48,5396,71,56,25556,56,5964
0.787,6,17,5164,9,150,98,174,664,8,835,97,1452,4500
2.663,1,10,840,10,56,295,56,840,0,0,0,0,0
2.798,17,2,204,1,34,0,34,62,1,114,0,114,142
0.011,17,2,268,1,32,0,32,60,1,180,0,180,208
1747.532,6,95,7203,63,38,28186,205,4476,32,33,56360,98,2727
1799.439,1,16,896,16,28,119962,28,896,0,0,0,0,0
0.016,17,4,344,2,47,0,47,150,2,69,1,75,194
1797.068,17,448,39896,403,35,4470,288,25676,45,288,40016,288,14220
1785.861,6,364,25530,210,100,8544,469,14816,154,69,11672,69,10714
280.334,6,28,7352,13,158,23361,267,1317,15,678,20019,2045,6035
0.441,6,23,5972,12,108,39,147,919,11,921,43,1581,5053
1794.672,6,365,23087,211,69,8546,69,12787,154,69,11729,69,10300
300.679,6,38,8566,20,315,15825,882,2093,18,441,500,1440,6473
240.114,6,42,4970,22,181,11433,517,2255,20,185,12637,851,2715
0.872,17,2,586,1,46,0,46,74,1,484,0,484,512
300.641,6,38,8450,19,286,16702,797,1936,19,441,471,1460,6514
13.955,17,4,1344,4,308,4651,308,1344,0,0,0,0,0
10.626,6,87,26613,44,548,247,1152,20411,43,447,245,1179,6202
1.666,6,19,3781,10,234,185,564,1452,9,463,184,1343,2329
1172.157,6,239,15356,133,70,8879,138,8287,106,69,11162,69,7069
1789.09,17,142,11360,71,48,25558,48,5396,71,56,25558,56,5964
1776.657,17,73,3060,72,14,25023,14,3024,1,8,0,8,36
1789.693,1,275,15400,275,28,6531,28,15400,0,0,0,0,0
1.069,17,4,684,2,39,1030,39,134,2,247,0,255,550
1783.814,6,350,22708,203,69,8830,69,12053,147,80,12217,421,10655
3.096,17,2,255,1,43,0,43,71,1,156,0,156,184
61.319,6,36,15980,22,810,2919,1408,9254,14,748,4697,2816,6726
367.246,6,23,1511,14,177,28249,177,925,9,110,9165,110,586
1791.292,17,86,3606,85,14,21324,14,3570,1,8,0,8,36
240.317,6,60,18198,30,753,8286,1418,15126,30,214,8286,580,3072
1750.721,17,13,534,11,14,175052,14,462,2,8,1750538,8,72
0.04,17,4,368,2,32,20,32,120,2,96,0,96,248
12.591,6,32,8222,15,370,899,721,2085,17,681,774,2840,6137
582.422,6,38,2739,21,31,29111,31,1402,17,31,36389,31,1337
79.274,6,716,332504,377,818,210,1152,313098,339,417,233,1179,19406
299.513,1,3,168,3,28,149756,28,168,0,0,0,0,0
1.388,6,11,976,5,283,301,283,551,6,105,242,105,425
1785.853,6,359,22709,209,69,8585,69,12569,150,69,11985,69,10140
1794.221,17,179,11456,179,36,10079,36,11456,0,0,0,0,0
1.38,6,41,10554,21,513,69,1440,4978,20,433,62,1440,5576
58.842,17,8,704,4,48,19607,48,304,4,72,19607,72,400
1796.445,1,234,24804,234,78,7710,78,24804,0,0,0,0,0
20.242,6,17,2316,10,189,2249,517,1298,7,323,3372,499,1018
0.909,17,2,144,1,36,0,36,64,1,52,0,52,80
0.107,6,26,14983,11,273,10,517,1401,15,1163,6,1402,13582
0.597,6,11,911,6,181,119,181,489,5,77,90,133,422
0.472,6,2,92,2,0,0,0,92,0,0,0,0,0
1793.499,17,350,61807,350,148,5138,391,61807,0,0,0,0,0
56.37,6,31,7731,11,156,9,267,1232,20,355,2966,3417,6499
1779.391,1,58,4872,58,56,31217,56,4872,0,0,0,0,0
180.741,6,29,8542,15,229,12900,778,1936,14,588,13892,1448,6606
0.126,17,4,284,2,32,59,32,120,2,54,68,60,164
1776.261,17,73,3060,72,14,25017,14,3024,1,8,0,8,36
4.208,6,42,8657,22,301,200,1162,3036,20,400,195,1460,5621
30.055,6,2606,2217809,1511,1378,19,1448,2152457,1095,776,27,1448,65352
0.312,17,2,2128,2,1036,312,1036,2128,0,0,0,0,0
12.828,17,3,984,3,300,6414,300,984,0,0,0,0,0
1789.42,17,144,11520,72,48,25202,48,5472,72,56,25202,56,6048
1.381,6,44,10157,23,440,62,1360,4496,21,437,60,2715,5661
1799.807,17,449,39928,404,35,4466,288,25708,45,288,40019,288,14220
1.882,6,30,10442,18,372,110,849,1841,12,1014,162,1414,8601
5.446,6,39,7269,20,218,286,314,3423,19,513,288,1179,3846
0.247,17,3,451,2,39,44,39,134,1,289,0,289,317
1798.165,1,58,4872,58,56,31546,56,4872,0,0,0,0,0
151.004,6,57,10768,23,226,4211,1189,3193,34,344,4575,1926,7575
1.895,17,4,352,2,60,1894,60,176,2,60,1894,60,176
0.143,17,4,588,2,48,132,48,152,2,190,131,308,436
1786.841,17,87,3648,86,14,21021,14,3612,1,8,0,8,36
16.719,6,100,35167,54,614,315,1152,29186,46,413,223,1152,5981
124.582,6,59,38807,38,1159,3367,1408,30973,21,748,3071,1408,7834
102.003,17,2,148,2,46,102003,46,148,0,0,0,0,0
276.89,6,94,46685,41,563,6917,1460,11308,53,923,5321,1460,35377
15.951,17,17,7707,9,593,1966,1350,5596,8,235,2259,1350,2111
1786.053,6,109,8641,69,65,26265,65,5035,40,59,45791,59,3606
1793.985,17,180,14040,180,50,10022,50,14040,0,0,0,0,0
1793.882,17,66,2766,65,14,28029,14,2730,1,8,0,8,36
1798.72,17,451,40276,405,35,4452,288,25740,46,288,39133,288,14536
1679.55,17,12,498,11,14,167955,14,462,1,8,0,8,36
4.004,17,8,1304,4,33,1333,33,244,4,237,1333,249,1060
11.046,6,20,4390,11,275,1104,275,998,9,755,735,1414,3392
325.103,6,98,69671,62,1226,5329,1408,59658,36,739,2463,2439,10013
1770.642,1,58,4872,0,0,0,0,0,58,56,31063,56,4872
1770.56,6,112,10414,71,66,25293,66,6038,41,60,44261,60,4376
0.01,17,2,414,1,32,0,32,60,1,326,0,326,354
1741.332,17,30,31680,30,1028,60045,1028,31680,0,0,0,0,0
821.582,1,12,672,12,28,74689,28,672,0,0,0,0,0
16.414,2,4,128,4,8,5471,8,128,0,0,0,0,0
0.088,6,3,156,0,0,0,0,0,3,0,0,0,156
11.683,17,15,17682,15,1150,834,1451,17682,0,0,0,0,0
1791.75,1,148,8288,148,28,12188,28,8288,0,0,0,0,0
0.023,6,10,1723,6,578,3,997,1400,4,159,7,159,323
30.727,6,11,472,2,0,325,0,100,9,0,3823,0,372
0.49,17,8,2750,8,315,70,354,2750,0,0,0,0,0
437.793,17,8,2688,8,308,62541,308,2688,0,0,0,0,0
1.253,6,39,8294,19,321,69,1164,2718,20,433,57,1360,5576
0.036,17,4,284,2,32,17,32,120,2,54,22,60,164
0.788,6,17,5060,10,760,87,1360,4220,7,274,105,396,840
3.944,17,3,1173,3,363,1972,363,1173,0,0,0,0,0
451.837,6,434,369005,287,1334,1579,1408,340645,147,544,2886,2439,28360
1772.512,6,180,15480,120,69,14895,69,8940,60,69,30035,69,6540
1741.201,6,87,6322,58,31,30547,31,3915,29,31,62185,31,2407
1.462,6,56,17826,27,765,56,1440,8757,29,438,51,1440,9069
69.551,6,29,7326,13,155,5795,267,1306,16,447,4636,1997,6020
16.635,6,20,3497,11,211,1663,211,1038,9,665,2078,904,2459
1792.402,17,179,13962,179,50,10069,50,13962,0,0,0,0,0
1794.104,6,310,27053,173,75,10354,267,11915,137,130,13191,1452,15138
0.951,6,25,9559,14,350,73,1044,1995,11,1016,77,1460,7564
5.626,6,38,7229,20,218,296,314,3423,18,513,314,1179,3806
2.548,17,4,1564,4,363,849,363,1564,0,0,0,0,0
280.245,6,27,7312,12,158,25476,267,1277,15,678,20012,2045,6035
0.533,6,10,924,5,283,91,283,551,5,105,91,105,373
373.851,6,27,1767,18,177,21991,177,1181,9,110,8789,110,586
1744.617,6,99,7473,65,38,27259,205,4580,34,33,52851,98,2893
0.288,17,3,234,2,39,140,39,134,1,72,0,72,100
1771.348,6,106,9811,68,65,26438,65,5758,38,59,47871,59,4053
17.237,6,2690,2479705,1717,1365,9,1408,2424445,973,931,17,2801,55260
4.116,17,4,296,4,46,1372,46,296,0,0,0,0,0
1741.713,6,87,6322,58,31,30556,31,3915,29,31,62203,31,2407
10.009,6,83,24845,41,542,250,1152,19008,42,461,237,1179,5837
4.995,17,3,433,2,37,4982,37,130,1,275,0,275,303
7.476,1,12,1248,0,0,0,0,0,12,76,679,76,1248
0.093,6,11,913,6,182,18,182,490,5,77,22,134,423
2.987,1,3,168,3,28,1493,28,168,0,0,0,0,0
34.032,6,12,1445,3,585,975,585,749,9,212,4253,212,696
0.043,6,2,80,1,0,0,0,40,1,0,0,0,40
2.984,1,3,168,3,28,1492,28,168,0,0,0,0,0
0.039,17,2,154,1,33,0,33,61,1,65,0,65,93
0.009,17,4,284,2,32,6,32,120,2,54,5,60,164
282.818,6,31,6759,13,186,9193,501,1455,18,305,16631,1420,5304
17.662,17,24,9592,12,555,1602,1350,7002,12,187,1602,1350,2590
48.712,17,4,240,2,32,48710,32,120,2,32,48711,32,120
106.58,6,20,812,8,0,7763,0,324,12,0,9688,0,488
0.537,6,13,1693,7,288,83,288,588,6,426,59,434,1105
9.118,6,79,24717,40,561,233,1152,19016,39,413,233,1152,5701
1786.749,6,356,22520,208,69,8631,69,12460,148,69,12154,69,10060
9.773,6,84,24917,42,561,238,1152,19096,42,413,232,1152,5821
1147.217,1,31,2604,31,56,38240,56,2604,0,0,0,0,0
1290.233,6,254,16232,143,69,8782,69,8618,111,69,11729,69,7614
1776.201,17,73,3060,72,14,25016,14,3024,1,8,0,8,36
1.934,6,9,527,5,43,483,43,311,4,0,643,0,216
1748.681,6,153,9370,82,44,21588,208,5600,71,31,24977,31,3770
1.355,17,14,7074,7,613,225,1350,4493,7,340,220,1350,2581
1770.401,17,249,47893,249,164,7138,353,47893,0,0,0,0,0
0.474,6,26,7495,16,302,31,693,2761,10,721,51,1420,4734
7.009,6,5,338,2,69,7009,69,149,3,69,1156,69,189
295.543,1,4,224,4,28,98514,28,224,0,0,0,0,0
10.016,17,3,486,2,43,10011,43,142,1,316,0,316,344
1771.538,6,83,4406,42,26,43206,26,2236,41,26,44286,26,2170
1787.083,6,358,23083,202,69,8890,69,12220,156,69,11529,69,10863
1799.055,17,448,39896,403,35,4475,288,25676,45,288,40020,288,14220
2.35,17,21,5922,8,274,335,1350,2416,13,241,130,1350,3506
208.238,6,35,8887,14,153,12678,516,1640,21,376,10407,1452,7247
1754.173,17,277,60904,277,191,6355,422,60904,0,0,0,0,0
0.129,1,2,112,2,28,129,28,112,0,0,0,0,0
1770.427,6,333,21117,194,69,9173,69,11693,139,69,12828,69,9424
0.199,6,10,1512,5,503,49,503,771,5,473,49,473,741
8.84,17,27,8061,12,394,800,1350,5075,15,171,628,1350,2986
1511.045,2,12,384,12,8,137367,8,384,0,0,0,0,0
7.526,6,1195,1034872,735,1357,10,1420,1012085,460,427,16,1420,22787
1757.002,6,266,39296,157,304,11262,304,28236,109,83,16266,83,11060
131.676,6,22,10160,11,433,81,990,1771,11,1133,13153,2568,8389
0.867,6,24,6015,13,108,72,147,959,11,922,83,2602,5056
0.113,17,8,2454,8,278,16,317,2454,0,0,0,0,0
1740.416,1,15,870,15,30,124315,30,870,0,0,0,0,0
280.486,6,28,7352,12,158,25498,267,1277,16,678,18693,2760,6075
0.091,17,4,284,2,32,13,32,120,2,54,79,60,164
592.3,6,260,97955,129,691,1644,1460,66852,131,391,4555,1642,31103
0.767,6,1843,2438191,726,223,1,517,38879,1117,2105,0,12618,2399312
1787.733,6,348,68545,154,329,11683,1460,43152,194,179,9262,1460,25393
138.242,17,6,456,6,48,27648,48,456,0,0,0,0,0
131.06,6,20,4217,7,407,1199,722,1186,13,261,10907,1408,3031
1745.37,1,53,4452,53,56,33564,56,4452,0,0,0,0,0
0.297,17,4,502,2,31,285,31,118,2,164,283,164,384
3.159,17,3,201,3,39,1579,39,201,0,0,0,0,0
1.727,6,50,20009,28,880,63,1360,14353,22,433,72,1360,5656
0.425,6,50,22110,28,1054,15,1380,16988,22,421,18,1923,5122
33.661,6,31,5094,15,154,2404,722,1859,16,342,2231,1408,3235
15.115,17,11,4193,5,414,3771,1350,2211,6,302,3016,1350,1982
0.962,6,4,220,2,0,962,0,100,2,0,306,0,120
1741.327,6,87,6322,58,31,30549,31,3915,29,31,62189,31,2407
115.171,17,6,528,3,60,57585,60,264,3,60,57585,60,264
0.362,17,2,152,1,48,0,48,76,1,48,0,48,76
0.058,17,2,195,1,44,0,44,72,1,95,0,95,123
0.122,6,24,14149,13,126,10,126,810,11,1594,11,3905,13339
7.282,6,35,14999,20,289,383,599,1671,15,1156,502,1452,13328
300.591,6,36,8391,19,291,16699,786,1957,17,478,526,2720,6434
75.514,6,38,8547,21,316,3775,633,1833,17,501,535,3488,6714
0.586,6,16,1825,8,288,58,288,640,8,284,57,434,1185
0.704,6,10,924,5,283,129,283,551,5,105,130,105,373
0.944,17,20,12477,11,896,91,1350,10170,9,228,113,1350,2307
0.963,17,4,368,2,32,829,32,120,2,96,850,96,248
1797.825,17,448,39896,403,35,4472,288,25676,45,288,40018,288,14220
159.142,17,2,152,2,48,159142,48,152,0,0,0,0,0
8.431,6,15,5673,4,106,2806,106,274,11,823,842,1460,5399
1797.191,1,345,28980,345,56,5224,56,28980,0,0,0,0,0
168.072,17,2,150,2,47,168072,47,150,0,0,0,0,0
0.439,6,27,9065,13,257,36,669,1714,14,945,31,1438,7351
1798.156,6,130,8202,74,47,24632,208,5032,56,31,32688,31,3170
10.758,6,19,4362,11,275,1075,275,998,8,1010,855,2840,3364
45.655,2,3,96,3,8,22827,8,96,0,0,0,0,0
237.856,17,4,352,2,60,237855,60,176,2,60,237855,60,176
1741.417,6,87,6322,58,31,30551,31,3915,29,31,62193,31,2407
0.148,6,16,6734,8,120,20,120,544,8,1153,21,1448,6190
22.098,17,29,13614,15,670,1576,1350,10474,14,196,1697,1350,3140
1799.134,6,133,8561,75,50,24310,208,5280,58,31,31560,31,3281
225.918,1,4,224,4,28,75306,28,224,0,0,0,0,0
10.354,6,6,328,4,0,3451,0,216,2,0,10133,0,112
8.858,6,17,5391,9,275,1107,275,643,8,1104,1102,1440,4748
0.012,17,2,322,1,33,0,33,61,1,233,0,233,261
45.148,17,46,6644,23,48,2051,48,1748,23,184,2051,308,4896
1756.842,6,105,6240,60,26,29775,26,3510,45,26,39925,26,2730
1.177,6,4,224,2,0,998,0,120,2,0,996,0,104
10.706,6,16,4230,7,92,1784,92,452,9,472,1313,2118,3778
661.778,2,7,224,7,8,110296,8,224,0,0,0,0,0
34.725,17,20,1760,10,48,3857,48,760,10,72,3857,72,1000
504.25,6,41,7702,26,121,20170,516,2380,15,362,31431,1452,5322
3.096,17,4,624,4,128,1032,128,624,0,0,0,0,0
0.402,6,50,20455,27,1012,15,1380,15293,23,383,16,1380,5162
82.65,6,80,56020,50,1219,1686,1368,47726,30,747,2135,1368,8294
1771.848,6,180,15480,120,69,14889,69,8940,60,69,30030,69,6540
0.055,17,2,168,1,48,0,48,76,1,64,0,64,92
0.091,17,2,204,1,51,0,51,79,1,97,0,97,125
0.048,17,4,352,2,37,0,37,130,2,83,22,89,222
241.173,6,168,117316,75,208,3257,581,5160,93,1308,2618,1732,112156
0.081,6,11,1566,6,503,16,503,823,5,475,20,475,743
122.645,6,50,14666,25,969,494,1360,8833,25,370,5102,1360,5833
1773.621,17,44,14784,44,308,41247,308,14784,0,0,0,0,0
1794.453,17,87,3648,86,14,21111,14,3612,1,8,0,8,36
21.793,6,3129,2742946,1821,1414,11,1448,2659986,1308,776,16,1448,82960
281.78,6,27,6017,14,321,21675,517,1403,13,491,4671,1408,4614
5.721,6,40,7309,21,218,286,314,3463,19,513,301,1179,3846
350.355,17,6,528,3,60,175176,60,264,3,60,175177,60,264
1773.024,6,181,15589,120,69,14899,69,8940,61,69,29548,69,6649
1794.212,17,142,11360,71,48,25631,48,5396,71,56,25631,56,5964
1787.81,17,83,3480,82,14,22071,14,3444,1,8,0,8,36
232.504,6,95,70591,62,1250,3811,1408,60740,33,677,3965,1408,9851
11.245,6,1788,1553544,1082,1382,10,1420,1521083,706,467,15,1883,32461
236.227,1,4,224,4,28,78742,28,224,0,0,0,0,0
1.234,6,49,20263,28,899,45,1360,14647,21,476,53,2715,5616
1786.764,6,102,8296,68,65,26668,65,4930,34,59,54141,59,3366
1468.688,6,289,18391,168,69,8794,69,10101,121,69,12238,69,8290
4.377,6,2,88,2,0,0,0,88,0,0,0,0,0
3.442,1,10,280,10,0,0,0,280,0,0,0,0,0
1771.616,6,99,9240,66,65,27255,65,5577,33,59,55360,59,3663
300.916,6,52,16522,28,955,11145,1460,10715,24,371,377,1460,5807
541.936,6,36,2120,21,26,27091,26,1222,15,26,38702,26,898
0.149,17,2,198,1,39,0,39,67,1,103,0,103,131
354.808,17,6,456,6,48,70961,48,456,0,0,0,0,0
2.054,6,51,21400,29,906,73,1360,15699,22,480,89,4075,5701
0.109,17,2,586,1,46,0,46,74,1,484,0,484,512
0.391,6,26,9017,13,257,32,669,1714,13,945,30,1438,7303
34.986,6,37,6307,18,142,2058,722,2085,19,357,1933,2026,4222
0.253,6,15,6589,8,339,36,339,787,7,1086,32,1368,5802
1.161,6,23,7952,13,164,82,267,1340,10,1216,109,3819,6612
1796.509,6,378,23952,216,69,8355,69,13332,162,69,11158,69,10620
1799.603,1,198,11088,198,28,9135,28,11088,0,0,0,0,0
1798.891,1,128,13568,128,78,14164,78,13568,0,0,0,0,0
240.209,6,53,19847,29,849,8578,1408,16801,24,255,10443,580,3046
1709.13,1,15,840,15,28,122080,28,840,0,0,0,0,0
112.359,17,4,352,2,60,112358,60,176,2,60,112357,60,176
279.174,17,4,240,2,32,279173,32,120,2,32,279173,32,120
1542.786,17,120,46680,120,361,12964,361,46680,0,0,0,0,0
1799.634,17,449,39928,404,35,4465,288,25708,45,288,40019,288,14220
57.837,6,71,51666,29,338,2065,1289,3533,42,1312,1410,1753,48133
1771.408,6,101,9410,66,66,27252,66,5610,35,60,52095,60,3800
31.65,6,7,336,1,0,0,0,48,6,0,6323,0,288
1797.674,1,248,13888,248,28,7278,28,13888,0,0,0,0,0
1799.168,17,142,11360,71,48,25702,48,5396,71,56,25702,56,5964
1790.921,17,142,11360,71,48,25584,48,5396,71,56,25583,56,5964
1796.205,6,372,26126,215,99,8393,469,15085,157,69,11514,69,11041
3.647,17,10,2338,5,30,907,30,290,5,381,909,484,2048
0.052,17,2,166,1,47,0,47,75,1,63,0,63,91
1.052,6,14,1093,8,182,150,182,602,6,77,206,134,491
7.142,6,1610,1485868,986,1427,7,1448,1448744,624,776,11,1448,37124
1770.101,6,99,9306,66,66,27232,66,5610,33,60,55313,60,3696
150.789,17,4,352,2,60,150788,60,176,2,60,150788,60,176
1784.452,17,82,3438,81,14,22305,14,3402,1,8,0,8,36
219.236,17,4,294,2,34,219229,37,125,2,56,219230,60,169
1792.115,6,356,22520,208,69,8657,69,12460,148,69,12191,69,10060
0.718,17,4,368,2,64,717,64,184,2,64,716,64,184
145.037,6,80,54013,49,1197,3021,1448,45678,31,746,2058,1448,8335
280.318,6,30,7432,13,158,23359,267,1317,17,543,17515,1300,6115
1771.958,6,180,15480,120,69,14890,69,8940,60,69,30031,69,6540
53.296,6,53,10627,27,533,600,910,3319,26,329,2126,2128,7308
0.027,17,4,320,2,52,0,52,160,2,52,10,52,160
5.055,6,39,7269,20,218,266,314,3423,19,513,266,1179,3846
300.771,2,3,96,3,8,150385,8,96,0,0,0,0,0
0.12,17,8,2438,8,276,17,315,2438,0,0,0,0,0
165.206,6,34,7688,15,158,11800,267,1397,19,460,9176,1400,6291
217.179,6,22,7511,7,267,402,502,1086,15,485,15506,1420,6425
1794.503,17,172,13416,172,50,10494,50,13416,0,0,0,0,0
1711.191,1,8,848,8,78,244455,78,848,0,0,0,0,0
1787.966,6,356,22520,208,69,8637,69,12460,148,69,12160,69,10060
0.942,17,3,1164,3,360,471,360,1164,0,0,0,0,0
5.506,6,39,7269,21,218,275,314,3463,18,513,308,1179,3806
1791.723,6,360,22818,210,69,8572,69,12678,150,69,12024,69,10140
4.608,6,39,7285,20,218,242,314,3423,19,516,242,1179,3862
0.827,6,55,14070,26,551,33,1429,4932,29,419,28,1460,9138
1745.505,6,95,7203,63,38,28153,205,4476,32,33,56296,98,2727
131.099,6,124,95171,79,1297,1680,1448,83261,45,637,2974,1448,11910
6.768,6,65,20518,34,556,205,1152,15835,31,491,216,1179,4683
240.184,6,54,18352,29,778,8577,1402,15528,25,189,10007,580,2824
1.645,6,34,6618,17,149,102,267,2033,17,650,90,1304,4585
1799.402,17,449,39928,404,35,4465,288,25708,45,288,40015,288,14220
1742.852,6,95,7203,63,38,28110,205,4476,32,33,56207,98,2727
4.08,17,5,290,5,30,1020,30,290,0,0,0,0,0
35.35,6,4923,4744024,3294,1363,10,1408,4654628,1629,931,21,2801,89396
44.052,6,895,770481,536,1358,82,1368,745399,359,899,122,2736,25082
1790.627,17,87,3648,86,14,21066,14,3612,1,8,0,8,36
371.547,6,25,1651,17,177,23221,177,1117,8,110,9232,110,534
572.699,17,288,21110,204,40,2820,41,14003,84,56,468,57,7107
0.09,6,12,963,6,181,18,181,489,6,77,16,133,474
0.001,17,2,136,1,32,0,32,60,1,48,0,48,76
1666.869,1,7,392,7,28,277811,28,392,0,0,0,0,0
18.69,6,99,41911,54,727,352,1360,27720,45,589,386,2720,14191
223.056,17,2,672,2,308,223056,308,672,0,0,0,0,0
1794.464,1,130,13780,130,78,13910,78,13780,0,0,0,0,0
25.863,6,3365,3157803,2128,1404,12,1448,3088815,1237,776,20,1448,68988
15.982,17,19,11888,11,853,1591,1350,9695,8,246,2271,1350,2193
24.158,6,43,12443,21,188,1207,721,2163,22,722,1141,1420,10280
300.801,6,51,10641,26,439,12032,910,3342,25,314,782,2720,7299
1780.263,17,142,11360,71,48,25432,48,5396,71,56,25432,56,5964
81.372,17,4,352,2,60,81371,60,176,2,60,81371,60,176
280.313,6,28,7352,12,158,25483,267,1277,16,603,18682,1400,6075
358.589,6,41,9080,18,156,12807,516,1974,23,343,16295,1452,7106
73.545,6,128,99388,83,1262,896,1368,88921,45,738,1644,2519,10467
1781.308,17,142,11360,71,48,25447,48,5396,71,56,25447,56,5964
1740.543,17,29,30624,29,1028,62162,1028,30624,0,0,0,0,0
1776.441,17,142,11360,71,48,25377,48,5396,71,56,25377,56,5964
10.874,6,85,24957,41,544,271,1152,19056,44,413,246,1152,5901
1564.199,2,16,512,16,8,104279,8,512,0,0,0,0,0
163.149,6,33,8992,15,158,11653,267,1397,18,624,9593,1400,7595
1772.933,6,180,15480,120,69,14898,69,8940,60,69,30047,69,6540
1783.336,1,58,4872,58,56,31286,56,4872,0,0,0,0,0
0.012,17,2,487,1,40,0,40,68,1,391,0,391,419
0.008,17,2,557,1,45,0,45,73,1,456,0,456,484
0.368,6,20,7151,12,318,33,600,1906,8,964,49,1471,5245
1741.557,17,29,19517,29,645,62198,645,19517,0,0,0,0,0
510.385,17,8,336,8,14,72912,14,336,0,0,0,0,0
1798.135,1,232,12992,232,28,7784,28,12992,0,0,0,0,0
280.198,6,26,7272,12,158,25472,267,1277,14,775,21551,2800,5995
192.908,17,9,2097,9,205,24113,205,2097,0,0,0,0,0
3.278,6,12,1580,7,279,546,279,918,5,191,582,272,662
0.264,17,2,167,1,39,0,39,67,1,72,0,72,100
1729.201,6,62,4504,40,33,44338,33,2740,22,31,82333,31,1764
0.055,17,2,255,1,43,0,43,71,1,156,0,156,184
1798.139,17,449,39928,404,35,4461,288,25708,45,288,40019,288,14220
0.315,6,21,7281,13,334,25,663,2021,8,1209,44,2816,5260
8.804,6,16,1402,8,275,1257,275,878,8,96,1116,96,524
1.014,17,4,268,2,39,1004,39,134,2,39,1003,39,134
11.099,6,18,5610,10,275,1233,275,958,8,1440,856,1440,4652
8.162,6,1337,1125581,797,1362,10,1380,1099727,540,421,15,1923,25854
0.0,6,1,264,0,0,0,0,0,1,224,0,224,264
280.185,6,27,7312,12,158,25471,267,1277,15,678,20010,2045,6035
1792.136,1,58,4872,58,56,31440,56,4872,0,0,0,0,0
693.085,17,191,31544,93,218,7533,1350,22956,98,59,6674,1350,8588
307.102,17,26,2080,13,48,25591,48,988,13,56,25590,56,1092
0.487,6,24,6040,13,108,40,147,959,11,772,45,1608,5081
206.52,1,28,2352,28,56,7648,56,2352,0,0,0,0,0
1655.987,1,22,2812,22,99,78856,173,2812,0,0,0,0,0
1794.419,17,180,11520,180,36,10024,36,11520,0,0,0,0,0
61.91,6,75,47290,43,1182,1474,1448,38895,32,747,1989,1448,8395
96.753,6,34,15464,16,585,59,1440,3609,18,926,5683,1440,11855
240.201,6,55,19442,29,837,8578,1408,16595,26,185,9607,580,2847
0.616,6,22,5040,11,137,61,267,1132,11,577,53,1400,3908
280.468,6,30,7432,13,158,23372,267,1317,17,603,17526,2760,6115
2.205,6,13,2311,8,188,315,245,700,5,1407,487,1407,1611
0.159,6,2,87,1,0,0,0,40,1,7,0,7,47
0.502,6,10,968,5,256,111,256,460,5,304,112,304,508
240.261,6,52,17985,27,804,9240,1418,15080,25,199,10009,580,2905
280.43,6,30,7432,13,158,23369,267,1317,17,603,17524,2076,6115
1744.716,2,27,864,27,8,67104,8,864,0,0,0,0,0
7.966,6,1863,1736635,1189,1383,6,1408,1696825,674,950,11,2816,39810
0.137,17,4,588,2,48,114,48,152,2,190,119,308,436
1787.087,6,102,8296,68,65,26672,65,4930,34,59,54150,59,3366
3.21,6,5,232,2,0,3210,0,88,3,0,1521,0,144
223.69,17,2,136,2,40,223690,47,136,0,0,0,0,0
1799.259,17,449,39928,404,35,4464,288,25708,45,288,40020,288,14220
11.842,6,19,4402,10,275,1315,275,958,9,768,742,1440,3444
1779.399,6,79,4160,40,26,45624,26,2106,39,26,46825,26,2054
795.438,17,40,3200,20,48,41864,48,1520,20,56,41864,56,1680
1729.219,6,63,4589,41,33,43230,33,2825,22,31,82332,31,1764
1.313,6,48,18177,26,878,52,1360,12521,22,433,54,1360,5656
29.862,6,37,9540,22,136,1422,159,2389,15,636,2132,1418,7151
1777.679,17,142,11360,71,48,25395,48,5396,71,56,25395,56,5964
186.031,6,15,972,11,34,18603,62,719,4,31,61928,31,253
10.778,6,19,7010,11,275,1077,275,998,8,1893,856,2840,6012
4.74,6,38,7229,19,218,263,314,3383,19,513,247,1179,3846
1774.82,6,247,24861,99,67,18108,616,9297,148,128,12072,1440,15564
76.704,6,66,46932,44,1185,1783,1408,39056,22,960,2932,3847,7876
27.145,6,37,8387,18,345,974,720,1811,19,446,1500,3488,6576
0.302,6,25,6116,12,181,27,537,1526,13,558,24,1408,4590
4.199,17,5,295,5,31,1049,31,295,0,0,0,0,0
1.677,17,19,7239,9,477,206,1350,4553,10,240,182,1350,2686
1796.289,17,484,59422,222,163,8127,1350,42569,262,36,6882,1350,16853
4.28,17,8,628,4,33,1333,33,244,4,68,1419,77,384
2.356,6,13,2311,8,188,336,245,700,5,1407,525,1407,1611
0.249,17,2,304,1,60,0,60,88,1,188,0,188,216
15.513,6,6,288,1,0,0,0,48,5,0,3875,0,240
293.242,17,8,2688,8,308,41891,308,2688,0,0,0,0,0
0.008,6,2,9948,1,0,0,0,40,1,9856,0,9856,9908
1742.33,6,103,7743,67,38,26398,205,4684,36,32,49769,98,3059
1.93,17,6,785,3,31,960,31,177,3,174,948,196,608
0.637,6,4,191,1,0,0,0,40,3,31,158,31,151
0.447,6,49,21169,28,994,16,1380,16087,21,421,19,1923,5082
1.284,6,47,18927,27,874,49,1360,13351,20,476,57,2715,5576
1699.504,17,12,498,11,14,169950,14,462,1,8,0,8,36
110.716,6,34,9157,19,214,6150,498,2266,15,571,7901,1420,6891
1788.083,6,354,22302,207,69,8680,69,12351,147,69,12203,69,9951
1787.559,6,365,23294,211,69,8512,69,12649,154,69,11683,69,10645
184.61,6,6,256,5,0,46152,0,208,1,0,0,0,48
0.448,6,10,1669,6,551,89,947,1346,4,159,149,159,323
25.899,6,41,13455,20,330,1363,721,3119,21,791,1285,2840,10336
63.869,2,2,64,2,8,63869,8,64,0,0,0,0,0
165.336,6,1543,755874,829,842,199,1152,720104,714,400,231,1179,35770
174.066,6,25,9968,12,549,65,1440,2709,13,961,14494,1440,7259
1793.4,6,175,11131,96,48,18838,208,6793,79,31,22989,31,4338
91.018,6,78,48891,45,1189,2068,1448,40424,33,842,1925,2359,8467
61.352,6,24,9750,12,405,55,907,1763,12,936,5566,1360,7987
1776.984,1,192,10752,192,28,9303,28,10752,0,0,0,0,0
4.12,1,5,140,5,0,0,0,140,0,0,0,0,0
1624.422,2,15,480,15,8,116030,8,480,0,0,0,0,0
96.569,17,4,352,2,60,96567,60,176,2,60,96568,60,176
76.607,17,4,240,2,32,76606,32,120,2,32,76606,32,120
0.008,17,2,1950,2,947,8,1409,1950,0,0,0,0,0
1740.473,17,30,7050,30,207,60016,207,7050,0,0,0,0,0
1383.653,2,15,480,15,8,98832,8,480,0,0,0,0,0
1798.26,6,126,12731,80,65,22762,722,6712,46,95,39956,2330,6019
3.888,17,4,352,2,48,3879,48,152,2,72,3877,72,200
1738.963,6,87,6322,58,31,30508,31,3915,29,31,62105,31,2407
925.199,17,46,1926,45,14,21027,14,1890,1,8,0,8,36
1712.375,1,8,448,8,28,244625,28,448,0,0,0,0,0
656.841,2,6,192,6,8,131368,8,192,0,0,0,0,0
0.564,6,7,371,4,0,188,0,204,3,7,164,7,167
31.109,17,36,5292,18,48,1829,48,1368,18,190,1829,308,3924
416.614,17,12,4288,12,329,37874,376,4288,0,0,0,0,0
1776.208,6,108,6384,62,26,29117,26,3614,46,26,39469,26,2770
4.32,17,26,8615,10,248,480,1350,2762,16,337,212,1350,5853
1798.542,6,367,25650,214,99,8443,469,15045,153,69,11830,69,10605
0.323,6,26,8991,13,247,26,624,1672,13,947,25,1438,7319
0.497,6,26,9012,13,252,41,646,1694,13,947,40,1402,7318
1.329,6,50,21981,29,948,47,1360,16365,21,476,57,2715,5616
358.846,6,50,10352,31,266,11961,1360,4745,19,402,479,2667,5607
2.035,17,6,460,3,40,1008,41,206,3,56,1007,57,254
29.055,6,8,320,3,0,11241,0,120,5,0,7263,0,200
1720.461,17,12,498,11,14,172046,14,462,1,8,0,8,36
3.289,6,2,88,2,0,0,0,88,0,0,0,0,0
1771.398,6,99,9240,66,65,27252,65,5577,33,59,55353,59,3663
1785.614,6,104,8376,68,65,26650,65,4930,36,59,51015,59,3446
0.542,6,10,924,5,283,90,283,551,5,105,91,105,373
263.251,17,107,4370,54,12,4905,58,2206,53,12,5062,56,2164
1799.517,17,136,10880,68,48,26858,48,5168,68,56,26858,56,5712
1796.727,1,345,28980,345,56,5223,56,28980,0,0,0,0,0
0.025,17,2,382,1,33,0,33,61,1,293,0,293,321
0.664,6,3,1273,1,288,0,288,328,2,853,664,853,945
0.693,6,11,1003,6,332,138,332,652,5,83,166,83,351
192.608,6,28,6724,13,262,16047,517,1472,15,744,13754,1418,5252
1786.509,17,87,3648,86,14,21017,14,3612,1,8,0,8,36
11.223,1,9,756,9,56,1402,56,756,0,0,0,0,0
1788.48,17,357,82133,357,202,5023,422,82133,0,0,0,0,0
47.943,6,13,532,7,0,7988,0,284,6,0,9585,0,248
281.468,6,28,7352,12,158,25588,267,1277,16,678,18761,2760,6075
0.138,6,10,584,5,44,34,44,312,5,0,32,0,272
1.704,6,25,8056,12,164,138,267,1288,13,869,126,1408,6768
0.962,17,4,788,2,36,939,36,128,2,302,953,302,660
1778.878,17,140,11200,70,48,25780,48,5320,70,56,25780,56,5880
76.36,6,16,660,8,0,10908,0,324,8,0,10737,0,336
240.58,6,40,9000,20,589,12661,1418,5765,20,273,12661,651,3235
300.807,6,33,9661,19,156,16711,285,1683,14,658,5109,1408,7978
374.148,6,26,1703,17,177,23384,177,1117,9,110,9226,110,586
1595.36,1,8,448,8,28,227908,28,448,0,0,0,0,0
1797.201,17,445,38948,402,35,4481,288,25360,43,288,41928,288,13588
1783.598,6,233,19328,120,100,14988,208,13816,113,31,15922,31,5512
112.411,6,25,10208,13,549,78,1360,2749,12,995,10202,1360,7459
1787.904,6,369,25730,214,99,8393,469,15045,155,69,11609,69,10685
1741.168,6,87,6322,58,31,30546,31,3915,29,31,62182,31,2407
1772.832,6,180,15480,120,69,14897,69,8940,60,69,30047,69,6540
240.124,6,47,10314,22,209,11434,834,2640,25,489,10004,1408,7674
15.73,17,21,14133,12,970,1423,1350,11985,9,210,1958,1350,2148
0.199,17,2,144,1,36,0,36,64,1,52,0,52,80
4.006,17,28,10392,10,421,445,1350,4498,18,299,231,1350,5894
0.356,17,4,624,2,64,342,64,184,2,192,291,192,440
1796.536,1,281,15736,281,28,6416,28,15736,0,0,0,0,0
0.243,6,47,21248,26,1079,9,1432,16175,21,420,10,1432,5073
33.787,6,33,5197,16,154,2252,722,1911,17,299,2099,1448,3286
212.59,17,3,1026,1,300,0,300,328,2,321,211592,321,698
134.516,6,26,4989,14,295,10347,594,2202,12,357,12224,1328,2787
1784.65,17,140,11200,70,48,25863,48,5320,70,56,25863,56,5880
1764.168,2,14,448,14,8,135705,8,448,0,0,0,0,0
2.348,17,20,9787,9,423,293,1350,4062,11,492,170,1350,5725
0.207,6,9,1340,5,145,51,145,349,4,827,59,827,991
280.239,6,25,7094,11,181,28023,267,1168,14,595,21553,1400,5926
386.268,6,19,1306,14,180,29712,180,928,5,110,15175,110,378
84.677,17,4,240,2,32,84676,32,120,2,32,84676,32,120
1791.457,6,356,22520,208,69,8654,69,12460,148,69,12186,69,10060
225.626,17,24,8010,24,305,9809,308,8010,0,0,0,0,0
20.78,6,20,3130,12,183,1889,517,1561,8,381,2967,499,1569
19.801,17,4,824,2,48,19785,48,152,2,308,19788,308,672
21.485,6,2625,2554365,1679,1443,12,1448,2500125,946,776,22,1448,54240
1741.31,6,87,6322,58,31,30549,31,3915,29,31,62189,31,2407
0.709,17,4,360,2,30,662,30,116,2,94,655,94,244
9.545,6,86,27863,43,586,227,1152,21661,43,407,221,1152,6202
24.853,6,38,8977,22,102,1183,320,1830,16,649,364,1642,7147
6.301,1,4,224,4,28,2100,28,224,0,0,0,0,0
1787.44,6,104,8376,68,65,26678,65,4930,36,59,51065,59,3446
0.018,17,2,172,1,50,0,50,78,1,66,0,66,94
1782.669,6,349,22378,204,69,8781,69,12438,145,69,12379,69,9940
1798.081,17,448,39612,404,35,4461,288,25708,44,288,40930,288,13904
29.916,17,6,2016,6,308,5983,308,2016,0,0,0,0,0
0.211,6,26,7256,13,155,17,267,1301,13,603,16,2036,5955
3.03,17,4,268,4,39,1010,39,268,0,0,0,0,0
240.768,6,48,8663,26,449,9630,1418,5856,22,205,11464,580,2807
1777.94,17,142,11360,71,48,25395,48,5396,71,56,25361,56,5964
1681.263,17,14,3815,7,30,280209,30,406,7,459,280209,463,3409
1771.369,6,101,9278,66,64,27251,64,5544,35,58,52096,58,3734
0.816,6,11,1727,7,100,136,100,384,4,589,182,1152,1343
3.698,17,4,739,2,48,3688,48,152,2,265,3679,286,587
1771.605,6,105,9700,68,65,26441,65,5758,37,59,49208,59,3942
1794.265,17,144,11520,72,48,25271,48,5472,72,56,25271,56,6048
1409.731,17,404,48282,194,150,7304,1350,34634,210,36,6744,1350,13648
289.951,17,4,352,2,60,289950,60,176,2,60,289950,60,176
240.316,6,44,8779,21,524,12015,1418,5816,23,195,10923,618,2963
2.638,6,13,2311,8,188,376,245,700,5,1407,596,1407,1611
1203.176,2,9,288,9,8,150397,8,288,0,0,0,0,0
1784.271,17,358,57536,358,132,4997,366,57536,0,0,0,0,0
5.429,6,40,7309,20,218,285,314,3423,20,513,269,1179,3886
0.021,17,4,284,2,32,3,32,120,2,54,10,60,164
96.011,17,4,352,2,60,96010,60,176,2,60,96010,60,176
1794.021,1,242,13552,242,28,7444,28,13552,0,0,0,0,0
371.359,1,50,5300,50,78,7578,78,5300,0,0,0,0,0
0.098,6,10,767,5,186,24,186,454,5,45,11,45,313
1786.742,6,104,8308,68,64,26667,64,4896,36,58,51047,58,3412
41.294,6,112,37406,55,631,764,1152,30628,57,449,732,1179,6778
39.576,17,44,6468,22,48,1884,48,1672,22,190,1884,308,4796
300.845,6,42,13626,23,889,13674,1360,8064,19,399,480,1360,5562
1763.877,6,134,8207,71,27,25197,27,4304,63,27,28448,27,3903
1770.847,6,99,9306,66,66,27243,66,5610,33,60,55335,60,3696
136.499,6,39,12116,20,633,7184,1360,4647,19,558,7572,1360,7469
0.073,6,8,1107,4,145,24,145,309,4,634,20,634,798
1.345,6,10,1687,7,100,224,100,384,3,1179,546,1179,1303
285.095,6,21,1509,11,330,28509,330,910,10,83,31676,83,599
0.966,6,11,1727,7,100,161,100,384,4,589,237,1152,1343
1767.319,17,44,14784,44,308,41100,308,14784,0,0,0,0,0
71.035,6,38,8370,13,169,5919,267,1711,25,313,2953,1420,6659
240.237,6,54,19197,29,820,8579,1418,16291,25,199,10009,580,2906
6.175,6,44,8369,23,227,280,314,4102,21,489,295,1179,4267
0.004,17,2,366,1,33,0,33,61,1,277,0,277,305
1787.409,17,87,3648,86,14,21028,14,3612,1,8,0,8,36
1.686,6,25,8763,15,285,120,587,1459,10,985,167,1420,7304
8.791,6,45,22913,20,479,462,1360,3771,25,1006,350,2720,19142
2.998,17,7,612,4,32,988,32,240,3,96,1482,96,372
9.23,17,2,126,2,35,9230,35,126,0,0,0,0,0
1750.599,17,12,498,11,14,175059,14,462,1,8,0,8,36
1744.644,2,26,832,26,8,69785,8,832,0,0,0,0,0
0.117,17,2,152,2,48,117,48,152,0,0,0,0,0
5.042,17,4,288,2,36,5010,36,128,2,52,5010,52,160
0.022,6,9,1557,5,515,5,515,783,4,558,7,558,774
1799.835,17,3020,144960,1510,20,1192,20,72480,1510,20,1192,20,72480
117.137,6,18,4442,7,296,19522,722,1249,11,373,11661,1448,3193
6.448,6,1099,972032,669,1374,9,1408,945008,430,931,14,2816,27024
1.251,6,26,9564,13,164,89,267,1388,13,1070,89,2816,8176
1795.605,17,82,3438,81,14,22445,14,3402,1,8,0,8,36
6.576,6,38,6615,22,129,313,267,2070,16,780,230,1460,4545
12.472,6,27,8926,15,402,890,721,3020,12,903,966,1440,5906
0.018,17,2,740,2,342,18,342,740,0,0,0,0,0
70.598,17,2,1773,2,858,70598,1030,1773,0,0,0,0,0
0.441,6,50,20531,27,1016,16,1380,15369,23,421,18,1923,5162
1796.306,17,241,55131,241,200,7484,422,55131,0,0,0,0,0
0.307,6,27,9076,13,252,25,647,1692,14,949,23,2816,7384
1745.722,6,95,7203,63,38,28156,205,4476,32,33,56299,98,2727
0.935,17,14,7750,7,747,155,1350,5425,7,304,123,1350,2325
1791.543,1,134,7504,134,28,13470,28,7504,0,0,0,0,0
69.13,6,28,7217,13,155,5760,267,1306,15,482,4937,1997,5911
4.042,6,2,88,2,0,0,0,88,0,0,0,0,0
287.414,6,30,3729,16,237,19160,585,1553,14,357,21960,580,2176
1743.756,6,96,7286,63,38,28125,205,4476,33,33,54478,98,2810
1797.726,6,154,16698,86,80,21149,721,7158,68,154,26827,1420,9540
3.875,17,8,2464,4,60,1283,60,352,4,500,1282,500,2112
30.491,17,4,352,2,60,30490,60,176,2,60,30490,60,176
1794.721,1,76,4256,76,28,23929,28,4256,0,0,0,0,0
0.4,17,2,214,1,47,0,47,75,1,111,0,111,139
1.895,17,5,625,3,31,945,31,177,2,196,7,196,448
41.715,17,44,6468,22,48,1983,48,1672,22,190,1980,308,4796
240.667,6,45,9477,20,272,12666,681,2981,25,518,10027,1517,6496
1789.55,6,122,13962,78,111,23240,1253,7266,44,126,41615,1420,6696
227.35,6,31,8981,13,158,18945,267,1317,18,630,13358,1400,7664
16.642,17,21,10944,11,730,1656,1350,8347,10,231,1841,1350,2597
1.497,17,4,360,2,30,583,30,116,2,94,0,94,244
9.453,6,83,24829,41,542,236,1152,19008,42,459,224,1179,5821
0.137,6,2,112,1,0,0,0,60,1,0,0,0,52
369.952,6,29763,31295932,9880,651,37,652,541878,19883,1495,18,8688,30754054
3.469,6,21,6349,10,262,380,517,1316,11,744,342,1418,5033
0.938,17,21,9614,9,421,117,1350,4046,12,436,46,1350,5568
10.976,6,18,4266,10,275,1219,275,958,8,992,887,1440,3308
60.114,2,2,64,2,8,60114,8,64,0,0,0,0,0
0.007,17,2,213,1,40,0,40,68,1,117,0,117,145
1699.416,17,12,498,11,14,169941,14,462,1,8,0,8,36
0.08,1,2,112,2,28,80,28,112,0,0,0,0,0
129.151,1,2,750,2,347,129151,347,750,0,0,0,0,0
1717.138,1,8,448,8,28,245305,28,448,0,0,0,0,0
0.055,17,2,272,1,60,0,60,88,1,156,0,156,184
20.129,6,22,5755,13,107,1677,159,1138,9,828,2515,1675,4617
42.375,17,24,2112,12,48,3847,48,912,12,72,3845,72,1200
240.217,6,55,18245,30,771,8283,1408,15452,25,185,10008,580,2793
5.223,6,7,380,4,0,1741,0,216,3,0,2605,0,164
0.395,6,48,19417,26,1017,15,1380,14295,22,383,16,1380,5122
1798.542,17,450,39960,405,35,4451,288,25740,45,288,40017,288,14220
1799.821,17,4164,199872,2082,20,864,20,99936,2082,20,864,20,99936
1704.25,1,8,448,8,28,243464,28,448,0,0,0,0,0
9.29,6,1522,1291347,898,1386,10,1420,1260259,624,553,14,1883,31088
1772.094,6,180,15480,120,69,14891,69,8940,60,69,30034,69,6540
78.585,1,3,312,0,0,0,0,0,3,76,39292,76,312
0.375,6,10,967,5,256,92,256,460,5,303,92,303,507
18.509,17,14,7978,7,613,3078,1350,4493,7,469,3078,1350,3485
6.512,6,67,20646,33,559,203,1152,15859,34,489,189,1179,4787
72.904,6,31,18612,18,702,53,1360,4967,13,1639,6064,6230,13645
300.616,6,42,8762,22,315,14315,882,2209,20,478,530,2720,6553
0.027,17,2,152,1,48,0,48,76,1,48,0,48,76
1.26,6,3,144,2,0,2,0,92,1,0,0,0,52
14.827,6,6,328,4,0,4942,0,216,2,0,14812,0,112
1.384,6,49,19219,27,889,53,1460,13563,22,433,57,1460,5656
0.657,6,9,871,5,304,164,304,572,4,83,214,83,299
0.385,6,12,1653,6,288,69,288,548,6,426,44,434,1105
0.629,6,10,767,5,186,155,186,454,5,45,156,45,313
5.044,6,34,6169,19,206,280,314,2824,15,548,337,1179,3345
70.888,6,597,303286,329,855,216,1152,291170,268,349,264,373,12116
1799.134,17,448,39896,403,35,4475,288,25676,45,288,40017,288,14220
68.967,6,32,6049,16,107,4597,159,1354,16,773,4597,1408,4695
1795.985,17,448,39896,403,35,4467,288,25676,45,288,40019,288,14220
37.621,6,22,4995,8,125,5374,245,700,14,927,2874,1152,4295
1797.639,1,58,4872,58,56,31537,56,4872,0,0,0,0,0
504.849,2,5,160,5,8,126212,8,160,0,0,0,0,0
281.457,6,33,7759,13,143,23454,267,1386,20,464,14800,1380,6373
17.142,17,29,13240,14,644,1316,1350,9418,15,226,1222,1350,3822
1793.324,6,240,35580,150,302,12035,302,25920,90,83,20149,83,9660
902.447,2,11,352,11,8,90244,8,352,0,0,0,0,0
16.635,17,25,9582,12,438,1509,1350,5596,13,278,1383,1350,3986
1792.002,6,361,22858,210,69,8574,69,12678,151,69,11946,69,10180
1.633,6,13,2311,8,188,233,245,700,5,1407,347,1407,1611
5.539,6,39,7269,20,218,291,314,3423,19,513,294,1179,3846
160.201,6,82,52572,47,1222,3482,1448,44028,35,746,1812,1448,8544
13.263,1,3,168,3,28,6631,28,168,0,0,0,0,0
47.369,6,20,5853,11,267,4736,501,1245,9,707,5910,1420,4608
3.051,17,3,228,2,48,2904,48,152,1,48,0,48,76
1764.613,2,13,416,13,8,147051,8,416,0,0,0,0,0
4.868,17,4,558,2,36,4863,36,128,2,187,4863,187,430
1740.489,17,29,30624,29,1028,62160,1028,30624,0,0,0,0,0
101.615,17,4,352,2,60,101613,60,176,2,60,101614,60,176
300.894,6,41,13532,23,882,13677,1460,8010,18,435,511,2567,5522
1.884,17,2,148,2,46,1884,46,148,0,0,0,0,0
1782.45,6,418,25021,209,69,8569,69,12500,209,34,8569,48,12521
13.017,17,4,352,2,48,12998,48,152,2,72,12995,72,200
0.038,6,10,1514,5,503,9,503,771,5,475,9,475,743
0.531,6,12,1304,6,256,98,256,756,6,304,95,304,548
40.398,17,4,352,2,60,40397,60,176,2,60,40396,60,176
1798.404,17,453,40168,406,35,4440,288,25812,47,277,38306,288,14356
1.998,6,20,3833,11,234,199,564,1504,9,463,228,1343,2329
1780.094,6,358,22600,207,69,8641,69,12420,151,69,11867,69,10180
1784.825,6,104,8504,69,66,26247,66,5004,35,60,52489,60,3500
15.845,17,3,228,3,48,7922,48,228,0,0,0,0,0
3.033,6,37,22225,19,787,168,1460,6289,18,1267,170,1607,15936
2.327,6,72,20200,36,551,66,1429,5428,36,512,58,1986,14772
293.794,17,4,352,2,60,293793,60,176,2,60,293793,60,176
23.743,17,45,8556,20,164,1247,1350,3847,25,160,987,1350,4709
1798.12,17,450,39960,405,35,4450,288,25740,45,288,40019,288,14220
241.347,6,31,6782,15,230,17221,643,2168,16,470,16073,1418,4614
61.823,6,71,49164,44,1210,1437,1448,41031,27,746,2370,1448,8133
31.811,6,7,308,1,0,0,0,44,6,0,6312,0,264
1786.476,6,104,8308,68,64,26663,64,4896,36,58,51040,58,3412
1685.566,17,12,498,11,14,168556,14,462,1,8,0,8,36
0.084,17,2,348,1,39,0,39,67,1,253,0,253,281
183.933,2,4,128,4,8,61311,8,128,0,0,0,0,0
0.185,6,40,16583,22,976,8,1420,11642,18,420,10,1420,4941
30.322,17,4,240,2,32,30321,32,120,2,32,30321,32,120
1793.661,17,66,2766,65,14,28025,14,2730,1,8,0,8,36
236.505,6,66,45305,43,1170,5631,1408,37373,23,961,2800,3847,7932
1776.619,1,58,4872,58,56,31168,56,4872,0,0,0,0,0
1740.982,6,139,8801,76,49,23213,208,5382,63,31,28075,31,3419
1649.179,1,76,4256,76,28,21989,28,4256,0,0,0,0,0
3.046,17,8,1718,4,37,1013,37,260,4,336,1013,348,1458
1772.08,6,182,15629,121,69,14767,69,8980,61,69,29530,69,6649
54.258,17,2,672,2,308,54258,308,672,0,0,0,0,0
5.408,6,39,7269,19,218,300,314,3383,20,513,268,1179,3886
1799.444,17,1045,71753,1045,40,1723,41,71753,0,0,0,0,0
93.971,6,26,5666,10,107,10440,159,970,16,967,6264,1669,4696
1786.196,17,87,3648,86,14,21014,14,3612,1,8,0,8,36
1745.104,6,101,7515,62,38,28608,205,4424,39,33,45918,98,3091
70.39,6,29,7392,13,158,5865,267,1317,16,603,4690,1400,6075
1796.34,6,381,24141,217,69,8316,69,13441,164,69,11018,69,10700
0.153,17,2,279,1,36,0,36,64,1,187,0,187,215
379.869,6,25,1651,17,177,23741,177,1117,8,110,9296,110,534
4.988,6,42,8289,20,227,262,314,3982,22,489,225,1179,4307
31.706,6,7,308,1,0,0,0,44,6,0,6321,0,264
0.01,6,5,276,3,0,3,0,164,2,0,7,0,112
39.807,17,20,1760,10,48,4421,48,760,10,72,4421,72,1000
0.191,1,10,840,10,56,21,56,840,0,0,0,0,0
70.073,6,17,1053,17,69,4379,69,1053,0,0,0,0,0
125.395,6,14,3169,7,92,20899,92,476,7,465,20866,1408,2693
1763.772,1,8,448,8,28,251967,28,448,0,0,0,0,0
262.8,17,3,228,3,48,131400,48,228,0,0,0,0,0
1.288,17,4,947,2,33,1283,37,123,2,384,1281,463,824
0.262,6,21,5000,10,137,29,267,1092,11,692,24,1467,3908
99.144,6,12322,11837622,8247,1358,12,1408,11621058,4075,776,24,1408,216564
22.727,17,24,1742,18,40,1334,41,1235,6,56,15,57,507
0.549,6,255,277268,142,183,3,230,8889,113,2364,3,8412,268379
31.24,6,8,348,2,0,311,0,84,6,0,6245,0,264
1.325,6,44,10145,23,440,60,1360,4484,21,437,57,2715,5661
2.795,6,29,17894,18,777,164,1360,6194,11,1874,267,3934,11700
1741.368,17,28,6580,28,207,64495,207,6580,0,0,0,0,0
1778.026,1,156,8736,156,28,11471,28,8736,0,0,0,0,0
0.004,6,2,672,1,0,0,0,40,1,580,0,580,632
1786.79,6,102,8228,68,64,26668,64,4896,34,58,54142,58,3332
1772.53,6,202,22250,130,75,13740,267,10057,72,136,24961,3417,12193
1790.491,17,493,56415,208,161,8649,1350,39352,285,31,6304,60,17063
1785.719,17,337,25612,337,48,5314,48,25612,0,0,0,0,0
280.643,6,30,7432,13,158,23386,267,1317,17,603,17525,2076,6115
371.098,6,19,1352,14,226,28546,226,974,5,110,15166,110,378
0.04,17,3,234,2,39,0,39,134,1,72,0,72,100
1.638,17,6,360,3,32,818,32,180,3,32,818,32,180
15.372,6,6,288,1,0,0,0,48,5,0,3840,0,240
0.446,6,48,18812,27,898,17,1380,13718,21,421,20,1923,5094
1.967,17,2,120,2,32,1967,32,120,0,0,0,0,0
19.583,6,6,328,4,0,6527,0,216,2,0,19569,0,112
1796.022,6,98,7421,65,38,28062,205,4611,33,33,56113,98,2810
1.369,6,38,8258,19,321,76,1168,2722,19,433,65,1460,5536
121.537,6,46,10301,18,249,7148,1189,2971,28,310,4501,1420,7330
31.735,6,7,396,1,0,0,0,60,6,0,6311,0,336
0.556,6,127,88305,59,131,9,232,2889,68,1312,8,1420,85416
1788.945,17,140,11200,70,48,25926,48,5320,70,56,25926,56,5880
1.047,6,27,8420,15,222,62,540,1964,12,1192,77,3151,6456
1792.772,17,177,11328,177,36,10186,36,11328,0,0,0,0,0
358.862,6,47,10175,29,266,12816,1360,4653,18,435,508,2667,5522
0.318,17,3,123,2,11,318,14,79,1,16,0,16,44
75.749,17,4,1344,4,308,25249,308,1344,0,0,0,0,0
6.84,6,512,478045,345,1329,19,1368,464697,167,776,40,1473,13348
1786.908,6,3649,3969040,1242,126,1439,349,74404,2407,1613,742,4224,3894636
60.354,6,39,20411,19,131,3353,134,1520,20,991,3174,1448,18891
0.23,17,4,906,4,198,76,357,906,0,0,0,0,0
1787.834,6,138,14693,80,77,22630,722,7347,58,91,31309,2328,7346
1198.087,6,288,28239,149,136,7784,1189,13226,139,138,8681,1917,15013
31.794,6,69,20326,31,588,449,1152,15379,38,489,852,1179,4947
1.408,6,51,20362,28,900,52,1360,14666,23,433,54,1360,5696
0.435,6,5,1564,3,413,217,413,946,2,269,197,269,618
140.399,17,4,240,2,32,140395,32,120,2,32,140398,32,120
1688.171,6,739,95235,358,181,4728,1360,74606,381,64,4442,316,20629
1763.559,6,79,4160,40,26,45218,26,2106,39,26,46408,26,2054
1.362,6,47,18687,27,857,52,1360,13111,20,476,62,2715,5576
11.504,6,1775,1652559,1108,1412,10,1448,1613199,667,776,17,1448,39360
352.41,17,7,532,7,48,58735,48,532,0,0,0,0,0
1096.49,17,216,16416,216,48,5099,48,16416,0,0,0,0,0
2.938,17,4,624,4,128,979,128,624,0,0,0,0,0
1.518,6,38,8252,19,320,84,1162,2716,19,433,73,1440,5536
1797.251,1,58,4872,58,56,31530,56,4872,0,0,0,0,0
1799.412,1,160,8960,160,28,11317,28,8960,0,0,0,0,0
0.189,6,24,7176,12,155,17,267,1261,12,775,16,3445,5915
0.107,17,2,588,1,39,0,39,67,1,493,0,493,521
9.304,17,3,208,2,36,9293,36,128,1,52,0,52,80
317.022,6,88,19959,47,313,6891,1360,10154,41,313,7922,1360,9805
75.086,6,29,7395,14,141,5775,267,1415,15,488,5362,2006,5980
20.363,6,21,3182,12,183,1851,517,1561,9,381,2543,499,1621
0.002,1,2,794,2,369,2,369,794,0,0,0,0,0
280.246,6,30,7432,13,158,23353,267,1317,17,543,17514,1400,6115
290.486,6,62,10271,29,657,10374,1418,6188,33,90,9077,580,4083
1797.071,17,447,39864,402,35,4481,288,25644,45,288,40021,288,14220
1799.999,6,228,16528,86,56,20823,457,7540,142,47,12765,142,8988
49.814,6,42,8873,20,412,618,889,2116,22,366,2365,2720,6757
60.261,2,2,64,2,8,60261,8,64,0,0,0,0,0
44.204,6,27,7177,13,155,3683,267,1306,14,530,3399,3417,5871
9.325,6,86,27794,44,583,216,1152,21616,42,449,221,1179,6178
2.053,17,4,314,2,31,2030,31,118,2,70,2030,70,196
0.458,17,2,632,1,288,0,288,316,1,288,0,288,316
68.677,6,31,8912,14,158,5282,267,1357,17,687,4288,1781,7555
1747.096,6,95,7203,63,38,28178,205,4476,32,33,56345,98,2727
1.145,6,30,10589,16,616,64,1360,3802,14,690,74,1360,6787
11.818,6,25,8453,13,275,984,275,1078,12,983,853,1420,7375
1.45,6,34,11527,17,447,90,1336,3410,17,1060,80,3942,8117
209.045,17,4,352,2,60,209044,60,176,2,60,209044,60,176
1769.892,6,101,9410,66,66,27229,66,5610,35,60,52052,60,3800
178.598,17,4,352,2,60,178596,60,176,2,60,178597,60,176
180.474,2,2,64,2,8,180474,8,64,0,0,0,0,0
1403.505,17,12,3294,6,30,280698,30,348,6,463,280698,463,2946
0.143,17,2,640,2,292,143,298,640,0,0,0,0,0
1785.746,6,116,13929,75,83,24131,516,5998,41,161,44641,1452,7931
7.578,6,32,8934,18,361,445,768,1835,14,652,513,4848,7099
1786.56,6,104,8376,68,65,26665,65,4930,36,59,51041,59,3446
82.386,17,36,9324,36,231,2353,388,9324,0,0,0,0,0
204.933,17,10,3360,10,308,22770,308,3360,0,0,0,0,0
0.554,6,14,1745,7,288,64,288,600,7,426,61,434,1145
1.487,6,47,17216,25,877,61,1460,11560,22,433,60,1460,5656
1789.572,1,191,10696,191,28,9418,28,10696,0,0,0,0,0
102.529,6,23,10278,12,433,68,990,1859,11,1138,10240,2720,8419
1708.599,1,8,448,8,28,244085,28,448,0,0,0,0,0
2.088,1,2,112,2,28,2088,28,112,0,0,0,0,0
1794.336,17,142,11360,71,48,25633,48,5396,71,56,25633,56,5964
1784.12,6,356,22520,208,69,8618,69,12460,148,69,12136,69,10060
1.818,6,23,6251,12,281,165,544,1328,11,559,170,1420,4923
29.636,6,12,1313,7,185,4939,185,557,5,244,7406,476,756
1.009,6,23,8060,14,400,77,663,2736,9,1209,121,1946,5324
1747.253,6,95,7203,63,38,28181,205,4476,32,33,56349,98,2727
1.277,6,38,9848,20,502,67,1460,4352,18,433,64,1460,5496
1771.088,6,100,9292,66,65,27247,65,5577,34,59,53665,59,3715
503.931,2,4,128,4,8,167977,8,128,0,0,0,0,0
1658.375,1,7,392,7,28,276395,28,392,0,0,0,0,0
12.161,6,1893,1678919,1161,1390,10,1420,1645418,732,467,16,1883,33501
0.269,17,12,4413,12,339,24,362,4413,0,0,0,0,0
3.164,17,22,14409,9,370,395,1350,3586,13,804,261,1350,10823
293.814,2,2,64,2,8,293814,8,64,0,0,0,0,0
0.019,17,2,212,1,46,0,46,74,1,110,0,110,138
373.566,6,21,1419,15,177,26683,177,989,6,110,12249,110,430
0.005,17,2,405,1,37,0,37,65,1,312,0,312,340
4.804,17,3,281,2,39,4781,39,134,1,119,0,119,147
367.208,6,23,1535,16,177,24480,177,1053,7,110,10362,110,482
0.044,6,10,1327,5,299,10,299,567,5,246,10,459,760
0.101,17,2,602,1,46,0,46,74,1,500,0,500,528
277.931,6,30,7432,13,158,23160,267,1317,17,543,17369,1400,6115
1777.561,17,73,3060,72,14,25036,14,3024,1,8,0,8,36
1.333,6,38,9114,20,398,70,1440,3618,18,433,67,1440,5496
1.176,6,28,10666,15,203,84,458,1490,13,1080,83,3926,9176
0.205,6,45,21002,26,1068,8,1420,16021,19,467,10,1883,4981
1786.517,6,104,8444,68,66,26664,66,4964,36,60,51040,60,3480
890.168,6,117,9143,46,75,19778,374,4555,71,49,12714,143,4588
1.278,6,27,8223,14,270,87,561,1945,13,957,91,1631,6278
6.354,6,733,567348,385,1390,16,1448,542776,348,776,17,1448,24572
102.557,6,6,364,4,31,34185,31,222,2,31,102544,31,142
0.341,6,23,4494,11,165,34,456,1394,12,493,28,888,3100
35.997,6,27,7177,13,155,2999,267,1306,14,530,2768,3417,5871
800.13,6,330,108098,171,714,4705,1360,89954,159,173,5063,2448,18144
1.042,6,23,6380,13,299,86,842,2023,10,988,114,1699,4357
0.313,6,15,4579,7,290,52,517,941,8,1071,41,1418,3638
1755.605,6,108,8911,69,42,25817,205,4984,39,52,46192,553,3927
13.768,6,36,5737,20,181,724,293,3343,16,437,899,1179,2394
0.142,17,2,2378,2,1161,142,1161,2378,0,0,0,0,0
3.766,17,4,624,4,128,1255,128,624,0,0,0,0,0
0.11,17,2,362,1,46,0,46,74,1,260,0,260,288
1783.808,17,140,11200,70,48,25852,48,5320,70,56,25852,56,5880
1794.318,17,262,52267,262,171,6874,422,52267,0,0,0,0,0
1.513,6,41,11378,22,547,72,1360,5842,19,476,71,2715,5536
2.012,6,6,248,4,0,670,0,164,2,0,990,0,84
8.029,1,9,756,0,0,0,0,0,9,56,1003,56,756
0.278,17,2,214,1,39,0,39,67,1,119,0,119,147
89.635,6,27,7312,13,158,7469,267,1317,14,678,6890,3456,5995
1.364,6,49,19231,27,890,52,1440,13575,22,433,56,1440,5656
1787.927,1,58,4872,0,0,0,0,0,58,56,31367,56,4872
3.912,6,16,5004,9,290,489,517,1057,7,1191,650,1396,3947
4.147,17,2,152,2,48,4147,48,152,0,0,0,0,0
1793.584,17,87,3648,86,14,21100,14,3612,1,8,0,8,36
120.43,17,4,1834,4,430,40143,695,1834,0,0,0,0,0
280.199,6,28,7352,13,158,23349,267,1317,15,678,20012,2045,6035
1210.537,6,122,10607,76,69,14816,69,5662,46,69,26900,69,4945
11.565,6,25,8473,13,275,963,275,1078,12,986,746,1440,7395
815.178,1,16,896,16,28,54345,28,896,0,0,0,0,0
1772.43,6,180,15480,120,69,14894,69,8940,60,69,30036,69,6540
5.019,17,4,558,2,36,5014,36,128,2,187,5015,187,430
0.096,6,9,1002,5,213,24,213,417,4,421,25,421,585
0.472,6,13,1693,7,288,73,288,588,6,426,56,434,1105
3.433,6,8,344,4,0,6,0,168,4,0,1141,0,176
1.978,17,3,1167,3,361,989,361,1167,0,0,0,0,0
0.311,17,2,180,1,30,0,30,58,1,94,0,94,122
280.249,6,29,7392,14,158,21557,267,1357,15,678,20010,3436,6035
25.283,6,58,25521,28,681,936,1460,7401,30,1054,866,1460,18120
16.866,6,21,4527,11,211,1686,722,1623,10,793,1851,1448,2904
0.657,6,2,80,1,0,0,0,40,1,0,0,0,40
1775.865,6,181,15589,120,69,14923,69,8940,61,69,29589,69,6649
5.819,6,490,408002,293,1319,19,1368,392494,197,776,28,2736,15508
25.439,1,4,224,4,28,8479,28,224,0,0,0,0,0
1787.387,6,102,8296,68,65,26677,65,4930,34,59,54159,59,3366
3.656,17,8,736,4,64,1218,64,368,4,64,1218,64,368
8.214,6,29,7876,14,215,631,721,1854,15,677,445,1414,6022
0.097,6,4,160,2,0,97,0,80,2,0,9,0,80
31.246,17,4,352,2,48,31236,48,152,2,72,31236,72,200
1.432,6,10,924,5,283,245,283,551,5,105,227,105,373
0.053,17,4,352,2,37,9,37,130,2,83,46,89,222
225.25,17,4,352,2,60,225249,60,176,2,60,225249,60,176
14.526,6,19,3442,10,210,1613,210,984,9,664,1815,904,2458
3.912,17,8,1216,4,60,1298,60,352,4,188,1297,188,864
846.039,6,158,23904,85,304,10071,304,16336,73,83,11741,83,7568
102.428,6,26,8333,13,418,55,953,1832,13,663,8525,2720,6501
1781.756,6,365,25501,212,100,8444,469,14896,153,69,11722,69,10605
1.328,6,39,8294,19,321,73,1164,2718,20,433,60,1460,5576
158.987,6,42,8351,15,149,11356,267,1503,27,338,6113,4260,6848
0.542,17,2,780,2,362,542,362,780,0,0,0,0,0
0.137,17,2,588,1,39,0,39,67,1,493,0,493,521
747.922,1,4,424,4,78,249307,78,424,0,0,0,0,0
66.448,6,30,16634,17,1012,4153,1448,8989,13,870,5522,1448,7645
171.687,6,45,10033,16,327,2851,1189,2615,29,312,6131,1420,7418
1794.468,17,140,11200,70,48,26006,48,5320,70,56,26006,56,5880
1780.976,1,74,4144,74,28,24396,28,4144,0,0,0,0,0
0.151,17,2,279,1,36,0,36,64,1,187,0,187,215
1.869,6,12,1304,6,256,371,256,756,6,304,371,304,548
1766.988,1,54,6330,54,89,33339,173,6330,0,0,0,0,0
92.684,17,2,672,2,308,92684,308,672,0,0,0,0,0
6.683,6,16,3265,9,211,835,211,910,7,665,1113,904,2355
441.443,6,58,8642,29,129,15764,517,2473,29,333,15764,1418,6169
118.126,17,5,380,5,48,29531,48,380,0,0,0,0,0
4.258,6,39,7269,20,218,224,314,3423,19,513,223,1179,3846
369.517,6,27,2495,18,141,21736,141,929,9,398,3020,419,1566
0.083,6,11,1535,6,507,16,507,767,5,556,20,556,768
70.997,1,2,112,2,28,70997,28,112,0,0,0,0,0
3.645,17,10,1448,5,31,910,31,295,5,202,909,229,1153
0.013,17,2,237,1,72,0,72,100,1,109,0,109,137
15.498,6,2403,2265052,1522,1409,10,1448,2214576,881,776,17,1448,50476
126.185,2,2,64,2,8,126185,8,64,0,0,0,0,0
0.91,6,10,1687,7,100,151,100,384,3,1179,322,1179,1303
112.545,6,22,4859,10,220,12505,516,1285,12,385,10223,1452,3574
0.034,17,2,904,1,300,0,300,328,1,548,0,548,576
0.163,17,2,180,1,30,0,30,58,1,94,0,94,122
42.546,17,24,2112,12,48,3867,48,912,12,72,3866,72,1200
14.018,6,28,10386,15,631,1001,1360,3159,13,956,1150,1717,7227
916.529,1,50,2800,50,28,18704,28,2800,0,0,0,0,0
0.387,17,3,1008,3,308,193,308,1008,0,0,0,0,0
5.02,17,4,288,2,36,5007,36,128,2,52,4999,52,160
0.597,6,20,7238,12,335,53,668,1974,8,1210,84,1906,5264
1762.835,6,99,7814,65,45,27544,205,4850,34,35,53410,98,2964
23.139,6,97,29268,46,685,514,1440,17764,51,445,432,1440,11504
367.08,6,25,1651,17,177,22942,177,1117,8,110,9168,110,534
0.01,17,2,423,1,45,0,45,73,1,322,0,322,350
33.465,6,30,5054,15,180,2378,722,1871,15,399,2378,1448,3183
29.693,6,3749,3497425,2365,1398,12,1448,3420769,1384,776,21,1448,76656
11.006,6,18,5610,10,275,1222,275,958,8,1440,854,1440,4652
1744.252,6,95,7203,63,38,28133,205,4476,32,33,56255,98,2727
1796.701,17,448,39896,403,35,4469,288,25676,45,288,40018,288,14220
0.011,6,2,92,1,0,0,0,52,1,0,0,0,40
0.606,17,4,624,2,64,586,64,184,2,192,417,192,440
0.553,6,14,1745,7,288,65,288,600,7,426,62,434,1145
1632.109,1,8,448,8,28,233158,28,448,0,0,0,0,0
20.321,6,19,2432,10,189,2257,517,1298,9,323,2532,499,1134
13.841,6,32,6740,16,154,908,721,1977,16,490,911,2026,4763
1771.147,6,101,9410,66,66,27248,66,5610,35,60,52090,60,3800
4.012,17,2,134,2,39,4012,39,134,0,0,0,0,0
1.503,17,3,1167,3,361,751,361,1167,0,0,0,0,0
24.595,6,17,5705,10,267,2732,502,1206,7,843,114,1420,4499
1784.559,6,102,8364,68,66,26635,66,4964,34,60,54074,60,3400
0.071,17,2,210,1,40,0,40,68,1,114,0,114,142
1783.811,6,371,25879,215,98,8335,469,15223,156,69,11508,69,10656
1740.419,17,29,19517,29,645,62157,645,19517,0,0,0,0,0
15.487,6,2611,2256812,1488,1423,10,1448,2185280,1123,776,13,1448,71532
65.24,6,28,7217,13,155,5436,267,1306,15,482,4659,1997,5911
1797.737,17,449,39928,404,35,4460,288,25708,45,288,40020,288,14220
11.701,6,1897,1611508,1136,1363,10,1380,1576838,761,468,15,3303,34670
1798.283,17,766,46192,766,32,2350,37,46192,0,0,0,0,0
102.248,6,22,4426,11,527,97,1318,2078,11,379,10208,1641,2348
61.369,6,24,5552,9,152,1151,267,822,15,412,4365,1179,4730
1107.463,17,25,1900,25,48,46144,48,1900,0,0,0,0,0
1741.507,6,96,7286,63,38,28088,205,4476,33,33,54412,98,2810
0.156,17,4,420,2,33,148,33,122,2,121,148,145,298
1787.524,6,204,23337,101,71,17875,721,8566,103,217,17520,2840,14771
1772.286,6,180,15480,120,69,14893,69,8940,60,69,30033,69,6540
3.495,17,2,656,2,300,3495,300,656,0,0,0,0,0
40.207,17,39,9125,17,239,2510,1350,4550,22,179,1913,1350,4575
1770.977,1,56,4704,56,56,32199,56,4704,0,0,0,0,0
125.42,2,2,64,2,8,125420,8,64,0,0,0,0,0
2.41,17,2,685,1,308,0,308,336,1,321,0,321,349
10.271,1,9,756,0,0,0,0,0,9,56,1283,56,756
35.624,6,2269,2096092,1566,1265,22,1448,2053326,703,1033,50,1448,42766
13.769,6,629,489149,368,1251,36,1368,470913,261,931,52,2736,18236
8.612,6,94,91385,24,131,373,232,1489,70,1360,124,1430,89896
236.036,6,106,81376,70,1253,3420,1408,71383,36,676,3449,1408,9993
0.842,17,4,424,2,46,841,46,148,2,110,840,110,276
300.213,6,84,15132,39,311,7900,1408,7335,45,247,6822,1408,7797
1.855,6,26,8811,16,286,123,591,1503,10,986,185,2760,7308
1791.663,6,109,6937,66,45,27564,208,4287,43,31,42651,31,2650
0.554,6,33,8329,16,408,36,910,1897,17,441,25,1460,6432
4.924,17,3,208,2,36,4895,36,128,1,52,0,52,80
7.655,6,44,7496,23,218,347,314,3543,21,444,369,1179,3953
217.092,17,4,240,2,32,217091,32,120,2,32,217091,32,120
1773.319,6,180,15480,120,69,14901,69,8940,60,69,30050,69,6540
0.218,6,3,120,2,0,1,0,80,1,0,0,0,40
1798.782,17,140,11200,70,48,26069,48,5320,70,56,26069,56,5880
1.63,6,47,19239,27,896,62,1360,13663,20,433,75,1360,5576
180.461,2,3,96,3,8,90230,8,96,0,0,0,0,0
49.215,17,4,352,2,60,49214,60,176,2,60,49213,60,176
13.524,6,24,6993,13,275,1127,275,1078,11,910,850,1414,5915
0.151,6,12,3462,6,75,30,75,395,6,1373,30,1448,3067
0.085,6,11,1535,6,507,17,507,767,5,556,21,556,768
23.928,17,4,1006,2,40,23915,40,136,2,407,23899,407,870
22.414,17,25,1891,14,40,1710,41,960,11,56,2235,57,931
41.7,6,36,12347,14,386,180,1008,2909,22,534,1978,1360,9438
4.91,6,41,7349,21,218,245,314,3463,20,513,245,1179,3886
0.363,17,2,152,1,48,0,48,76,1,48,0,48,76
31.172,6,19,6704,8,150,4453,174,624,11,938,2107,1452,6080
1.954,17,2,312,2,128,1954,128,312,0,0,0,0,0
1621.138,6,215,17213,82,79,20012,338,8637,133,50,12281,143,8576
1401.205,17,12,3278,6,30,280240,30,348,6,460,280240,463,2930
0.913,6,23,6421,13,312,75,901,2087,10,982,100,1731,4334
240.226,6,52,17678,27,789,9239,1418,14832,25,192,10008,580,2846
444.001,1,9,504,9,28,55500,28,504,0,0,0,0,0
0.18,6,8,1939,1,0,0,0,40,7,761,28,1172,1899
281.403,6,33,7552,14,158,21646,267,1357,19,543,15632,1400,6195
1780.006,1,342,28728,342,56,5219,56,28728,0,0,0,0,0
19.146,6,38,8868,20,390,1007,1216,2394,18,441,501,1360,6474
1780.349,1,290,16240,290,28,6160,28,16240,0,0,0,0,0
1795.573,6,356,22520,208,69,8674,69,12460,148,69,12214,69,10060
27.888,17,4,304,4,48,9296,48,304,0,0,0,0,0
0.984,17,4,624,2,64,982,64,184,2,192,869,192,440
118.092,6,37,7991,15,141,8435,267,1455,22,332,5612,1460,6536
1787.387,6,219,17352,82,75,22064,337,8463,137,50,13141,143,8889
0.451,6,53,23007,29,1045,16,1380,15882,24,511,17,1923,7125
0.002,6,2,246,1,154,0,154,206,1,0,0,0,40
0.229,17,2,136,1,32,0,32,60,1,48,0,48,76
1782.888,17,130,10400,65,48,27857,48,4940,65,56,27857,56,5460
34.139,6,27,7177,13,155,2844,267,1306,14,530,2625,3417,5871
0.008,17,2,283,1,31,0,31,59,1,196,0,196,224
0.474,17,2,152,1,48,0,48,76,1,48,0,48,76
1790.431,6,459,27039,242,69,7429,69,14027,217,35,8289,64,13012
182.89,6,19191,18154268,11869,1442,15,1448,17725304,7322,776,24,1448,428964
6.422,6,57,19284,29,864,229,1440,13307,28,400,230,1440,5977
78.526,6,54,14352,23,158,3569,267,2514,31,557,2610,1400,11838
1661.12,1,8,848,8,78,237302,78,848,0,0,0,0,0
177.651,17,4,240,2,32,177650,32,120,2,32,177649,32,120
280.308,6,28,7352,12,158,25482,267,1277,16,603,18682,1400,6075
300.413,6,62,45887,39,1297,7905,1448,39666,23,715,1406,1448,6221
125.95,2,2,64,2,8,125950,8,64,0,0,0,0,0
300.26,6,28,9451,14,559,23096,1448,3556,14,573,2843,1448,5895
0.029,17,2,664,1,308,0,308,336,1,300,0,300,328
280.196,6,27,7312,13,158,23349,267,1317,14,775,21550,3445,5995
0.504,6,12,1653,6,288,99,288,548,6,426,55,434,1105
976.045,6,79,8829,44,75,22694,722,3950,35,127,28702,2329,4879
58.552,6,29,4417,16,234,3903,564,1840,13,463,3601,1343,2577
0.304,6,3,199,1,31,0,31,83,2,0,304,0,116
374.747,6,18,1242,14,180,28826,180,916,4,110,20071,110,326
18.39,17,17,5203,8,313,2622,1350,2732,9,246,2294,1350,2471
257.833,6,28,6961,13,229,159,498,1672,15,390,18410,1420,5289
0.051,6,12,1843,7,138,8,138,510,5,532,11,891,1333
23.086,17,26,8888,13,416,1921,1350,5775,13,211,1921,1350,3113
1787.535,6,357,31209,207,103,8677,469,15551,150,128,11996,1420,15658
5.512,6,22,10790,11,275,551,275,719,11,1069,510,2840,10071
273.035,17,15,5040,15,308,19502,308,5040,0,0,0,0,0
4.359,6,13,2311,8,188,622,245,700,5,1407,1022,1407,1611
280.46,6,30,7432,13,158,23371,267,1317,17,543,17522,1400,6115
1799.458,17,327,78821,327,213,5519,422,78821,0,0,0,0,0
1783.0,17,142,11360,71,48,25470,48,5396,71,56,25470,56,5964
5.291,17,2,154,1,33,0,33,61,1,65,0,65,93
21.799,6,9,527,5,43,5449,43,311,4,0,7228,0,216
1793.887,6,244,35804,152,302,11880,302,26032,92,83,19712,83,9772
22.975,6,17,2620,10,211,2532,211,1161,7,545,3798,904,1459
1.0,17,4,308,2,33,1000,33,122,2,65,965,65,186
1796.924,2,26,832,26,8,71876,8,832,0,0,0,0,0
1782.744,17,142,11360,71,48,25467,48,5396,71,56,25467,56,5964
3.614,6,2,88,2,0,0,0,88,0,0,0,0,0
2.021,17,4,314,2,31,1988,31,118,2,70,1988,70,196
0.955,6,52,13869,24,551,41,1429,4840,28,438,34,1460,9029
0.057,17,2,198,1,37,0,37,65,1,105,0,105,133
252.026,2,2,64,2,8,252026,8,64,0,0,0,0,0
300.207,6,149,99047,72,213,4228,517,4724,77,1290,3950,2816,94323
79.829,6,36,5368,21,154,3991,722,2184,15,342,1113,1408,3184
0.079,6,10,1568,5,121,19,121,389,5,911,19,911,1179
1795.11,17,80,3354,79,14,23014,14,3318,1,8,0,8,36
300.263,6,25,8099,13,441,25021,1178,2462,12,715,2720,1491,5637
42.451,6,45,10209,22,533,723,910,3083,23,364,1922,2720,7126
280.402,6,27,7312,12,158,25491,267,1277,15,678,20026,2045,6035
1795.661,17,449,39928,404,35,4455,288,25708,45,288,40020,288,14220
1788.046,17,87,3648,86,14,21035,14,3612,1,8,0,8,36
1680.737,17,13,534,11,14,168055,14,462,2,8,1680552,8,72
164.81,17,4,352,2,60,164809,60,176,2,60,164809,60,176
8.215,6,78,24645,40,560,210,1152,18968,38,461,215,1179,5677
145.296,6,22,8264,11,549,99,1309,2120,11,948,14512,1591,6144
0.138,6,10,1669,6,551,27,947,1346,4,159,45,159,323
7.472,6,70,20782,35,559,219,1152,15955,35,427,212,1152,4827
280.218,6,26,7272,12,158,25474,267,1277,14,775,21552,3445,5995
1787.064,17,141,11276,71,48,25529,48,5396,70,56,25899,56,5880
1747.597,17,22,7043,22,292,83218,726,7043,0,0,0,0,0
1773.042,6,180,15480,120,69,14899,69,8940,60,69,30048,69,6540
0.942,6,28,8460,15,222,55,540,1964,13,994,64,1791,6496
1740.546,1,14,784,14,28,133888,28,784,0,0,0,0,0
0.412,17,6,2062,6,315,82,355,2062,0,0,0,0,0
172.124,6,20846,20055610,14001,1355,12,1408,19695006,6845,931,25,2801,360604
292.269,6,43,15062,24,945,12698,1360,9500,19,435,16226,2667,5562
1.355,6,50,19096,29,872,48,1360,13435,21,480,58,4075,5661
1779.843,1,342,28728,342,56,5219,56,28728,0,0,0,0,0
28.409,6,14,1682,12,222,2582,222,1594,2,0,1114,0,88
504.214,2,4,128,4,8,168071,8,128,0,0,0,0,0
1795.636,1,262,14672,262,28,6879,28,14672,0,0,0,0,0
0.262,17,2,157,1,31,0,31,59,1,70,0,70,98
1772.125,6,180,15480,120,69,14891,69,8940,60,69,30035,69,6540
241.961,6,47,5807,23,205,10998,517,2689,24,168,10519,851,3118
1798.561,17,504,187662,504,344,3575,548,187662,0,0,0,0,0
1789.953,6,367,25650,214,99,8403,469,15045,153,69,11776,69,10605
1792.87,17,87,3648,86,14,21092,14,3612,1,8,0,8,36
0.014,17,2,586,1,46,0,46,74,1,484,0,484,512
1082.897,2,9,288,9,8,135362,8,288,0,0,0,0,0
546.491,6,86,12654,43,96,13011,267,3945,43,199,13010,1942,8709
1555.924,1,78,4368,78,28,20206,28,4368,0,0,0,0,0
1.365,6,50,20257,28,896,50,1360,14601,22,476,55,2720,5656
4.521,6,63,21370,31,805,150,1380,15776,32,383,144,1380,5594
95.521,17,14,2176,7,48,15918,48,532,7,206,15918,308,1644
1772.28,6,180,15480,120,69,14893,69,8940,60,69,30034,69,6540
1.298,6,38,9276,20,419,68,1360,3780,18,433,65,1360,5496
0.574,17,2,152,1,48,0,48,76,1,48,0,48,76
0.756,17,2,776,2,360,756,360,776,0,0,0,0,0
1796.104,17,142,11360,71,48,25658,48,5396,71,56,25658,56,5964
1764.596,2,15,480,15,8,126042,8,480,0,0,0,0,0
0.252,6,2,80,1,0,0,0,40,1,0,0,0,40
0.019,17,2,384,1,39,0,39,67,1,289,0,289,317
0.049,6,2,149,1,0,0,0,40,1,69,0,69,109
0.557,6,14,7038,5,106,139,106,314,9,908,42,1420,6724
36.768,17,22,1936,11,48,3674,48,836,11,72,3673,72,1100
1789.633,6,361,22858,209,69,8604,69,12500,152,69,11851,69,10358
58.778,6,36,8360,18,378,511,786,1886,18,478,3449,2720,6474
1778.013,17,138,11040,69,48,26147,48,5244,69,56,26147,56,5796
1740.76,17,29,6815,29,207,62170,207,6815,0,0,0,0,0
107.188,17,4,1344,4,308,35729,308,1344,0,0,0,0,0
1.953,17,22,5709,22,231,93,389,5709,0,0,0,0,0
1789.948,6,354,22647,203,69,8861,69,12260,151,69,11932,69,10387
367.033,6,18,1242,14,180,28233,180,916,4,110,20060,110,326
1.29,6,11,1727,7,100,215,100,384,4,589,344,1152,1343
191.607,1,2,728,2,336,191607,336,728,0,0,0,0,0
0.046,6,2,80,1,0,0,0,40,1,0,0,0,40
0.007,17,2,443,1,40,0,40,68,1,347,0,347,375
1.923,6,25,5795,14,158,147,370,1355,11,799,191,1420,4440
1786.378,6,104,8376,68,65,26662,65,4930,36,59,51036,59,3446
9.023,6,10,728,4,92,2949,92,308,6,92,1770,92,420
0.036,6,12,3705,6,171,6,171,491,6,964,6,1448,3214
902.415,2,9,288,9,8,112801,8,288,0,0,0,0,0
319.147,17,8,2688,8,308,45592,308,2688,0,0,0,0,0
280.33,6,30,7432,13,158,23360,267,1317,17,543,17518,1400,6115
0.287,6,24,6064,12,181,26,537,1526,12,651,24,1448,4538
0.016,17,2,335,1,39,0,39,67,1,240,0,240,268
1790.2,1,59,4956,0,0,0,0,0,59,56,30865,56,4956
1.162,6,21,5960,12,285,105,556,1340,9,709,128,1380,4620
165.233,6,149,113102,93,1294,1796,1448,100617,56,797,1862,5255,12485
0.124,17,2,152,1,48,0,48,76,1,48,0,48,76
1740.437,17,30,7050,30,207,60015,207,7050,0,0,0,0,0
0.003,6,3,170,1,0,0,0,40,2,26,1,26,130
9.546,6,9,527,5,43,2386,43,311,4,0,3179,0,216
1781.766,6,362,22898,210,69,8525,69,12678,152,69,11799,69,10220
0.187,1,2,112,2,28,187,28,112,0,0,0,0,0
0.317,1,3,168,3,28,158,28,168,0,0,0,0,0
0.053,17,2,144,1,36,0,36,64,1,52,0,52,80
72.722,6,79,53951,49,1197,1515,1448,45668,30,839,2125,2359,8283
1635.134,17,130,10400,65,48,25548,48,4940,65,56,25548,56,5460
1.397,6,41,10025,22,502,66,1460,4444,19,400,67,1460,5581
7.515,2,4,160,4,16,2505,16,160,0,0,0,0,0
1775.933,6,683,201027,307,245,5803,1440,64203,376,665,4735,1440,136824
126.525,6,18,1584,16,106,8433,106,1496,2,0,126510,0,88
0.021,17,2,150,1,39,0,39,67,1,55,0,55,83
1795.794,6,356,22520,208,69,8675,69,12460,148,69,12216,69,10060
1796.531,17,448,39612,404,35,4457,288,25708,44,288,40949,288,13904
1.244,6,10,1687,7,100,207,100,384,3,1179,485,1179,1303
35.484,6,33,5198,16,154,2365,722,1912,17,299,2190,1448,3286
3.611,6,23,8169,11,349,354,517,1990,12,924,320,2449,6179
379.844,6,18,1242,14,180,29218,180,916,4,110,20059,110,326
104.625,6,112,76809,66,1277,1609,1448,66072,46,631,2295,1448,10737
0.553,17,4,355,2,39,21,39,134,2,82,536,93,221
0.082,6,6,464,3,136,34,136,300,3,0,40,0,164
4.303,6,39,7269,20,218,226,314,3423,19,513,224,1179,3846
1772.761,6,180,15480,120,69,14897,69,8940,60,69,30039,69,6540
5.969,6,5,220,5,0,0,0,220,0,0,0,0,0
167.312,6,22,9334,11,596,68,1446,2262,11,945,16717,1460,7072
280.363,6,24,7054,11,181,28036,267,1168,13,670,23358,2036,5886
1264.132,6,157,11832,59,66,21793,294,5545,98,48,13032,78,6287
1681.291,1,14,784,14,28,129330,28,784,0,0,0,0,0
300.84,6,32,8331,18,204,17696,467,1820,14,525,5426,2694,6511
1134.159,2,6,192,6,8,226831,8,192,0,0,0,0,0
1587.365,1,8,448,8,28,226766,28,448,0,0,0,0,0
18.52,6,59,19266,29,620,661,1152,14820,30,405,629,1179,4446
300.41,6,64,37378,39,1201,7905,1408,30954,25,511,1569,1491,6424
0.13,17,2,602,1,46,0,46,74,1,500,0,500,528
1790.599,6,359,22709,209,69,8608,69,12569,150,69,12017,69,10140
1772.282,6,180,15480,120,69,14893,69,8940,60,69,30034,69,6540
1798.695,17,448,39896,403,35,4474,288,25676,45,288,40023,288,14220
1790.204,6,382,27064,218,103,8249,469,15950,164,69,10982,69,11114
23.099,17,4,352,2,60,23098,60,176,2,60,23097,60,176
120.109,6,50,29492,29,1120,4284,1448,22811,21,466,5998,1559,6681
213.093,6,6,364,4,31,71031,31,222,2,31,213081,31,142
0.113,1,2,112,2,28,113,28,112,0,0,0,0,0
1797.478,17,457,62144,213,182,8478,1350,44882,244,42,7396,1350,17262
1794.162,17,80,3354,79,14,23002,14,3318,1,8,0,8,36
300.781,6,38,8580,20,318,15830,928,2107,18,441,507,1440,6473
258.411,6,52,12990,28,508,9570,1402,6036,24,569,11234,2422,6954
1746.063,6,94,7151,62,38,28623,205,4424,32,33,56314,98,2727
1772.892,6,180,15480,120,69,14898,69,8940,60,69,30040,69,6540
0.326,17,2,157,1,31,0,31,59,1,70,0,70,98
2.11,6,14,2351,8,188,301,245,700,6,703,373,1152,1651
4.41,17,2,656,2,300,4410,300,656,0,0,0,0,0
240.629,17,4,352,2,60,240628,60,176,2,60,240627,60,176
1772.288,6,180,15480,120,69,14893,69,8940,60,69,30037,69,6540
12.855,6,37,8301,19,345,714,721,1828,18,441,502,1460,6473
3.395,17,3,1167,3,361,1697,361,1167,0,0,0,0,0
0.095,2,2,64,2,8,95,8,64,0,0,0,0,0
0.019,6,2,111,1,0,0,0,40,1,31,0,31,71
10.015,17,3,431,2,41,10008,41,138,1,265,0,265,293
0.538,6,27,8920,13,227,44,547,1592,14,941,24,1438,7328
1747.509,17,22,7467,22,311,83214,1261,7467,0,0,0,0,0
1770.934,6,130,7920,70,26,25665,26,4206,60,26,30015,26,3714
7.695,17,26,14706,14,802,591,1350,11633,12,228,686,1350,3073
0.755,17,4,377,2,33,737,37,123,2,99,737,136,254
0.01,6,5,322,3,31,5,31,187,2,31,0,31,135
1783.81,6,368,23276,212,69,8453,69,12896,156,69,11508,69,10380
1.356,6,48,17865,26,856,54,1460,12209,22,433,56,1460,5656
261.263,17,4,240,2,32,261262,32,120,2,32,261261,32,120
17.786,6,15,2306,9,210,2222,210,908,6,545,3557,904,1398
0.06,17,2,245,1,32,0,32,60,1,157,0,157,185
159.423,6,29,7392,13,158,13285,267,1317,16,603,10625,2800,6075
3.501,6,44,28682,24,952,152,1360,11471,20,2049,177,4080,17211
1792.813,17,66,2766,65,14,28012,14,2730,1,8,0,8,36
0.243,17,11,4677,5,431,60,1350,2299,6,368,34,1350,2378
902.434,2,8,256,8,8,128919,8,256,0,0,0,0,0
111.244,6,131,97226,83,1263,1356,1408,85197,48,680,2164,2439,12029
1630.328,1,8,448,8,28,232904,28,448,0,0,0,0,0
269.174,1,4,224,4,28,89724,28,224,0,0,0,0,0
1022.808,2,7,224,7,8,170468,8,224,0,0,0,0,0
280.434,6,31,7472,13,158,23369,267,1317,18,603,16493,2076,6155
33.585,6,32,5145,15,154,2398,722,1859,17,299,2087,1448,3286
1786.547,6,106,8644,70,66,25891,66,5044,36,60,51041,60,3600
5.31,6,10,2030,7,241,885,241,1726,3,92,99,92,304
1.658,17,3,1176,3,364,829,364,1176,0,0,0,0,0
39.237,6,67,16344,33,438,564,720,3275,34,467,1184,1360,13069
280.837,6,29,7733,12,158,25530,267,1277,17,577,17550,1400,6456
0.012,17,2,330,1,30,0,30,58,1,244,0,244,272
0.286,17,2,136,1,32,0,32,60,1,48,0,48,76
1794.766,6,276,38050,115,137,15742,1360,16155,161,190,11216,4662,21895
11.816,6,1904,1631382,1151,1363,10,1380,1595097,753,558,15,1923,36285
1793.33,1,58,4872,58,56,31461,56,4872,0,0,0,0,0
215.197,17,4,352,2,60,215195,60,176,2,60,215196,60,176
61.349,6,37,16127,22,819,2921,1408,9349,15,665,4365,1408,6778
0.01,6,2,99,1,0,0,0,40,1,7,0,7,59
1788.675,1,59,4956,59,56,30839,56,4956,0,0,0,0,0
1772.098,6,180,15480,120,69,14891,69,8940,60,69,30033,69,6540
363.679,6,16,832,16,0,0,0,832,0,0,0,0,0
1787.544,6,102,8296,68,65,26679,65,4930,34,59,54164,59,3366
1796.428,17,442,37716,404,35,4457,288,25708,38,288,47597,288,12008
1.061,17,4,644,2,33,1050,33,122,2,233,10,233,522
0.22,17,8,2750,8,315,31,354,2750,0,0,0,0,0
334.245,17,5,2136,3,300,126082,300,984,2,548,69,548,1152
1.02,17,2,368,1,37,0,37,65,1,275,0,275,303
1739.976,6,87,6322,58,31,30525,31,3915,29,31,62141,31,2407
10.956,6,20,4442,11,275,1095,275,998,9,768,774,1440,3444
280.555,6,29,7392,13,158,23379,267,1317,16,678,18694,2760,6075
1745.55,6,96,7286,63,38,28154,205,4476,33,33,54536,98,2810
1747.888,6,101,7608,64,38,27744,205,4528,37,33,48541,98,3080
330.209,6,39,10014,21,191,16510,281,2287,18,616,14201,1408,7727
0.385,6,2,104,1,0,0,0,52,1,0,0,0,52
366.49,6,26,1703,17,177,22905,177,1117,9,110,9151,110,586
1782.154,17,83,3480,82,14,22001,14,3444,1,8,0,8,36
91.643,6,70,48882,45,1203,2082,1408,40848,25,960,2566,3847,8034
1784.198,17,83,3474,81,14,22300,14,3402,2,8,1784021,8,72
1795.889,17,448,39896,403,35,4467,288,25676,45,288,40016,288,14220
0.451,6,12,1304,6,256,85,256,756,6,304,87,304,548
1022.736,2,8,256,8,8,146105,8,256,0,0,0,0,0
5.012,17,4,288,2,36,4995,36,128,2,52,4993,52,160
0.023,17,2,144,1,36,0,36,64,1,52,0,52,80
10.023,17,4,744,2,34,10010,34,124,2,282,10009,282,620
0.623,17,2,225,1,37,0,37,65,1,132,0,132,160
0.019,17,2,574,1,32,0,32,60,1,486,0,486,514
1703.667,1,22,1232,22,28,81127,28,1232,0,0,0,0,0
10.279,6,1545,1408770,996,1363,10,1420,1382471,549,475,18,1883,26299
241.442,17,4,352,2,60,241441,60,176,2,60,241440,60,176
10.263,6,1921,1773710,1216,1380,8,1408,1732386,705,931,14,2816,41324
7.315,6,5,284,1,0,0,0,60,4,0,2377,0,224
0.999,6,38,10430,21,490,49,1420,3338,17,492,45,1420,7092
3.689,17,25,14106,14,787,281,1350,11422,11,216,365,1350,2684
1750.608,1,118,12508,118,78,14962,78,12508,0,0,0,0,0
60.138,2,2,64,2,8,60138,8,64,0,0,0,0,0
292.059,17,44,14750,44,307,6792,329,14750,0,0,0,0,0
61.789,6,75,49319,44,1208,1436,1448,40979,31,746,2052,1448,8340
1799.797,17,448,39896,403,35,4477,288,25676,45,288,40020,288,14220
0.987,6,28,8484,15,222,60,540,1988,13,994,67,1791,6496
63.35,6,19,2159,10,302,7038,302,1422,9,83,7917,83,737
0.407,6,10,967,5,256,98,256,460,5,303,98,303,507
2.185,17,2,677,1,300,0,300,328,1,321,0,321,349
0.048,17,2,136,1,32,0,32,60,1,48,0,48,76
0.701,6,27,7296,13,155,58,267,1301,14,603,46,2600,5995
6.237,6,40,7309,22,218,297,314,3503,18,513,352,1179,3806
0.768,6,28,5780,14,125,59,267,1315,14,650,54,1420,4465
1745.174,6,96,7255,63,38,28147,205,4476,33,33,54524,98,2779
13.699,6,2430,2269105,1559,1379,8,1408,2219125,871,931,15,2816,49980
1789.821,1,158,8848,158,28,11400,28,8848,0,0,0,0,0
14.219,6,119,49059,67,677,215,1360,36596,52,493,275,1938,12463
0.033,6,9,1880,5,910,8,910,1178,4,486,10,486,702
0.008,17,2,429,1,34,0,34,62,1,339,0,339,367
1773.016,6,210,24360,132,91,13534,1093,11299,78,136,23024,1420,13061
0.007,17,2,351,1,39,0,39,67,1,256,0,256,284
1.934,17,6,936,3,64,923,64,276,3,192,942,192,660
9.693,6,89,28298,46,562,215,1152,22096,43,407,224,1152,6202
1786.509,6,150,19350,90,302,20073,302,13740,60,83,30279,83,5610
91.68,6,105,75012,63,1278,1478,1448,64664,42,741,2230,2359,10348
6.86,6,14,2242,8,210,978,210,844,6,545,1370,904,1398
4.202,17,5,290,5,30,1050,30,290,0,0,0,0,0
0.114,6,11,1711,6,98,22,98,358,5,1149,24,1149,1353
1788.342,6,5415,5052726,1995,128,896,352,117937,3420,1422,523,5672,4934789
300.789,6,38,9598,20,540,15831,1360,4076,18,399,513,1360,5522
112.576,6,24,980,10,0,5430,0,404,14,0,8659,0,576
887.07,17,16,1283,8,30,126722,37,471,8,73,126723,136,812
126.132,2,2,64,2,8,126132,8,64,0,0,0,0,0
23.707,1,3,279,3,65,11853,88,279,0,0,0,0,0
1.81,17,33,15997,18,572,104,1350,10804,15,318,127,1350,5193
1772.039,6,180,15480,120,69,14891,69,8940,60,69,30033,69,6540
1776.925,17,73,3060,72,14,25027,14,3024,1,8,0,8,36
59.806,6,9,527,5,43,14951,43,311,4,0,19914,0,216
0.188,17,2,2382,2,1163,188,1163,2382,0,0,0,0,0
1.427,6,48,20350,28,908,52,1360,14774,20,476,63,2715,5576
1793.757,1,58,4872,58,56,31469,56,4872,0,0,0,0,0
256.717,6,28,6961,13,229,160,498,1672,15,390,18330,1420,5289
155.792,17,4,352,2,60,155791,60,176,2,60,155791,60,176
0.05,6,13,3980,7,88,8,88,388,6,1670,10,1880,3592
86.341,6,29,7392,13,158,7195,267,1317,16,603,5753,1400,6075
0.153,1,2,112,2,28,153,28,112,0,0,0,0,0
1753.427,1,70,5880,0,0,0,0,0,70,56,25411,56,5880
280.625,6,30,7773,13,158,23385,267,1317,17,577,17537,1400,6456
0.136,17,2,174,1,45,0,45,73,1,73,0,73,101
27.384,6,23,3980,13,269,2282,517,1796,10,548,2247,998,2184
0.012,6,10,1863,5,105,2,105,325,5,1326,2,1326,1538
346.54,17,6,2016,6,308,69308,308,2016,0,0,0,0,0
59.191,6,26,7137,12,155,5381,267,1266,14,530,4552,2006,5871
1787.38,6,108,8654,70,65,25904,65,5010,38,59,48304,59,3644
281.915,6,27,7312,12,158,25628,267,1277,15,678,20110,2045,6035
1756.268,1,63,5292,0,0,0,0,0,63,56,28326,56,5292
7.527,6,1489,1398962,960,1381,7,1408,1366790,529,931,13,2801,32172
64.121,17,18,1584,9,48,8014,48,684,9,72,8013,72,900
4.086,17,10,1450,5,40,1018,40,340,5,194,1019,194,1110
1465.536,6,98,12341,64,83,23261,504,5224,34,185,44407,1452,7117
0.222,17,2,456,2,200,222,352,456,0,0,0,0,0
9.522,6,62,21231,31,856,317,1440,15003,31,347,308,1440,6228
191.347,6,9,504,4,112,63778,112,280,5,0,47834,0,224
1772.815,6,180,15480,120,69,14897,69,8940,60,69,30041,69,6540
0.508,17,19,7593,9,502,63,1350,4771,10,254,49,1350,2822
7.761,6,26,8009,8,155,868,267,1106,18,474,456,1420,6903
1782.43,1,208,11648,208,28,8610,28,11648,0,0,0,0,0
280.05,6,30,7432,13,158,23337,267,1317,17,543,17500,1400,6115
1779.929,6,356,22658,207,69,8640,69,12420,149,69,12026,69,10238
0.714,6,11,1971,6,451,142,500,1222,5,481,178,481,749
280.483,6,29,7392,13,158,23373,267,1317,16,678,18694,2760,6075
1782.661,17,142,11360,71,48,25466,48,5396,71,56,25466,56,5964
0.523,17,3,451,2,39,386,39,134,1,289,0,289,317
38.276,17,44,6468,22,48,1822,48,1672,22,190,1822,308,4796
1795.437,17,80,3354,79,14,23018,14,3318,1,8,0,8,36
0.965,6,28,8160,15,222,58,540,1964,13,944,65,1591,6196
0.021,17,4,344,2,47,15,47,150,2,69,14,75,194
158.185,6,31,7725,11,141,15818,267,1295,20,374,8325,2840,6430
1786.895,1,64,5376,64,56,28363,56,5376,0,0,0,0,0
19.739,17,22,6725,11,355,1970,1350,4213,11,200,1970,1350,2512
503.641,2,4,128,4,8,167880,8,128,0,0,0,0,0
1.968,6,24,5755,13,158,163,370,1315,11,999,195,1731,4440
125.184,6,987,523527,571,855,219,1152,502890,416,399,301,1152,20637
0.436,6,48,20746,27,1037,16,1380,15664,21,421,20,1923,5082
240.391,6,44,8934,21,524,12019,1418,5816,23,212,10926,618,3118
1.512,6,11,1727,7,100,252,100,384,4,589,422,1152,1343
848.945,1,8,448,8,28,121277,28,448,0,0,0,0,0
1749.399,6,95,7203,63,38,28216,205,4476,32,33,56419,98,2727
0.228,17,2,290,1,40,0,40,68,1,194,0,194,222
0.582,6,13,1497,6,585,116,585,893,7,212,86,212,604
85.179,6,23,8118,12,417,59,950,1777,11,841,8504,2720,6341
304.823,6,77,45696,45,1164,6927,1448,37285,32,747,2064,1448,8411
37.849,17,22,1672,22,48,1802,48,1672,0,0,0,0,0
15.677,6,17,4282,6,92,3135,92,400,11,367,1534,1448,3882
12.025,6,1882,1655850,1170,1363,10,1380,1623128,712,421,16,2760,32722
1782.555,6,356,22520,208,69,8611,69,12460,148,69,12126,69,10060
140.967,6,35,11498,14,158,10843,267,1357,21,664,7044,1400,10141
0.279,6,26,7256,12,155,25,267,1261,14,603,19,1400,5995
1744.781,2,26,832,26,8,69791,8,832,0,0,0,0,0
1786.678,6,2337,2317165,785,130,2278,344,47381,1552,1480,1151,5672,2269784
3.011,6,20,6317,10,268,329,517,1333,10,744,329,1418,4984
1787.249,6,102,8296,68,65,26675,65,4930,34,59,54155,59,3366
2.421,6,15,2391,9,188,302,245,740,6,703,429,1152,1651
980.711,1,12,672,12,28,89155,28,672,0,0,0,0,0
165.901,6,21,10221,11,408,80,916,1697,10,1352,18416,2568,8524
6.001,17,4,1144,2,41,5989,41,138,2,475,5989,489,1006
1783.672,17,83,3480,82,14,22020,14,3444,1,8,0,8,36
0.41,6,14,1733,7,288,64,288,588,7,284,36,434,1145
0.596,6,10,924,5,283,98,283,551,5,105,102,105,373
102.162,17,4,1344,4,308,34054,308,1344,0,0,0,0,0
0.369,6,4,1037,2,0,220,0,104,2,853,150,853,933
11.023,6,91,26853,47,535,239,1152,20611,44,447,250,1179,6242
35.175,6,29,4990,14,180,2705,722,1807,15,342,2473,1448,3183
280.508,6,29,7392,13,158,23375,267,1317,16,678,18691,3456,6075
14.214,17,3,2906,3,940,7107,1451,2906,0,0,0,0,0
1.421,6,50,20351,27,967,54,1460,14655,23,433,56,1460,5696
31.691,6,12,5538,4,106,10563,106,274,8,822,4494,1452,5264
1766.45,6,122,7427,67,27,26763,27,4018,55,27,32711,27,3409
0.909,6,25,9907,14,360,69,1084,2047,11,1234,72,2570,7860
158.577,17,8,2688,8,308,22653,308,2688,0,0,0,0,0
0.0,1,1,390,1,362,0,362,390,0,0,0,0,0
3.698,6,34,8423,18,334,217,686,1754,16,547,237,2720,6669
1794.126,17,80,3354,79,14,23001,14,3318,1,8,0,8,36
20.216,6,17,2316,10,189,2246,517,1298,7,323,3364,499,1018
1.592,17,17,7346,9,510,194,1350,4850,8,284,222,1350,2496
18.18,6,15,2297,9,211,2272,211,898,6,545,3597,904,1399
1798.739,1,15,840,15,28,128481,28,840,0,0,0,0,0
6.072,6,15,1144,9,181,759,181,661,6,77,47,134,483
260.532,6,73,11960,33,188,6760,1189,3778,40,285,6680,2006,8182
1780.692,17,140,11200,70,48,25807,48,5320,70,56,25806,56,5880
9.242,6,2,1175,1,0,0,0,40,1,1095,0,1095,1135
1799.978,1,56,4704,56,56,32726,56,4704,0,0,0,0,0
1769.58,1,53,4452,53,56,34030,56,4452,0,0,0,0,0
15.725,17,30,18818,16,822,1046,1350,13614,14,343,1207,1350,5204
838.562,6,173,12839,82,56,10316,65,4709,91,38,9313,63,8130
35.735,6,29,7257,13,155,2977,267,1306,16,441,2381,1420,5951
0.13,17,2,386,1,46,0,46,74,1,284,0,284,312
62.408,2,6,192,6,8,12481,8,192,0,0,0,0,0
1786.16,6,109,8700,70,65,25886,65,5075,39,59,46998,59,3625
1.468,6,37,9087,20,399,77,1460,3631,17,433,79,1460,5456
5.098,17,4,288,2,36,5002,36,128,2,52,4907,52,160
3.916,17,4,2367,4,563,1305,1280,2367,0,0,0,0,0
0.127,6,12,3462,6,75,25,75,395,6,1373,25,1448,3067
1.35,6,50,21550,28,982,50,1440,15894,22,433,55,1440,5656
2.975,6,2,120,2,0,0,0,120,0,0,0,0,0
0.303,6,21,5000,10,137,33,267,1092,11,692,28,1467,3908
373.433,6,18,1242,14,180,28725,180,916,4,110,20061,110,326
1.3,6,48,18145,28,873,48,1360,12524,20,480,59,4075,5621
0.016,17,2,640,2,292,16,298,640,0,0,0,0,0
1772.974,6,182,15629,121,69,14774,69,8980,61,69,29547,69,6649
11.058,6,6,328,4,0,3686,0,216,2,0,10838,0,112
1797.19,6,355,22480,207,69,8724,69,12420,148,69,12225,69,10060
1.464,17,6,1438,3,30,726,30,174,3,393,726,468,1264
150.319,6,18,1548,12,69,13665,69,894,6,69,30035,69,654
231.055,6,34,6437,18,286,13591,1314,2445,16,334,15402,1414,3992
28.725,6,42,20185,22,918,1367,1438,9417,20,1080,1507,1484,10768
1772.187,6,180,15480,120,69,14892,69,8940,60,69,30034,69,6540
150.154,6,76,5147,38,31,4058,31,2563,38,31,4058,31,2584
20.883,6,26,4758,15,176,1491,517,2035,11,428,2087,499,2723
1772.478,6,180,15480,120,69,14894,69,8940,60,69,30036,69,6540
1798.669,6,214,17392,135,69,13422,69,9747,79,69,23059,69,7645
1788.708,17,142,11360,71,48,25552,48,5396,71,56,25552,56,5964
17.172,6,2541,2162017,1431,1415,11,1448,2089617,1110,776,15,1448,72400
9.325,6,40,8696,20,389,490,854,2049,20,416,482,3488,6647
0.374,17,2,154,1,33,0,33,61,1,65,0,65,93
264.492,1,10,560,10,28,29388,28,560,0,0,0,0,0
0.002,6,7,21472,1,0,0,0,40,6,3520,0,5632,21432
1794.474,6,359,22709,209,69,8627,69,12569,150,69,12041,69,10140
0.876,17,23,11895,11,725,87,1350,8293,12,272,64,1350,3602
1786.792,6,104,8376,68,65,26668,65,4930,36,59,51047,59,3446
1789.955,6,366,25541,213,100,8443,469,14936,153,69,11776,69,10605
0.257,6,21,5000,10,137,28,267,1092,11,692,23,1467,3908
32.677,6,29,8433,14,523,2513,1050,2353,15,529,2274,1491,6080
1720.612,17,12,498,11,14,172061,14,462,1,8,0,8,36
932.655,6,240,14016,130,69,7229,69,7408,110,34,8556,64,6608
219.501,6,52,10679,19,241,12194,1189,2942,33,267,6859,1420,7737
240.19,6,50,16273,26,746,9607,1402,13301,24,214,10442,580,2972
320.36,6,658,539601,419,1317,766,1360,522720,239,214,118,1360,16881
1799.885,1,192,20352,192,78,9423,78,20352,0,0,0,0,0
1795.412,17,449,39928,404,35,4455,288,25708,45,288,40019,288,14220
21.823,6,26,5515,16,217,1454,517,2374,10,522,2423,969,3141
240.651,2,3,96,3,8,120325,8,96,0,0,0,0,0
2.382,6,20,3833,11,234,238,564,1504,9,463,275,1343,2329
280.489,6,28,7352,13,158,23374,267,1317,15,603,20029,2760,6035
0.376,17,2,196,1,62,0,62,90,1,78,0,78,106
1770.279,6,136,8346,73,26,24586,26,4412,63,26,28552,26,3934
1399.241,1,116,6496,116,28,12167,28,6496,0,0,0,0,0
1794.525,17,82,3443,80,14,22715,15,3361,2,13,34360,18,82
0.561,6,23,7451,14,275,43,674,2115,9,1212,62,1946,5336
5.438,6,40,7309,21,218,271,314,3463,19,513,288,1179,3846
1742.274,6,95,7203,63,38,28101,205,4476,32,33,56192,98,2727
1.541,6,9,382,4,0,513,0,164,5,7,265,7,218
1.202,17,23,9492,10,531,133,1350,5593,13,271,74,1350,3899
6.194,2,2,64,2,8,6194,8,64,0,0,0,0,0
254.694,17,6,480,3,48,127341,48,228,3,56,127341,56,252
8.844,6,77,24253,39,549,232,1152,18592,38,459,231,1179,5661
4.394,17,496,537104,102,114,43,1350,14497,394,1298,11,1350,522607
2.823,6,137,193724,58,286,49,903,4745,79,2498,36,7040,188979
29.448,6,247,163895,137,1372,117,1460,151029,110,192,268,1460,12866
1773.257,6,180,15480,120,69,14901,69,8940,60,69,30046,69,6540
1740.957,6,89,6426,58,31,30543,31,3915,31,31,58031,31,2511
42.142,17,87,55510,48,850,896,1350,42179,39,313,1108,1350,13331
0.142,1,2,112,2,28,142,28,112,0,0,0,0,0
1788.537,17,87,3648,86,14,21041,14,3612,1,8,0,8,36
1793.343,17,179,13962,179,50,10074,50,13962,0,0,0,0,0
1795.765,17,448,39896,403,35,4467,288,25676,45,288,40018,288,14220
0.473,17,4,288,2,36,440,36,128,2,52,435,52,160
891.975,17,50,16800,50,308,18203,308,16800,0,0,0,0,0
2.819,6,17,2471,9,125,352,245,740,8,703,367,1152,1731
300.135,6,53,14119,27,750,11537,1360,7924,26,302,11998,2667,6195
284.439,17,4,352,2,60,284438,60,176,2,60,284438,60,176
0.373,6,13,1693,7,288,62,288,588,6,284,37,434,1105
0.814,6,2,80,1,0,0,0,40,1,0,0,0,40
845.13,6,100,6852,37,46,23475,46,2906,63,46,13628,46,3946
0.399,6,21,7217,13,318,33,599,1957,8,967,54,1471,5260
0.956,6,23,6457,13,322,79,951,2137,10,979,105,1791,4320
1773.075,6,351,22251,203,69,8777,69,12260,148,69,12061,69,9991
7.107,6,1587,1462296,1003,1380,6,1408,1427264,584,931,11,2801,35032
94.263,6,36,7951,16,140,6284,267,1633,20,367,4953,1460,6318
2.451,6,49,21050,28,952,90,1460,15434,21,433,106,1460,5616
1793.968,17,177,13806,177,50,10193,50,13806,0,0,0,0,0
1791.698,1,264,14784,264,28,6812,28,14784,0,0,0,0,0
299.596,1,4,224,4,28,99865,28,224,0,0,0,0,0
1784.74,17,134,10704,69,48,26246,48,5244,65,56,27886,56,5460
53.389,17,8,2688,8,308,7627,308,2688,0,0,0,0,0
64.903,6,13,540,6,0,4954,0,248,7,0,10815,0,292
1742.98,6,103,8151,67,45,26408,205,4992,36,35,49791,98,3159
0.047,6,9,1340,5,145,11,145,349,4,827,11,827,991
293.163,17,4,352,2,60,293162,60,176,2,60,293162,60,176
1785.476,17,516,70135,243,184,7378,1350,51597,273,39,6563,1350,18538
4.087,17,8,1784,4,32,1361,32,240,4,358,1360,470,1544
0.744,17,2,204,1,34,0,34,62,1,114,0,114,142
1.263,6,17,3001,8,324,180,585,1097,9,285,156,580,1904
173.6,2,2,64,2,8,173600,8,64,0,0,0,0,0
0.539,17,3,451,2,39,18,39,134,1,289,0,289,317
278.697,17,11,836,11,48,27869,48,836,0,0,0,0,0
3.77,6,25,5795,13,158,312,370,1315,12,799,340,1460,4480
0.873,17,2,148,2,46,873,46,148,0,0,0,0,0
1795.359,6,356,22520,208,69,8673,69,12460,148,69,12213,69,10060
231.114,17,4,352,2,60,231112,60,176,2,60,231112,60,176
1664.696,1,7,392,7,28,277449,28,392,0,0,0,0,0
175.273,17,2,72,1,8,0,8,36,1,8,0,8,36
1773.081,6,180,15480,120,69,14899,69,8940,60,69,30049,69,6540
19.8,6,2707,2523060,1652,1443,11,1448,2459760,1055,776,18,1448,63300
0.389,6,24,4571,12,165,35,456,1446,12,415,33,888,3125
15.159,17,4,4400,4,1072,5053,1072,4400,0,0,0,0,0
12.757,6,1156,1078571,713,1434,17,1448,1050151,443,776,27,1448,28420
27.651,6,44,13777,21,289,1382,721,3451,23,783,1248,1414,10326
240.268,6,43,9071,21,519,12013,1402,5772,22,238,11441,618,3299
0.502,17,3,543,2,39,264,39,134,1,381,0,381,409
1763.823,2,14,448,14,8,135678,8,448,0,0,0,0,0
0.48,17,3,451,2,39,246,39,134,1,289,0,289,317
1030.742,6,20,19608,2,174,10061,174,258,18,1431,60607,1452,19350
2.486,6,20,3833,11,234,248,564,1504,9,463,284,1343,2329
108.579,17,4,352,2,60,108578,60,176,2,60,108577,60,176
0.174,6,11,911,6,181,34,181,489,5,77,35,133,422
8.315,6,80,24421,39,550,218,1152,18624,41,461,201,1179,5797
240.235,6,54,18007,29,806,8579,1418,15226,25,184,10009,580,2781
0.457,6,20,7151,12,318,39,600,1906,8,1205,62,1851,5245
190.671,17,4,240,2,32,190670,32,120,2,32,190670,32,120
4.328,17,2,656,2,300,4328,300,656,0,0,0,0,0
1771.48,6,99,9174,66,64,27253,64,5544,33,58,55356,58,3630
11.74,6,1867,1621875,1130,1381,10,1420,1588174,737,467,15,1883,33701
26.312,17,4,352,2,60,26311,60,176,2,60,26311,60,176
26.019,6,42,13475,20,330,1369,721,3119,22,728,1230,1440,10356
1.971,6,26,5751,14,114,151,267,1366,12,650,172,1420,4385
1177.494,6,331,60689,149,304,7956,1440,32395,182,218,6504,1702,28294
3.37,6,6,324,4,0,1123,0,216,2,0,3167,0,108
1786.9,17,762,45960,762,32,2348,37,45960,0,0,0,0,0
1783.808,6,365,25501,212,100,8454,469,14896,153,69,11735,69,10605
207.529,17,4,352,2,60,207528,60,176,2,60,207528,60,176
1798.656,6,286,36327,117,140,15504,1360,17122,169,148,10705,3302,19205
382.473,6,87,12133,29,94,13659,267,2774,58,156,6709,1933,9359
9.723,17,2,2089,2,1016,9723,1451,2089,0,0,0,0,0
1794.05,6,361,22858,210,69,8583,69,12678,151,69,11960,69,10180
0.612,6,27,9071,13,247,51,624,1672,14,832,45,1448,7399
1746.643,6,97,7307,63,38,28171,205,4476,34,33,52918,98,2831
11.025,6,19,4362,11,275,1102,275,998,8,1010,892,2840,3364
240.123,6,89,62030,45,179,5457,179,2527,44,1395,5583,1438,59503
120.341,2,2,64,2,8,120341,8,64,0,0,0,0,0
1.101,6,24,6637,13,350,91,1090,2277,11,783,109,1420,4360
0.009,17,2,201,1,40,0,40,68,1,105,0,105,133
0.403,6,7,383,4,0,134,0,216,3,7,104,7,167
2.357,6,14,2351,8,188,336,245,700,6,703,418,1152,1651
1787.55,6,104,8376,68,65,26679,65,4930,36,59,51069,59,3446
9.33,17,36,9001,11,280,931,1350,3395,25,196,387,1350,5606
8.19,6,68,20558,36,554,234,1152,15851,32,427,256,1152,4707
615.84,6,164,39373,73,445,8553,1360,24910,91,171,6841,3289,14463
41.527,17,16,1216,16,48,2768,48,1216,0,0,0,0,0
1786.571,6,106,8524,68,66,26665,66,4964,38,60,48283,60,3560
115.443,6,107,72625,64,1227,1832,1408,62250,43,677,1995,1408,10375
11.727,6,1860,1621027,1128,1383,10,1420,1587526,732,467,16,1883,33501
0.398,6,6,324,4,0,132,0,216,2,0,206,0,108
1745.165,6,95,7203,63,38,28147,205,4476,32,33,56286,98,2727
16.568,17,26,7463,11,356,1653,1350,4227,15,187,1181,1350,3236
7.518,6,6,324,2,0,7518,0,100,4,0,2434,0,224
1787.37,6,102,8296,68,65,26677,65,4930,34,59,54160,59,3366
1.589,6,44,18488,27,851,61,1360,13032,17,529,86,4075,5456
1720.487,17,12,498,11,14,172048,14,462,1,8,0,8,36
1771.204,6,101,9344,66,65,27249,65,5577,35,59,52091,59,3767
1797.98,17,449,39928,404,35,4461,288,25708,45,288,40014,288,14220
1797.389,17,767,46299,767,32,2346,37,46299,0,0,0,0,0
1777.847,17,142,11360,71,48,25397,48,5396,71,56,25397,56,5964
26.2,6,66,19865,33,579,818,1152,15816,33,389,810,1179,4049
177.804,2,2,64,2,8,177804,8,64,0,0,0,0,0
95.23,6,35,5313,20,180,5012,722,2130,15,342,1104,1408,3183
1773.636,1,58,4872,58,56,31116,56,4872,0,0,0,0,0
421.106,2,5,160,5,8,105276,8,160,0,0,0,0,0
180.858,6,24,10090,12,532,57,1360,2678,12,1153,16429,2720,7412
0.048,17,2,176,1,48,0,48,76,1,72,0,72,100
2.148,17,2,677,1,300,0,300,328,1,321,0,321,349
371.514,6,27,1767,18,177,21853,177,1181,9,110,8818,110,586
1744.852,6,95,7203,63,38,28142,205,4476,32,33,56276,98,2727
185.5,6,30,7432,13,158,15458,267,1317,17,603,11591,2076,6115
1746.816,6,95,7203,63,38,28174,205,4476,32,33,56336,98,2727
1781.762,6,362,22967,210,69,8525,69,12609,152,69,11799,69,10358
280.208,6,27,7312,12,158,25473,267,1277,15,678,20011,2800,6035
139.141,6,30,7505,13,151,5345,267,1588,17,475,8695,1420,5917
11.851,6,25,8473,13,275,987,275,1078,12,986,852,1440,7395
4.785,6,40,7309,20,218,251,314,3423,20,440,239,1152,3886
299.526,6,6,364,4,31,99842,31,222,2,31,299514,31,142
69.122,6,7,380,3,0,34561,0,164,4,0,22975,0,216
0.035,6,29,16043,15,127,2,127,939,14,1197,2,1448,15104
280.205,6,27,7312,13,158,23350,267,1317,14,775,21550,3445,5995
1427.297,6,35463,36117850,15390,342,92,351,909076,20073,1706,71,4104,35208774
0.146,6,46,22431,27,1090,5,1420,17450,19,467,7,1883,4981
15.6,6,7,328,2,0,15600,0,88,5,0,3571,0,240
81.7,6,234,268690,167,872,38,1360,22580,67,4270,1235,20400,246110
42.783,6,6,328,4,0,14261,0,216,2,0,42767,0,112
1532.888,1,15,1930,15,100,109492,117,1930,0,0,0,0,0
334.757,6,92,19074,41,307,8368,1408,7671,51,335,6695,2816,11403
291.458,6,52,9745,25,229,12142,517,2742,27,430,11208,1418,7003
378.589,6,18,1242,14,180,29122,180,916,4,110,20066,110,326
8.626,6,14,808,7,0,1437,0,396,7,0,1412,0,412
86.11,6,126,97983,80,1281,1090,1448,87477,46,675,1908,1448,10506
0.439,6,22,7333,12,334,39,663,1969,10,1209,48,2816,5364
43.061,6,34,9067,15,327,106,1189,2575,19,477,2391,1917,6492
1772.663,6,180,15480,120,69,14896,69,8940,60,69,30037,69,6540
0.067,6,2,1444,1,1364,0,1364,1404,1,0,0,0,40
0.091,17,4,344,2,47,84,47,150,2,69,84,75,194
0.024,17,2,475,1,40,0,40,68,1,379,0,379,407
0.431,6,5,1564,3,413,215,413,946,2,269,183,269,618
0.122,17,2,154,1,33,0,33,61,1,65,0,65,93
0.079,17,2,2754,2,1349,79,1349,2754,0,0,0,0,0
0.514,17,2,178,1,29,0,29,57,1,93,0,93,121
0.335,17,2,144,1,36,0,36,64,1,52,0,52,80
0.032,6,11,1661,6,106,6,106,426,5,967,8,967,1235
1791.703,6,363,33846,177,415,10180,841,12621,186,64,9683,1550,21225
1782.007,6,354,22440,207,69,8650,69,12420,147,69,12205,69,10020
107.96,6,18,2393,10,324,11995,585,1177,8,396,15417,580,1216
184.233,2,2,64,2,8,184233,8,64,0,0,0,0,0
1790.489,6,380,23549,209,69,8608,69,12569,171,50,10532,69,10980
1.886,6,13,2311,8,188,269,245,700,5,1407,398,1407,1611
14.099,6,1098,1011816,694,1381,20,1448,985020,404,776,34,1448,26796
240.173,6,54,17511,28,775,8895,1408,14640,26,215,9606,580,2871
1661.604,1,142,15052,142,78,11784,78,15052,0,0,0,0,0
0.21,17,2,157,1,31,0,31,59,1,70,0,70,98
226.003,1,4,224,4,28,75334,28,224,0,0,0,0,0
113.614,6,83,57656,51,1226,2272,1368,49257,32,840,1999,2519,8399
1.258,6,23,7952,12,164,97,267,1288,11,1216,107,2896,6664
5.033,17,4,288,2,36,5002,36,128,2,52,4987,52,160
82.471,6,5,293,4,31,27490,31,222,1,31,0,31,71
0.084,17,2,1918,2,931,84,931,1918,0,0,0,0,0
1.177,6,40,16843,24,619,51,1360,9050,16,793,69,4649,7793
1770.696,6,101,9344,66,65,27241,65,5577,35,59,52076,59,3767
3.511,17,5,340,5,40,877,40,340,0,0,0,0,0
0.446,6,22,7269,12,318,40,599,1905,10,1209,48,3314,5364
1.81,6,27,10192,16,287,120,593,1505,11,1030,164,1420,8687
1772.126,6,180,15480,120,69,14891,69,8940,60,69,30032,69,6540
0.08,17,4,352,2,37,75,37,130,2,83,77,89,222
1264.541,17,14,1117,7,31,210745,37,413,7,72,210747,136,704
64.246,6,23,6760,9,156,2045,156,560,14,1125,4929,1360,6200
0.023,6,2,92,1,0,0,0,40,1,0,0,0,52
1783.612,17,83,3480,82,14,22019,14,3444,1,8,0,8,36
0.164,6,47,22960,27,1122,6,1432,17939,20,420,8,1432,5021
0.7,17,14,7058,7,613,116,1350,4493,7,338,111,1350,2565
0.009,17,2,418,1,37,0,37,65,1,325,0,325,353
0.063,17,4,588,2,48,50,48,152,2,190,52,308,436
1745.026,6,97,7338,64,38,27698,205,4528,33,33,54524,98,2810
5.436,6,15,3213,6,92,1087,92,400,9,579,625,1448,2813
0.464,17,15,10485,8,987,62,1350,8125,7,309,71,1350,2360
226.847,17,4,240,2,32,226846,32,120,2,32,226846,32,120
1.12,6,212,164101,124,1337,9,1432,156110,88,427,12,1432,7991
1107.439,17,46,7116,23,48,50337,48,1748,23,205,50337,308,5368
4.4,6,37,7205,18,218,258,314,3343,19,516,229,1179,3862
295.641,17,2,244,2,94,295641,94,244,0,0,0,0,0
47.651,6,29,7481,9,165,5956,267,1029,20,352,2498,1460,6452
4.959,17,3,2048,3,654,2479,655,2048,0,0,0,0,0
3.186,6,2,88,2,0,0,0,88,0,0,0,0,0
16.499,17,18,12772,11,945,1646,1350,10705,7,267,2744,1350,2067
1781.65,6,102,8296,68,65,26591,65,4930,34,59,53986,59,3366
1789.345,17,83,3480,82,14,22090,14,3444,1,8,0,8,36
4.317,17,5,588,4,64,1334,64,368,1,192,0,192,220
102.771,6,37,8252,13,149,2710,267,1572,24,317,4467,1460,6680
1794.467,6,90,7562,43,36,42503,36,2440,47,444,39010,445,5122
725.159,6,46,13167,26,439,29006,1360,5502,20,489,38156,1360,7665
7.95,6,6,374,2,31,3,31,135,4,31,2605,31,239
625.949,1,9,1242,9,110,78243,176,1242,0,0,0,0,0
0.265,17,2,2728,2,1336,265,1336,2728,0,0,0,0,0
1796.177,17,448,39896,403,35,4468,288,25676,45,288,40015,288,14220
11.288,6,92,27389,46,549,250,1152,21067,46,407,245,1152,6322
1800.0,6,662,174278,306,186,5803,1360,54014,356,736,5070,5440,120264
44.845,17,6,2248,6,346,8969,548,2248,0,0,0,0,0
12.193,6,2582,2465078,1652,1414,7,1440,2412042,930,776,12,1440,53036
8.617,6,12,1310,7,182,1436,182,554,5,244,2152,476,756
1.074,17,2,116,2,30,1074,30,116,0,0,0,0,0
1772.515,6,202,22388,130,75,13740,267,10057,72,138,24958,4846,12331
3.334,17,2,136,1,32,0,32,60,1,48,0,48,76
0.11,17,2,396,1,39,0,39,67,1,301,0,301,329
1.025,6,23,9472,14,350,78,1041,1992,9,1421,104,3830,7480
0.179,6,27,7296,13,155,14,267,1301,14,603,12,2800,5995
6.216,6,1522,1400577,962,1378,6,1408,1366793,560,931,10,2801,33784
1770.115,6,101,9344,66,65,27232,65,5577,35,59,52059,59,3767
0.229,17,8,2750,8,315,32,354,2750,0,0,0,0,0
46.318,6,43,12280,17,319,275,1189,2922,26,461,1852,1420,9358
21.459,6,27,7034,17,124,1341,159,1640,10,811,2383,1675,5394
1060.735,6,144,17849,68,105,13283,721,7156,76,254,14140,1440,10693
180.453,2,2,64,2,8,180453,8,64,0,0,0,0,0
1789.235,6,375,26177,217,98,8283,469,15372,158,69,11396,69,10805
1793.763,6,182,20105,95,107,19082,722,10144,87,161,20852,2103,9961
1.006,17,2,116,2,30,1006,30,116,0,0,0,0,0
29.788,17,13,584,10,10,3309,24,380,3,40,103,40,204
0.024,6,2,92,1,0,0,0,52,1,0,0,0,40
999.304,17,195,14820,195,48,5151,48,14820,0,0,0,0,0
7.701,6,47,8505,24,211,334,314,4142,23,491,337,1179,4363
314.462,6,26,5635,9,133,39307,159,887,17,967,19653,1669,4748
1.855,6,14,2351,8,188,265,245,700,6,703,314,1152,1651
143.716,6,21,3555,7,92,136,92,464,14,214,11034,1448,3091
1782.637,6,285,36576,116,145,15500,1360,17183,169,148,10610,4662,19393
125.44,2,2,64,2,8,125440,8,64,0,0,0,0,0
1.335,6,56,17954,28,707,49,1360,8925,28,438,49,1360,9029
72.204,6,32,8952,14,158,5554,267,1357,18,624,4243,1400,7595
1789.611,1,140,7840,140,28,12874,28,7840,0,0,0,0,0
1772.23,6,180,15480,120,69,14892,69,8940,60,69,30034,69,6540
32.179,6,218,185667,91,121,357,285,6103,127,1406,255,2836,179564
1798.971,6,356,22520,208,69,8690,69,12460,148,69,12237,69,10060
1.31,17,19,7357,9,495,163,1350,4715,10,236,139,1350,2642
156.494,1,8,448,8,28,22356,28,448,0,0,0,0,0
1740.952,6,91,6604,59,31,30016,31,3998,32,31,56158,31,2606
1797.918,6,373,25559,216,92,8362,469,14863,157,69,11522,69,10696
1790.184,6,358,22807,207,69,8690,69,12420,151,69,11934,69,10387
1784.384,17,142,11360,71,48,25491,48,5396,71,56,25491,56,5964
0.853,6,2,1194,1,0,0,0,40,1,1114,0,1114,1154
0.344,6,26,9012,13,252,28,646,1694,13,947,26,1438,7318
1788.411,6,5733,5241001,2386,128,749,342,149319,3347,1502,534,4224,5091682
72.196,6,31,7544,13,155,6016,267,1306,18,423,4246,3417,6238
368.462,6,25,1651,17,177,23028,177,1117,8,110,9226,110,534
1.996,6,28,10519,12,232,181,705,2040,16,951,129,1438,8479
13.035,6,1944,1796848,1268,1363,10,1432,1765109,676,475,19,1871,31739
1776.165,17,73,3060,72,14,25016,14,3024,1,8,0,8,36
156.98,6,168,130364,104,1319,1524,1448,117539,64,632,1656,1448,12825
162.968,17,10,3360,10,308,18107,308,3360,0,0,0,0,0
1789.953,6,353,22262,206,69,8731,69,12311,147,69,12259,69,9951
1740.681,17,29,30624,29,1028,62167,1028,30624,0,0,0,0,0
1.032,6,35,12979,19,691,57,1440,5647,16,668,56,1440,7332
9.111,17,16,1656,8,50,1301,50,624,8,101,1300,107,1032
1.755,17,6,471,3,31,862,31,177,3,70,861,70,294
39.365,17,22,1936,11,48,3935,48,836,11,72,3935,72,1100
128.056,6,34,7935,12,155,32,267,1266,22,340,6097,3417,6669
240.211,6,53,17660,28,784,8896,1408,14801,25,193,10008,580,2859
51.885,6,30,7297,14,155,3991,267,1346,16,441,3458,1420,5951
0.197,17,2,180,1,30,0,30,58,1,94,0,94,122
0.289,17,2,180,1,30,0,30,58,1,94,0,94,122
154.507,6,25,10302,13,561,56,1360,2843,12,995,14033,1360,7459
58.618,6,39,8549,19,372,851,802,1933,20,414,3078,2720,6616
81.161,6,219,176623,138,1308,592,1408,162850,81,682,1012,3847,13773
1742.536,6,101,7949,66,45,26808,205,4902,35,35,51238,98,3047
280.343,6,22,6974,11,181,28034,267,1168,11,893,28028,2800,5806
1798.037,6,416,25112,211,69,8562,69,12580,205,37,8813,69,12532
90.268,6,37,8519,18,410,530,882,2006,19,478,5005,2128,6513
0.491,17,4,768,2,39,486,39,134,2,289,10,289,634
1799.784,6,383,26773,220,97,8204,469,15630,163,69,11109,69,11143
300.668,6,44,9081,23,348,13666,1047,2394,21,389,429,2720,6687
1798.602,17,450,39960,405,35,4451,288,25740,45,288,40019,288,14220
0.256,17,2,154,1,41,0,41,69,1,57,0,57,85
1785.689,6,119,13795,77,81,23495,501,6030,42,152,43551,1420,7765
1738.795,6,96,6950,61,31,28979,31,4145,35,31,51140,31,2805
0.066,6,12,1846,7,139,11,139,511,5,533,6,905,1335
1786.304,6,365,23439,211,69,8506,69,12718,154,74,11675,421,10721
3.241,6,35,10598,16,132,216,267,1570,19,826,171,1452,9028
16.087,1,20,2080,0,0,0,0,0,20,76,846,76,2080
177.125,6,22,9062,11,376,63,794,1601,11,1001,17699,1440,7461
1786.806,6,102,8296,68,65,26668,65,4930,34,59,54141,59,3366
0.013,6,2,123,1,0,0,0,40,1,31,0,31,83
1744.635,6,95,7203,63,38,28139,205,4476,32,33,56269,98,2727
3.964,17,5,337,4,33,1315,33,244,1,65,0,65,93
1789.776,6,4731,3871726,2172,130,824,339,122984,2559,1450,699,2816,3748742
960.332,17,78,6240,39,48,25271,48,2964,39,56,25271,56,3276
1795.783,17,445,39232,401,35,4489,288,25328,44,288,40953,288,13904
300.565,6,11,863,6,177,60078,177,497,5,110,75097,110,366
1799.849,1,218,23108,218,78,8294,78,23108,0,0,0,0,0
1769.844,6,101,9344,66,65,27228,65,5577,35,59,52048,59,3767
26.134,6,39,9644,22,136,1244,159,2389,17,707,1629,1709,7255
38.162,17,11,836,11,48,3816,48,836,0,0,0,0,0
394.2,6,27,1767,18,177,23188,177,1181,9,110,8800,110,586
1751.526,6,185,11314,93,47,19038,208,6735,92,31,19244,31,4579
1779.552,6,354,22440,207,69,8638,69,12420,147,69,12188,69,10020
1790.559,17,140,11200,70,48,25950,48,5320,70,56,25950,56,5880
1799.26,17,449,39928,404,35,4464,288,25708,45,288,40021,288,14220
0.021,17,2,912,1,308,0,308,336,1,548,0,548,576
1744.637,2,30,960,30,8,60159,8,960,0,0,0,0,0
99.257,6,23,1699,17,43,6203,43,1339,6,0,19844,0,360
0.474,6,10,1992,5,288,114,288,508,5,424,63,434,1484
5.541,6,41,8501,22,218,263,314,3503,19,604,293,1179,4998
907.618,17,10,2594,5,31,226901,37,297,5,431,226901,463,2297
1.229,6,30,7976,15,269,87,780,1978,15,897,75,1738,5998
8.199,6,19,9695,9,275,1024,275,643,10,1440,792,1440,9052
0.454,6,21,7238,13,318,37,600,1970,8,968,62,1851,5268
0.123,6,9,1340,5,145,30,145,349,4,827,37,827,991
4.153,2,2,64,2,8,4153,8,64,0,0,0,0,0
1.634,6,19,3781,10,234,181,564,1452,9,463,181,1343,2329
11.213,17,4,919,2,33,11208,37,123,2,370,11208,435,796
4.277,6,27,10892,16,612,285,1360,3782,11,1109,414,4080,7110
0.014,17,2,527,1,39,0,39,67,1,432,0,432,460
243.88,6,40,4031,20,193,12835,585,1880,20,137,12835,580,2151
1772.263,6,180,15480,120,69,14892,69,8940,60,69,30031,69,6540
14.103,17,6,2016,6,308,2820,308,2016,0,0,0,0,0
1632.619,1,8,448,8,28,233231,28,448,0,0,0,0,0
180.463,2,3,96,3,8,90231,8,96,0,0,0,0,0
0.021,17,3,1007,1,137,0,137,165,2,393,20,393,842
1372.39,6,140,12017,92,69,15081,69,6923,48,69,29199,69,5094
0.064,17,4,420,2,33,0,33,122,2,121,20,145,298
1787.114,6,102,8296,68,65,26673,65,4930,34,59,54151,59,3366
280.295,6,28,7352,12,158,25481,267,1277,16,603,18684,1400,6075
4.866,6,38,7229,19,218,270,314,3383,19,513,254,1179,3846
138.409,17,4,352,2,60,138407,60,176,2,60,138408,60,176
9.956,6,25,3841,18,211,584,211,1486,7,665,1659,904,2355
1745.846,6,110,8781,70,48,25302,205,5302,40,36,44754,98,3479
1772.025,6,180,15480,120,69,14890,69,8940,60,69,30032,69,6540
1798.739,6,388,26973,221,96,8176,469,15808,167,69,10835,69,11165
183.557,17,4,352,2,60,183556,60,176,2,60,183555,60,176
89.439,6,120,92995,77,1268,1176,1408,82638,43,811,2124,3847,10357
1772.928,6,180,15480,120,69,14898,69,8940,60,69,30041,69,6540
0.43,6,10,968,5,256,103,256,460,5,304,101,304,508
990.474,6,230,25982,114,183,8245,1407,12277,116,148,8612,1420,13705
4.116,6,38,7229,19,218,228,314,3383,19,440,214,1152,3846
264.264,6,45,10789,19,782,14681,1418,7268,26,194,10570,580,3521
5.025,17,33,11143,14,364,386,1350,5489,19,269,186,1350,5654
1789.831,1,273,15288,273,28,6580,28,15288,0,0,0,0,0
0.035,17,2,235,1,36,0,36,64,1,143,0,143,171
89.105,6,24,9863,12,410,60,922,1742,12,953,8088,1696,8121
0.647,17,2,146,1,37,0,37,65,1,53,0,53,81
269.817,6,5,293,4,31,89939,31,222,1,31,0,31,71
280.746,6,33,8234,14,158,21595,267,1357,19,509,15596,1400,6877
0.425,17,4,240,2,32,424,32,120,2,32,424,32,120
6.319,6,1158,1029858,705,1382,8,1408,1001638,453,931,13,2801,28220
1788.864,6,356,22520,208,69,8641,69,12460,148,69,12166,69,10060
1717.287,1,16,1304,16,53,114485,78,1304,0,0,0,0,0
0.01,17,2,178,1,29,0,29,57,1,93,0,93,121
0.25,17,2,476,1,39,0,39,67,1,381,0,381,409
761.479,1,10,1160,10,88,84608,88,1160,0,0,0,0,0
164.943,17,54,11005,38,40,4457,41,2605,16,497,9587,505,8400
1750.888,17,12,498,11,14,175088,14,462,1,8,0,8,36
0.045,6,2,92,1,0,0,0,40,1,0,0,0,52
52.536,17,4,352,2,60,52535,60,176,2,60,52535,60,176
185.519,17,4,240,2,32,185518,32,120,2,32,185518,32,120
280.448,6,30,7432,13,158,23370,267,1317,17,603,17525,2076,6115
0.868,6,114,86855,50,131,17,232,2529,64,1385,13,2860,84326
22.734,17,14,1232,7,48,3786,48,532,7,72,3787,72,700
1788.53,17,86,3606,85,14,21292,14,3570,1,8,0,8,36
4.439,6,38,7229,19,218,246,314,3383,19,440,232,1152,3846
1740.652,6,87,6322,58,31,30537,31,3915,29,31,62165,31,2407
15.56,6,5,232,2,0,15560,0,88,3,0,6114,0,144
0.083,6,4,239,2,0,82,0,104,2,31,0,31,135
268.08,6,21,5079,6,235,3539,516,1186,15,328,19141,1452,3893
1687.602,17,18,4909,9,30,210948,30,522,9,459,210948,463,4387
1796.086,17,142,11360,71,48,25658,48,5396,71,56,25658,56,5964
10.6,17,4,352,2,48,10578,48,152,2,72,10579,72,200
2.05,6,6,336,3,0,1025,0,164,3,0,781,0,172
35.721,17,22,1936,11,48,3565,48,836,11,72,3565,72,1100
83.121,6,31,8912,14,158,6393,267,1357,17,687,5186,1781,7555
106.285,6,14,3882,7,407,17714,722,1186,7,1164,17683,1408,2696
4.645,6,694,878792,248,537,18,1396,15065,446,1901,10,6980,863727
0.847,6,3,151,1,0,0,0,40,2,31,1,31,111
3.01,17,7,710,4,46,1000,46,296,3,110,1499,110,414
240.171,6,51,14543,27,657,9237,1402,11932,24,169,10441,580,2611
0.549,6,28,7336,13,155,45,267,1301,15,543,36,1400,6035
8.37,6,75,27531,37,990,232,1440,16472,38,495,214,1440,11059
38.538,17,11,836,11,48,3853,48,836,0,0,0,0,0
3.126,6,2,88,2,0,0,0,88,0,0,0,0,0
1.692,6,47,16913,27,844,65,1360,11292,20,437,77,2715,5621
1791.304,17,179,13962,179,50,10063,50,13962,0,0,0,0,0
1779.767,17,142,11360,71,48,25425,48,5396,71,56,25425,56,5964
63.828,6,36,9695,16,287,4255,1189,3232,20,471,3357,1420,6463
5.115,6,35,6209,19,206,284,314,2824,16,548,323,1179,3385
77.909,17,4,352,2,60,77907,60,176,2,60,77908,60,176
299.534,6,6,364,4,31,99844,31,222,2,31,299519,31,142
0.25,17,4,624,2,64,249,64,184,2,192,133,192,440
1738.728,6,88,6374,58,31,30504,31,3915,30,31,59955,31,2459
38.537,6,29,7392,13,158,3211,267,1317,16,603,2566,2800,6075
1.172,6,618,593252,260,345,4,351,14218,358,1578,3,4206,579034
1120.147,6,60,3972,41,41,28003,208,2809,19,31,41193,31,1163
0.272,6,23,5935,12,164,24,453,1442,11,782,26,2231,4493
1741.421,17,28,6580,28,207,64497,207,6580,0,0,0,0,0
1.647,6,49,20982,28,947,61,1360,15366,21,433,70,1360,5616
10.928,6,89,27013,46,557,242,1152,20795,43,449,254,1179,6218
1189.941,17,312,34115,140,143,8560,1350,24056,172,30,6957,61,10059
372.041,6,25,1651,17,177,23252,177,1117,8,110,9246,110,534
1.572,6,48,19296,27,897,60,1360,13680,21,433,68,1360,5616
276.507,6,86,12798,40,184,7089,1189,4196,46,232,6140,1460,8602
7.085,17,35,11101,17,281,440,1350,5265,18,296,414,1350,5836
0.033,17,2,150,1,47,0,47,75,1,47,0,47,75
1121.97,17,12,888,6,30,224389,30,348,6,62,224389,62,540
1786.494,6,107,8496,68,65,26664,65,4930,39,59,47009,59,3566
29.849,17,4,824,2,48,29840,48,152,2,308,29838,308,672
300.801,6,45,10240,24,433,13078,910,3194,21,387,773,2720,7046
36.601,6,2,144,0,0,0,0,0,2,64,36601,64,144
0.672,17,4,240,2,32,670,32,120,2,32,671,32,120
5.071,17,4,304,4,48,1690,48,304,0,0,0,0,0
3.712,17,3,1167,3,361,1856,361,1167,0,0,0,0,0
0.971,6,10,1687,7,100,161,100,384,3,1179,353,1179,1303
280.292,6,28,7352,12,158,25481,267,1277,16,603,18685,1400,6075
1730.959,1,14,1141,14,53,133150,78,1141,0,0,0,0,0
1797.746,1,345,28980,345,56,5226,56,28980,0,0,0,0,0
1.359,6,55,20408,30,852,46,1360,13227,25,474,49,1360,7181
1782.443,17,83,3480,82,14,22005,14,3444,1,8,0,8,36
1686.009,17,14,3799,7,30,280999,30,406,7,456,280999,463,3393
62.178,6,81,57866,51,1202,1243,1368,49572,30,840,2135,2736,8294
0.971,17,4,624,2,64,969,64,184,2,192,843,192,440
1774.532,1,65,5460,65,56,27727,56,5460,0,0,0,0,0
1748.81,1,158,16748,158,78,11138,78,16748,0,0,0,0,0
1570.371,17,19,4762,19,222,87242,687,4762,0,0,0,0,0
1772.481,6,180,15480,120,69,14894,69,8940,60,69,30034,69,6540
2.042,17,2,677,1,300,0,300,328,1,321,0,321,349
108.014,6,49,10267,20,246,3450,1189,3030,29,337,3857,1420,7237
3.226,17,10,1472,5,40,805,40,340,5,198,804,216,1132
1.58,6,30,10413,18,368,92,837,1829,12,1012,135,1420,8584
1786.203,17,87,3648,86,14,21014,14,3612,1,8,0,8,36
0.286,17,2,152,1,48,0,48,76,1,48,0,48,76
0.078,17,2,362,1,46,0,46,74,1,260,0,260,288
97.109,6,15,1132,4,226,120,226,442,11,110,9693,110,690
0.027,17,2,180,1,30,0,30,58,1,94,0,94,122
315.375,6,29,6448,11,139,31536,159,1150,18,873,18551,1668,5298
10.963,6,1622,1502089,1062,1364,10,1420,1475374,560,475,19,1883,26715
0.903,6,11,1727,7,100,150,100,384,4,589,213,1152,1343
5.364,6,553,483764,344,1336,15,1368,467048,209,776,24,1473,16716
2.03,6,9,527,5,43,507,43,311,4,0,675,0,216
6.905,17,739,576771,494,1098,14,1350,556280,245,55,28,1350,20491
1787.385,6,102,8228,68,64,26677,64,4896,34,58,54159,58,3332
1.562,17,2,1441,2,692,1562,1030,1441,0,0,0,0,0
123.303,6,66,35809,36,970,97,1421,13131,30,894,4247,1460,22678
263.781,6,569,516724,209,225,1267,906,12903,360,1402,734,2836,503821
9.62,6,1411,1303993,922,1364,10,1432,1280130,489,427,19,1432,23863
79.995,6,804,383011,421,847,190,1152,361845,383,389,208,1152,21166
179.989,1,5,931,5,158,44997,351,931,0,0,0,0,0
95.795,6,8,509,5,31,23784,31,322,3,31,315,31,187
251.863,2,3,96,3,8,125931,8,96,0,0,0,0,0
1741.443,1,15,870,15,30,124388,30,870,0,0,0,0,0
31.948,6,9,396,2,0,3428,0,88,7,0,5295,0,308
1782.446,6,416,25016,206,69,8694,69,12380,210,34,8528,48,12636
0.405,17,4,566,2,31,394,31,118,2,196,393,196,448
0.773,6,20,5947,11,281,77,543,1287,9,716,87,1420,4660
0.024,6,9,1612,5,636,5,636,904,4,492,7,492,708
1797.651,17,448,39896,403,35,4471,288,25676,45,288,40022,288,14220
1787.352,6,102,8296,68,65,26676,65,4930,34,59,54157,59,3366
240.021,17,4,352,2,60,240020,60,176,2,60,240020,60,176
0.96,2,2,64,2,8,960,8,64,0,0,0,0,0
4.357,6,11,1548,4,279,1393,279,774,7,191,696,272,774
0.027,17,2,550,2,247,27,247,550,0,0,0,0,0
43.431,6,42,12077,18,392,83,1189,5040,24,357,1887,1420,7037
240.348,6,43,8883,21,515,12017,1402,5740,22,221,11444,618,3143
3.248,17,5,542,4,32,1077,32,240,1,274,0,274,302
1.293,6,46,18844,26,938,51,1460,13268,20,433,58,1460,5576
0.133,6,9,1340,5,145,33,145,349,4,827,42,827,991
7.94,6,70,20286,35,562,233,1152,15459,35,427,226,1152,4827
1774.994,6,207,23921,132,89,13549,981,11118,75,139,23984,3457,12803
7.413,6,429,353053,261,1288,27,1368,339653,168,776,43,2736,13400
7.973,6,1094,1011520,704,1389,11,1432,990885,390,475,20,1871,20635
68.134,6,28,7217,13,155,5677,267,1306,15,482,4866,2840,5911
367.049,6,19,1303,14,177,28234,177,925,5,110,15160,110,378
2.998,17,4,232,4,30,999,30,232,0,0,0,0,0
16.91,6,1133,973471,709,1297,23,1368,946759,424,931,39,2841,26712
169.252,17,4,240,2,32,169251,32,120,2,32,169251,32,120
6.734,6,47,10235,25,132,280,356,2361,22,581,314,1360,7874
1783.809,6,365,25432,213,100,8414,469,14936,152,69,11813,69,10496
190.263,17,4,240,2,32,190262,32,120,2,32,190257,32,120
1799.999,6,218,16980,83,72,21585,346,8260,135,48,13432,78,8720
1799.494,17,81,3390,79,14,23070,14,3318,2,8,1777284,8,72
1777.246,17,73,3060,72,14,25031,14,3024,1,8,0,8,36
0.449,17,21,14780,12,995,40,1350,12286,9,249,52,1350,2494
269.532,6,21,1840,6,483,53906,483,803,15,83,19247,83,1037
4.788,6,40,7309,21,218,239,314,3463,19,440,251,1152,3846
0.471,6,25,6081,13,108,39,147,959,12,773,38,1608,5122
66.253,6,16,11914,5,174,16563,174,378,11,1386,6611,1452,11536
167.765,1,10,560,10,28,18640,28,560,0,0,0,0,0
17.925,17,27,6332,11,236,1789,1350,2905,16,186,1192,1350,3427
0.039,17,2,363,1,29,0,29,57,1,278,0,278,306
1.423,6,41,11380,21,616,71,1460,5804,20,433,64,1460,5576
17.861,6,24,4671,11,256,1786,722,1592,13,299,1471,1408,3079
0.69,6,39,11808,23,547,31,1188,7761,16,356,39,758,4047
1742.39,1,8,448,8,28,248912,28,448,0,0,0,0,0
198.131,6,29,7392,13,158,16510,267,1317,16,603,13206,2036,6075
0.294,17,8,2758,8,316,42,355,2758,0,0,0,0,0
300.291,6,46,29587,24,190,13056,444,2053,22,1648,11473,4206,27534
46.103,6,27,7183,13,156,3841,267,1312,14,530,3545,3417,5871
377.292,6,23,1535,16,177,25152,177,1053,7,110,10415,110,482
1.188,6,2,120,2,0,0,0,120,0,0,0,0,0
1797.897,17,142,11360,71,48,25684,48,5396,71,56,25684,56,5964
1742.821,6,95,7203,62,38,28570,205,4424,33,33,54451,98,2779
17.436,6,2819,2600571,1794,1370,9,1408,2542607,1025,931,16,2816,57964
31.986,6,42,12380,21,321,1599,721,3098,21,702,1510,1440,9282
0.016,6,10,1723,6,578,2,997,1400,4,159,4,159,323
1789.137,17,142,11360,71,48,25558,48,5396,71,56,25559,56,5964
0.097,6,3,132,1,0,0,0,52,2,0,0,0,80
1670.968,1,8,448,8,28,238709,28,448,0,0,0,0,0
0.864,6,30,7674,17,479,54,1333,2652,13,498,56,1384,5022
281.544,6,26,7272,12,158,25594,267,1277,14,775,21654,4836,5995
1.223,6,47,18582,27,848,47,1360,13006,20,476,55,2715,5576
55.199,17,2,72,1,8,0,8,36,1,8,0,8,36
605.595,6,45,3616,29,51,21622,205,2277,16,36,40361,98,1339
0.051,17,2,179,1,43,0,43,71,1,80,0,80,108
0.62,6,15,6244,6,106,124,106,354,9,788,49,1420,5890
1793.995,6,365,23087,211,69,8542,69,12787,154,69,11723,69,10300
1786.761,6,102,8228,68,64,26668,64,4896,34,58,54141,58,3332
1.585,6,10,1687,7,100,264,100,384,3,1179,656,1179,1303
1789.957,6,372,23436,212,69,8483,69,12896,160,69,11257,69,10540
240.323,6,51,15625,27,714,9242,1402,12841,24,191,10448,580,2784
1721.291,17,248,50845,248,177,6968,356,50845,0,0,0,0,0
94.29,6,31,7566,14,141,7253,267,1415,17,420,5880,1460,6151
5.496,6,41,7349,21,218,274,314,3463,20,440,275,1152,3886
240.233,6,53,17787,28,784,8897,1418,14803,25,209,10009,580,2984
1.153,17,6,606,3,33,520,33,183,3,113,570,145,423
1263.34,2,11,352,11,8,126334,8,352,0,0,0,0,0
0.353,17,2,290,1,40,0,40,68,1,194,0,194,222
11.024,6,21,6825,12,275,1002,275,1038,9,1353,750,1440,5787
15.4,6,8,452,3,0,7570,0,172,5,0,3848,0,280
284.683,6,40,8924,18,143,16746,267,1586,22,496,13552,1400,7338
1788.88,6,98,7421,65,38,27951,205,4611,33,33,55896,98,2810
281.997,6,30,7432,13,158,23499,267,1317,17,543,17601,1400,6115
1773.363,1,58,4872,0,0,0,0,0,58,56,31111,56,4872
0.241,6,26,7256,13,155,20,267,1301,13,678,16,2045,5955
1796.07,17,136,10880,68,48,26806,48,5168,68,56,26806,56,5712
1787.042,6,102,8296,68,65,26672,65,4930,34,59,54148,59,3366
1772.883,6,180,15480,120,69,14898,69,8940,60,69,30046,69,6540
0.55,6,14,1745,7,288,62,288,600,7,426,64,434,1145
280.729,6,29,7461,12,158,25520,267,1277,17,550,17532,1400,6184
0.821,6,27,5927,13,156,68,267,1462,14,650,57,1420,4465
1777.601,17,142,11360,71,48,25394,48,5396,71,56,25394,56,5964
3.893,6,2,88,2,0,0,0,88,0,0,0,0,0
0.43,1,10,840,10,56,47,56,840,0,0,0,0,0
1.361,6,29,6387,14,164,104,267,1882,15,780,84,1460,4505
533.163,2,6,192,6,8,106632,8,192,0,0,0,0,0
1786.915,6,102,8364,68,66,26670,66,4964,34,60,54145,60,3400
94.007,17,4,240,2,32,94006,32,120,2,32,94006,32,120
9.981,6,87,26309,44,555,232,1152,20107,43,447,230,1179,6202
1777.352,17,141,11276,71,48,25389,48,5396,70,56,25757,56,5880
107.189,6,50,17258,23,1002,900,1360,10992,27,287,4116,2667,6266
529.482,17,6,360,3,32,264740,32,180,3,32,264740,32,180
1323.15,6,159,10914,59,46,22812,46,4614,100,46,13365,46,6300
25.049,6,18,3108,9,183,3131,183,611,9,531,3079,853,2497
240.252,6,57,18455,30,819,8284,1418,15507,27,192,9240,580,2948
0.108,17,2,672,2,308,108,308,672,0,0,0,0,0
3.93,6,144,92863,74,131,53,232,3489,70,1331,53,1430,89374
0.202,17,2,2380,2,1162,202,1162,2380,0,0,0,0,0
246.867,6,48,8519,22,331,11755,1056,3523,26,330,9874,906,4996
6.303,1,4,224,4,28,2101,28,224,0,0,0,0,0
658.402,2,8,256,8,8,94057,8,256,0,0,0,0,0
20.295,6,169,199726,147,192,139,226,6694,22,10112,965,54507,193032
1798.835,17,448,39896,403,35,4474,288,25676,45,288,40021,288,14220
0.012,17,3,244,2,32,7,32,120,1,96,0,96,124
1798.964,1,232,12992,232,28,7787,28,12992,0,0,0,0,0
0.187,6,27,7296,13,155,15,267,1301,14,603,13,2036,5995
5.987,17,3,1008,3,308,2993,308,1008,0,0,0,0,0
1.081,6,27,8420,15,222,65,540,1964,12,1192,81,3151,6456
109.339,17,4,1344,4,308,36446,308,1344,0,0,0,0,0
3.988,17,4,244,4,33,1329,33,244,0,0,0,0,0
0.078,1,2,112,2,28,78,28,112,0,0,0,0,0
394.766,17,12,1788,12,121,35887,121,1788,0,0,0,0,0
21.892,17,4,304,4,48,7297,48,304,0,0,0,0,0
67.416,6,28,7217,13,155,5618,267,1306,15,482,4814,1420,5911
1797.209,17,350,26600,350,48,5149,48,26600,0,0,0,0,0
1789.97,6,352,22705,199,69,9040,69,12100,153,69,11775,69,10605
86.851,17,2,152,2,48,86851,48,152,0,0,0,0,0
173.312,6,42,25887,19,840,41,1460,5847,23,1194,7871,1460,20040
1643.15,1,8,448,8,28,234735,28,448,0,0,0,0,0
1.916,17,3,264,3,60,958,60,264,0,0,0,0,0
51.994,17,4,352,2,60,51993,60,176,2,60,51993,60,176
1792.071,6,356,22520,208,69,8657,69,12460,148,69,12190,69,10060
1768.543,6,118,7180,66,27,27207,27,3939,52,27,34676,27,3241
0.108,6,10,1671,6,552,21,948,1348,4,159,36,159,323
0.043,17,4,284,2,32,0,32,120,2,54,40,60,164
0.051,1,3,180,3,32,25,32,180,0,0,0,0,0
0.006,6,15,7274,9,134,0,134,610,6,3172,1,4896,6664
0.032,17,2,367,1,33,0,33,61,1,278,0,278,306
289.588,6,327,52229,180,304,1617,304,36712,147,83,1979,83,15517
1778.623,1,61,5124,0,0,0,0,0,61,56,29643,56,5124
1773.629,1,55,4620,0,0,0,0,0,55,56,32844,56,4620
300.252,6,28,7011,12,158,27295,267,1277,16,636,20011,1380,5734
69.795,6,39,9405,17,327,4362,1189,2655,22,418,3316,1460,6750
1797.497,6,367,25650,214,99,8438,469,15045,153,69,11824,69,10605
12.321,6,1939,1701914,1183,1384,10,1420,1667441,756,467,16,1883,34473
1.763,6,38,8252,19,320,97,1162,2716,19,433,84,1460,5536
1744.638,6,95,7203,63,38,28139,205,4476,32,33,56266,98,2727
1.697,17,2,154,1,33,0,33,61,1,65,0,65,93
4.745,6,39,7269,19,218,263,314,3383,20,513,234,1179,3886
280.503,6,30,7432,13,158,23375,267,1317,17,543,17528,1400,6115
1394.431,6,126,13819,70,84,20206,722,6444,56,101,25350,1408,7375
0.158,17,4,368,2,32,95,32,120,2,96,0,96,248
1787.907,6,375,23361,213,69,8433,69,12522,162,56,11104,69,10839
4.583,6,41,7349,21,218,229,314,3463,20,440,228,1152,3886
374.88,6,25,1651,17,177,23430,177,1117,8,110,9251,110,534
5.035,17,3,208,2,36,5006,36,128,1,52,0,52,80
8.078,6,50,9461,26,233,323,314,4781,24,464,339,1179,4680
87.632,17,4,352,2,60,87631,60,176,2,60,87631,60,176
0.28,6,10,1838,5,899,70,899,1167,5,403,70,403,671
4.047,17,5,290,5,30,1011,30,290,0,0,0,0,0
1764.401,2,14,448,14,8,135723,8,448,0,0,0,0,0
1.136,6,29,8200,15,222,69,540,1964,14,944,71,1591,6236
1624.326,2,22,704,22,8,77348,8,704,0,0,0,0,0
1783.622,17,83,3480,82,14,22020,14,3444,1,8,0,8,36
0.678,6,10,924,5,283,114,283,551,5,105,117,105,373
1794.051,17,66,2766,65,14,28032,14,2730,1,8,0,8,36
1787.454,6,102,8296,68,65,26678,65,4930,34,59,54161,59,3366
79.764,6,36,5365,21,154,3988,721,2182,15,342,1110,1408,3183
150.945,17,3,1236,3,384,75472,548,1236,0,0,0,0,0
2.718,6,14,10365,4,290,890,517,797,10,1291,297,1408,9568
10.828,6,84,24933,42,544,264,1152,19096,42,461,257,1179,5837
80.168,17,4,352,2,60,80167,60,176,2,60,80166,60,176
0.057,6,2,123,1,0,0,0,40,1,31,0,31,83
21.454,6,3311,3191963,2157,1402,9,1440,3127291,1154,776,18,1440,64672
38.649,17,44,6468,22,48,1837,48,1672,22,190,1834,308,4796
0.827,6,20,5948,11,281,82,544,1288,9,716,92,1420,4660
15.463,6,21,6825,12,275,1405,275,1038,9,1353,1306,1440,5787
32.651,6,45,12527,19,231,66,762,3109,26,522,1300,1360,9418
38.551,17,4,352,2,60,38550,60,176,2,60,38550,60,176
298.908,1,4,224,4,28,99636,28,224,0,0,0,0,0
147.157,17,10,417,9,13,18394,14,373,1,16,0,16,44
1787.013,6,104,8444,68,66,26671,66,4964,36,60,51054,60,3480
29.514,6,3789,3571183,2408,1403,12,1448,3494683,1381,776,21,1448,76500
296.855,17,4,352,2,60,296854,60,176,2,60,296854,60,176
38.972,17,44,6468,22,48,1855,48,1672,22,190,1855,308,4796
4.858,6,43,8329,21,227,242,314,4022,22,489,219,1179,4307
0.209,17,2,180,1,30,0,30,58,1,94,0,94,122
300.764,2,4,128,4,8,100254,8,128,0,0,0,0,0
64.445,1,3,364,3,93,32222,173,364,0,0,0,0,0
3.38,6,2,88,2,0,0,0,88,0,0,0,0,0
1782.57,1,156,8736,156,28,11500,28,8736,0,0,0,0,0
1769.487,6,253,42331,147,304,12119,304,30572,106,83,16852,83,11759
5.029,17,4,288,2,36,5004,36,128,2,52,5011,52,160
0.026,17,2,322,1,33,0,33,61,1,233,0,233,261
300.643,6,48,8999,24,266,13071,720,2130,24,327,675,1460,6869
1798.049,6,363,24414,212,88,8521,469,14027,151,69,11986,69,10387
156.494,6,25,10089,12,531,58,1360,2637,13,988,13029,1360,7452
75.006,6,19,780,9,0,5931,0,364,10,0,8332,0,416
1790.609,6,355,22480,207,69,8692,69,12420,148,69,12180,69,10060
4.012,17,8,720,4,30,1333,30,232,4,94,1333,94,488
1.63,6,15,5771,9,290,203,517,1045,6,1468,323,2424,4726
6.053,6,39,7285,20,218,318,314,3423,19,516,322,1179,3862
893.804,6,12,728,8,31,127686,31,444,4,31,297926,31,284
1051.841,6,60,4267,39,31,27675,31,2586,21,31,52583,31,1681
1789.392,6,362,24305,211,88,8520,469,13987,151,69,11927,69,10318
187.56,1,2,220,2,82,187560,88,220,0,0,0,0,0
0.011,17,3,388,2,30,1,30,116,1,244,0,244,272
0.006,17,3,1007,1,137,0,137,165,2,393,6,393,842
0.514,6,23,7397,13,334,42,663,2021,10,967,51,1946,5376
0.0,17,5,1506,5,273,0,316,1506,0,0,0,0,0
36.548,6,1748,1601868,1171,1295,30,1368,1567200,577,931,62,2736,34668
1.644,6,10,1514,5,503,411,503,771,5,475,410,475,743
229.523,6,30,8872,13,158,19126,267,1317,17,687,14340,1400,7555
0.158,17,4,240,2,32,157,32,120,2,32,157,32,120
1773.424,6,180,15480,120,69,14902,69,8940,60,69,30049,69,6540
33.889,6,30,5040,15,154,2420,721,1857,15,399,2405,1368,3183
792.574,6,88,13996,48,483,16863,483,9821,40,83,20319,83,4175
0.483,6,27,9130,13,263,40,688,1748,14,947,33,1368,7382
1.875,6,12,3423,6,188,375,245,620,6,1279,321,1407,2803
8.723,6,14,1247,7,222,1452,222,728,7,231,1452,231,519
1797.724,17,139,11116,70,48,26052,48,5320,69,56,26436,56,5796
25.497,6,12,504,6,0,5096,0,248,6,0,5096,0,256
1.341,6,50,19331,27,894,51,1360,13635,23,433,52,1360,5696
4.965,6,110,83651,65,978,77,1360,13402,45,2012,108,4080,70249
1796.7,6,369,25799,215,99,8395,469,15085,154,69,11742,69,10714
156.538,6,20,8744,11,310,62,619,1402,9,1394,19551,3932,7342
1774.743,6,180,15480,120,69,14913,69,8940,60,69,30075,69,6540
1793.106,6,361,22858,210,69,8579,69,12678,151,69,11953,69,10180
1683.77,1,92,9752,92,78,18502,78,9752,0,0,0,0,0
286.277,6,30,7523,13,158,23856,267,1317,17,502,17887,1400,6206
3.747,6,9,673,5,177,936,177,445,4,0,979,0,228
11.238,6,87,25837,44,550,261,1152,18824,43,528,260,1179,7013
0.006,17,2,378,1,39,0,39,67,1,283,0,283,311
0.255,6,26,7256,12,155,23,267,1261,14,603,18,1400,5995
11.4,17,15,17714,15,1152,814,1451,17714,0,0,0,0,0
368.881,6,26,1703,17,177,23055,177,1117,9,110,8562,110,586
1798.141,17,450,39960,405,35,4450,288,25740,45,288,40017,288,14220
2.159,17,6,1142,3,36,1077,36,192,3,288,1077,318,950
1770.304,6,99,9240,66,65,27235,65,5577,33,59,55319,59,3663
1771.229,6,108,10086,67,65,26836,65,5653,41,59,44278,59,4433
290.601,6,38,8434,17,158,18162,267,1477,21,509,14529,1400,6957
400.077,1,5,580,5,88,100019,88,580,0,0,0,0,0
7.208,6,16,1871,6,304,1441,304,916,10,83,796,83,955
0.008,17,2,347,1,29,0,29,57,1,262,0,262,290
0.001,6,2,604,1,0,0,0,40,1,512,0,512,564
2.354,6,13,2311,8,188,336,245,700,5,1407,525,1407,1611
293.498,6,49,8100,24,116,12758,517,2203,25,456,12227,1418,5897
3.477,17,5,295,5,31,869,31,295,0,0,0,0,0
1793.66,17,144,11520,72,48,25262,48,5472,72,56,25262,56,6048
66.601,1,3,1028,3,314,33300,327,1028,0,0,0,0,0
31.471,6,4560,4299606,2978,1365,10,1408,4212678,1582,931,19,2816,86928
1794.383,1,58,4872,58,56,31480,56,4872,0,0,0,0,0
1794.159,17,148,9472,148,36,12205,36,9472,0,0,0,0,0
300.318,6,55,30127,25,190,12513,444,2117,30,1101,8342,1461,28010
11.321,6,93,28799,47,572,246,1152,22477,46,447,246,1179,6322
7.386,6,1617,1498249,1002,1416,7,1448,1461605,615,776,11,1448,36644
0.247,6,12,3705,6,171,44,171,491,6,964,44,1448,3214
280.472,6,30,7432,13,158,23372,267,1317,17,543,17516,1400,6115
4.41,6,38,7229,19,218,245,314,3383,19,513,231,1179,3846
1766.422,6,214,14760,108,68,16506,210,9492,106,31,16818,34,5268
0.48,6,6,248,4,0,160,0,164,2,0,260,0,84
1798.874,6,356,22520,208,69,8690,69,12460,148,69,12237,69,10060
280.238,6,27,7312,13,158,23353,267,1317,14,775,21551,2800,5995
7.465,6,31,5956,14,149,574,267,1610,17,523,462,1487,4346
1796.099,6,360,23991,193,69,9314,69,11860,167,69,10819,69,12131
271.946,1,4,224,4,28,90648,28,224,0,0,0,0,0
5.811,6,22,6669,11,248,572,517,1587,11,750,571,2736,5082
1796.976,6,375,27996,216,109,8357,1189,15765,159,87,11370,485,12231
240.168,6,57,19742,31,796,8005,1408,16761,26,202,9606,580,2981
1700.377,17,12,498,11,14,170037,14,462,1,8,0,8,36
2.649,6,2,88,2,0,0,0,88,0,0,0,0,0
1112.064,6,213,13488,122,69,8730,69,7364,91,69,12356,69,6124
1786.148,17,156,14024,78,66,23196,952,7360,78,57,23196,72,6664
2.332,6,29,10365,17,367,145,833,1785,12,1012,204,1420,8580
8.989,6,17,5391,9,275,1123,275,643,8,1104,1139,1440,4748
240.245,6,53,15784,26,706,9609,1402,12660,27,214,9239,580,3124
115.273,6,20,9776,11,380,79,832,1613,9,1558,14393,3928,8163
1.667,6,52,18891,29,853,59,1360,13150,23,400,66,1360,5741
1.701,6,52,19349,27,890,65,1360,13573,25,433,60,1360,5776
1443.909,2,16,512,16,8,96260,8,512,0,0,0,0,0
0.044,17,4,350,2,34,1,34,124,2,85,0,91,226
2.639,17,2,784,2,364,2639,364,784,0,0,0,0,0
1778.109,6,185,19785,98,98,18331,721,9731,87,146,20671,2840,10054
1740.417,17,29,6815,29,207,62157,207,6815,0,0,0,0,0
9.8,6,73,25651,35,935,288,1440,14606,38,495,259,1440,11045
1786.24,6,106,8456,68,65,26660,65,4930,38,59,48273,59,3526
1749.538,17,12,498,11,14,174953,14,462,1,8,0,8,36
1780.997,6,354,22440,207,69,8645,69,12420,147,69,12198,69,10020
1750.996,6,99,7442,64,38,27793,205,4528,35,33,51490,98,2914
1749.886,17,12,498,11,14,174988,14,462,1,8,0,8,36
1720.429,17,12,498,11,14,172042,14,462,1,8,0,8,36
99.733,17,4,240,2,32,99732,32,120,2,32,99732,32,120
1744.655,2,20,640,20,8,91823,8,640,0,0,0,0,0
0.469,6,49,20895,27,1047,18,1380,15773,22,421,20,1923,5122
21.408,6,6,328,4,0,7136,0,216,2,0,21392,0,112
1799.956,6,359,22709,209,69,8653,69,12569,150,69,12080,69,10140
1.315,6,50,21512,29,919,46,1360,15896,21,433,57,1360,5616
0.265,17,2,204,1,34,0,34,62,1,114,0,114,142
72.018,6,596,265459,305,803,236,1152,248298,291,424,247,1179,17161
0.017,17,2,413,1,100,0,100,128,1,257,0,257,285
374.173,6,25,1651,17,177,23385,177,1117,8,110,9450,110,534
488.624,6,68,9346,35,304,14371,304,6400,33,83,15200,83,2946
0.099,17,2,192,1,37,0,37,65,1,99,0,99,127
0.022,6,14,4020,8,88,3,88,428,6,1670,4,1880,3592
280.449,6,27,7312,12,158,25495,267,1277,15,775,20027,3465,6035
1798.168,17,448,39896,403,35,4473,288,25676,45,288,40017,288,14220
2.298,6,30,13777,16,949,153,1440,6366,14,854,165,1468,7411
15.45,6,4,172,2,0,15450,0,84,2,0,8196,0,88
0.836,6,3,151,1,0,0,0,40,2,31,0,31,111
0.024,17,5,1000,3,60,7,60,264,2,340,9,340,736
1.341,6,46,19056,27,886,51,1360,13520,19,529,64,4075,5536
0.11,6,4,208,0,0,0,0,0,4,0,0,0,208
1691.925,6,102,9334,66,101,26029,1250,5874,36,61,48338,191,3460
0.793,17,3,244,2,32,769,32,120,1,96,0,96,124
1798.2,6,366,25679,213,99,8482,469,15005,153,69,11828,69,10674
54.371,17,4,244,2,33,54370,33,122,2,33,54370,33,122
1.726,6,9,527,5,43,431,43,311,4,0,572,0,216
278.788,6,212,170113,137,1310,2049,1408,153884,75,616,3540,2439,16229
30.315,6,37,8495,18,410,518,882,1982,19,441,1674,1360,6513
0.016,17,2,554,1,30,0,30,58,1,468,0,468,496
17.228,6,3083,3025087,2088,1375,8,1408,2968683,995,776,17,1408,56404
122.576,17,6,2016,6,308,24515,308,2016,0,0,0,0,0
0.368,6,28,7037,17,242,23,645,2383,11,701,36,1728,4654
290.511,17,4,240,2,32,290510,32,120,2,32,290510,32,120
0.008,6,2,100,1,0,0,0,60,1,0,0,0,40
63.666,6,31,10385,9,166,191,267,1035,22,470,3031,1997,9350
1.959,17,2,312,2,128,1959,128,312,0,0,0,0,0
273.172,17,4,558,2,36,273167,36,128,2,187,273165,187,430
198.122,17,4,288,2,36,198121,36,128,2,52,198121,52,160
1.959,17,4,736,2,30,1949,30,116,2,282,1946,292,620
184.679,6,53,10173,21,121,9233,267,2306,32,286,5950,1420,7867
0.699,6,27,7296,13,155,58,267,1301,14,603,51,1400,5995
7.109,6,1533,1421908,974,1383,7,1408,1388176,559,931,12,2801,33732
1771.379,6,105,9759,68,65,26438,65,5758,37,59,49202,59,4001
1.011,17,4,534,2,31,1001,31,118,2,180,304,196,416
0.075,17,2,389,1,34,0,34,62,1,299,0,299,327
249.007,6,31,8912,14,158,19154,267,1357,17,687,15557,2036,7555
1792.861,17,81,5184,81,36,22410,36,5184,0,0,0,0,0
240.199,6,51,17570,28,742,8896,1408,14821,23,193,10917,580,2749
1635.91,1,7,392,7,28,272651,28,392,0,0,0,0,0
0.077,6,14,4334,7,111,12,111,483,7,869,12,1448,3851
301.017,6,52,10253,26,366,12040,766,2976,26,327,421,1460,7277
0.014,17,2,318,1,39,0,39,67,1,223,0,223,251
11.785,6,1888,1630062,1151,1363,10,1380,1596340,737,383,15,1380,33722
1727.135,17,302,57454,302,162,5737,422,57454,0,0,0,0,0
0.853,6,49,13749,24,551,37,1429,4840,25,493,34,3446,8909
1722.522,1,8,448,8,28,246074,28,448,0,0,0,0,0
282.389,6,32,7719,12,158,25671,267,1277,20,433,14851,1400,6442
711.693,17,16,5376,16,308,47446,308,5376,0,0,0,0,0
1.771,17,2,144,1,36,0,36,64,1,52,0,52,80
1421.337,17,161,12236,161,48,8883,48,12236,0,0,0,0,0
31.548,6,7,308,1,0,0,0,44,6,0,6288,0,264
159.319,6,22,8452,11,314,82,634,1415,11,940,15919,1460,7037
1785.367,1,104,11024,104,78,17333,78,11024,0,0,0,0,0
70.105,6,14,572,6,0,7232,0,244,8,0,10012,0,328
0.241,6,10,1677,6,555,40,951,1354,4,159,76,159,323
1745.192,6,95,7203,63,38,28148,205,4476,32,33,56286,98,2727
1700.536,17,12,498,11,14,170053,14,462,1,8,0,8,36
280.447,6,28,7352,12,158,25495,267,1277,16,678,18692,2760,6075
1667.711,1,8,858,8,79,238244,88,858,0,0,0,0,0
39.396,17,44,6468,22,48,1870,48,1672,22,190,1875,308,4796
31.687,6,8,348,2,0,18,0,84,6,0,6335,0,264
5.854,6,554,470993,336,1332,16,1368,454665,218,665,26,1368,16328
1739.889,6,87,6322,58,31,30524,31,3915,29,31,62138,31,2407
0.001,6,3,2880,0,0,0,0,0,3,1368,0,1368,2880
1786.426,6,102,8296,68,65,26663,65,4930,34,59,54131,59,3366
1744.619,2,29,928,29,8,62307,8,928,0,0,0,0,0
0.047,1,2,112,2,28,47,28,112,0,0,0,0,0
10.793,17,15,17706,15,1152,770,1449,17706,0,0,0,0,0
9.974,6,6,1257,4,327,3324,414,815,2,181,9760,270,442
0.034,17,2,144,1,44,0,44,72,1,44,0,44,72
1.004,6,12,2925,5,288,207,288,508,7,531,138,853,2417
1795.549,17,448,39896,403,35,4466,288,25676,45,288,40018,288,14220
0.424,6,50,22250,28,997,15,1380,17128,22,421,17,1923,5122
0.286,6,26,8995,13,252,23,647,1692,13,1103,23,2816,7303
0.613,17,4,288,2,36,582,36,128,2,52,581,52,160
217.933,17,6,528,3,48,108960,48,228,3,72,108961,72,300
1795.262,17,80,3354,79,14,23016,14,3318,1,8,0,8,36
102.555,6,30,8872,14,158,7888,267,1357,16,763,6824,3436,7515
1730.781,17,132,26595,132,173,13212,422,26595,0,0,0,0,0
5.026,6,39,7285,20,218,264,314,3423,19,516,265,1179,3862
3.18,6,5,232,2,0,3180,0,88,3,0,1508,0,144
0.494,6,5,200,2,0,356,0,80,3,0,239,0,120
0.321,17,19,10228,9,693,40,1350,6497,10,345,28,1350,3731
10.732,6,27,7177,13,155,894,267,1306,14,530,825,3417,5871
0.052,17,2,166,1,47,0,47,75,1,63,0,63,91
1764.029,2,14,448,14,8,135694,8,448,0,0,0,0,0
1146.267,6,98,11976,59,89,19763,501,4595,39,161,30162,1420,7381
22.267,6,48,11439,26,147,890,615,3494,22,641,1047,2720,7945
1681.185,17,14,3799,7,30,280196,30,406,7,456,280196,463,3393
1786.298,6,109,9029,70,70,25888,274,5250,39,63,47005,247,3779
0.356,6,27,8915,14,231,27,563,1660,13,938,28,1438,7255
2.741,17,2,178,1,29,0,29,57,1,93,0,93,121
90.747,17,40,6459,32,40,2927,41,2195,8,505,3567,505,4264
43.366,17,6,360,3,32,21682,32,180,3,32,21682,32,180
9.991,17,4,472,2,43,9987,43,142,2,137,9986,137,330
315.183,6,36,6899,22,142,15008,516,2025,14,391,24238,1452,4874
61.337,6,39,17513,23,801,2788,1408,9275,16,739,4073,1408,8238
1711.632,1,8,448,8,28,244518,28,448,0,0,0,0,0
1793.81,6,356,22520,208,69,8665,69,12460,148,69,12201,69,10060
50.81,6,13,1024,11,43,5080,43,924,2,0,50808,0,100
0.198,17,8,2750,8,315,28,354,2750,0,0,0,0,0
1773.21,6,180,15480,120,69,14900,69,8940,60,69,30051,69,6540
24.501,17,24,3528,12,48,2213,48,912,12,190,2210,308,2616
59.839,6,8,432,5,0,14959,0,268,3,0,29915,0,164
0.921,6,10,1687,7,100,153,100,384,3,1179,330,1179,1303
1773.019,6,180,15480,120,69,14899,69,8940,60,69,30046,69,6540
15.325,17,18,9557,9,483,1911,1350,4600,9,522,1911,1350,4957
614.863,6,43,7782,21,134,16243,516,2050,22,255,29275,1452,5732
126.232,2,2,64,2,8,126232,8,64,0,0,0,0,0
1792.655,17,142,11360,71,48,25608,48,5396,71,56,25608,56,5964
1.627,6,29,10365,17,367,101,833,1785,12,1012,139,1420,8580
1738.519,6,87,6322,58,31,30500,31,3915,29,31,62089,31,2407
0.163,17,2,2384,2,1164,163,1164,2384,0,0,0,0,0
0.02,17,2,148,1,38,0,38,66,1,54,0,54,82
8.083,17,40,7284,12,218,734,1350,2963,28,126,298,1350,4321
1785.395,6,228,17932,87,74,20758,337,8745,141,49,12751,143,9187
1786.779,6,354,22440,207,69,8673,69,12420,147,69,12238,69,10020
2.45,6,31,6255,16,338,163,1314,2334,15,331,174,1414,3921
0.429,6,51,20391,28,938,15,1380,15229,23,421,17,1923,5162
166.889,6,22,9920,11,433,74,990,1771,11,1099,16674,1440,8149
1.233,6,41,8443,21,321,61,1164,2822,20,400,56,1360,5621
2.367,17,29,6521,13,231,194,1350,3376,16,168,155,1350,3145
0.436,17,2,116,2,30,436,30,116,0,0,0,0,0
23.911,17,39,18638,17,301,1492,1350,5609,22,564,1136,1350,13029
1.643,6,10,924,5,283,366,283,551,5,105,366,105,373
635.876,17,48,3824,26,48,25435,48,1976,22,56,25392,56,1848
1785.273,17,87,3648,86,14,21003,14,3612,1,8,0,8,36
0.978,17,2,148,2,46,978,46,148,0,0,0,0,0
0.049,17,4,284,2,32,0,32,120,2,54,2,60,164
0.2,17,8,2750,8,315,28,354,2750,0,0,0,0,0
7.416,6,1681,1332232,868,1431,8,1448,1278056,813,776,8,1448,54176
0.432,17,4,377,2,33,414,37,123,2,99,416,136,254
369.661,6,25,1651,17,177,23103,177,1117,8,110,9219,110,534
1799.675,17,450,39960,405,35,4454,288,25740,45,288,40018,288,14220
1.711,6,42,8471,21,321,85,1164,2810,21,400,75,1460,5661
176.479,6,13,5585,4,106,58821,106,274,9,823,22057,1917,5311
5.331,6,35,8262,17,175,333,721,2089,18,681,282,1440,6173
0.86,17,21,14787,10,665,95,1350,6931,11,686,59,1350,7856
280.259,6,29,7392,14,158,21558,267,1357,15,678,20016,3436,6035
125.951,2,2,64,2,8,125951,8,64,0,0,0,0,0
1763.669,6,27,4077,18,241,103745,241,2889,9,92,220436,92,1188
240.32,6,44,9077,21,519,12015,1402,5777,23,232,10923,618,3300
0.001,6,2,777,1,0,0,0,40,1,697,0,697,737
1786.714,6,104,8444,68,66,26667,66,4964,36,60,51046,60,3480
0.328,6,26,9017,13,261,27,683,1728,13,943,26,1438,7289
31.905,6,9,396,2,0,3481,0,88,7,0,5304,0,308
0.738,6,40,12322,23,588,33,1188,8252,17,353,39,758,4070
1782.214,17,270,57697,270,185,6625,422,57697,0,0,0,0,0
7.048,6,1444,1329287,913,1380,7,1408,1297011,531,931,12,2801,32276
0.186,6,3,175,2,31,0,31,135,1,0,0,0,40
240.356,6,46,8572,24,449,10450,1408,5752,22,208,11445,580,2820
1793.653,1,58,4872,0,0,0,0,0,58,56,31467,56,4872
0.242,17,2,172,1,50,0,50,78,1,66,0,66,94
0.088,6,9,1343,5,145,22,145,349,4,830,26,830,994
1772.517,6,180,15480,120,69,14895,69,8940,60,69,30041,69,6540
1785.86,6,365,25501,212,100,8463,469,14896,153,69,11749,69,10605
1780.214,6,186,16065,121,69,14835,69,8980,65,69,27810,69,7085
1786.326,6,114,12258,74,81,24470,500,5909,40,128,45801,1420,6349
5.713,6,611,516352,366,1340,15,1368,498936,245,776,22,2736,17416
0.27,17,4,352,2,37,263,37,130,2,83,263,89,222
1359.388,6,268,16999,155,69,8827,69,9374,113,69,12137,69,7625
1071.953,2,15,480,15,8,76568,8,480,0,0,0,0,0
0.73,17,23,12197,12,557,65,1350,7020,11,442,69,1350,5177
1680.751,17,13,534,11,14,168056,14,462,2,8,1680554,8,72
61.339,6,35,15971,22,814,2920,1408,9296,13,855,5091,2816,6675
1798.985,17,450,39960,405,35,4452,288,25740,45,288,40018,288,14220
1794.224,6,356,22520,208,69,8667,69,12460,148,69,12205,69,10060
1788.519,6,105,8416,68,65,26694,65,4930,37,59,49677,59,3486
300.37,6,58,44328,37,1297,8343,1448,38260,21,828,1545,1448,6068
0.823,6,16,5711,9,272,102,516,1180,7,849,119,1452,4531
1781.877,6,104,8564,68,66,26595,66,4964,36,60,50908,60,3600
1795.488,6,356,22520,208,69,8673,69,12460,148,69,12214,69,10060
3.048,6,54,21526,29,953,108,1460,15505,25,357,119,1460,6021
300.926,6,45,13745,25,881,12538,1460,8098,20,371,459,1460,5647
1797.691,17,449,39928,404,35,4460,288,25708,45,288,40019,288,14220
400.171,1,4,464,4,88,133390,88,464,0,0,0,0,0
1796.6,6,387,27333,221,102,8166,469,16208,166,69,10888,69,11125
98.796,6,870,447890,499,834,198,1152,428243,371,400,266,1152,19647
15.642,17,20,13649,9,630,1948,1350,5929,11,673,1556,1350,7720
4.39,6,38,7229,19,218,243,314,3383,19,513,228,1179,3846
280.377,6,30,7432,13,158,23364,267,1317,17,543,17518,1400,6115
1795.801,6,365,25032,213,94,8470,469,14536,152,69,11890,69,10496
0.399,6,48,20249,26,1003,15,1380,15127,22,421,17,1923,5122
1793.867,17,66,2766,65,14,28029,14,2730,1,8,0,8,36
6.934,6,1602,1465919,1003,1383,6,1408,1430107,599,931,11,2801,35812
1787.148,6,102,8228,68,64,26673,64,4896,34,58,54153,58,3332
1772.288,6,180,15480,120,69,14893,69,8940,60,69,30032,69,6540
368.8,6,25,1651,17,177,23050,177,1117,8,110,9214,110,534
1787.841,6,102,8228,68,64,26684,64,4896,34,58,54174,58,3332
1786.522,6,102,8364,68,66,26664,66,4964,34,60,54134,60,3400
1.365,6,38,9848,21,440,68,1360,4392,17,476,74,2715,5456
2.907,17,3,468,3,128,1453,128,468,0,0,0,0,0
293.248,2,3,96,3,8,146624,8,96,0,0,0,0,0
0.082,17,4,284,2,32,0,32,120,2,54,77,60,164
70.405,6,28,7355,12,155,6400,267,1266,16,453,4693,2006,6089
20.374,6,21,3194,11,183,2037,517,1509,10,381,2256,499,1685
277.444,6,6,906,4,241,92481,241,642,2,92,277232,92,264
38.1,6,18,2241,6,210,7620,210,518,12,545,3142,905,1723
62.28,6,73,53853,48,1203,1325,1368,45818,25,840,2584,2519,8035
219.366,6,66,43890,41,1204,5484,1448,35860,25,746,2562,1448,8030
0.463,6,11,2032,5,288,108,288,508,6,424,50,434,1524
11.605,6,1835,1600296,1115,1380,10,1420,1567263,720,467,16,2840,33033
4.804,6,790,671255,464,1404,10,1432,651835,326,428,14,1871,19420
1770.92,6,135,8337,73,27,24595,27,4432,62,27,29030,27,3905
0.729,17,15,5505,6,399,145,1350,2564,9,298,53,1350,2941
1.083,17,22,8951,11,508,104,1350,5906,11,248,104,1350,3045
1797.987,1,345,28980,345,56,5226,56,28980,0,0,0,0,0
0.205,17,2,2384,2,1164,205,1164,2384,0,0,0,0,0
1786.413,6,370,23425,213,69,8426,69,13005,157,69,11451,69,10420
0.226,6,2,84,1,0,0,0,40,1,0,0,0,44
1323.502,2,12,384,12,8,120318,8,384,0,0,0,0,0
48.529,2,5,224,5,20,12132,32,224,0,0,0,0,0
0.845,17,2,144,1,36,0,36,64,1,52,0,52,80
174.579,6,143,151119,31,616,5819,1408,7824,112,1328,1556,1408,143295
1761.913,6,186,11385,93,47,19151,208,6766,93,31,19148,31,4619
284.989,6,30,7432,13,158,23749,267,1317,17,543,17809,1400,6115
1796.714,17,553,185808,553,308,3254,308,185808,0,0,0,0,0
3.043,6,3,180,3,0,0,0,180,0,0,0,0,0
0.09,17,4,284,2,32,1,32,120,2,54,79,60,164
0.304,1,5,420,5,56,76,56,420,0,0,0,0,0
5.592,6,42,7405,22,218,266,314,3503,20,516,280,1179,3902
291.623,17,4,240,2,32,291622,32,120,2,32,291622,32,120
1680.722,17,13,534,11,14,168054,14,462,2,8,1680542,8,72
1789.954,6,367,23236,212,69,8483,69,12896,155,69,11623,69,10340
675.194,6,89,6965,31,69,22504,298,3124,58,47,11841,78,3841
351.975,17,26,2288,13,48,29330,48,988,13,72,29330,72,1300
300.388,6,43,27239,27,405,11553,1034,3033,16,1797,8233,5608,24206
1.989,6,19,3309,11,99,182,182,976,8,477,259,1343,2333
1680.783,17,13,534,11,14,168060,14,462,2,8,1680602,8,72
317.024,6,51,17556,31,489,10567,1360,9097,20,695,16678,4649,8459
300.728,6,43,8833,22,315,14320,882,2209,21,444,473,2720,6624
0.395,17,2,602,1,46,0,46,74,1,500,0,500,528
1784.339,6,356,22520,208,69,8619,69,12460,148,69,12138,69,10060
191.081,17,4,304,2,48,191064,48,152,2,48,191064,48,152
1.904,17,4,624,2,64,1881,64,184,2,192,1870,192,440
1717.947,17,66,22112,66,307,26429,308,22112,0,0,0,0,0
1793.679,17,144,11520,72,48,25262,48,5472,72,56,25263,56,6048
0.02,17,2,189,1,30,0,30,58,1,103,0,103,131
0.402,6,10,967,5,256,97,256,460,5,303,98,303,507
5.322,6,40,7309,21,218,266,314,3463,19,513,281,1179,3846
1782.44,6,102,8296,68,65,26603,65,4930,34,59,54010,59,3366
1701.045,1,8,448,8,28,243006,28,448,0,0,0,0,0
1773.736,1,58,4872,58,56,31118,56,4872,0,0,0,0,0
6.378,6,5,300,1,0,0,0,60,4,0,2123,0,240
0.044,17,2,170,1,37,0,37,65,1,77,0,77,105
0.701,17,4,524,2,39,669,39,134,2,167,656,167,390
1798.581,6,1728,1647492,561,149,3211,884,36368,1167,1419,1542,7090,1611124
1777.304,17,142,11360,71,48,25389,48,5396,71,56,25389,56,5964
1.505,6,17,5183,8,150,215,174,624,9,699,176,1420,4559
0.852,6,11,1727,7,100,142,100,384,4,589,202,1152,1343
132.06,17,4,288,2,36,132059,36,128,2,52,132059,52,160
1740.595,17,30,31680,30,1028,60020,1028,31680,0,0,0,0,0
1797.46,6,371,25948,216,98,8360,469,15263,155,69,11669,69,10685
1783.277,17,83,3480,82,14,22015,14,3444,1,8,0,8,36
1.391,6,38,9848,20,502,73,1460,4352,18,433,71,1460,5496
1.596,6,51,18805,29,850,57,1360,13104,22,400,66,1360,5701
11.587,6,25,8473,13,275,965,275,1078,12,986,757,1440,7395
11.402,6,1799,1575534,1093,1388,10,1420,1543073,706,467,16,2840,32461
11.716,17,4,352,2,48,11694,48,152,2,72,11692,72,200
1794.847,6,612,108507,394,304,4566,304,80764,218,83,8270,102,27743
66.397,6,36,8455,17,410,554,882,1942,19,478,3679,2128,6513
1794.337,17,138,11040,69,48,26387,48,5244,69,56,26387,56,5796
12.194,6,2650,2382727,1556,1440,7,1448,2312935,1094,776,10,1448,69792
1795.221,1,240,13440,240,28,7511,28,13440,0,0,0,0,0
14.736,6,79,24397,39,550,387,1152,18640,40,461,371,1179,5757
374.642,6,18,1242,14,180,28818,180,916,4,110,20059,110,326
1795.903,6,129,7923,72,43,25294,208,4744,57,31,32062,31,3179
1799.371,6,356,22520,208,69,8692,69,12460,148,69,12240,69,10060
0.166,6,46,21749,27,1044,6,1420,16768,19,467,8,1883,4981
10.763,6,20,4402,11,275,1076,275,998,9,758,748,1420,3404
1776.706,17,73,3060,72,14,25024,14,3024,1,8,0,8,36
119.868,6,111,68943,55,994,2219,1438,16800,56,1229,2179,2876,52143
79.134,17,4,352,2,60,79133,60,176,2,60,79049,60,176
4.228,17,5,295,5,31,1057,31,295,0,0,0,0,0
38.363,17,22,1936,11,48,3831,48,836,11,72,3829,72,1100
4.728,6,41,7349,22,218,225,314,3503,19,440,249,1152,3846
18.64,6,14,2242,8,210,2662,210,844,6,545,3716,904,1398
3.346,6,2,88,2,0,0,0,88,0,0,0,0,0
5.814,6,30,7297,14,155,447,267,1346,16,441,387,1420,5951
0.075,17,4,308,2,38,0,38,132,2,60,46,66,176
1788.652,6,357,22629,209,69,8599,69,12569,148,69,12167,69,10060
296.633,1,4,326,4,53,98877,78,326,0,0,0,0,0
5.019,17,3,208,2,36,5006,36,128,1,52,0,52,80
42.535,6,43,7445,18,218,260,314,3343,25,516,1761,1179,4102
76.278,17,8,704,4,48,25423,48,304,4,72,25423,72,400
1766.669,1,58,4872,58,56,30994,56,4872,0,0,0,0,0
5.039,17,4,288,2,36,5007,36,128,2,52,5008,52,160
1063.41,6,90,9897,50,81,21698,722,4564,40,112,27262,1408,5333
334.174,6,283,106709,142,719,2065,1440,75610,141,363,2385,1702,31099
40.013,17,4,4280,4,1042,13337,1043,4280,0,0,0,0,0
166.388,6,42,25113,19,884,38,1360,6097,23,1130,7556,1696,19016
1785.987,6,130,14670,82,79,22049,479,6239,48,147,37997,1452,8431
1742.837,6,95,7203,63,38,28110,205,4476,32,33,56211,98,2727
198.19,6,25,6318,9,272,93,516,1180,16,345,13206,1452,5138
1786.308,17,138,11040,69,48,26269,48,5244,69,56,26269,56,5796
1773.898,6,180,15480,120,69,14906,69,8940,60,69,30064,69,6540
235.844,6,28,7352,12,158,21440,267,1277,16,603,15720,1400,6075
1792.646,17,87,3648,86,14,21089,14,3612,1,8,0,8,36
1782.629,17,73,3060,72,14,25107,14,3024,1,8,0,8,36
10.87,17,15,17706,15,1152,776,1449,17706,0,0,0,0,0
1788.972,6,355,22480,207,69,8684,69,12420,148,69,12166,69,10060
7.482,17,3,228,3,48,3741,48,228,0,0,0,0,0
0.813,6,10,1687,7,100,135,100,384,3,1179,275,1179,1303
12.625,17,42,15168,15,387,901,1350,6238,27,302,462,1350,8930
0.227,17,2,196,1,62,0,62,90,1,78,0,78,106
5.737,6,2,120,2,0,0,0,120,0,0,0,0,0
0.459,17,8,2758,8,316,65,355,2758,0,0,0,0,0
0.104,6,13,1749,7,253,17,500,878,6,275,20,500,871
300.128,6,48,11094,25,697,12498,1360,5265,23,326,13634,1360,5829
33.544,17,21,8075,10,509,3723,1350,5376,11,217,3351,1350,2699
145.348,17,4,304,2,48,145347,64,152,2,48,145347,64,152
4.032,6,2,88,2,0,0,0,88,0,0,0,0,0
11.239,6,84,24581,43,550,267,1152,18800,41,459,273,1179,5781
240.188,6,54,17757,29,790,8577,1402,14951,25,187,10007,580,2806
1783.374,6,361,22858,210,69,8532,69,12678,151,69,11888,69,10180
1.601,6,74,55709,46,1276,35,1408,48348,28,982,52,2816,7361
48.193,6,47,27109,17,538,32,1066,2508,30,921,1661,1491,24601
22.312,6,9,577,0,0,0,0,0,9,31,2789,31,577
503.916,2,4,128,4,8,167972,8,128,0,0,0,0,0
1.141,6,25,5847,13,156,95,267,1462,12,650,97,1420,4385
1793.037,17,180,14040,180,50,10016,50,14040,0,0,0,0,0
0.101,1,2,112,2,28,101,28,112,0,0,0,0,0
252.269,2,2,64,2,8,252269,8,64,0,0,0,0,0
1799.033,17,448,39896,403,35,4475,288,25676,45,288,40019,288,14220
280.424,6,28,7352,12,158,25493,267,1277,16,603,18689,1400,6075
9.408,1,9,756,0,0,0,0,0,9,56,1176,56,756
1792.876,17,66,2766,65,14,28013,14,2730,1,8,0,8,36
0.039,6,12,3633,6,100,7,100,420,6,964,7,1448,3213
0.024,17,2,158,1,34,0,34,62,1,68,0,68,96
405.373,6,288,46688,160,304,2549,304,32816,128,83,3190,83,13872
1751.163,6,100,7702,66,40,26940,205,4730,34,35,53053,108,2972
1756.847,6,106,6330,61,26,29279,26,3574,45,26,39924,26,2756
1.857,6,2,92,2,0,0,0,92,0,0,0,0,0
20.152,6,20,5366,12,107,1832,159,1074,8,1289,2875,3077,4292
0.108,6,12,1697,7,253,17,500,878,5,551,26,551,819
0.007,17,2,390,1,46,0,46,74,1,288,0,288,316
0.097,6,13,4282,7,111,16,111,483,6,1159,19,2896,3799
138.553,1,40,3360,40,56,3552,56,3360,0,0,0,0,0
0.004,17,2,207,1,36,0,36,64,1,115,0,115,143
10.546,6,1302,1669526,733,1160,14,1360,65520,569,2869,18,65280,1604006
28.436,6,18,3169,10,275,3158,501,2055,8,794,4059,794,1114
2.633,6,30,9090,18,371,154,845,1837,12,846,228,1380,7253
367.009,6,17,1190,13,180,30584,180,864,4,110,20057,110,326
20.075,6,11,640,4,0,6691,0,220,7,0,2923,0,420
170.12,17,8,2688,8,308,24302,308,2688,0,0,0,0,0
1769.87,1,58,4872,58,56,31050,56,4872,0,0,0,0,0
41.535,17,24,1824,24,48,1805,48,1824,0,0,0,0,0
1786.185,6,102,8228,68,64,26659,64,4896,34,58,54124,58,3332
0.027,6,2,116,1,0,0,0,64,1,0,0,0,52
1792.497,6,327,20808,191,69,9434,69,11504,136,69,13277,69,9304
507.907,6,353,282839,217,1360,2351,1448,258890,136,537,2132,1448,23949
0.062,17,2,368,1,37,0,37,65,1,275,0,275,303
1789.222,1,283,15848,283,28,6344,28,15848,0,0,0,0,0
18.247,6,1048,919087,638,1360,28,1368,890175,410,776,44,2736,28912
1771.539,1,58,4872,58,56,31079,56,4872,0,0,0,0,0
1.381,6,37,8212,19,320,76,1162,2716,18,476,70,2720,5496
27.58,6,3017,2720890,1819,1410,15,1448,2649702,1198,776,22,1448,71188
1789.764,1,63,5292,63,56,28867,56,5292,0,0,0,0,0
0.066,17,2,912,1,308,0,308,336,1,548,0,548,576
0.012,17,2,219,1,36,0,36,64,1,127,0,127,155
252.699,17,4,288,2,36,252655,36,128,2,52,252652,52,160
178.373,6,22,10814,11,410,62,922,1702,11,1237,17824,1460,9112
1.347,6,38,8254,19,321,74,1164,2718,19,433,64,1360,5536
72.963,2,2,64,2,8,72963,8,64,0,0,0,0,0
1745.831,6,90,6540,60,31,29590,31,4050,30,31,60189,31,2490
5.04,17,3,208,2,36,5005,36,128,1,52,0,52,80
372.215,6,25,1651,17,177,23263,177,1117,8,110,9259,110,534
0.193,6,28,18213,14,263,14,389,1789,14,1307,12,2166,16424
3.14,6,12,3044,4,92,1046,92,296,8,581,412,2026,2748
16.55,17,14,5834,7,492,2753,1350,3640,7,285,2753,1350,2194
0.593,6,10,924,5,283,103,283,551,5,105,102,105,373
0.409,17,14,7750,7,747,68,1350,5425,7,304,57,1350,2325
1788.147,1,46,4876,46,78,39736,78,4876,0,0,0,0,0
1747.639,6,96,7255,63,38,28187,205,4476,33,33,54599,98,2779
175.203,17,2,72,1,8,0,8,36,1,8,0,8,36
1316.958,6,135,22418,80,236,16670,815,13147,55,156,24386,1408,9271
288.237,6,35,3537,17,324,18014,585,1589,18,169,16954,580,1948
1795.755,17,447,39864,402,35,4478,288,25644,45,288,40023,288,14220
1787.903,6,354,22440,207,69,8679,69,12420,147,69,12245,69,10020
3.221,17,2,656,2,300,3221,300,656,0,0,0,0,0
1799.143,17,772,46624,772,32,2333,37,46624,0,0,0,0,0
5.015,17,4,288,2,36,5001,36,128,2,52,4995,52,160
33.568,6,29,4988,15,154,2397,721,1857,14,479,2567,2026,3131
1043.07,6,41,4431,27,137,40118,1440,3331,14,31,80203,31,1100
1795.35,17,448,39896,403,35,4466,288,25676,45,288,40021,288,14220
0.688,6,23,7367,14,261,52,602,2043,9,1209,78,1946,5324
1789.048,1,58,4872,58,56,31386,56,4872,0,0,0,0,0
11.264,6,26,9901,13,275,938,275,1078,13,1036,680,1414,8823
1787.141,6,155,29048,93,387,19425,1303,21564,62,106,29295,242,7484
197.855,6,98,20205,53,294,3804,821,10102,45,298,4495,1408,10103
61.316,6,7,292,4,0,20438,0,164,3,0,30654,0,128
386.374,6,18,1242,14,180,29721,180,916,4,110,20061,110,326
175.173,17,4,304,2,48,175165,48,152,2,48,175165,48,152
0.542,6,21,7290,12,335,48,668,1974,9,968,66,1475,5316
8.723,6,684,601119,434,1316,19,1368,583455,250,776,34,1473,17664
0.334,17,2,152,1,48,0,48,76,1,48,0,48,76
11.349,6,13,3231,5,83,2796,92,435,8,472,1597,1408,2796
8.095,6,19,8351,9,275,1011,275,643,10,1216,871,1440,7708
0.882,17,2,778,2,361,882,361,778,0,0,0,0,0
2.887,17,4,236,4,31,962,31,236,0,0,0,0,0
31.622,6,7,308,1,0,0,0,44,6,0,6306,0,264
58.246,6,15,2391,7,188,9707,245,660,8,1407,8280,1407,1731
1786.848,6,108,8796,71,66,25526,66,5216,37,60,49631,60,3580
280.55,6,30,7432,13,158,23379,267,1317,17,543,17529,1400,6115
1796.126,17,448,39896,403,35,4467,288,25676,45,288,40017,288,14220
85.312,6,21,2680,12,304,7755,304,1860,9,83,10651,83,820
196.415,17,8,704,4,48,65469,48,304,4,72,65468,72,400
240.115,6,46,9126,24,209,10439,835,2721,22,525,11433,2338,6405
382.406,6,18,1242,14,180,29415,180,916,4,110,20059,110,326
1.758,6,70,53211,45,1247,39,1402,46006,25,1179,65,3825,7205
1799.563,17,142,11360,71,48,25707,48,5396,71,56,25707,56,5964
0.172,6,275,314608,112,186,1,282,6391,163,1861,0,7010,308217
280.641,6,29,7392,13,158,23386,267,1317,16,603,18705,2800,6075
1776.846,6,109,8771,71,65,25383,65,5245,38,59,48020,59,3526
1795.352,17,446,39832,401,35,4488,288,25612,45,288,40021,288,14220
240.66,2,4,128,4,8,80220,8,128,0,0,0,0,0
1.392,6,49,19581,27,915,53,1360,13925,22,476,58,2715,5656
657.851,17,44,14784,44,308,15298,308,14784,0,0,0,0,0
54.877,6,10,520,0,0,0,0,0,10,0,0,0,520
1799.531,17,449,39928,404,35,4465,288,25708,45,288,40017,288,14220
1.385,6,11,1727,7,100,230,100,384,4,589,377,1152,1343
10.661,6,84,26381,42,561,260,1152,20203,42,449,253,1179,6178
0.929,6,10,1687,7,100,154,100,384,3,1179,341,1179,1303
1770.828,1,58,4872,0,0,0,0,0,58,56,31067,56,4872
0.269,6,26,9041,13,261,22,683,1752,13,1100,22,2816,7289
1783.296,17,83,3480,82,14,22016,14,3444,1,8,0,8,36
8.632,6,14,1247,7,222,1437,222,728,7,231,1436,231,519
18.726,6,2875,2678565,1839,1377,10,1408,2620029,1036,931,17,2816,58536
300.761,6,45,10240,23,433,13670,910,3154,22,364,734,2128,7086
0.876,6,20,5948,11,281,87,544,1288,9,716,99,1420,4660
3.097,6,24,5755,13,158,257,370,1315,11,999,308,1731,4440
35.211,17,4,240,2,32,35210,32,120,2,32,35210,32,120
188.953,6,56,29354,31,1106,472,1360,16761,25,827,7866,2720,12593
0.279,17,2,152,1,48,0,48,76,1,48,0,48,76
0.469,6,12,1653,6,288,92,288,548,6,426,50,434,1105
1.479,6,47,18436,26,903,59,1460,12820,21,433,63,1460,5616
2.454,6,5,280,2,0,2454,0,100,3,0,1165,0,180
280.209,6,28,7352,13,158,23350,267,1317,15,678,20010,3436,6035
1.636,6,26,8745,16,275,109,558,1470,10,981,161,1420,7275
0.004,6,2,80,1,0,0,0,40,1,0,0,0,40
18.062,17,27,20772,15,852,1287,1350,13202,12,602,1638,1350,7570
9.124,6,86,53315,51,845,182,1402,10320,35,1715,268,5608,42995
5.222,6,40,7325,19,218,290,314,3383,21,442,247,1152,3942
1773.342,6,180,15480,120,69,14902,69,8940,60,69,30052,69,6540
15.017,6,22,6817,12,275,1365,275,1038,10,1073,1110,1440,5779
102.121,6,50,10142,26,450,455,766,2945,24,366,4434,3488,7197
0.41,6,26,8870,13,232,34,567,1612,13,939,33,1438,7258
27.423,6,15,1948,12,222,2493,222,1816,3,0,1686,0,132
1772.326,6,180,15480,120,69,14893,69,8940,60,69,30032,69,6540
708.687,17,14,4708,14,308,54514,328,4708,0,0,0,0,0
1773.009,6,203,22290,130,75,13744,267,10057,73,134,24618,1997,12233
0.034,17,2,384,1,39,0,39,67,1,289,0,289,317
299.359,2,4,128,4,8,99786,8,128,0,0,0,0,0
1794.346,17,324,67426,324,180,5555,422,67426,0,0,0,0,0
31.871,6,17,6365,5,186,7965,267,581,12,588,2896,1420,5784
212.811,6,53,7046,25,135,8867,722,2798,28,154,7490,1408,4248
0.627,6,8,521,4,31,209,31,270,4,31,97,31,251
0.0,6,2,116,1,0,0,0,40,1,24,0,24,76
1740.455,17,30,6930,30,203,60015,203,6930,0,0,0,0,0
0.025,17,4,368,2,32,9,32,120,2,96,10,96,248
280.191,6,27,7312,13,158,23349,267,1317,14,775,21551,4836,5995
240.253,6,35,4250,17,178,15015,585,1964,18,191,14131,580,2286
0.057,17,2,150,2,47,57,47,150,0,0,0,0,0
85.359,17,3,228,3,48,42679,48,228,0,0,0,0,0
5.374,6,40,7309,21,218,268,314,3463,19,513,284,1179,3846
1738.329,1,52,4368,52,56,34084,56,4368,0,0,0,0,0
0.013,6,10,1792,6,612,2,1069,1469,4,159,4,159,323
1769.776,6,100,9363,66,65,27227,65,5589,34,59,53626,59,3774
247.911,6,26,4186,15,483,17707,483,3191,11,83,24790,83,995
1771.608,6,107,9881,69,65,26053,65,5875,38,59,47878,59,4006
1793.297,17,87,3648,86,14,21097,14,3612,1,8,0,8,36
1773.066,6,180,15480,120,69,14899,69,8940,60,69,30047,69,6540
1798.803,1,8,448,8,28,256971,28,448,0,0,0,0,0
367.12,6,23,1535,16,177,24474,177,1053,7,110,10364,110,482
1.796,17,2,122,2,33,1796,33,122,0,0,0,0,0
276.971,1,4,224,4,28,92323,28,224,0,0,0,0,0
16.522,6,30,6514,16,154,1086,722,1966,14,636,1038,2026,4548
13.692,6,2002,1867786,1317,1365,10,1420,1836083,685,475,20,1883,31703
572.139,17,111,8436,111,48,5201,48,8436,0,0,0,0,0
1.674,6,10,1102,6,483,334,483,803,4,83,556,83,299
1729.18,6,67,4897,43,33,41170,33,2974,24,31,75174,31,1923
9.777,6,1833,1649694,1136,1375,8,1408,1608786,697,931,13,2816,40908
300.716,6,37,8229,20,241,15827,618,1797,17,478,535,2128,6432
1740.524,17,29,30624,29,1028,62161,1028,30624,0,0,0,0,0
0.081,6,19,9933,10,125,9,125,653,9,1467,10,1564,9280
31.809,6,7,396,1,0,0,0,60,6,0,6323,0,336
1150.152,6,139,16763,87,79,13373,267,6888,52,165,22551,1997,9875
1772.058,1,58,4872,58,56,31088,56,4872,0,0,0,0,0
38.764,1,44,4576,0,0,0,0,0,44,76,901,76,4576
1789.217,17,142,11360,71,48,25560,48,5396,71,56,25560,56,5964
0.062,17,4,284,2,32,17,32,120,2,54,51,60,164
1700.869,17,12,498,11,14,170086,14,462,1,8,0,8,36
212.04,6,58,9681,23,108,7422,267,2120,35,256,6236,1420,7561
1798.785,1,242,25652,242,78,7463,78,25652,0,0,0,0,0
12.345,6,10,424,5,0,3082,0,208,5,0,3082,0,216
59.999,17,4,3065,4,738,19999,1070,3065,0,0,0,0,0
0.946,6,10,1687,7,100,157,100,384,3,1179,347,1179,1303
1796.025,17,448,39384,403,35,4467,288,25412,45,282,40017,288,13972
645.035,1,16,896,16,28,43002,28,896,0,0,0,0,0
0.118,17,2,410,1,46,0,46,74,1,308,0,308,336
4.004,17,8,616,4,33,1334,33,244,4,65,1334,65,372
4.997,17,6,1404,6,206,999,206,1404,0,0,0,0,0
280.655,6,30,7432,13,158,23387,267,1317,17,603,17538,2760,6115
280.572,6,30,7432,13,158,23381,267,1317,17,543,17531,1400,6115
1757.482,6,105,6240,60,26,29787,26,3510,45,26,39940,26,2730
300.674,6,42,8738,22,286,14317,766,2092,20,388,783,2720,6646
0.18,17,2,180,1,30,0,30,58,1,94,0,94,122
888.143,1,84,4704,84,28,10700,28,4704,0,0,0,0,0
1734.167,17,165,27175,165,136,10574,389,27175,0,0,0,0,0
114.138,6,25,11302,12,421,84,956,1789,13,997,9497,1460,9513
1742.857,6,144,9249,77,50,22932,208,5391,67,31,26403,31,3858
1739.296,6,87,6322,58,31,30513,31,3915,29,31,62117,31,2407
7.127,6,8,448,4,0,2330,0,240,4,0,2330,0,208
316.116,6,77,13679,33,199,9878,1305,4012,44,239,7347,1629,9667
1.232,6,40,9928,21,440,61,1360,4392,19,433,59,1360,5536
188.154,1,10,560,10,28,20906,28,560,0,0,0,0,0
0.255,17,2,157,1,31,0,31,59,1,70,0,70,98
125.035,6,24,8035,12,366,64,795,1654,12,736,11355,1360,6381
1240.897,1,74,4144,74,28,16998,28,4144,0,0,0,0,0
0.356,17,2,152,1,48,0,48,76,1,48,0,48,76
5.011,17,4,514,2,36,5006,36,128,2,165,5007,187,386
1.349,6,47,19930,27,945,51,1440,14354,20,433,61,1440,5576
374.464,6,25,1651,17,177,23404,177,1117,8,110,9268,110,534
807.887,17,160,12160,160,48,5081,48,12160,0,0,0,0,0
378.177,6,71,5191,35,86,11087,86,1966,36,41,10706,63,3225
280.214,6,30,7432,13,158,23351,267,1317,17,543,17512,1400,6115
310.669,6,26,5635,9,133,38833,159,887,17,967,19416,1669,4748
0.411,6,26,8991,13,252,34,647,1692,13,945,31,1438,7299
0.085,17,2,184,1,32,0,32,60,1,96,0,96,124
1779.942,6,351,22182,205,69,8725,69,12271,146,69,12274,69,9911
1768.984,6,103,8115,67,45,26802,205,4985,36,34,50531,98,3130
3.514,17,4,352,2,60,3513,60,176,2,60,3513,60,176
10.706,6,47,13983,23,891,486,1360,8128,24,325,457,1360,5855
0.242,17,2,178,1,29,0,29,57,1,93,0,93,121
0.251,17,3,451,2,39,102,39,134,1,289,0,289,317
1771.577,6,101,9344,66,65,27255,65,5577,35,59,52102,59,3767
1754.902,1,60,5040,60,56,29744,56,5040,0,0,0,0,0
0.415,6,6,324,4,0,138,0,216,2,0,229,0,108
0.22,17,4,1216,2,64,144,64,184,2,488,0,504,1032
6.093,17,4,996,2,46,6005,46,148,2,396,6006,484,848
1790.073,17,87,3648,86,14,21059,14,3612,1,8,0,8,36
0.027,6,2,80,1,0,0,0,40,1,0,0,0,40
245.647,6,28,7352,12,158,22331,267,1277,16,603,16369,1400,6075
1789.954,17,86,3606,85,14,21308,14,3570,1,8,0,8,36
5.117,17,4,240,2,32,5116,32,120,2,32,5116,32,120
45.295,6,11,788,3,92,22555,92,256,8,92,6444,92,532
1775.506,6,184,15778,122,69,14673,69,9020,62,69,29106,69,6758
13.856,6,2047,1741360,1144,1427,11,1448,1682144,903,776,15,1448,59216
1786.843,6,104,8376,68,65,26669,65,4930,36,59,51048,59,3446
0.569,17,2,198,1,63,0,63,91,1,79,0,79,107
1.28,6,41,12061,22,623,60,1460,6525,19,433,61,1460,5536
1.116,6,23,6515,13,334,92,1009,2195,10,979,123,2840,4320
997.036,17,8,2876,8,331,142433,548,2876,0,0,0,0,0
0.053,17,2,602,1,46,0,46,74,1,500,0,500,528
6.002,17,4,1370,2,308,5008,308,672,2,321,5000,321,698
1.652,6,51,22984,28,1009,61,1460,17288,23,433,66,1460,5696
8.342,6,29,8619,13,481,695,721,2451,16,552,473,1440,6168
0.512,6,22,7342,13,335,42,668,2026,9,1210,57,1946,5316
280.529,6,30,7432,13,158,23377,267,1317,17,543,17518,1400,6115
2.771,6,2,88,2,0,0,0,88,0,0,0,0,0
0.013,6,12,3462,6,75,2,75,395,6,1373,2,1448,3067
7.288,6,1709,1592198,1090,1383,6,1408,1555346,619,931,11,2801,36852
949.193,6,60,4749,38,64,25653,64,2736,22,56,45195,58,2013
0.009,17,4,284,2,32,4,32,120,2,54,5,60,164
1787.757,6,358,23538,209,82,8594,469,13369,149,69,12078,69,10169
289.023,6,125,89760,76,1252,3853,1408,79090,49,811,1741,3847,10670
1780.706,6,292,37168,119,140,15089,1360,17609,173,145,10352,2720,19559
39.33,17,44,6468,22,48,1871,48,1672,22,190,1870,308,4796
11.919,6,1774,1637593,1154,1368,10,1432,1608125,620,428,19,1871,29468
0.481,6,66,29538,33,1130,15,1380,23964,33,421,14,1923,5574
1733.19,6,77,5636,48,33,36876,33,3336,29,31,61893,31,2300
2.664,17,2,685,1,308,0,308,336,1,321,0,321,349
0.043,17,2,323,1,33,0,33,61,1,234,0,234,262
240.393,6,46,9308,24,519,10451,1402,5930,22,247,11447,618,3378
36.981,17,18,1368,18,48,2175,48,1368,0,0,0,0,0
282.483,6,32,9286,13,168,43,517,1720,19,505,15692,1418,7566
1784.708,6,106,8456,68,65,26637,65,4930,38,59,48232,59,3526
241.146,6,33,9061,14,158,18549,267,1357,19,578,13384,1400,7704
0.082,17,2,409,1,36,0,36,64,1,317,0,317,345
280.289,6,28,7352,13,158,23357,267,1317,15,678,20017,2045,6035
94.71,6,25,9908,12,549,66,1460,2709,13,952,7881,1460,7199
1777.777,17,140,11200,70,48,25764,48,5320,70,56,25764,56,5880
3.326,17,2,656,2,300,3326,300,656,0,0,0,0,0
1772.181,6,180,15480,120,69,14892,69,8940,60,69,30034,69,6540
47.419,6,24,7516,9,154,5927,267,832,15,552,3385,1452,6684
1787.739,6,103,8280,68,64,26682,65,4902,35,58,52578,59,3378
0.436,6,10,968,5,256,105,256,460,5,304,104,304,508
10.632,6,83,24877,41,561,265,1152,19056,42,413,253,1152,5821
1134.32,2,8,256,8,8,162045,8,256,0,0,0,0,0
371.933,6,27,1767,18,177,21878,177,1181,9,110,8671,110,586
405.317,17,8,846,8,77,57902,300,846,0,0,0,0,0
5.223,17,3,208,2,36,5002,36,128,1,52,0,52,80
0.187,6,27,7296,13,155,15,267,1301,14,603,13,2800,5995
1794.384,17,66,2766,65,14,28037,14,2730,1,8,0,8,36
1772.52,6,180,15480,120,69,14895,69,8940,60,69,30041,69,6540
0.495,17,2,384,1,39,0,39,67,1,289,0,289,317
1284.044,6,104,10825,58,74,22527,721,5040,46,91,26765,1448,5785
2.572,6,14,2351,8,188,367,245,700,6,703,461,1152,1651
0.037,17,2,128,1,28,0,28,56,1,44,0,44,72
138.392,17,4,272,2,40,138391,47,136,2,40,138390,47,136
1704.21,1,8,448,8,28,243458,28,448,0,0,0,0,0
357.762,6,73,5306,36,86,10221,86,2054,37,40,9625,63,3252
2.636,17,3,192,3,36,1318,36,192,0,0,0,0,0
0.262,17,2,290,1,40,0,40,68,1,194,0,194,222
8.515,6,32,6326,18,286,500,1314,2445,14,368,190,2673,3881
2.242,6,14,2351,8,188,320,245,700,6,703,397,1152,1651
127.543,6,11,586,4,106,42510,106,274,7,0,21255,0,312
365.8,6,18,1242,14,180,28138,180,916,4,110,20063,110,326
0.261,6,4,529,2,259,261,259,339,2,110,3,110,190
1788.615,17,87,3648,86,14,21042,14,3612,1,8,0,8,36
58.549,6,36,8360,18,378,508,786,1886,18,478,3435,2720,6474
0.136,17,2,588,1,39,0,39,67,1,493,0,493,521
1784.264,6,104,8308,68,64,26630,64,4896,36,58,50976,58,3412
240.722,6,43,5877,20,278,12669,686,3024,23,183,10941,580,2853
5.38,6,13,3137,6,92,1076,92,412,7,2329,863,2329,2725
1.397,6,17,4953,8,150,199,174,624,9,660,159,1452,4329
1786.009,6,367,24574,213,87,8424,469,14136,154,69,11673,69,10438
79.84,6,23,9674,11,351,68,746,1571,12,1087,7246,1360,8103
1.134,17,24,10876,11,605,113,1350,6971,13,272,83,1350,3905
40.64,17,6,528,3,48,20315,48,228,3,72,20315,72,300
2.415,17,4,288,2,36,2330,36,128,2,52,2337,52,160
24.702,6,6,340,2,0,24702,0,100,4,0,2434,0,240
318.394,6,10,538,7,106,53065,106,394,3,0,1508,0,144
0.087,17,4,352,2,37,45,37,130,2,83,49,89,222
2.027,17,6,471,3,31,957,31,177,3,70,0,70,294
240.174,6,52,17423,27,768,9237,1402,14474,25,205,10007,580,2949
126.214,6,71,49089,45,1208,2868,1448,41013,26,839,2465,2359,8076
618.029,6,77,15075,27,195,23770,1305,3848,50,230,12610,4649,11227
0.03,6,13,3980,7,88,5,88,388,6,1670,5,1880,3592
1794.56,17,144,11520,72,48,25275,48,5472,72,56,25275,56,6048
17.815,6,2814,2609863,1802,1369,9,1408,2552575,1012,931,17,2816,57288
1794.051,6,373,26235,212,98,8502,469,15103,161,69,11212,69,11132
1790.111,17,180,11520,180,36,10000,36,11520,0,0,0,0,0
1798.712,6,357,22629,208,69,8689,69,12460,149,69,12152,69,10169
1776.643,17,142,11360,71,48,25379,48,5396,71,56,25379,56,5964
0.925,17,3,1170,3,362,462,362,1170,0,0,0,0,0
4.086,6,13,985,7,222,679,222,506,6,231,814,231,479
0.485,17,2,384,1,39,0,39,67,1,289,0,289,317
0.078,6,4,239,2,0,72,0,104,2,31,1,31,135
16.312,17,5,380,5,48,4078,48,380,0,0,0,0,0
125.963,17,4,1344,4,308,41987,308,1344,0,0,0,0,0
0.017,17,2,157,1,31,0,31,59,1,70,0,70,98
0.008,6,2,92,1,0,0,0,52,1,0,0,0,40
300.797,6,41,9775,23,540,13672,1360,4208,18,402,507,2667,5567
1773.455,6,180,15480,120,69,14902,69,8940,60,69,30050,69,6540
421.823,6,72,4744,30,46,14545,46,2190,42,46,10284,46,2554
537.431,1,8,448,8,28,76775,28,448,0,0,0,0,0
636.021,17,48,3824,26,48,25440,48,1976,22,56,25412,56,1848
0.064,17,2,144,1,36,0,36,64,1,52,0,52,80
8.093,6,18,6791,9,275,1011,275,643,9,1155,725,1420,6148
0.504,17,3,451,2,39,284,39,134,1,289,0,289,317
0.005,17,4,352,2,60,4,60,176,2,60,3,60,176
1.247,6,25,8056,12,164,96,267,1288,13,869,88,1408,6768
240.19,6,40,5357,19,247,13343,832,2739,21,189,12009,635,2618
1744.492,6,95,7203,63,38,28136,205,4476,32,33,56263,98,2727
11.85,6,24,9520,13,275,987,275,1078,11,1331,940,1420,8442
0.557,6,22,7368,14,337,42,674,2096,8,969,72,1946,5272
1740.493,17,30,31170,30,1011,60017,1011,31170,0,0,0,0,0
240.291,6,58,20786,31,852,8008,1418,17830,27,193,9241,580,2956
46.719,6,13,900,7,180,7786,180,552,6,0,9174,0,348
1774.282,1,16,896,16,28,118285,28,896,0,0,0,0,0
11.322,17,8,704,4,48,3771,48,304,4,72,3770,72,400
465.495,1,14,784,14,28,35807,28,784,0,0,0,0,0
107.286,6,32,22525,17,549,52,1360,2932,15,2109,7653,6211,19593
70.603,6,14,580,6,0,8760,0,248,8,0,10084,0,332
280.479,6,29,7392,13,158,23373,267,1317,16,603,18695,2076,6075
103.211,6,26,9401,12,552,81,1319,2170,14,832,7926,1791,7231
9.93,6,4,220,2,0,9930,0,104,2,0,4694,0,116
1779.296,17,140,11200,70,48,25786,48,5320,70,56,25786,56,5880
0.198,17,2,1922,2,933,198,933,1922,0,0,0,0,0
1741.714,6,95,7203,63,38,28092,205,4476,32,33,56170,98,2727
1773.26,1,59,4956,0,0,0,0,0,59,56,30573,56,4956
15.266,17,20,12720,12,851,1384,1350,10555,8,242,2176,1350,2165
6.323,6,920,803598,555,1370,11,1408,779954,365,931,16,2801,23644
0.097,17,2,158,1,34,0,34,62,1,68,0,68,96
54.5,6,1131,985935,699,1412,59,1440,960406,432,195,126,1440,25529
6.265,6,1513,1423543,972,1388,6,1408,1390747,541,931,11,2801,32796
1786.434,6,104,8504,69,66,26271,66,5004,35,60,52539,60,3500
22.96,6,34,8137,16,188,1530,721,1964,18,605,1339,1414,6173
3.316,17,16,2062,16,100,221,362,2062,0,0,0,0,0
0.936,6,11,1727,7,100,156,100,384,4,589,224,1152,1343
0.012,17,4,624,2,36,1,36,128,2,220,3,292,496
1782.273,6,354,22440,207,69,8651,69,12420,147,69,12206,69,10020
7.938,17,2,1799,2,871,7938,1097,1799,0,0,0,0,0
1794.278,6,242,46639,151,483,11961,483,36844,91,83,19936,83,9795
0.407,6,21,7203,13,318,33,600,1958,8,964,56,1471,5245
0.009,17,2,334,1,39,0,39,67,1,239,0,239,267
299.842,1,4,224,4,28,99947,28,224,0,0,0,0,0
1776.76,6,106,9754,69,64,26128,64,5788,37,58,49351,58,3966
1133.641,2,14,448,14,8,87203,8,448,0,0,0,0,0
280.476,6,30,7432,14,158,21575,267,1357,16,678,18694,3456,6075
1799.814,1,57,4788,57,56,32139,56,4788,0,0,0,0,0
2.3,6,14,1144,8,283,325,283,719,6,105,424,105,425
1082.907,2,11,352,11,8,108290,8,352,0,0,0,0,0
5.024,17,4,514,2,36,5019,36,128,2,165,5019,187,386
1777.459,1,58,4872,58,56,31183,56,4872,0,0,0,0,0
1790.435,6,353,22469,204,69,8819,69,12369,149,69,12096,69,10100
0.345,6,20,7238,12,335,30,668,1974,8,1210,48,1906,5264
1791.617,6,358,22669,209,69,8613,69,12500,149,69,12102,69,10169
1759.502,6,187,11487,93,47,19125,208,6766,94,31,18916,31,4721
26.007,17,4,240,2,32,26006,32,120,2,32,26006,32,120
1740.504,17,28,6580,28,207,64463,207,6580,0,0,0,0,0
0.017,17,2,672,2,308,17,308,672,0,0,0,0,0
1791.149,6,356,22520,208,69,8652,69,12460,148,69,12184,69,10060
0.497,6,25,7887,16,364,33,1125,3193,9,721,60,1420,4694
64.46,6,11,452,5,0,4387,0,204,6,0,12887,0,248
0.207,6,12,3462,6,75,41,75,395,6,1373,41,1448,3067
1.602,6,46,19191,27,894,61,1360,13655,19,476,77,2715,5536
1621.458,1,7,392,7,28,270243,28,392,0,0,0,0,0
145.424,6,201,165711,131,1312,1118,1408,151170,70,640,2104,2439,14541
1.074,6,9,1647,6,100,214,100,344,3,1179,402,1179,1303
13.773,6,25,4654,14,275,1059,275,1122,11,768,899,1440,3532
1797.115,17,80,3354,79,14,23039,14,3318,1,8,0,8,36
1.037,17,24,14531,13,891,83,1350,11948,11,206,100,1350,2583
240.192,6,54,17999,29,794,8578,1402,15016,25,209,10007,580,2983
0.494,6,20,7229,13,334,41,663,2021,7,1209,74,1946,5208
280.469,6,29,7392,13,158,23372,267,1317,16,678,18692,3456,6075
61.641,6,29,7257,13,155,5136,267,1306,16,441,4108,1460,5951
2.892,6,37,18978,20,689,152,1440,5673,17,1051,171,1440,13305
6.533,6,10,628,3,106,3255,106,234,7,90,1084,90,394
0.135,1,2,112,2,28,135,28,112,0,0,0,0,0
1770.337,6,259,17500,109,46,16387,46,7774,150,46,11881,46,9726
9.552,6,78,24405,40,552,244,1152,18744,38,459,251,1179,5661
2.413,17,38,23149,20,931,127,1350,19191,18,191,94,1350,3958
108.772,6,30,7432,13,158,9064,267,1317,17,543,6795,1400,6115
0.441,6,24,7391,12,271,38,517,1718,12,840,38,1448,5673
131.235,6,32,8952,14,158,10095,267,1357,18,624,7711,1400,7595
1741.437,17,30,31680,30,1028,60049,1028,31680,0,0,0,0,0
91.432,6,31,24672,19,884,30,1360,6097,12,2583,8300,8817,18575
1765.381,17,86,3606,85,14,21016,14,3570,1,8,0,8,36
1786.773,6,356,22520,208,69,8631,69,12460,148,69,12154,69,10060
0.817,17,4,360,2,30,796,30,116,2,94,805,94,244
1684.809,17,14,1036,7,30,280798,30,406,7,62,280781,62,630
0.096,17,2,323,1,33,0,33,61,1,234,0,234,262
291.433,6,38,8717,18,206,17140,517,1780,20,737,15335,1418,6937
305.975,6,276,218914,168,1361,1832,1448,199358,108,574,2002,1448,19556
64.177,6,39,8412,13,140,5347,267,1513,26,292,2566,1460,6899
19.005,17,28,6151,14,223,1459,1350,3516,14,160,1459,1350,2635
0.967,6,27,8420,15,222,58,540,1964,12,1192,72,3151,6456
68.72,17,2,656,2,300,68720,300,656,0,0,0,0,0
0.744,6,32,8952,14,158,57,267,1357,18,624,36,1400,7595
0.897,6,10,1687,7,100,149,100,384,3,1179,319,1179,1303
1792.227,17,142,11360,71,48,25603,48,5396,71,56,25603,56,5964
13.404,6,2399,2298064,1530,1423,8,1448,2248188,869,776,15,1448,49876
3.403,17,10,2443,5,40,848,40,340,5,392,849,423,2103
14.543,6,3842,5484506,599,726,24,1396,44055,3243,1630,4,8376,5440451
0.007,17,2,531,1,40,0,40,68,1,435,0,435,463
0.017,17,2,255,1,43,0,43,71,1,156,0,156,184
1.622,6,62,46735,40,1253,41,1408,39686,22,982,69,2411,7049
1767.508,1,58,4872,58,56,31008,56,4872,0,0,0,0,0
10.762,6,18,5610,10,275,1195,275,958,8,1440,821,1440,4652
0.51,6,58,23986,33,959,15,1380,16776,25,515,19,1923,7210
11.288,6,1683,1544605,1092,1363,10,1420,1516638,591,475,19,1883,27967
105.732,17,40,10360,40,231,2711,388,10360,0,0,0,0,0
0.591,17,2,152,1,48,0,48,76,1,48,0,48,76
576.664,1,6,336,6,28,115332,28,336,0,0,0,0,0
1.238,6,48,19388,27,904,47,1360,13772,21,476,53,2715,5616
36.853,6,45,10881,23,830,517,1360,5154,22,402,1747,2667,5727
0.037,17,2,586,1,46,0,46,74,1,484,0,484,512
15.545,6,33,5419,16,154,1036,722,1935,17,288,961,2026,3484
1.375,6,37,8214,19,321,76,1164,2718,18,476,70,2615,5496
0.25,6,16,4552,8,88,35,88,460,8,1253,35,1880,4092
6.971,6,29,7464,12,155,633,267,1266,17,423,435,3417,6198
1799.154,6,361,24872,211,94,8567,469,14456,150,69,12072,69,10416
1797.659,6,406,24781,213,69,8479,69,12729,193,42,9362,69,12052
11.234,6,27,11373,13,275,936,275,1078,14,1080,832,1420,10295
158.314,6,131,98737,84,1267,1907,1408,86758,47,680,2533,2439,11979
1771.318,6,101,9278,66,64,27251,64,5544,35,58,52094,58,3734
0.525,6,20,7238,13,335,43,668,2026,7,1210,82,1946,5212
1796.766,17,142,11360,71,48,25667,48,5396,71,56,25667,56,5964
41.293,17,38,5940,19,48,2293,48,1444,19,208,2293,308,4496
0.086,17,2,198,1,39,0,39,67,1,103,0,103,131
1790.391,6,163,20939,95,302,19046,302,14640,68,83,26722,83,6299
1785.139,6,106,8456,68,65,26643,65,4930,38,59,48244,59,3526
1782.438,6,157,12486,86,93,20969,208,8747,71,31,25456,31,3739
1770.922,6,99,9240,66,65,27244,65,5577,33,59,55338,59,3663
11.885,6,1896,1646537,1163,1363,10,1380,1612975,733,421,16,1923,33562
1736.176,1,56,4704,56,56,31566,56,4704,0,0,0,0,0
1798.453,1,150,8400,150,28,12070,28,8400,0,0,0,0,0
0.407,6,21,7203,12,318,35,600,1906,9,964,48,1471,5297
1619.521,1,7,392,7,28,269920,28,392,0,0,0,0,0
159.501,6,134,25252,82,395,1322,1284,11194,52,323,3125,1420,14058
2.039,6,14,2351,8,188,291,245,700,6,703,355,1152,1651
179.421,17,10,760,10,48,19935,48,760,0,0,0,0,0
0.261,17,2,2378,2,1161,261,1161,2378,0,0,0,0,0
1049.669,17,12,912,12,48,95424,48,912,0,0,0,0,0
20.027,17,33,13016,15,554,1427,1350,8735,18,209,1175,1350,4281
915.719,17,173,39719,173,201,5323,361,39719,0,0,0,0,0
157.999,17,4,352,2,60,157998,60,176,2,60,157997,60,176
0.251,6,3,144,2,0,251,0,92,1,0,0,0,52
12.696,2,3,96,3,8,6348,8,96,0,0,0,0,0
1772.565,6,180,15480,120,69,14895,69,8940,60,69,30036,69,6540
0.062,6,2,80,1,0,0,0,40,1,0,0,0,40
0.036,17,2,482,1,37,0,37,65,1,389,0,389,417
1798.563,6,356,22520,208,69,8688,69,12460,148,69,12234,69,10060
1782.844,17,124,9920,62,48,29226,48,4712,62,56,29226,56,5208
101.983,6,90,59066,55,1219,1888,1448,50459,35,677,2586,1448,8607
1799.065,17,3884,186432,1942,20,926,20,93216,1942,20,926,20,93216
1725.323,1,8,448,8,28,246474,28,448,0,0,0,0,0
1785.769,6,104,8564,68,66,26653,66,4964,36,60,51019,60,3600
20.492,6,20,3130,12,183,1862,517,1561,8,381,2926,499,1569
63.759,17,8,2702,8,309,9108,322,2702,0,0,0,0,0
0.894,6,15,2224,7,288,116,288,620,8,424,100,434,1604
1798.66,1,68,5712,0,0,0,0,0,68,56,26845,56,5712
1773.872,17,140,11200,70,48,25708,48,5320,70,56,25708,56,5880
367.338,6,27,1767,18,177,21608,177,1181,9,110,8553,110,586
1786.422,17,87,3648,86,14,21016,14,3612,1,8,0,8,36
0.554,6,18,5935,10,290,61,517,1097,8,1101,75,1418,4838
240.274,6,48,9539,25,519,10011,1402,5995,23,234,10921,618,3544
411.617,17,11,3940,11,330,41161,548,3940,0,0,0,0,0
1.13,6,23,7952,12,164,87,267,1288,11,1216,96,3819,6664
47.086,6,32,9219,16,176,3139,267,1704,16,858,3136,4200,7515
1786.96,6,106,8524,68,66,26671,66,4964,38,60,48293,60,3560
81.78,6,10,952,2,69,360,69,149,8,69,11682,69,803
1742.77,6,119,12037,75,63,23550,722,6266,44,96,40519,1408,5771
12.707,6,1894,1746049,1208,1391,10,1432,1713041,686,389,18,1432,33008
317.981,6,77,19846,34,429,9635,1460,9976,43,290,7567,1629,9870
32.384,6,18,1407,9,222,4046,222,808,9,231,4046,231,599
30.041,6,12,1316,7,174,5006,174,546,5,251,7490,475,770
1649.93,1,8,448,8,28,235704,28,448,0,0,0,0,0
0.353,17,2,157,1,31,0,31,59,1,70,0,70,98
3.74,17,5,295,5,31,935,31,295,0,0,0,0,0
1.747,6,31,8912,14,158,134,267,1357,17,687,108,2036,7555
0.176,6,35,19127,16,173,11,319,1532,19,1276,9,1588,17595
0.827,6,10,1687,7,100,137,100,384,3,1179,278,1179,1303
10.96,6,20,2593,11,211,1095,211,1038,9,545,1369,904,1555
4.374,6,34,6169,18,206,257,314,2784,16,456,274,1152,3385
173.798,17,4,352,2,60,173797,60,176,2,60,173797,60,176
1789.869,1,342,28728,342,56,5248,56,28728,0,0,0,0,0
9.611,6,34,8161,17,345,589,721,1728,17,478,576,2920,6433
15.159,17,25,10915,10,437,1679,1350,4655,15,389,1080,1350,6260
1796.091,6,201,26046,111,304,16328,304,17772,90,83,20180,83,8274
1794.672,17,319,70204,319,192,5643,422,70204,0,0,0,0,0
1770.152,6,237,20362,91,77,19666,339,9270,146,70,12207,1062,11092
0.09,17,2,572,1,39,0,39,67,1,477,0,477,505
1764.038,2,12,384,12,8,160367,8,384,0,0,0,0,0
1.953,17,3,2906,3,940,976,1451,2906,0,0,0,0,0
316.94,6,109,34739,57,507,5659,1360,23630,52,333,6211,3289,11109
38.56,17,36,9279,16,302,2568,1350,5288,20,171,2027,1350,3991
1779.396,6,102,8296,68,65,26558,65,4930,34,59,53918,59,3366
4.906,6,35,7056,17,231,291,314,3234,18,516,274,1179,3822
25.583,6,3644,3436665,2308,1408,11,1448,3361297,1336,776,19,1448,75368
300.824,6,38,9915,21,593,15041,1460,4433,17,435,538,2567,5482
1418.845,6,280,19232,119,46,12024,46,7824,161,46,8866,46,11408
0.278,17,2,152,1,48,0,48,76,1,48,0,48,76
39.073,17,44,6468,22,48,1860,48,1672,22,190,1860,308,4796
0.004,6,9,12040,1,0,0,0,40,8,1448,0,1448,12000
1785.751,6,102,8296,68,65,26653,65,4930,34,59,54110,59,3366
1765.495,1,52,6160,52,90,34617,351,6160,0,0,0,0,0
1.134,6,23,7952,12,164,88,267,1288,11,1216,96,3819,6664
1786.621,6,406,32532,230,86,7801,501,15834,176,132,10208,1926,16698
1008.961,6,123,9180,46,65,21751,294,4271,77,48,13275,78,4909
0.495,17,3,451,2,39,252,39,134,1,289,0,289,317
0.044,17,2,146,1,37,0,37,65,1,53,0,53,81
0.073,17,2,198,1,39,0,39,67,1,103,0,103,131
16.828,6,2567,2461940,1700,1372,9,1408,2412192,867,776,19,1408,49748
46.894,6,13,760,5,0,11723,0,280,8,0,6691,0,480
1796.935,17,180,14040,180,50,10038,50,14040,0,0,0,0,0
1.005,6,185,139772,108,1320,9,1432,132401,77,427,12,1432,7371
1.128,17,4,288,2,36,1109,36,128,2,52,1093,52,160
169.004,17,2,672,2,308,169004,308,672,0,0,0,0,0
0.117,6,11,819,6,186,23,186,506,5,45,29,45,313
2.861,6,30,10328,18,372,168,848,1840,12,1000,251,1452,8488
0.067,17,2,2756,2,1350,67,1350,2756,0,0,0,0,0
0.657,17,4,624,2,64,655,64,184,2,192,544,192,440
1738.916,6,87,6322,58,31,30507,31,3915,29,31,62103,31,2407
364.128,6,30,6416,15,185,7799,499,1529,15,356,26002,1420,4887
149.248,6,29,14025,15,519,59,884,2721,14,1073,11469,1503,11304
477.819,1,3,318,3,78,238909,78,318,0,0,0,0,0
8.897,6,77,24301,39,550,234,1152,18640,38,459,232,1179,5661
12.199,6,10,548,5,0,3047,0,276,5,0,3047,0,272
1.25,6,25,8056,12,164,97,267,1288,13,869,89,1408,6768
188.741,17,2,150,2,47,188741,47,150,0,0,0,0,0
30.229,17,16,6322,7,499,5028,1350,3691,9,264,3767,1350,2631
300.874,6,43,8880,23,308,13676,888,2235,20,416,513,3388,6645
81.664,6,17,3304,6,92,16332,92,400,11,1164,8146,1448,2904
22.309,6,28,6439,14,117,1716,159,1337,14,727,1713,1418,5102
1.399,6,24,8004,12,164,108,267,1288,12,1014,108,2491,6716
245.242,6,33,19494,22,915,11678,1231,13973,11,705,2728,1448,5521
298.293,2,2,64,2,8,298293,8,64,0,0,0,0,0
1.457,6,47,18164,26,882,58,1460,12548,21,433,63,1460,5616
25.67,6,3224,3008204,2040,1394,12,1448,2941948,1184,776,21,1448,66256
8.557,6,14,1247,7,222,1423,222,728,7,231,1423,231,519
0.044,17,4,284,2,32,28,32,120,2,54,21,60,164
0.498,17,3,451,2,39,353,39,134,1,289,0,289,317
588.576,1,6,489,6,53,117715,78,489,0,0,0,0,0
8.453,6,77,25202,40,579,216,1152,19581,37,459,226,1179,5621
296.055,17,4,240,2,32,296054,32,120,2,32,296054,32,120
280.486,6,30,7432,13,158,23373,267,1317,17,543,17525,1400,6115
12.602,6,322,216406,163,254,77,693,8321,159,1353,79,2840,208085
1772.087,6,180,15480,120,69,14891,69,8940,60,69,30031,69,6540
71.082,17,4,240,2,32,71081,32,120,2,32,71081,32,120
1770.129,6,99,9240,66,65,27232,65,5577,33,59,55313,59,3663
61.308,6,37,15977,22,804,2919,1448,9199,15,665,4360,1448,6778
1799.061,17,448,39896,403,35,4475,288,25676,45,288,40017,288,14220
21.729,1,2,112,2,28,21729,28,112,0,0,0,0,0
11.195,6,27,11433,13,275,932,275,1078,14,1087,768,1440,10355
1681.239,1,15,840,15,28,120088,28,840,0,0,0,0,0
4.858,6,89,58124,53,830,93,1408,10239,36,1916,138,7040,47885
1773.256,6,123,12307,76,62,23643,722,6350,47,94,38540,1408,5957
0.126,17,2,152,2,48,126,48,152,0,0,0,0,0
240.074,6,36,10141,17,150,15004,478,1808,19,612,13337,1408,8333
1682.41,17,14,1036,7,30,280396,30,406,7,62,280396,62,630
11.756,6,1109,848759,574,1380,20,1448,812319,535,776,21,1448,36440
1704.465,1,8,448,8,28,243495,28,448,0,0,0,0,0
1.277,6,50,18674,27,847,49,1360,12978,23,433,50,1360,5696
5.315,6,45,8409,22,227,253,314,4062,23,427,229,1152,4347
9.428,1,2,72,2,8,9428,8,72,0,0,0,0,0
23.465,6,27,3778,15,139,1676,326,1251,12,465,2112,1448,2527
1798.446,17,448,39896,403,35,4473,288,25676,45,288,40020,288,14220
1774.194,6,189,11567,94,47,19077,208,6806,95,31,18871,31,4761
376.438,6,25,1651,17,177,23527,177,1117,8,110,9272,110,534
187.403,17,4,352,2,60,187401,60,176,2,60,187401,60,176
368.333,1,6,336,6,28,73666,28,336,0,0,0,0,0
0.256,6,20,4960,10,137,28,267,1092,10,692,27,1467,3868
223.207,6,30,7432,13,158,18600,267,1317,17,543,13946,1400,6115
488.241,6,5644,5030890,2864,402,170,420,164479,2780,1702,175,18304,4866411
178.69,17,4,352,2,60,178689,60,176,2,60,178689,60,176
0.525,17,4,317,2,39,523,39,134,2,63,266,72,183
0.125,6,10,1495,5,507,31,507,727,5,556,31,556,768
0.628,6,18,3068,9,282,78,531,1606,9,493,62,828,1462
11.793,6,1880,1629479,1140,1375,10,1420,1595658,740,467,15,1883,33821
0.982,6,24,6042,13,108,81,147,959,11,773,87,1608,5083
31.182,6,13,9168,5,421,7795,517,1110,8,1526,419,2816,8058
3.13,17,2,334,1,39,0,39,67,1,239,0,239,267
1772.049,6,180,15480,120,69,14891,69,8940,60,69,30033,69,6540
107.338,6,32,16096,13,249,71,431,1433,19,803,5953,1440,14663
280.041,6,28,7352,12,158,25458,267,1277,16,603,18666,1400,6075
15.733,6,13,760,5,0,3933,0,280,8,0,2176,0,480
6.154,17,4,240,2,32,6153,32,120,2,32,6153,32,120
0.524,17,2,184,1,32,0,32,60,1,96,0,96,124
0.018,17,2,239,1,59,0,59,87,1,124,0,124,152
0.047,6,13,3980,7,88,7,88,388,6,1670,9,2920,3592
70.617,6,10,412,4,0,3991,0,164,6,0,14121,0,248
50.596,17,4,240,2,32,50595,32,120,2,32,50595,32,120
1772.441,6,180,15480,120,69,14894,69,8940,60,69,30032,69,6540
1787.093,17,87,3648,86,14,21024,14,3612,1,8,0,8,36
0.173,17,2,262,1,39,0,39,67,1,167,0,167,195
4.513,6,39,7269,19,218,250,314,3383,20,440,223,1152,3886
418.176,1,34,1904,34,28,12672,28,1904,0,0,0,0,0
1779.095,6,100,10567,49,168,37063,517,3396,51,748,35581,2816,7171
0.061,17,2,334,1,32,0,32,60,1,246,0,246,274
4.268,6,2,88,2,0,0,0,88,0,0,0,0,0
15.744,17,10,760,10,48,1749,48,760,0,0,0,0,0
1781.798,6,237,24696,94,68,19157,659,9060,143,135,12546,1938,15636
1783.826,6,359,22709,209,69,8576,69,12569,150,69,11971,69,10140
280.218,6,30,7432,13,158,23351,267,1317,17,543,17513,1400,6115
0.335,17,5,1757,5,323,83,354,1757,0,0,0,0,0
300.477,6,82,14648,37,305,8345,1368,7123,45,235,6828,1368,7525
1798.718,1,16,896,16,28,119914,28,896,0,0,0,0,0
7.416,6,1467,1199152,783,1431,9,1448,1151648,684,776,10,1448,47504
1.32,6,51,18822,27,855,50,1360,13086,24,433,49,1360,5736
65.145,17,8,704,4,48,21712,48,304,4,72,21712,72,400
2.929,17,4,624,4,128,976,128,624,0,0,0,0,0
0.13,17,2,170,1,37,0,37,65,1,77,0,77,105
10.719,6,20,4442,11,275,1071,275,998,9,768,743,1440,3444
71.972,6,35,27004,18,667,54,1360,4088,17,1852,4487,6800,22916
31.032,6,45,9990,23,315,1410,721,3451,22,564,1467,1440,6539
11.024,6,20,4442,11,275,1102,275,998,9,768,780,1440,3444
0.394,6,439,446775,278,183,1,230,15633,161,2658,1,9856,431142
9.143,6,25,7024,8,146,1306,267,1058,17,479,563,1420,5966
4.091,17,5,290,5,30,1022,30,290,0,0,0,0,0
73.014,6,30,7770,8,162,297,267,1303,22,348,3476,1420,6467
240.67,2,4,128,4,8,80223,8,128,0,0,0,0,0
1778.645,6,105,8255,69,45,26156,205,5096,36,35,50807,98,3159
0.081,6,14,5624,6,112,16,112,360,8,822,2,1420,5264
280.419,6,31,7472,13,158,23368,267,1317,18,543,16492,1380,6155
0.086,17,2,322,1,33,0,33,61,1,233,0,233,261
2.191,6,13,2311,8,188,313,245,700,5,1407,485,1407,1611
1772.563,6,180,15480,120,69,14895,69,8940,60,69,30036,69,6540
8.226,6,18,6871,9,275,1028,275,643,9,1171,957,1440,6228
300.128,6,46,16022,25,934,12498,1360,10380,21,399,14998,1360,5642
60.717,6,8,432,5,0,15179,0,268,3,0,30150,0,164
32.168,6,182,185312,101,124,321,296,7650,81,2252,402,8448,177662
352.168,6,24,10611,4,112,260,112,280,20,529,18534,1917,10331
273.192,17,4,530,2,36,273187,36,128,2,173,273184,187,402
4.365,6,38,7229,19,218,242,314,3383,19,513,227,1179,3846
1.402,6,50,20101,28,886,51,1360,14445,22,433,57,1360,5656
13.524,6,24,5362,12,351,1229,1382,2242,12,376,1208,1460,3120
232.549,6,26,7272,12,158,21140,267,1277,14,678,17884,2085,5995
1786.184,6,102,8160,68,63,26659,63,4862,34,57,54124,57,3298
372.214,6,23,1535,16,177,24814,177,1053,7,110,10394,110,482
1798.762,1,345,28980,345,56,5228,56,28980,0,0,0,0,0
0.102,17,4,588,2,48,97,48,152,2,190,96,308,436
0.512,17,2,167,1,39,0,39,67,1,72,0,72,100
267.297,17,4,304,2,48,267296,64,152,2,48,267296,64,152
0.106,1,2,112,2,28,106,28,112,0,0,0,0,0
1763.345,6,93,6701,59,31,30402,31,3991,34,31,53430,31,2710
3.101,6,13,2311,8,188,443,245,700,5,1407,711,1407,1611
1719.459,17,12,498,11,14,171945,14,462,1,8,0,8,36
24.798,6,22,3262,10,632,2753,1452,2300,12,231,2253,231,962
882.225,2,7,224,7,8,147037,8,224,0,0,0,0,0
11.812,6,1858,1624678,1147,1362,10,1380,1591996,711,383,16,1380,32682
0.174,17,2,237,1,72,0,72,100,1,109,0,109,137
0.08,17,8,2446,8,277,11,316,2446,0,0,0,0,0
1.455,6,58,18034,28,707,53,1360,8925,30,438,49,1360,9109
215.88,17,4,240,2,32,215878,32,120,2,32,215879,32,120
33.656,6,31,5294,16,154,2243,722,1910,15,433,2390,2026,3384
5.557,6,40,7309,20,218,292,314,3423,20,513,276,1179,3886
72.138,6,32,7584,13,155,6011,267,1306,19,393,4007,1997,6278
191.605,6,30,7429,7,138,31934,267,843,23,332,8708,1420,6586
0.531,6,29,10646,13,261,44,683,1764,16,893,34,1408,8882
1748.104,6,95,7203,63,38,28195,205,4476,32,33,56380,98,2727
59.114,6,24,1759,18,43,3477,43,1399,6,0,9933,0,360
1781.761,6,416,24920,208,69,8607,69,12460,208,34,8607,48,12460
1752.349,1,56,4704,56,56,31860,56,4704,0,0,0,0,0
10.987,6,22,4526,12,275,998,275,1038,10,768,706,1440,3488
1580.718,6,38,6778,26,241,63228,241,5378,12,92,143680,92,1400
245.896,6,54,3738,32,65,7932,65,2060,22,66,11704,149,1678
1787.554,6,106,8456,68,65,26679,65,4930,38,59,48310,59,3526
0.417,6,7,295,4,0,139,0,164,3,7,103,7,131
0.393,6,6,324,4,0,131,0,216,2,0,214,0,108
1781.264,1,342,28728,342,56,5223,56,28728,0,0,0,0,0
1771.14,6,101,9410,66,66,27248,66,5610,35,60,52089,60,3800
0.379,6,12,1653,6,288,71,288,548,6,426,41,434,1105
1715.247,1,8,448,8,28,245035,28,448,0,0,0,0,0
4.664,6,34,7321,18,206,274,314,2784,16,648,292,1179,4537
721.921,2,8,256,8,8,103131,8,256,0,0,0,0,0
1256.99,6,266,25568,156,114,8109,469,13097,110,161,10128,3423,12471
1782.299,17,83,3480,82,14,22003,14,3444,1,8,0,8,36
280.042,6,27,7312,13,158,23336,267,1317,14,775,21540,4836,5995
504.568,2,4,128,4,8,168189,8,128,0,0,0,0,0
1763.966,17,216,55977,216,231,8204,422,55977,0,0,0,0,0
0.406,6,24,6041,13,108,33,147,959,11,773,40,1608,5082
1777.89,1,64,5376,64,56,28220,56,5376,0,0,0,0,0
1786.079,6,102,8296,68,65,26657,65,4930,34,59,54120,59,3366
5.952,17,3,228,3,48,2976,48,228,0,0,0,0,0
0.09,17,2,214,1,39,0,39,67,1,119,0,119,147
1789.911,17,87,3648,86,14,21057,14,3612,1,8,0,8,36
38.779,1,6,336,6,28,7755,28,336,0,0,0,0,0
45.051,6,27,7177,13,155,3754,267,1306,14,530,3464,3417,5871
358.859,6,46,10606,29,302,12816,1360,5124,17,435,537,2667,5482
0.023,6,17,6068,10,88,2,88,556,7,1740,3,1880,5512
1779.641,17,142,11360,71,48,25423,48,5396,71,56,25423,56,5964
1779.802,6,354,22440,207,69,8639,69,12420,147,69,12189,69,10020
1789.874,1,342,28728,342,56,5248,56,28728,0,0,0,0,0
1740.144,6,87,6322,58,31,30528,31,3915,29,31,62147,31,2407
241.316,6,62,22476,31,858,8043,1408,18007,31,284,8043,580,4469
2.0,17,2,134,2,39,2000,39,134,0,0,0,0,0
0.68,17,8,2750,8,315,97,354,2750,0,0,0,0,0
11.698,6,1824,1615149,1127,1380,10,1420,1583048,697,467,16,1883,32101
0.357,6,26,9017,13,261,29,683,1728,13,943,28,1408,7289
78.609,6,25,9849,12,531,62,1440,2637,13,954,6539,1440,7212
1.276,6,42,10065,23,440,58,1360,4484,19,437,61,2715,5581
1744.648,2,25,800,25,8,72693,8,800,0,0,0,0,0
5.007,17,4,288,2,36,4991,36,128,2,52,4989,52,160
0.051,17,4,284,2,32,39,32,120,2,54,39,60,164
300.833,6,52,10618,26,433,12033,910,3310,26,312,612,1460,7308
0.179,6,25,7216,13,155,14,267,1301,12,678,14,3436,5915
2.078,17,11,4674,5,431,519,1350,2298,6,368,167,1350,2376
0.268,17,2,197,1,44,0,44,72,1,97,0,97,125
0.014,17,2,198,1,39,0,39,67,1,103,0,103,131
1.07,6,26,9564,13,164,76,267,1388,13,1070,75,2816,8176
9.242,6,82,24805,41,560,231,1152,19008,41,461,224,1179,5797
0.256,6,24,7176,13,155,21,267,1301,11,775,24,2800,5875
299.518,6,6,364,4,31,99839,31,222,2,31,299506,31,142
116.008,6,64,30746,37,945,3203,1368,23674,27,468,4456,3087,7072
0.349,6,20,7238,13,335,29,668,2026,7,1210,56,1906,5212
0.039,17,2,1152,1,548,0,548,576,1,548,0,548,576
90.175,6,10885,10259754,6736,1436,13,1448,10017918,4149,776,21,1448,241836
8.631,6,1327,1266644,841,1430,10,1448,1236708,486,776,17,1448,29936
957.205,17,14,3509,7,32,159532,37,420,7,413,159532,463,3089
1740.928,6,91,6604,59,31,30016,31,3998,32,31,56158,31,2606
0.009,6,33,8043,17,131,0,131,1023,16,441,0,500,7020
1.614,6,46,19043,26,885,64,1360,13467,20,433,74,1360,5576
1797.657,6,356,22520,208,69,8684,69,12460,148,69,12228,69,10060
1784.61,6,361,23065,208,69,8621,69,12529,153,69,11740,69,10536
18.178,6,1989,1757023,1228,1374,14,1380,1719317,761,421,23,1923,37706
0.056,17,2,136,1,32,0,32,60,1,48,0,48,76
421.161,6,43,7822,20,132,14792,501,1995,23,245,19139,1420,5827
1793.563,17,84,3522,83,14,21872,14,3486,1,8,0,8,36
39.313,17,22,1936,11,48,3930,48,836,11,72,3930,72,1100
0.025,17,2,354,1,33,0,33,61,1,265,0,265,293
117.389,6,61,39645,39,1143,3089,1408,31760,22,841,2925,2816,7885
7.332,6,1524,1450714,999,1377,7,1408,1418750,525,931,13,2801,31964
87.9,6,30,7432,13,158,7325,267,1317,17,543,5489,1400,6115
27.578,6,25,4803,13,197,2298,314,2105,12,369,2483,1179,2698
1751.069,1,69,3864,69,28,25751,28,3864,0,0,0,0,0
8.731,6,36,22465,11,340,873,340,924,25,1345,256,1460,21541
301.998,6,33,6397,17,286,18874,1314,2405,16,334,20132,1420,3992
378.49,6,23,1538,16,180,25232,180,1056,7,110,10359,110,482
0.025,17,4,314,2,31,0,31,118,2,70,0,70,196
301.838,6,37,8268,20,241,15886,619,1834,17,478,605,1928,6434
98.529,6,32,7728,12,156,32,267,1272,20,376,5185,3417,6456
0.009,17,2,182,1,39,0,39,67,1,87,0,87,115
1786.599,17,103,8236,52,48,35031,48,3952,51,56,35232,56,4284
1788.583,1,339,28476,339,56,5291,56,28476,0,0,0,0,0
1787.805,6,163,16868,87,103,20788,722,9304,76,80,23834,1448,7564
0.013,17,2,211,1,48,0,48,76,1,107,0,107,135
8.693,6,82,24805,41,560,217,1152,19008,41,461,211,1179,5797
1786.406,6,102,8364,68,66,26662,66,4964,34,60,54130,60,3400
1.43,6,50,21133,28,955,52,1460,15477,22,433,59,1460,5656
251.421,2,2,64,2,8,251421,8,64,0,0,0,0,0
19.48,6,95,31236,46,603,432,1152,24778,49,449,400,1179,6458
9.188,17,4,1344,4,308,3062,308,1344,0,0,0,0,0
5.021,17,3,433,2,37,4980,37,130,1,275,0,275,303
0.051,17,2,184,1,32,0,32,60,1,96,0,96,124
0.511,6,5,248,3,0,255,0,144,2,0,509,0,104
11.869,6,1834,1626179,1145,1366,10,1380,1592717,689,421,17,1923,33462
1782.074,6,365,25501,212,100,8445,469,14896,153,69,11724,69,10605
15.79,6,11,6339,4,100,5263,100,264,7,1157,2247,1179,6075
17.69,6,2952,2722137,1866,1379,9,1408,2661001,1086,931,16,2816,61136
1788.023,17,141,11276,71,48,25542,48,5396,70,56,25912,56,5880
1791.599,6,356,22520,208,69,8655,69,12460,148,69,12187,69,10060
1274.891,6,74,5696,43,42,30350,205,3126,31,33,42490,98,2570
147.175,6,57,10815,23,241,4764,1189,3102,34,288,4459,1420,7713
1656.489,1,8,448,8,28,236641,28,448,0,0,0,0,0
1793.489,6,360,22818,210,69,8581,69,12678,150,69,12036,69,10140
0.055,6,7,423,4,43,6,43,259,3,0,22,0,164
116.273,6,166,127332,103,1299,1139,1448,114557,63,632,1468,1448,12775
0.392,17,13,6251,6,585,78,1350,3680,7,339,57,1350,2571
2.279,17,2,204,1,34,0,34,62,1,114,0,114,142
317.01,6,91,24826,43,442,7547,1360,14611,48,315,6741,1360,10215
1789.178,17,1181,266742,1181,197,1516,389,266742,0,0,0,0,0
1784.364,6,102,8364,68,66,26632,66,4964,34,60,54068,60,3400
1789.65,1,58,4872,0,0,0,0,0,58,56,31397,56,4872
0.249,6,9,527,5,43,62,43,311,4,0,81,0,216
0.091,1,2,112,2,28,91,28,112,0,0,0,0,0
1794.043,17,142,11360,71,48,25629,48,5396,71,56,25629,56,5964
0.193,6,32,15714,18,171,11,313,1642,14,1667,14,3189,14072
0.483,17,4,334,2,39,435,39,134,2,72,157,72,200
1745.94,1,164,17384,164,78,10711,78,17384,0,0,0,0,0
7.598,6,80,23881,41,563,189,1152,18537,39,472,192,1179,5344
150.08,17,4,542,2,36,150069,36,128,2,179,150070,187,414
242.365,6,50,9546,24,523,10537,1418,5983,26,177,9694,618,3563
0.068,6,10,1865,6,649,11,1141,1542,4,159,18,159,323
11.786,6,20,4442,10,275,1309,275,958,10,768,1200,1440,3484
1791.334,6,396,31938,224,90,8032,1093,15186,172,137,10475,2077,16752
0.368,17,4,732,2,36,363,36,128,2,274,363,274,604
170.968,6,25,11358,12,433,71,990,1823,13,1000,14236,1360,9535
1612.611,6,146,15119,81,80,20155,722,7201,65,95,25194,1408,7918
1770.003,6,80,7443,53,65,34038,65,4446,27,59,68073,59,2997
0.04,17,2,280,1,48,0,48,76,1,176,0,176,204
3.95,6,13,2311,8,188,564,245,700,5,1407,924,1407,1611
0.218,17,2,2382,2,1163,218,1163,2382,0,0,0,0,0
280.395,6,30,7432,13,158,23366,267,1317,17,543,17521,1400,6115
3.655,6,31,9039,19,291,203,605,1637,12,988,247,1452,7402
8.859,6,1753,1692789,1122,1430,7,1448,1655313,631,776,13,1448,37476
25.997,6,12,700,4,0,8665,0,220,8,0,1490,0,480
1799.927,17,763,46039,763,32,2362,37,46039,0,0,0,0,0
280.787,6,35,11162,16,158,18719,267,1437,19,746,15597,2045,9725
391.172,6,74,4754,40,69,8617,69,2428,34,69,11853,69,2326
5.042,17,4,288,2,36,5011,36,128,2,52,5005,52,160
11.386,6,28,7148,13,155,948,267,1306,15,475,812,1420,5842
1.163,6,23,7952,13,164,82,267,1340,10,1216,109,3819,6612
0.157,17,2,390,1,46,0,46,74,1,288,0,288,316
1791.807,6,191,18600,125,89,14450,965,10574,66,81,27558,485,8026
0.017,17,2,810,2,377,17,377,810,0,0,0,0,0
274.507,6,10,824,7,92,45751,92,648,3,0,1095,0,176
263.49,1,4,224,4,28,87830,28,224,0,0,0,0,0
11.773,6,1873,1626868,1134,1380,10,1420,1593075,739,467,15,1883,33793
1323.582,2,12,384,12,8,120325,8,384,0,0,0,0,0
61.829,6,72,49671,45,1187,1405,1408,41533,27,960,2369,3847,8138
142.79,1,8,448,8,28,20398,28,448,0,0,0,0,0
55.732,6,34,9866,13,155,4644,267,1306,21,453,2786,3417,8560
1794.754,17,66,2766,65,14,28043,14,2730,1,8,0,8,36
1799.404,1,345,28980,345,56,5230,56,28980,0,0,0,0,0
0.501,17,3,451,2,39,232,39,134,1,289,0,289,317
98.344,6,65,43186,41,1180,2458,1448,35186,24,843,2700,2896,8000
0.135,6,12,3462,6,75,27,75,395,6,1373,26,1448,3067
68.787,6,28,7217,13,155,5732,267,1306,15,482,4912,1420,5911
280.561,6,30,7432,13,158,23380,267,1317,17,543,17528,1400,6115
0.183,17,2,176,1,48,0,48,76,1,72,0,72,100
1392.469,1,170,9520,170,28,8239,28,9520,0,0,0,0,0
1704.451,17,12,498,11,14,170445,14,462,1,8,0,8,36
16.133,6,20,4397,8,241,2304,722,1376,12,394,1447,2026,3021
1.319,6,52,20446,29,964,47,1460,14705,23,400,52,1460,5741
26.291,17,4,352,2,60,26290,60,176,2,60,26290,60,176
123.81,6,32,7786,11,155,31,267,1226,21,357,6190,2006,6560
66.4,6,532,240651,271,816,245,1152,224706,261,423,254,1179,15945
1794.312,17,144,11520,72,48,25271,48,5472,72,56,25271,56,6048
1684.472,2,16,512,16,8,112298,8,512,0,0,0,0,0
1786.466,17,87,3648,86,14,21017,14,3612,1,8,0,8,36
1785.064,6,111,9306,72,58,25141,205,5785,39,38,46969,98,3521
0.085,17,2,586,1,46,0,46,74,1,484,0,484,512
280.233,6,29,7392,14,158,21556,267,1357,15,678,20010,3436,6035
280.313,6,30,7432,13,158,23359,267,1317,17,543,17514,1400,6115
188.47,6,5,328,4,112,62823,112,280,1,0,0,0,48
1790.714,1,58,4872,58,56,31416,56,4872,0,0,0,0,0
1783.812,6,371,25810,215,99,8335,469,15154,156,69,11508,69,10656
0.07,17,2,176,1,60,0,60,88,1,60,0,60,88
1682.677,17,14,1036,7,30,280438,30,406,7,62,280440,62,630
1.451,6,38,8252,19,320,80,1162,2716,19,433,70,1440,5536
2.217,17,28,17839,15,773,158,1350,12025,13,419,120,1350,5814
0.18,6,12,3462,6,75,36,75,395,6,1373,35,1448,3067
1786.264,17,87,3648,86,14,21014,14,3612,1,8,0,8,36
116.548,6,49,10632,25,723,404,1360,4732,24,328,5059,2667,5900
1740.674,1,70,5880,70,56,25227,56,5880,0,0,0,0,0
16.408,17,24,6108,10,256,1819,1350,2848,14,204,1259,1350,3260
300.285,6,57,30245,26,190,12011,444,2181,31,1057,8125,1551,28064
4.05,17,6,5701,2,723,4050,1350,1503,4,1021,619,1350,4198
0.805,6,19,5907,11,281,80,543,1287,8,859,103,2642,4620
1.212,6,25,8056,12,164,94,267,1288,13,869,85,1448,6768
1763.928,2,12,384,12,8,160357,8,384,0,0,0,0,0
251.975,2,2,64,2,8,251975,8,64,0,0,0,0,0
3.517,6,3,127,2,0,3517,0,80,1,7,0,7,47
1743.582,6,95,7203,63,38,28122,205,4476,32,33,56231,98,2727
41.309,17,12,1764,6,48,8260,48,456,6,190,8260,308,1308
6.476,6,44,8369,22,227,308,314,4062,22,489,296,1179,4307
0.077,6,12,3702,6,170,15,170,490,6,964,15,1448,3212
1785.571,17,87,3648,86,14,21006,14,3612,1,8,0,8,36
0.929,17,4,368,2,64,927,64,184,2,64,928,64,184
1781.803,6,77,4056,39,26,46888,26,2054,38,26,48155,26,2002
10.355,6,19,7623,10,155,1147,185,743,9,1627,1277,2574,6880
0.313,6,33,16923,19,171,17,313,1694,14,1811,23,4346,15229
9.403,6,772,784540,500,1118,18,1360,46831,272,2817,34,13600,737709
3.478,17,5,295,5,31,869,31,295,0,0,0,0,0
1783.805,6,469,27040,261,69,6860,69,14580,208,34,8617,64,12460
1794.055,17,140,11200,70,48,26000,48,5320,70,56,26000,56,5880
3.808,6,2,87,1,0,0,0,40,1,7,0,7,47
13.44,6,6,328,4,0,4480,0,216,2,0,13416,0,112
1031.612,17,256,22392,231,34,4485,288,14492,25,288,40023,288,7900
6.638,6,21,10757,9,275,829,275,639,12,963,491,2840,10118
1770.892,6,99,9306,66,66,27244,66,5610,33,60,55337,60,3696
5.519,6,45,8409,22,227,262,314,4062,23,427,239,1152,4347
1726.449,17,12,498,11,14,172644,14,462,1,8,0,8,36
203.121,6,28,6562,11,220,5494,516,1325,17,325,12689,1452,5237
1741.402,17,29,6815,29,207,62192,207,6815,0,0,0,0,0
231.247,17,4,240,2,32,231246,32,120,2,32,231246,32,120
5.023,17,4,288,2,36,4989,36,128,2,52,4982,52,160
3.924,6,25,7215,13,197,326,501,1315,12,902,355,1420,5900
4.055,17,4,488,4,94,1351,94,488,0,0,0,0,0
0.035,17,4,284,2,32,20,32,120,2,54,16,60,164
1741.481,17,30,31680,30,1028,60051,1028,31680,0,0,0,0,0
4.839,17,12,1008,6,45,966,45,438,6,67,966,73,570
1440.172,6,185,14011,71,67,20571,291,6684,114,48,12744,78,7327
1.39,17,2,178,1,29,0,29,57,1,93,0,93,121
1.32,6,47,18660,26,920,52,1460,13044,21,433,56,1460,5616
0.233,6,3,120,1,0,0,0,40,2,0,233,0,80
29.481,17,6,8216,6,1341,5896,1348,8216,0,0,0,0,0
1670.699,1,7,392,7,28,278449,28,392,0,0,0,0,0
0.287,6,4,244,4,0,0,0,244,0,0,0,0,0
7.288,17,21,18493,8,700,1041,1350,5829,13,946,515,1350,12664
3.257,6,2,88,2,0,0,0,88,0,0,0,0,0
32.582,6,348,284991,152,86,215,286,9310,196,1404,167,1418,275681
10.723,1,2,112,2,28,10723,28,112,0,0,0,0,0
1769.16,6,121,12141,75,63,23907,721,6266,46,96,39309,1448,5875
39.589,17,4,352,2,60,39588,60,176,2,60,39588,60,176
202.46,6,12,3189,7,56,33743,56,444,5,621,50560,1408,2745
615.961,6,131,23527,67,261,9332,1360,11744,64,219,9774,4649,11783
1787.362,17,83,3480,82,14,22066,14,3444,1,8,0,8,36
31.67,6,8,376,2,0,31670,0,88,6,0,6301,0,288
67.635,6,34,9006,14,327,469,1189,2535,20,514,3553,1917,6471
240.46,6,49,8758,26,449,9618,1418,5868,23,187,10929,580,2890
4.552,6,37,7664,19,350,252,1152,4615,18,465,249,1179,3049
0.158,6,9,1338,5,549,39,549,753,4,421,44,421,585
0.051,6,2,303,1,211,0,211,263,1,0,0,0,40
1784.499,6,102,8296,68,65,26634,65,4930,34,59,54073,59,3366
66.619,6,28,7217,13,155,5551,267,1306,15,482,4757,1997,5911
1781.871,17,360,83613,360,204,4963,422,83613,0,0,0,0,0
0.042,17,4,284,2,32,26,32,120,2,54,22,60,164
1772.056,6,180,15480,120,69,14891,69,8940,60,69,30031,69,6540
1796.215,17,448,39896,403,35,4468,288,25676,45,288,40024,288,14220
1791.764,1,58,4872,58,56,31434,56,4872,0,0,0,0,0
0.086,6,10,861,6,182,17,182,490,4,77,13,134,371
900.834,6,58,4611,32,65,26168,65,2320,26,50,36029,59,2291
22.798,6,19,3865,5,92,5699,92,348,14,278,1737,1448,3517
1786.226,6,102,8364,68,66,26660,66,4964,34,60,54125,60,3400
1788.35,1,258,27348,258,78,6958,78,27348,0,0,0,0,0
3.771,17,5,290,5,30,942,30,290,0,0,0,0,0
0.132,17,4,284,2,32,1,32,120,2,54,0,60,164
1768.846,1,156,8736,156,28,11411,28,8736,0,0,0,0,0
1.362,6,47,19166,27,891,52,1460,13590,20,476,62,2615,5576
0.131,17,8,2750,8,315,18,354,2750,0,0,0,0,0
240.215,6,55,18218,29,809,8578,1408,15283,26,175,9608,580,2935
0.598,17,2,170,1,37,0,37,65,1,77,0,77,105
1014.007,6,74,5788,44,46,23581,205,3198,30,39,34959,170,2590
280.223,6,29,7392,13,158,23351,267,1317,16,543,18680,1400,6075
0.075,17,4,1148,2,32,64,32,120,2,486,64,486,1028
0.26,6,3,128,2,0,260,0,84,1,0,0,0,44
0.011,1,4,416,0,0,0,0,0,4,76,3,76,416
1771.92,6,180,15480,120,69,14890,69,8940,60,69,30031,69,6540
220.907,6,5,200,5,0,0,0,200,0,0,0,0,0
1774.684,6,180,15480,120,69,14913,69,8940,60,69,30077,69,6540
280.437,6,29,7392,13,158,23369,267,1317,16,678,18692,3456,6075
240.193,6,53,17646,28,780,8895,1418,14726,25,201,10007,580,2920
1794.576,17,122,9760,61,48,29909,48,4636,61,56,29909,56,5124
0.026,17,2,656,1,300,0,300,328,1,300,0,300,328
280.449,6,30,7432,13,158,23370,267,1317,17,603,17524,2760,6115
11.595,6,21,6825,12,275,1054,275,1038,9,1353,821,1440,5787
1773.035,6,180,15480,120,69,14899,69,8940,60,69,30049,69,6540
1799.017,6,369,23385,213,69,8485,69,13005,156,69,11606,69,10380
3.478,6,13,2311,8,188,496,245,700,5,1407,806,1407,1611
177.457,17,4,240,2,32,177456,32,120,2,32,177456,32,120
802.878,6,78,12293,42,134,19582,721,5174,36,378,12210,2007,7119
655.606,17,82,14749,82,151,8093,392,14749,0,0,0,0,0
1.639,17,13,8980,8,846,234,1350,6999,5,368,299,1350,1981
2.035,17,2,176,2,60,2035,60,176,0,0,0,0,0
1772.035,6,180,15480,120,69,14891,69,8940,60,69,30033,69,6540
1784.161,1,72,4032,72,28,25129,28,4032,0,0,0,0,0
1799.732,1,58,4872,0,0,0,0,0,58,56,31574,56,4872
7.88,6,662,566393,403,1334,19,1368,548249,259,776,29,1473,18144
0.153,6,46,22814,27,1115,5,1420,17833,19,467,8,1883,4981
3.572,6,24,6533,12,268,321,517,1437,12,744,320,1418,5096
276.74,17,2,136,2,40,276740,47,136,0,0,0,0,0
0.199,6,25,7216,13,155,16,267,1301,12,775,17,2800,5915
0.401,6,10,968,5,256,98,256,460,5,304,98,304,508
1790.807,6,448,124198,213,540,8446,1440,95125,235,194,7652,1698,29073
33.169,6,49,9354,25,172,1382,721,2735,24,564,1397,1420,6619
248.854,17,214,28002,182,40,1374,41,12482,32,457,2707,505,15520
0.867,6,22,14806,13,249,72,431,1433,9,1842,83,3343,13373
158.548,17,4,352,2,60,158547,60,176,2,60,158546,60,176
1789.885,1,58,4872,0,0,0,0,0,58,56,31401,56,4872
4.498,17,7,1275,4,39,1317,39,268,3,307,2243,345,1007
0.644,6,11,1892,6,901,128,901,1221,5,403,160,403,671
1798.455,6,186,11239,93,45,19548,208,6558,93,31,19545,31,4681
24.554,6,37,9568,18,813,522,1460,4006,19,399,1354,1460,5562
3.283,6,33,15497,18,838,193,1360,7456,15,1232,222,2574,8041
280.442,6,29,7392,13,158,23370,267,1317,16,678,18693,3456,6075
0.513,6,25,10117,13,568,42,1398,2390,12,886,46,1408,7727
97.337,6,30,7432,13,158,8111,267,1317,17,543,6080,1400,6115
165.713,17,4,352,2,60,165711,60,176,2,60,165712,60,176
74.696,1,10,840,10,56,8299,56,840,0,0,0,0,0
1497.892,17,12,4062,12,310,136172,1435,4062,0,0,0,0,0
1772.573,6,180,15480,120,69,14895,69,8940,60,69,30035,69,6540
1.369,6,56,23822,31,1019,45,1380,16645,25,511,55,1923,7177
1700.596,17,12,498,11,14,170059,14,462,1,8,0,8,36
5.602,6,2000,1871294,1276,1388,4,1408,1828982,724,931,7,2816,42312
41.879,17,3,228,3,48,20939,48,228,0,0,0,0,0
0.088,17,2,384,1,32,0,32,60,1,296,0,296,324
1679.922,1,15,840,15,28,119994,28,840,0,0,0,0,0
0.151,6,10,1326,5,299,25,299,567,5,245,27,458,759
7.979,6,19,8351,9,275,997,275,643,10,1216,859,1440,7708
11.447,6,24,6901,13,275,953,275,1078,11,1073,641,1440,5823
1668.709,1,9,504,9,28,208588,28,504,0,0,0,0,0
1742.004,17,145,23677,145,135,12097,392,23677,0,0,0,0,0
1747.67,6,185,13562,96,78,18394,208,9103,89,31,19858,31,4459
0.352,17,2,255,1,43,0,43,71,1,156,0,156,184
1770.576,6,99,9240,66,65,27239,65,5577,33,59,55327,59,3663
1796.424,17,448,39896,403,35,4468,288,25676,45,288,40014,288,14220
1795.755,6,356,22520,208,69,8675,69,12460,148,69,12215,69,10060
0.005,17,2,413,1,42,0,42,70,1,315,0,315,343
300.618,6,37,8571,20,315,15822,917,2107,17,481,528,3488,6464
0.774,6,154,101802,81,1304,9,1420,94591,73,427,10,1420,7211
0.189,17,2,2382,2,1163,189,1163,2382,0,0,0,0,0
10.986,6,20,4402,11,275,1098,275,998,9,758,775,1420,3404
1741.33,17,30,7050,30,207,60045,207,7050,0,0,0,0,0
21.26,6,28,6440,15,117,1518,159,1389,13,727,1770,1418,5051
369.671,6,18,1242,14,180,28436,180,916,4,110,20070,110,326
1.085,1,10,840,10,56,120,56,840,0,0,0,0,0
12.336,17,13,1616,10,37,1334,37,650,3,294,6165,331,966
0.352,6,13,2173,6,503,70,503,855,7,473,58,473,1318
5.023,17,4,288,2,36,5003,36,128,2,52,5008,52,160
1.978,17,2,154,1,33,0,33,61,1,65,0,65,93
801.654,17,94,7544,94,52,8619,355,7544,0,0,0,0,0
33.48,6,31,5295,15,154,2391,722,1859,16,371,2219,1402,3436
12.287,6,31,8038,13,268,1023,721,1865,18,495,711,1420,6173
10.788,6,18,5610,10,275,1198,275,958,8,1440,818,1440,4652
2.387,6,14,1093,8,182,341,182,602,6,77,449,134,491
16.191,17,2,152,2,48,16191,48,152,0,0,0,0,0
7.715,17,12,1764,6,48,1541,48,456,6,190,1541,308,1308
1799.955,1,16,896,16,28,119997,28,896,0,0,0,0,0
1.313,6,47,18164,26,882,52,1360,12548,21,476,56,2715,5616
3.442,6,2,88,2,0,0,0,88,0,0,0,0,0
0.158,6,14,5718,8,290,22,517,993,6,1468,23,2836,4725
305.72,6,171,59630,84,734,2021,1360,44579,87,288,3553,1360,15051
0.05,1,2,112,2,28,50,28,112,0,0,0,0,0
15.154,6,5,752,3,46,7577,46,166,2,506,15018,506,586
0.106,1,10,840,10,56,11,56,840,0,0,0,0,0
199.801,6,30,7432,14,158,15369,267,1357,16,603,13317,2800,6075
0.059,6,10,1495,5,507,14,507,727,5,556,14,556,768
17.738,1,4,224,4,28,5912,28,224,0,0,0,0,0
57.988,6,36,13312,15,158,4142,267,1397,21,790,2898,1400,11915
177.57,6,138,88108,73,840,146,1360,31554,65,1254,2772,2720,56554
5.021,17,4,824,2,48,5009,48,152,2,308,5008,308,672
0.383,6,10,968,5,256,92,256,460,5,304,92,304,508
280.467,6,30,7432,13,158,23372,267,1317,17,543,17526,1400,6115
968.615,6,223,21617,116,109,8422,1189,9030,107,169,9137,1420,12587
1750.541,17,12,498,11,14,175054,14,462,1,8,0,8,36
280.248,6,30,7432,13,158,23354,267,1317,17,543,17513,1400,6115
280.326,6,30,7432,13,158,23360,267,1317,17,543,17515,1400,6115
280.228,6,28,7352,13,158,23352,267,1317,15,678,20014,3436,6035
245.492,6,497,396750,221,701,1115,1418,21153,276,1389,892,1418,375597
0.137,17,4,284,2,32,68,32,120,2,54,70,60,164
0.03,6,10,1865,6,649,5,1141,1542,4,159,9,159,323
1773.859,6,218,16668,83,67,21630,294,7994,135,48,13234,78,8674
1797.699,17,142,11360,71,48,25681,48,5396,71,56,25681,56,5964
0.182,1,2,112,2,28,182,28,112,0,0,0,0,0
1789.477,1,342,28728,342,56,5247,56,28728,0,0,0,0,0
1673.888,1,8,448,8,28,239126,28,448,0,0,0,0,0
1793.827,6,356,22520,208,69,8665,69,12460,148,69,12202,69,10060
0.25,17,8,2758,8,316,35,355,2758,0,0,0,0,0
0.537,6,12,1653,6,288,105,288,548,6,426,59,434,1105
0.094,17,4,284,2,32,45,32,120,2,54,50,60,164
32.955,17,19,4814,19,225,1830,464,4814,0,0,0,0,0
604.278,6,4952,4549140,2747,387,220,420,159150,2205,1944,209,18304,4389990
240.303,6,58,19201,29,811,8581,1418,16122,29,195,8581,580,3079
1616.18,1,56,4704,56,56,29385,56,4704,0,0,0,0,0
3.828,6,14,3168,8,49,546,92,523,6,1164,726,1448,2645
902.394,2,6,192,6,8,180478,8,192,0,0,0,0,0
0.111,6,10,1369,5,134,27,134,402,5,351,27,380,967
1680.713,17,13,534,11,14,168052,14,462,2,8,1680520,8,72
1787.27,6,106,8456,68,65,26675,65,4930,38,59,48301,59,3526
1763.937,2,15,480,15,8,125995,8,480,0,0,0,0,0
0.918,6,10,1687,7,100,153,100,384,3,1179,325,1179,1303
267.797,17,1048,195060,1006,163,266,172,192732,42,27,3798,172,2328
0.373,6,10,1671,6,552,74,948,1348,4,159,123,159,323
1771.605,6,102,9779,68,70,26441,234,5948,34,60,53682,83,3831
1781.758,6,356,22520,208,69,8607,69,12460,148,69,12120,69,10060
1782.648,6,354,22440,207,69,8653,69,12420,147,69,12209,69,10020
354.79,6,47,10451,29,287,12671,1360,4929,18,435,509,2667,5522
1751.974,17,214,54305,214,225,8225,422,54305,0,0,0,0,0
1788.944,17,140,11200,70,48,25926,48,5320,70,56,25926,56,5880
1798.097,17,450,39960,405,35,4450,288,25740,45,288,40018,288,14220
220.888,17,9,3024,9,308,27611,308,3024,0,0,0,0,0
1740.787,17,30,7050,30,207,60027,207,7050,0,0,0,0,0
1795.563,1,122,6832,122,28,14839,28,6832,0,0,0,0,0
1790.117,1,58,4872,0,0,0,0,0,58,56,31405,56,4872
1681.955,17,14,1036,7,30,280320,30,406,7,62,280320,62,630
1681.577,17,14,1036,7,30,280260,30,406,7,62,280260,62,630
1785.611,17,84,3522,83,14,21775,14,3486,1,8,0,8,36
140.401,17,5,4552,5,882,35100,1437,4552,0,0,0,0,0
0.222,6,2,92,1,0,0,0,52,1,0,0,0,40
1784.387,17,142,11360,71,48,25491,48,5396,71,56,25491,56,5964
1789.727,6,359,22709,209,69,8604,69,12569,150,69,12011,69,10140
94.761,17,4,352,2,60,94760,60,176,2,60,94760,60,176
1754.898,6,205,27541,109,304,16249,304,18824,96,83,18472,83,8717
173.885,17,4,240,2,32,173884,32,120,2,32,173884,32,120
1783.651,1,9,954,9,78,222956,78,954,0,0,0,0,0
1777.036,17,80,3348,78,14,23076,14,3276,2,8,1776854,8,72
110.357,17,4,240,2,32,110356,32,120,2,32,110356,32,120
65.231,17,4,304,2,48,65230,64,152,2,48,65230,64,152
0.032,17,2,396,1,39,0,39,67,1,301,0,301,329
280.427,6,30,7432,13,158,23368,267,1317,17,603,17522,2076,6115
11.477,6,1794,1586241,1123,1359,10,1420,1554954,671,534,17,3303,31287
6.606,6,8,436,5,100,1651,100,304,3,0,1517,0,132
240.296,6,43,9123,21,523,12014,1418,5815,22,239,11442,618,3308
1794.057,6,457,42815,254,190,7091,1189,26196,203,81,8881,325,16619
1787.217,6,106,8456,68,65,26674,65,4930,38,59,48299,59,3526
0.032,6,10,1609,5,106,7,106,374,5,967,8,967,1235
0.089,6,11,1535,6,507,17,507,767,5,556,22,556,768
0.908,6,5,248,3,0,454,0,144,2,0,441,0,104
5.33,6,44,8385,22,227,253,314,4062,22,491,241,1179,4323
63.306,6,15,16425,3,171,84,171,335,12,1545,5740,2801,16090
1800.0,6,226,17190,88,67,20345,293,8258,138,48,13138,78,8932
0.307,17,4,560,2,64,305,64,184,2,160,189,160,376
0.603,6,22,7312,13,325,50,626,1984,9,1210,70,1946,5328
520.718,6,54,8927,25,119,16187,500,2316,29,209,18593,1420,6611
54.473,6,27,7177,13,155,4539,267,1306,14,530,4189,3417,5871
19.819,17,43,14308,21,462,989,1350,10296,22,154,942,1350,4012
1776.28,1,136,7616,136,28,13157,28,7616,0,0,0,0,0
24.886,6,30,8872,14,158,1914,267,1357,16,763,1654,2036,7515
1796.982,17,449,39928,404,35,4459,288,25708,45,288,40022,288,14220
0.072,17,2,180,1,30,0,30,58,1,94,0,94,122
0.092,6,38,38020,8,283,13,517,1273,30,1353,2,1438,36747
280.224,6,30,7432,13,158,23352,267,1317,17,603,17512,2800,6115
0.477,6,3,144,2,0,3,0,92,1,0,0,0,52
1.57,6,10,1687,7,100,261,100,384,3,1179,652,1179,1303
240.384,6,43,9053,21,517,12018,1418,5758,22,238,11446,619,3295
12.657,17,12,1764,6,48,2528,48,456,6,190,2528,308,1308
0.037,6,3,151,2,31,0,31,111,1,0,0,0,40
1739.98,6,87,6322,58,31,30525,31,3915,29,31,62139,31,2407
0.298,17,4,284,2,32,175,32,120,2,54,124,60,164
300.601,6,38,8471,20,291,15821,786,1997,18,478,497,2720,6474
0.01,17,2,471,1,39,0,39,67,1,376,0,376,404
31.973,6,15,6105,4,186,10653,267,541,11,639,3196,1452,5564
4.685,6,38,7245,19,218,260,314,3383,19,516,244,1179,3862
3.279,6,4,176,1,0,0,0,44,3,0,1516,0,132
1786.977,6,104,8376,68,65,26671,65,4930,36,59,51053,59,3446
163.887,6,29,7392,13,158,13657,267,1317,16,603,10924,1400,6075
615.856,6,117,22537,58,285,10804,1360,11046,59,233,10615,2720,11491
280.021,6,29,7392,13,158,23335,267,1317,16,603,18664,2800,6075
5.688,6,41,7349,21,218,284,314,3463,20,513,284,1179,3886
33.695,6,29,5003,15,154,2406,721,1871,14,480,2577,2026,3132
15.581,17,14,5233,7,423,2588,1350,3162,7,267,2585,1350,2071
1797.491,6,257,17674,102,46,17796,46,7518,155,46,11671,46,10156
1795.622,17,449,39928,404,35,4455,288,25708,45,288,40021,288,14220
280.608,6,28,7352,13,158,23384,267,1317,15,678,20039,2760,6035
5.853,17,4,288,2,36,5006,36,128,2,52,0,52,160
0.048,6,7,759,3,69,13,69,189,4,205,11,341,570
1647.301,1,8,448,8,28,235328,28,448,0,0,0,0,0
47.554,6,27,7129,12,165,4323,267,1149,15,488,3395,3417,5980
0.122,17,2,136,1,32,0,32,60,1,48,0,48,76
0.038,17,4,352,2,37,1,37,130,2,83,0,89,222
68.285,17,2,152,2,48,68285,48,152,0,0,0,0,0
1787.905,6,357,22629,208,69,8637,69,12460,149,69,12080,69,10169
0.998,6,14,3608,7,101,166,101,481,7,1373,166,1448,3127
1780.298,1,56,4704,56,56,32369,56,4704,0,0,0,0,0
0.1,17,4,368,2,32,100,32,120,2,96,24,96,248
48.313,6,48,13128,23,1026,701,1460,7171,25,290,2005,1460,5957
353.144,6,40,10773,24,140,15306,267,2227,16,790,990,1400,8546
0.266,17,2,178,1,29,0,29,57,1,93,0,93,121
0.507,17,2,476,1,39,0,39,67,1,381,0,381,409
1.366,6,24,8004,13,164,96,267,1340,11,1014,116,2491,6664
3.45,6,2,88,2,0,0,0,88,0,0,0,0,0
1772.359,6,180,15480,120,69,14893,69,8940,60,69,30036,69,6540
0.243,6,49,25262,29,1121,8,1414,20241,20,467,12,1889,5021
0.194,6,33,8105,17,297,12,517,1889,16,556,12,1883,6216
286.873,6,32,7864,15,163,20490,267,1749,17,775,17924,4836,6115
1743.356,6,95,7203,63,38,28118,205,4476,32,33,56224,98,2727
484.04,6,122,15844,60,139,8203,1189,5479,62,238,7934,1460,10365
1787.535,6,104,8376,68,65,26679,65,4930,36,59,51068,59,3446
368.342,6,18,1288,14,226,28334,226,962,4,110,20060,110,326
4.401,17,2,656,2,300,4401,300,656,0,0,0,0,0
0.035,17,2,146,1,37,0,37,65,1,53,0,53,81
0.165,6,45,20132,25,1006,6,1420,15111,20,467,8,1883,5021
0.105,17,2,154,1,33,0,33,61,1,65,0,65,93
43.561,17,9,6990,9,748,5445,1451,6990,0,0,0,0,0
280.25,6,30,7432,14,158,21557,267,1357,16,603,18677,2800,6075
1786.989,6,356,22520,208,69,8632,69,12460,148,69,12156,69,10060
1794.512,17,144,11520,72,48,25274,48,5472,72,56,25274,56,6048
0.085,2,3,96,3,8,42,8,96,0,0,0,0,0
18.282,6,23,4618,11,204,1828,722,1592,12,399,1638,1408,3026
1783.949,6,356,22520,208,69,8618,69,12460,148,69,12135,69,10060
77.026,2,3,96,3,8,38513,8,96,0,0,0,0,0
44.686,6,30,7432,13,158,3723,267,1317,17,543,2790,1400,6115
10.796,6,18,5610,10,275,1199,275,958,8,1440,826,1440,4652
39.358,17,7,2531,7,333,6559,361,2531,0,0,0,0,0
34.715,17,40,5880,20,48,1826,48,1520,20,190,1826,308,4360
36.398,1,2,120,2,32,36398,32,120,0,0,0,0,0
1772.063,6,180,15480,120,69,14891,69,8940,60,69,30034,69,6540
0.182,17,4,284,2,32,106,32,120,2,54,104,60,164
0.472,6,24,6040,13,108,39,147,959,11,772,46,1608,5081
104.737,6,24,10657,13,741,60,1360,3517,11,1337,10458,4428,7140
3.162,6,51,36435,32,941,102,1360,11710,19,2177,167,7571,24725
0.074,6,10,582,5,42,18,42,310,5,0,17,0,272
1785.862,6,102,8364,68,66,26654,66,4964,34,60,54114,60,3400
280.249,6,26,7272,12,158,25477,267,1277,14,775,21550,3445,5995
125.82,2,2,64,2,8,125820,8,64,0,0,0,0,0
3.361,6,13,2311,8,188,480,245,700,5,1407,778,1407,1611
1769.483,6,103,9514,66,66,27222,66,5610,37,60,49149,60,3904
1779.52,6,188,11527,94,47,19132,208,6806,94,31,19132,31,4721
28.98,6,12,5628,4,106,9660,106,274,8,837,4126,1460,5354
394.963,6,122,17833,55,194,7314,1189,6490,67,240,5983,1460,11343
0.056,6,12,3702,6,170,8,170,490,6,964,11,1448,3212
191.85,17,2,136,2,40,191850,47,136,0,0,0,0,0
0.016,6,3,168,1,0,0,0,52,2,0,16,0,116
1650.924,1,14,784,14,28,126994,28,784,0,0,0,0,0
168.388,6,27,13510,13,279,67,527,1401,14,1153,12942,1893,12109
4.411,6,37,7189,19,218,245,314,3383,18,513,245,1179,3806
3.107,17,3,228,2,48,2998,48,152,1,48,0,48,76
1698.034,6,160,13921,104,70,16485,138,7886,56,69,28065,69,6035
1790.457,6,356,22520,208,69,8649,69,12460,148,69,12179,69,10060
1798.127,17,448,39612,404,35,4461,288,25708,44,288,40949,288,13904
63.273,6,14,5625,4,106,21087,106,274,10,823,7029,1460,5351
5.948,6,4,176,4,0,0,0,176,0,0,0,0,0
1781.76,6,364,23047,211,69,8484,69,12787,153,69,11722,69,10260
0.872,6,160,113396,91,1316,9,1432,106336,69,428,12,1871,7060
2.166,17,2,170,1,37,0,37,65,1,77,0,77,105
1779.734,6,119,13847,77,83,23417,516,6078,42,152,43405,1452,7769
2.281,17,4,240,2,32,2280,32,120,2,32,2280,32,120
1720.515,17,12,498,11,14,172051,14,462,1,8,0,8,36
0.377,6,12,1653,6,288,69,288,548,6,426,43,434,1105
86.258,6,21,1228,9,0,10782,0,516,12,0,7841,0,712
37.304,17,10,760,10,48,4144,48,760,0,0,0,0,0
1776.21,6,33,7218,21,241,88810,241,3033,12,308,161457,959,4185
8.278,1,9,756,9,56,1034,56,756,0,0,0,0,0
60.815,6,43,10788,21,812,696,1360,4982,22,327,2887,2720,5806
20.135,6,21,5417,12,107,1830,159,1074,9,966,2515,1668,4343
1740.401,17,30,20190,30,645,60013,645,20190,0,0,0,0,0
1.297,6,37,8212,19,320,72,1162,2716,18,433,66,1360,5496
0.862,6,10,1687,7,100,143,100,384,3,1179,306,1179,1303
63.194,6,7,420,7,0,0,0,420,0,0,0,0,0
7.132,6,191,199598,128,133,56,201,5687,63,3243,112,12726,193911
1.063,6,6,504,4,256,354,256,420,2,0,95,0,84
1788.6,6,357,22629,208,69,8640,69,12460,149,69,12085,69,10169
10.0,17,3,433,2,37,9988,37,130,1,275,0,275,303
367.105,6,18,1239,14,177,28238,177,913,4,110,20056,110,326
2.072,6,78,57532,49,1251,43,1368,50119,29,982,67,2491,7413
1780.083,17,287,59078,287,177,6224,422,59078,0,0,0,0,0
37.505,17,11,836,11,48,3750,48,836,0,0,0,0,0
0.031,17,2,437,1,46,0,46,74,1,335,0,335,363
0.009,17,2,252,1,32,0,32,60,1,164,0,164,192
280.454,6,29,7392,13,158,23371,267,1317,16,678,18693,2085,6075
1773.867,6,180,15480,120,69,14906,69,8940,60,69,30063,69,6540
18.374,17,28,16489,16,858,1222,1350,14178,12,164,1667,1350,2311
63.125,6,7,420,7,0,0,0,420,0,0,0,0,0
1740.433,17,28,29568,28,1028,64460,1028,29568,0,0,0,0,0
0.087,6,9,1147,5,145,21,145,349,4,634,25,634,798
8.842,6,1015,920707,651,1370,13,1380,900653,364,383,24,1380,20054
0.208,17,2,2380,2,1162,208,1162,2380,0,0,0,0,0
10.016,17,4,352,2,60,10015,60,176,2,60,10014,60,176
0.152,6,16,6197,8,128,21,128,552,8,1044,21,1448,5645
52.515,17,8,704,4,48,17502,48,304,4,72,17502,72,400
1793.991,17,67,2811,66,13,27599,14,2767,1,16,0,16,44
1784.634,17,83,3480,82,14,22032,14,3444,1,8,0,8,36
12.914,6,93,28911,46,575,286,1152,22549,47,447,274,1179,6362
1750.681,17,12,498,11,14,175068,14,462,1,8,0,8,36
11.844,6,84,24964,41,560,296,1152,19008,43,384,276,1152,5956
1786.275,6,105,8610,70,66,25888,66,5110,35,60,52534,60,3500
1783.76,17,142,11360,71,48,25481,48,5396,71,56,25481,56,5964
1798.064,6,357,22629,208,69,8686,69,12460,149,69,12149,69,10169
1.266,6,38,9848,20,502,66,1460,4352,18,433,64,1460,5496
290.557,17,6,528,3,60,145278,60,264,3,60,145277,60,264
1733.458,17,14,3232,14,202,133342,682,3232,0,0,0,0,0
308.408,6,24,4943,8,220,8250,516,1205,16,257,20554,1452,3738
0.677,6,8,440,4,0,225,0,216,4,0,223,0,224
1796.963,17,448,39384,403,35,4470,288,25412,45,282,40019,288,13972
1.87,6,54,20112,27,938,71,1440,14256,27,433,63,1440,5856
1794.277,6,134,8986,76,59,23923,208,5643,58,31,31474,31,3343
1787.227,6,2398,2226199,905,128,1977,342,56123,1493,1472,1197,4254,2170076
280.056,6,29,7392,13,158,23338,267,1317,16,603,18666,2800,6075
0.032,17,2,206,1,44,0,44,72,1,106,0,106,134
1779.935,17,142,11360,71,48,25427,48,5396,71,56,25427,56,5964
31.001,6,43,8893,21,401,499,889,2136,22,391,1470,2720,6757
77.989,17,6,2016,6,308,15597,308,2016,0,0,0,0,0
1745.624,6,90,6540,60,31,29586,31,4050,30,31,60182,31,2490
1790.544,1,267,14952,267,28,6731,28,14952,0,0,0,0,0
374.766,6,18,1696,14,509,28828,509,1089,4,435,78820,435,607
300.401,6,32,11665,17,811,18775,1448,5798,15,564,2351,1448,5867
0.594,17,15,8444,8,706,84,1350,5872,7,339,89,1350,2572
1770.38,6,99,9306,66,66,27236,66,5610,33,60,55321,60,3696
0.501,17,3,451,2,39,345,39,134,1,289,0,289,317
1799.158,6,360,22818,209,69,8649,69,12569,151,69,11994,69,10249
1798.999,17,447,39864,402,35,4486,288,25644,45,288,40024,288,14220
32.15,6,334,345239,97,103,334,301,5458,237,1411,136,1418,339781
1350.953,6,137,11759,91,69,15010,69,6814,46,69,30020,69,4945
0.117,6,8,552,4,120,39,120,336,4,0,39,0,216
0.54,17,4,288,2,36,488,36,128,2,52,496,52,160
47.502,6,6259,5888842,4085,1363,11,1408,5771130,2174,931,21,2801,117712
300.84,6,42,13509,23,874,13674,1360,7947,19,399,479,1360,5562
55.396,6,7105,6813101,4742,1359,11,1408,6685561,2363,776,23,1408,127540
1750.326,6,95,7203,63,38,28231,205,4476,32,33,56454,98,2727
286.077,17,4,352,2,60,286076,60,176,2,60,286075,60,176
1745.482,6,95,7203,63,38,28152,205,4476,32,33,56294,98,2727
463.746,1,8,448,8,28,66249,28,448,0,0,0,0,0
0.04,6,12,3462,6,75,7,75,395,6,1373,7,1448,3067
0.255,17,2,144,1,36,0,36,64,1,52,0,52,80
257.914,6,41,9502,16,208,9058,517,2089,25,381,10743,2411,7413
1789.434,17,142,11360,71,48,25563,48,5396,71,56,25563,56,5964
0.219,6,12,3462,6,75,43,75,395,6,1373,43,1448,3067
1792.274,17,486,99216,486,176,3695,353,99216,0,0,0,0,0
1787.905,6,355,22480,207,69,8679,69,12420,148,69,12162,69,10060
21.355,17,6,456,6,48,4271,48,456,0,0,0,0,0
280.399,6,31,7472,13,158,23366,267,1317,18,603,16491,2076,6155
0.013,17,2,600,1,36,0,36,64,1,508,0,508,536
1788.538,17,87,3648,86,14,21041,14,3612,1,8,0,8,36
151.679,6,24,8002,12,365,56,794,1621,12,736,13777,1360,6381
0.141,17,2,152,2,48,141,48,152,0,0,0,0,0
0.373,6,21,7203,13,318,31,600,1958,8,964,51,1471,5245
4.735,6,12,2271,7,188,789,245,660,5,1407,1117,1407,1611
280.443,6,29,7392,13,158,23370,267,1317,16,678,18692,2760,6075
1443.87,6,119,12322,68,74,21550,722,5987,51,96,28868,1448,6335
3.274,17,3,1173,3,363,1637,363,1173,0,0,0,0,0
0.52,17,2,384,1,39,0,39,67,1,289,0,289,317
1772.496,6,180,15480,120,69,14894,69,8940,60,69,30040,69,6540
9.814,6,79,24381,39,550,258,1152,18640,40,459,243,1179,5741
0.891,17,4,560,2,64,867,64,184,2,160,865,160,376
240.437,6,54,18029,28,797,8904,1418,15018,26,206,9617,580,3011
198.62,6,221,174294,135,1309,1482,1408,158926,86,680,2333,3847,15368
480.968,17,5,980,5,168,120242,168,980,0,0,0,0,0
0.438,6,3,189,1,0,0,0,40,2,69,359,69,149
31.15,17,36,17544,18,500,1830,1350,9509,18,418,1829,1350,8035
0.016,17,4,288,2,33,1,33,122,2,55,2,61,166
1654.629,1,8,448,8,28,236375,28,448,0,0,0,0,0
0.833,17,6,2075,6,317,166,355,2075,0,0,0,0,0
1795.979,17,449,39928,404,35,4456,288,25708,45,288,40017,288,14220
0.415,6,26,9026,13,263,34,691,1736,13,943,33,1448,7290
78.488,6,46,13342,24,926,522,1360,7536,22,351,3729,4027,5806
0.458,6,14,1085,8,182,65,182,602,6,77,85,134,483
1798.299,6,362,22967,210,69,8604,69,12609,152,69,11909,69,10358
0.667,6,115,87461,53,131,12,232,2649,62,1444,10,2760,84812
1796.703,17,135,10796,68,48,26816,48,5168,67,56,27222,56,5628
0.145,6,12,2073,7,326,24,589,1013,5,396,33,580,1060
1798.745,17,449,39928,404,35,4463,288,25708,45,288,40013,288,14220
1740.908,6,87,6322,58,31,30542,31,3915,29,31,62174,31,2407
12.253,6,87,24685,45,550,278,1152,18864,42,413,292,1152,5821
1786.492,6,102,8296,68,65,26664,65,4930,34,59,54133,59,3366
1651.319,1,8,448,8,28,235902,28,448,0,0,0,0,0
1767.405,1,54,4536,54,56,33347,56,4536,0,0,0,0,0
1595.359,6,342,23310,152,46,10565,46,9730,190,46,8440,46,13580
281.509,1,3,180,3,32,140754,32,180,0,0,0,0,0
4.418,17,3,2906,3,940,2209,1451,2906,0,0,0,0,0
1.46,6,16,2305,8,328,208,593,1069,8,396,183,580,1236
0.913,6,10,1687,7,100,152,100,384,3,1179,331,1179,1303
0.024,17,2,308,1,34,0,34,62,1,218,0,218,246
280.055,6,30,7432,14,158,21542,267,1357,16,603,18666,2800,6075
299.918,6,99,59243,57,1250,5354,1360,52380,42,371,7309,1360,6863
0.101,17,2,588,1,39,0,39,67,1,493,0,493,521
0.123,17,2,154,1,33,0,33,61,1,65,0,65,93
134.4,17,12,920,6,40,26879,41,412,6,56,26877,57,508
875.038,17,172,13072,172,48,5117,48,13072,0,0,0,0,0
1781.766,6,477,29912,261,100,6852,469,16856,216,34,8287,64,13056
51.153,17,16,18203,16,1109,3410,1451,18203,0,0,0,0,0
2.041,17,4,518,3,39,906,39,201,1,289,0,289,317
1741.991,1,15,840,15,28,124427,28,840,0,0,0,0,0
1794.186,17,144,11520,72,48,25270,48,5472,72,56,25270,56,6048
38.631,17,22,1672,22,48,1839,48,1672,0,0,0,0,0
1743.2,6,95,7203,63,38,28116,205,4476,32,33,56221,98,2727
1729.208,6,157,20185,91,304,19213,304,14156,66,83,26603,83,6029
9.66,17,489,97480,484,172,20,172,96800,5,108,1254,172,680
0.657,6,10,766,5,185,127,185,453,5,45,163,45,313
3.323,17,5,295,5,31,830,31,295,0,0,0,0,0
230.205,6,367,305632,237,1317,975,1408,283805,130,602,1582,3847,21827
0.245,6,25,7216,13,155,20,267,1301,12,678,21,2045,5915
240.206,6,55,18645,30,789,8282,1418,15786,25,193,10008,580,2859
0.09,17,2,572,1,39,0,39,67,1,477,0,477,505
130.351,17,4,1658,4,386,43450,394,1658,0,0,0,0,0
1.119,6,68,55699,43,351,26,351,2595,25,2354,46,7040,53104
70.544,6,30,7435,13,155,5878,267,1306,17,418,4408,1997,6129
0.452,17,2,136,1,32,0,32,60,1,48,0,48,76
46.339,6,30,7297,14,155,3564,267,1346,16,441,3088,1420,5951
20.167,6,23,5510,13,107,1680,159,1114,10,967,2239,1675,4396
1782.402,17,83,3480,82,14,22004,14,3444,1,8,0,8,36
14.673,6,111,36471,57,626,262,1152,29829,54,407,272,1152,6642
0.047,6,11,1517,7,88,7,170,549,4,752,13,752,968
7.503,6,3,189,1,0,0,0,40,2,69,7412,69,149
61.794,1,5,140,5,0,0,0,140,0,0,0,0,0
1792.012,6,458,49108,262,207,6865,1189,27466,196,127,9189,512,21642
1.714,17,21,13249,12,873,152,1350,10812,9,242,209,1350,2437
387.452,6,19,1306,14,180,29804,180,928,5,110,15161,110,378
0.009,17,2,312,1,32,0,32,60,1,224,0,224,252
16.886,17,486,412815,188,85,90,1350,21342,298,1285,51,1350,391473
1794.718,6,359,22709,209,69,8628,69,12569,150,69,12044,69,10140
0.0,6,2,231,0,0,0,0,0,2,151,0,151,231
1.11,17,2,122,2,33,1110,33,122,0,0,0,0,0
1681.281,1,15,840,15,28,120091,28,840,0,0,0,0,0
0.846,6,53,13909,26,551,33,1429,4920,27,464,31,1986,8989
1600.064,6,24,3973,16,262,106670,413,2740,8,114,228554,269,1233
280.288,6,29,7392,13,158,23357,267,1317,16,603,18684,2036,6075
1652.922,6,311,62653,139,344,11977,1360,42169,172,147,9665,1360,20484
0.047,17,2,164,1,46,0,46,74,1,62,0,62,90
0.543,6,22,7354,13,335,45,668,2026,9,1210,63,1946,5328
1780.236,17,316,93352,316,267,5651,422,93352,0,0,0,0,0
1517.005,17,116,9280,58,48,26613,48,4408,58,56,26613,56,4872
240.175,6,53,17770,28,783,8895,1402,14788,25,209,10007,580,2982
69.061,17,4,352,2,60,69060,60,176,2,60,69059,60,176
8.693,6,22,9370,11,275,869,275,723,11,1170,783,1414,8647
1.173,6,9,8536,8,1022,119,1360,8496,1,0,0,0,40
0.785,6,10,1687,7,100,130,100,384,3,1179,264,1179,1303
1.332,6,37,8212,19,320,74,1162,2716,18,476,67,2715,5496
39.71,1,44,4576,0,0,0,0,0,44,76,923,76,4576
280.263,17,4,296,2,30,280251,30,116,2,62,280252,62,180
1794.75,6,356,22520,208,69,8670,69,12460,148,69,12209,69,10060
1.082,1,10,840,10,56,120,56,840,0,0,0,0,0
0.024,17,2,548,2,246,24,246,548,0,0,0,0,0
1786.862,6,244,25090,99,68,18231,681,9328,145,136,12407,2720,15762
280.259,6,28,7352,13,158,23354,267,1317,15,603,20017,2036,6035
1.239,6,17,5164,9,150,154,174,664,8,835,147,1452,4500
97.333,6,868,431074,482,830,202,1152,410486,386,428,252,1179,20588
0.464,6,51,22269,29,932,16,1380,15233,22,557,19,1923,7036
4.688,6,37,7189,19,218,260,314,3383,18,513,255,1179,3806
124.452,6,29,4233,18,304,7320,304,3072,11,83,12442,83,1161
1.014,6,5,1077,3,0,391,0,144,2,853,802,853,933
11.589,6,13,2133,8,324,1655,585,1073,5,396,2837,580,1060
1799.971,17,449,39928,404,35,4466,288,25708,45,288,40019,288,14220
1794.375,6,306,23486,182,98,9913,469,13972,124,69,14587,69,9514
9.551,6,29,7392,13,158,795,267,1317,16,603,634,1400,6075
240.653,2,3,96,3,8,120326,8,96,0,0,0,0,0
29.007,6,18,4638,9,324,3625,722,1762,9,793,3580,1448,2876
0.049,6,2,218,1,138,0,138,178,1,0,0,0,40
18.391,17,34,12863,18,539,1079,1350,10212,16,137,1223,1350,2651
300.542,6,18,1275,9,177,37545,177,701,9,110,37545,110,574
1743.872,1,69,5796,69,56,25645,56,5796,0,0,0,0,0
1790.984,6,124,14549,80,85,22670,516,6438,44,158,41643,1452,8111
282.525,6,28,6978,11,506,28252,1418,3134,17,267,17649,611,3844
125.399,6,14,3143,7,92,20899,92,452,7,464,20866,1448,2691
20.222,6,24,5827,13,107,1685,159,1138,11,684,2020,1418,4689
1741.022,6,87,6322,58,31,30544,31,3915,29,31,62178,31,2407
4.104,6,220,189113,85,283,48,882,6128,135,1364,28,1418,182985
57.918,6,11,1003,6,332,11583,332,652,5,83,14477,83,351
0.944,17,2,116,2,30,944,30,116,0,0,0,0,0
0.348,6,26,6090,14,164,26,453,1570,12,648,27,1542,4520
1788.582,17,87,3648,86,14,21042,14,3612,1,8,0,8,36
1740.868,6,87,6322,58,31,30541,31,3915,29,31,62173,31,2407
184.391,6,9,522,2,106,184377,106,194,7,0,30729,0,328
336.54,17,14,1232,7,48,56087,48,532,7,72,56088,72,700
0.87,6,3,127,1,0,0,0,40,2,7,0,7,87
1788.649,6,356,22520,208,69,8640,69,12460,148,69,12165,69,10060
1782.496,17,73,3060,72,14,25105,14,3024,1,8,0,8,36
0.258,17,2,440,1,39,0,39,67,1,345,0,345,373
13.68,6,2065,1955833,1311,1413,10,1448,1911949,754,776,17,1448,43884
0.555,6,22,7342,13,335,46,668,2026,9,1210,62,1946,5316
368.37,6,18,1242,14,180,28336,180,916,4,110,20062,110,326
12.218,17,3,984,3,300,6109,300,984,0,0,0,0,0
57.289,6,44,9008,21,412,720,889,2180,23,368,2597,4080,6828
0.147,17,2,152,1,48,0,48,76,1,48,0,48,76
18.943,17,26,13232,15,694,1350,1350,10842,11,189,1889,1350,2390
1741.752,6,87,6322,58,31,30557,31,3915,29,31,62203,31,2407
0.419,17,19,7372,9,472,52,1350,4500,10,259,40,1350,2872
0.339,17,2,152,1,48,0,48,76,1,48,0,48,76
1701.121,1,8,448,8,28,243017,28,448,0,0,0,0,0
2.011,6,15,3491,6,288,396,288,560,9,639,230,853,2931
3.591,6,14,3145,8,49,513,92,511,6,579,41,1408,2634
120.389,2,2,64,2,8,120389,8,64,0,0,0,0,0
1779.843,6,354,22440,207,69,8640,69,12420,147,69,12190,69,10020
11.422,17,4,352,2,48,11406,48,152,2,72,11405,72,200
0.125,17,2,656,2,300,125,300,656,0,0,0,0,0
1.693,6,38,8254,19,321,94,1164,2718,19,433,82,1360,5536
1.803,6,27,8851,16,286,120,591,1503,11,863,159,1380,7348
0.332,6,21,7281,12,334,29,663,1969,9,967,40,1471,5312
58.831,6,11,1583,11,127,5883,127,1583,0,0,0,0,0
1789.954,6,428,25789,213,69,8443,69,12729,215,35,8364,64,13060
35.182,6,25,6569,15,117,2513,159,1401,10,773,3907,1675,5168
306.073,6,28,7842,12,125,27824,126,1012,16,1029,1959,1460,6830
0.904,6,10,1687,7,100,150,100,384,3,1179,322,1179,1303
41.12,2,4,128,4,8,13706,8,128,0,0,0,0,0
331.371,6,54,8395,24,116,14405,517,2191,30,384,11425,1418,6204
280.51,6,29,7392,13,158,23375,267,1317,16,603,18695,1400,6075
0.034,17,4,288,2,36,17,36,128,2,52,16,52,160
4.621,17,2,656,2,300,4621,300,656,0,0,0,0,0
178.507,6,25,10616,13,514,116,1236,2118,12,1000,16198,2079,8498
1682.867,17,14,1036,7,30,280468,30,406,7,62,280471,62,630
125.075,6,5441,5017005,3535,1339,35,1368,4908781,1906,931,65,2841,108224
75.365,17,10,4115,10,383,8373,394,4115,0,0,0,0,0
1772.317,6,180,15480,120,69,14893,69,8940,60,69,30030,69,6540
137.092,6,31,15814,17,968,50,1360,8460,14,1130,10531,4445,7354
0.205,17,2,154,1,33,0,33,61,1,65,0,65,93
1729.233,6,60,4400,40,33,44339,33,2740,20,31,91001,31,1660
70.304,17,145,10768,19,36,3905,288,1216,126,47,518,288,9552
124.62,6,11,5498,4,106,41540,106,274,7,987,20717,1917,5224
60.135,17,4,408,2,34,60104,34,124,2,114,60103,114,284
1799.868,1,82,6888,0,0,0,0,0,82,56,22220,56,6888
120.152,6,130,21373,70,304,1741,304,15516,60,83,2036,83,5857
26.484,6,20,3634,11,195,2648,195,874,9,398,3279,419,2760
240.198,6,53,16059,28,685,8896,1402,13118,25,204,10008,580,2941
17.719,1,4,224,4,28,5906,28,224,0,0,0,0,0
0.033,17,2,327,1,35,0,35,63,1,236,0,236,264
1795.345,17,449,39928,404,35,4454,288,25708,45,288,40019,288,14220
0.384,6,12,1653,6,288,71,288,548,6,426,43,434,1105
301.111,6,38,9128,20,308,15847,885,2064,18,487,525,1460,7064
73.507,17,4,240,2,32,73506,32,120,2,32,73506,32,120
6.239,1,4,424,4,78,2079,78,424,0,0,0,0,0
1773.575,1,58,4872,58,56,31115,56,4872,0,0,0,0,0
1770.335,6,101,9344,66,65,27235,65,5577,35,59,52065,59,3767
0.228,17,2,196,1,62,0,62,90,1,78,0,78,106
1799.844,1,345,28980,345,56,5232,56,28980,0,0,0,0,0
317.041,6,57,12684,29,141,11322,615,3596,28,418,11737,6009,9088
11.793,6,19,4402,11,275,1179,275,998,8,768,1538,1440,3404
1788.115,6,356,22520,208,69,8638,69,12460,148,69,12160,69,10060
0.004,17,2,496,1,40,0,40,68,1,400,0,400,428
253.849,1,70,1960,70,0,0,0,1960,0,0,0,0,0
281.922,6,31,7541,14,143,21686,267,1426,17,678,17618,2085,6115
33.206,6,12,6874,4,185,302,245,535,8,1203,4707,1407,6339
4.53,6,38,7229,19,218,251,314,3383,19,513,237,1179,3846
4.97,6,37,7189,19,218,276,314,3383,18,513,276,1179,3806
1798.388,6,356,22520,208,69,8687,69,12460,148,69,12233,69,10060
1776.4,1,61,5124,0,0,0,0,0,61,56,29606,56,5124
300.16,6,39,9853,21,576,14998,1360,4331,18,435,17645,2720,5522
0.329,6,22,7333,12,334,29,663,1969,10,1209,35,1906,5364
7.24,6,234,237148,157,133,46,201,7327,77,3105,92,11312,229821
15.066,6,1926,1708753,1201,1368,12,1380,1673595,725,421,20,1923,35158
0.627,6,23,7451,14,275,48,674,2115,9,1212,71,1946,5336
1796.222,6,382,26595,220,97,8201,469,15630,162,69,11156,69,10965
1797.362,1,231,12936,231,28,7814,28,12936,0,0,0,0,0
81.553,6,26,7272,12,158,7413,267,1277,14,775,6270,3445,5995
1769.543,6,101,9344,66,65,27223,65,5577,35,59,52042,59,3767
85.8,6,32,8952,14,158,6600,267,1357,18,624,5041,1400,7595
1.221,17,6,552,3,32,610,32,180,3,96,610,96,372
6.379,6,43,8329,21,227,318,314,4022,22,489,290,1179,4307
300.746,6,37,8526,19,315,16708,882,2053,18,441,500,1440,6473
1215.772,6,299,50728,114,334,10759,1360,28963,185,103,6592,3289,21765
35.072,6,41,26171,25,1190,1461,1408,20363,16,828,2333,1491,5808
5.156,17,3,208,2,36,5013,36,128,1,52,0,52,80
8.016,6,81,24493,40,551,205,1152,18696,41,461,194,1179,5797
228.357,17,4,240,2,32,228356,32,120,2,32,228356,32,120
6.556,6,46,8449,23,227,298,314,4102,23,427,286,1152,4347
0.907,6,24,9000,14,259,69,680,1631,10,1159,81,2720,7369
4.254,6,704,592769,418,1383,10,1420,577108,286,467,14,1883,15661
0.428,17,8,2758,8,316,61,355,2758,0,0,0,0,0
1680.494,17,28,6580,28,207,62240,207,6580,0,0,0,0,0
0.223,6,13,2100,7,329,37,500,1030,6,375,44,500,1070
0.007,17,2,452,1,62,0,62,90,1,334,0,334,362
2.592,17,21,7057,10,315,284,1350,3437,11,301,256,1350,3620
603.686,6,105,15748,57,304,10780,304,10856,48,83,12843,83,4892
89.026,6,21,8374,11,520,85,1223,2034,10,1185,9872,3151,6340
300.731,6,37,8232,19,241,16707,619,1758,18,441,500,1440,6474
262.784,17,4,304,4,48,87594,48,304,0,0,0,0,0
1.31,6,22,5962,12,108,119,147,919,10,927,130,1608,5043
7.21,6,1719,1643320,1126,1384,6,1408,1607820,593,776,11,1408,35500
11.642,6,1849,1608233,1117,1384,10,1420,1574732,732,467,15,1883,33501
1.385,6,51,21057,28,947,51,1360,15361,23,433,54,1360,5696
1746.0,6,97,7307,63,38,28161,205,4476,34,33,52895,98,2831
11.804,6,95,27477,47,532,256,1152,21059,48,449,245,1179,6418
365.775,6,18,1242,14,180,28136,180,916,4,110,20070,110,326
98.07,6,11,719,11,31,9807,31,719,0,0,0,0,0
64.252,6,33,12304,15,476,68,1360,2585,18,748,3771,1360,9719
0.47,17,7,2397,7,314,78,355,2397,0,0,0,0,0
0.012,17,2,213,1,36,0,36,64,1,121,0,121,149
1783.811,6,364,22936,211,69,8494,69,12580,153,65,11735,69,10356
0.603,6,32,23822,19,840,33,1360,5883,13,2486,35,8141,17939
0.098,17,2,214,1,39,0,39,67,1,119,0,119,147
3.818,17,26,8648,10,248,424,1350,2762,16,339,212,1350,5886
2.162,17,29,16485,13,547,180,1350,7486,16,534,136,1350,8999
1793.065,1,58,4872,0,0,0,0,0,58,56,31457,56,4872
2.863,6,2,88,2,0,0,0,88,0,0,0,0,0
1776.986,17,73,3060,72,14,25027,14,3024,1,8,0,8,36
1766.278,1,259,14504,259,28,6846,28,14504,0,0,0,0,0
0.374,6,3,160,2,0,374,0,100,1,0,0,0,60
39.082,17,46,6644,23,48,1773,48,1748,23,184,1771,308,4896
11.51,6,1774,1590255,1107,1384,10,1420,1559153,667,421,17,1883,31102
1796.832,6,358,22669,209,69,8638,69,12569,149,69,12140,69,10100
0.006,17,2,447,1,44,0,44,72,1,347,0,347,375
1760.064,1,88,7392,0,0,0,0,0,88,56,20230,56,7392
0.044,17,4,284,2,32,30,32,120,2,54,19,60,164
202.613,17,10,580,10,30,22512,30,580,0,0,0,0,0
10.315,6,2137,1989809,1364,1382,7,1408,1944949,773,931,13,2801,44860
0.876,6,10,1687,7,100,146,100,384,3,1179,312,1179,1303
35.56,6,27,7177,12,155,3232,267,1266,15,482,2539,1420,5911
618.035,6,87,21361,39,380,16264,1360,10402,48,265,13146,1929,10959
0.907,6,10,1687,7,100,151,100,384,3,1179,323,1179,1303
11.821,6,98,28786,50,550,241,1152,22368,48,449,245,1179,6418
1797.257,17,448,39896,403,35,4470,288,25676,45,288,40016,288,14220
11.588,6,115,39659,56,650,210,1152,32817,59,407,195,1152,6842
1791.117,17,140,11184,72,48,25226,48,5472,68,56,26732,56,5712
622.822,17,60,5641,54,30,11751,37,3153,6,386,112256,463,2488
40.207,17,3,228,3,48,20103,48,228,0,0,0,0,0
17.065,17,10,880,5,48,4263,48,380,5,72,4263,72,500
149.4,6,59,36775,37,1122,4150,1448,28879,22,749,2925,1448,7896
1786.821,6,102,8228,68,64,26668,64,4896,34,58,54143,58,3332
0.542,17,23,12103,12,738,49,1350,9201,11,235,38,1350,2902
5.338,6,54,22626,28,949,197,1440,16345,26,373,202,1440,6281
2.205,6,14,2351,8,188,315,245,700,6,703,390,1152,1651
7.823,6,7,828,3,69,2068,69,258,4,205,1232,341,570
288.311,17,4,296,2,30,288297,30,116,2,62,288297,62,180
1793.21,17,87,3648,86,14,21096,14,3612,1,8,0,8,36
1782.802,6,272,33627,111,139,16205,1360,16299,161,135,11141,4662,17328
1770.362,6,108,10004,70,65,25657,65,5939,38,59,47845,59,4065
1784.666,17,138,11040,69,48,26244,48,5244,69,56,26244,56,5796
0.039,17,2,142,1,35,0,35,63,1,51,0,51,79
300.756,6,40,8775,17,308,18789,889,1947,23,368,13664,3488,6828
1797.017,1,345,28980,345,56,5223,56,28980,0,0,0,0,0
1781.205,17,79,3312,78,14,23132,14,3276,1,8,0,8,36
324.393,17,6,360,3,32,162196,32,180,3,32,162196,32,180
252.581,2,2,64,2,8,252581,8,64,0,0,0,0,0
1750.709,17,12,498,11,14,175070,14,462,1,8,0,8,36
175.211,1,12,1248,0,0,0,0,0,12,76,15928,76,1248
1786.493,6,130,18012,80,242,22613,1253,12894,50,77,36457,191,5118
5.02,17,4,288,2,36,5004,36,128,2,52,4966,52,160
31.495,6,7,336,1,0,0,0,48,6,0,6297,0,288
1071.824,6,217,13786,125,69,8642,69,7553,92,69,11778,69,6233
665.18,6,42,3349,25,64,27715,64,1768,17,56,41568,58,1581
280.294,6,30,7432,13,158,23357,267,1317,17,543,17517,1400,6115
15.308,17,4,352,2,60,15307,60,176,2,60,15307,60,176
45.371,17,32,5012,17,47,2835,288,1280,15,220,2871,308,3732
59.967,6,8,432,5,0,14991,0,268,3,0,29977,0,164
21.642,17,2,904,1,300,0,300,328,1,548,0,548,576
31.736,6,8,440,5,0,7934,0,268,3,0,15712,0,172
1790.234,6,356,22520,208,69,8648,69,12460,148,69,12177,69,10060
1775.834,17,140,11200,70,48,25736,48,5320,70,56,25736,56,5880
1772.958,6,180,15480,120,69,14898,69,8940,60,69,30048,69,6540
0.504,17,2,152,1,48,0,48,76,1,48,0,48,76
47.152,1,5,280,5,28,11788,28,280,0,0,0,0,0
1034.049,6,97,6054,53,46,19882,208,3705,44,31,24043,31,2349
7.487,17,6,528,3,48,3715,48,228,3,72,3670,72,300
1778.265,1,114,6384,114,28,15736,28,6384,0,0,0,0,0
3.992,17,3,276,3,64,1996,64,276,0,0,0,0,0
0.326,6,27,8963,13,237,27,590,1635,14,941,24,1408,7328
300.812,6,52,10649,26,433,12032,910,3310,26,299,761,1460,7339
1785.858,6,354,22440,206,69,8711,69,12380,148,69,12148,69,10060
5.726,17,25,7624,10,306,636,1350,3340,15,257,228,1350,4284
1763.725,2,14,448,14,8,135671,8,448,0,0,0,0,0
1796.491,17,447,39580,403,35,4468,288,25676,44,288,40951,288,13904
1745.824,6,96,7255,63,38,28158,205,4476,33,33,54545,98,2779
8.297,1,5,140,5,0,0,0,140,0,0,0,0,0
286.706,17,3,192,3,36,143353,36,192,0,0,0,0,0
0.143,6,10,1380,6,145,28,145,389,4,827,45,827,991
1681.719,17,14,1036,7,30,280281,30,406,7,62,280281,62,630
0.046,6,12,3704,6,171,8,171,491,6,964,7,1448,3213
1.321,6,54,21538,30,967,45,1460,15757,24,400,49,1460,5781
300.636,1,6,558,6,65,60127,88,558,0,0,0,0,0
1771.371,6,99,9240,66,65,27251,65,5577,33,59,55352,59,3663
0.252,17,2,157,1,31,0,31,59,1,70,0,70,98
0.005,17,2,345,1,32,0,32,60,1,257,0,257,285
360.977,2,4,128,4,8,120325,8,128,0,0,0,0,0
0.165,17,2,2380,2,1162,165,1162,2380,0,0,0,0,0
41.74,17,48,7056,24,48,1814,48,1824,24,190,1814,308,5232
12.025,6,22,6817,12,275,1093,275,1038,10,1073,768,1440,5779
6.795,17,36,7174,12,219,617,1350,2964,24,147,294,1350,4210
19.849,6,649,638878,418,210,47,649,25852,231,2683,86,14080,613026
0.328,17,8,2766,8,317,46,356,2766,0,0,0,0,0
1777.485,1,62,5208,0,0,0,0,0,62,56,29139,56,5208
0.807,17,2,672,2,308,807,308,672,0,0,0,0,0
2.662,17,22,6125,9,249,332,1350,2494,13,251,132,1350,3631
1793.422,6,356,22520,208,69,8663,69,12460,148,69,12200,69,10060
1794.678,6,362,24774,211,94,8546,469,14387,151,69,11964,69,10387
6.772,6,65,20086,34,540,205,1152,15419,31,489,217,1179,4667
1797.879,17,278,96949,278,320,6490,548,96949,0,0,0,0,0
9.088,6,2,1520,1,0,0,0,40,1,1440,0,1440,1480
40.355,17,4,352,2,60,40354,60,176,2,60,40354,60,176
0.893,17,28,14319,15,743,61,1350,11570,13,183,69,1350,2749
0.978,6,16,3672,9,150,122,174,664,7,681,146,1452,3008
1783.993,1,342,28728,342,56,5231,56,28728,0,0,0,0,0
3.976,17,4,352,2,48,3970,48,152,2,72,3967,72,200
1.362,6,47,18704,26,924,54,1460,13088,21,433,58,1460,5616
0.21,17,2,2756,2,1350,210,1350,2756,0,0,0,0,0
8.215,6,19,8251,9,275,1026,275,643,10,1199,860,1420,7608
1.267,6,57,14106,28,553,46,1429,5028,29,416,44,1460,9078
1742.355,1,14,784,14,28,134027,28,784,0,0,0,0,0
120.547,6,49,10156,21,263,3277,1189,2959,28,357,4464,1420,7197
1745.964,6,96,7286,63,38,28160,205,4476,33,33,54547,98,2810
3.059,6,2,88,2,0,0,0,88,0,0,0,0,0
10.986,6,19,4362,11,275,1098,275,998,8,758,913,1420,3364
1682.831,17,13,534,11,14,168235,14,462,2,8,1682522,8,72
1773.191,6,183,15738,121,69,14776,69,8980,62,69,29062,69,6758
46.923,17,6,528,3,60,23460,60,264,3,60,23461,60,264
17.554,17,23,13209,11,591,1752,1350,6814,12,504,1592,1350,6395
5.38,6,40,7325,20,218,283,314,3423,20,442,269,1152,3902
1758.972,1,8,448,8,28,251281,28,448,0,0,0,0,0
0.722,6,17,5132,9,150,90,174,664,8,828,90,1420,4468
1783.811,6,359,22709,209,69,8576,69,12569,150,69,11971,69,10140
1778.147,17,140,11200,70,48,25770,48,5320,70,56,25770,56,5880
3.777,6,52,13925,25,551,157,1429,4936,27,464,29,1986,8989
191.066,6,9,522,2,106,191058,106,194,7,0,31842,0,328
2.165,17,2,144,1,36,0,36,64,1,52,0,52,80
0.434,6,20,7165,12,318,38,599,1905,8,1209,60,1906,5260
0.124,6,10,1671,6,552,24,948,1348,4,159,41,159,323
93.118,6,25,10170,13,695,1411,1237,3333,12,793,8448,1460,6837
1241.275,17,100,8628,92,30,13640,37,5364,8,380,168785,463,3264
1798.704,1,284,15904,284,28,6355,28,15904,0,0,0,0,0
0.51,17,3,451,2,39,220,39,134,1,289,0,289,317
100.74,6,25,6288,9,272,115,516,1180,16,372,6709,1452,5108
2.993,6,9,360,6,0,1,0,240,3,0,1496,0,120
1786.453,6,104,8444,68,66,26663,66,4964,36,60,51039,60,3480
606.721,6,38,6659,20,250,31932,1314,2556,18,281,35688,1460,4103
401.394,17,10,880,5,48,100346,48,380,5,72,100346,72,500
7.429,6,1093,990323,438,1101,17,1440,40723,655,1440,11,4320,949600
0.017,17,3,244,2,32,1,32,120,1,96,0,96,124
79.024,6,185,139953,109,1324,731,1448,126285,76,537,1051,1448,13668
18.442,6,21,3923,12,211,1674,211,1277,9,545,2304,904,2646
1.981,17,3,468,3,128,990,128,468,0,0,0,0,0
1750.573,17,12,498,11,14,175057,14,462,1,8,0,8,36
280.19,6,30,7432,14,158,21553,267,1357,16,603,18676,2800,6075
95.082,6,102,71862,64,1222,1509,1448,60801,38,755,2505,2359,11061
1772.644,6,180,15480,120,69,14896,69,8940,60,69,30038,69,6540
12.144,17,10,690,5,33,3034,33,305,5,49,3034,49,385
60.426,17,4,646,2,33,60416,33,122,2,234,60225,234,524
1775.709,17,140,11200,70,48,25734,48,5320,70,56,25734,56,5880
2.474,17,13,7301,6,586,494,1350,3686,7,488,280,1350,3615
1.407,6,50,19901,28,872,52,1360,14245,22,433,57,1360,5656
1790.541,6,362,22898,210,69,8567,69,12678,152,69,11857,69,10220
1276.797,1,246,20664,246,56,5211,56,20664,0,0,0,0,0
1789.212,6,356,22520,208,69,8643,69,12460,148,69,12171,69,10060
1742.741,6,95,7203,63,38,28108,205,4476,32,33,56205,98,2727
1.412,6,25,8056,12,164,110,267,1288,13,1014,101,2736,6768
385.484,17,6,2016,6,308,77096,308,2016,0,0,0,0,0
37.714,1,43,4472,0,0,0,0,0,43,76,897,76,4472
275.931,17,4,240,2,32,275930,32,120,2,32,275930,32,120
1681.787,17,14,1036,7,30,280295,30,406,7,62,280289,62,630
1790.043,17,87,3648,86,14,21059,14,3612,1,8,0,8,36
573.611,17,114,8664,114,48,5076,48,8664,0,0,0,0,0
1786.857,6,106,8456,68,65,26669,65,4930,38,59,48289,59,3526
2.384,6,19,2893,10,324,264,585,1201,9,304,293,580,1692
13.428,17,10,1000,7,50,2238,288,548,3,122,221,288,452
15.483,17,40,9499,17,249,965,1350,4710,23,180,702,1350,4789
1738.832,6,128,8060,73,47,24150,208,4961,55,31,32193,31,3099
1.303,6,42,15089,23,781,59,1360,9553,19,476,62,2715,5536
27.164,6,36,8319,19,364,1509,777,1885,17,478,542,1928,6434
20.171,6,22,5755,13,107,1680,159,1138,9,828,2520,1675,4617
384.002,6,6,861,6,103,76800,138,861,0,0,0,0,0
1787.904,6,370,26170,214,105,8393,469,15514,156,69,11534,69,10656
0.019,17,2,184,1,64,0,64,92,1,64,0,64,92
28.336,6,9,372,7,0,4722,0,284,2,0,1246,0,88
27.901,6,32,8952,14,158,2146,267,1357,18,624,1636,1400,7595
0.255,17,2,154,1,33,0,33,61,1,65,0,65,93
8.704,6,36,8428,18,401,512,888,1956,18,441,501,1360,6472
377.236,2,3,96,3,8,188618,8,96,0,0,0,0,0
1795.264,17,740,44600,740,32,2429,37,44600,0,0,0,0,0
63.925,6,9,515,5,43,15981,43,299,4,0,21305,0,216
27.857,6,213,159140,123,1370,226,1440,150268,90,328,310,1440,8872
0.005,17,2,521,1,30,0,30,58,1,435,0,435,463
164.794,6,25,11835,12,405,71,907,1739,13,1062,13721,1460,10096
372.0,6,25,1651,17,177,23250,177,1117,8,110,9252,110,534
131.435,6,58,36279,36,1152,3755,1448,28381,22,749,2929,1448,7898
0.943,6,11,1727,7,100,157,100,384,4,589,225,1152,1343
191.561,17,4,304,4,48,63853,48,304,0,0,0,0,0
3.202,6,23,6743,13,372,266,1205,2386,10,988,355,1791,4357
40.195,17,22,1936,11,48,4018,48,836,11,72,4018,72,1100
0.2,17,2,152,1,48,0,48,76,1,48,0,48,76
0.274,17,2,588,1,39,0,39,67,1,493,0,493,521
2.498,6,14,2351,8,188,356,245,700,6,703,448,1152,1651
159.748,6,22,10160,11,433,64,990,1771,11,1133,15962,1390,8389
7.645,6,9,392,4,0,2548,0,172,5,0,1131,0,220
1798.314,6,373,26028,216,98,8364,469,15263,157,69,11527,69,10765
165.718,6,21,8374,11,520,92,1223,2034,10,1185,18393,3151,6340
15.285,17,19,5835,8,328,2178,1350,2850,11,243,1524,1350,2985
0.005,17,2,142,1,43,0,43,71,1,43,0,43,71
4.326,17,2,668,2,306,4326,306,668,0,0,0,0,0
16.162,17,14,5435,7,423,2687,1350,3158,7,297,2686,1350,2277
1.246,6,23,7952,12,164,96,267,1288,11,1216,106,2804,6664
280.272,6,26,7134,11,181,28027,267,1168,15,595,20015,1400,5966
1.517,6,58,18034,28,707,56,1360,8925,30,438,51,1360,9109
28.128,6,4234,4109703,2846,1368,9,1408,4032863,1388,931,20,2801,76840
30.069,6,12,1314,7,171,5011,171,543,5,251,7508,476,771
1.157,6,23,7952,11,164,98,267,1236,12,1014,89,2331,6716
0.025,17,4,352,2,60,23,60,176,2,60,24,60,176
1.184,6,2,1175,1,0,0,0,40,1,1095,0,1095,1135
72.664,6,136,100163,83,1267,886,1368,89278,53,738,1366,2519,10885
170.778,6,36,23924,19,840,33,1360,5835,17,1739,10665,5411,18089
1746.844,6,97,7338,64,38,27727,205,4528,33,33,54579,98,2810
0.556,17,2,144,1,36,0,36,64,1,52,0,52,80
240.652,2,4,128,4,8,80217,8,128,0,0,0,0,0
31.595,6,7,308,1,0,0,0,44,6,0,6301,0,264
4.241,6,10,1335,4,299,1407,299,515,6,246,844,459,820
0.058,17,2,220,1,50,0,50,78,1,114,0,114,142
1792.716,17,142,11360,71,48,25609,48,5396,71,56,25609,56,5964
1.011,17,2,685,1,308,0,308,336,1,321,0,321,349
140.689,6,25,9903,12,410,53,922,1742,13,847,11713,1360,8161
15.33,17,18,8310,9,483,1912,1350,4601,9,384,1912,1350,3709
1619.054,1,14,784,14,28,124542,28,784,0,0,0,0,0
1792.1,17,87,3648,86,14,21083,14,3612,1,8,0,8,36
2.904,6,27,11469,17,823,181,1440,9759,10,432,307,573,1710
1793.685,6,355,22480,207,69,8707,69,12420,148,69,12201,69,10060
101.084,6,59,15663,24,287,1949,1189,3271,35,457,2972,1420,12392
0.395,6,13,1693,7,288,62,288,588,6,426,42,434,1105
1786.56,6,102,8296,68,65,26665,65,4930,34,59,54135,59,3366
1793.292,6,370,23563,208,69,8663,69,12667,162,69,11138,69,10896
1795.196,17,449,39928,404,35,4454,288,25708,45,288,40017,288,14220
0.04,17,4,284,2,32,19,32,120,2,54,23,60,164
0.895,17,2,784,2,364,895,364,784,0,0,0,0,0
268.946,17,4,352,2,60,268945,60,176,2,60,268945,60,176
7.748,17,6,528,3,48,3868,48,228,3,72,3868,72,300
1800.0,6,212,16324,79,68,22692,294,7730,133,48,13636,78,8594
37.897,6,29,10141,16,614,2526,1460,3142,13,808,3136,1460,6999
1743.311,6,95,7203,63,38,28117,205,4476,32,33,56222,98,2727
3.478,6,68,45499,41,978,86,1360,12447,27,1682,127,4080,33052
6.131,6,42,7405,23,218,278,314,3543,19,516,325,1179,3862
1.231,6,225,165532,126,1323,9,1420,157257,99,534,12,3303,8275
0.015,17,2,184,1,32,0,32,60,1,96,0,96,124
208.855,6,66,46871,44,1183,4857,1408,38992,22,961,2935,3847,7879
22.562,17,4,240,2,32,22561,32,120,2,32,22561,32,120
95.401,6,41,11287,13,391,2056,1407,3657,28,270,3532,1460,7630
1.491,6,17,5791,11,429,146,634,3156,6,767,291,1328,2635
1785.863,6,356,22520,208,69,8627,69,12460,148,69,12148,69,10060
126.013,2,2,64,2,8,126013,8,64,0,0,0,0,0
67.597,6,27,7177,13,155,5633,267,1306,14,530,5199,4260,5871
1738.97,6,87,6322,58,31,30508,31,3915,29,31,62105,31,2407
1744.934,6,95,7203,63,38,28144,205,4476,32,33,56275,98,2727
35.03,6,29,4990,14,180,2694,722,1807,15,342,2465,1448,3183
240.814,6,48,9220,25,519,10033,1402,5995,23,202,10945,618,3225
1788.316,17,87,3648,86,14,21039,14,3612,1,8,0,8,36
0.587,17,2,152,1,48,0,48,76,1,48,0,48,76
35.323,6,16,2594,9,253,4415,597,1469,7,190,5631,346,1125
1.255,6,10,1687,7,100,209,100,384,3,1179,494,1179,1303
1.036,6,10,1687,7,100,172,100,384,3,1179,379,1179,1303
1763.312,17,150,25454,150,141,11834,373,25454,0,0,0,0,0
395.482,17,8,2045,4,31,131801,37,239,4,423,131824,463,1806
657.107,6,123,8054,57,46,11734,46,3758,66,46,10107,46,4296
1.262,6,14,2181,7,324,210,585,1009,7,396,209,580,1172
2.052,17,6,1270,3,30,1017,30,174,3,337,1021,468,1096
3.762,6,2,88,2,0,0,0,88,0,0,0,0,0
1799.95,17,450,39960,405,35,4455,288,25740,45,288,40019,288,14220
0.408,6,16,6297,9,141,51,275,646,7,1073,30,2840,5651
1785.489,6,356,22520,208,69,8625,69,12460,148,69,12146,69,10060
1799.093,1,57,4788,57,56,32126,56,4788,0,0,0,0,0
0.24,17,4,1210,4,274,80,294,1210,0,0,0,0,0
39.785,17,44,6468,22,48,1894,48,1672,22,190,1894,308,4796
1203.182,2,13,416,13,8,100265,8,416,0,0,0,0,0
0.086,17,4,2876,2,689,86,1350,1434,2,693,50,1350,1442
0.85,6,24,6404,13,296,70,826,2007,11,988,83,1731,4397
14.774,1,4,224,4,28,4924,28,224,0,0,0,0,0
0.403,6,47,17209,26,848,16,1380,12127,21,421,18,1923,5082
1795.603,1,250,14000,250,28,7211,28,14000,0,0,0,0,0
6.049,6,1445,1337113,915,1384,6,1408,1304889,530,931,11,2801,32224
1.239,6,205,160289,123,1331,10,1432,152718,82,427,14,1432,7571
15.455,17,17,6558,8,484,2201,1350,4096,9,245,1926,1350,2462
1.055,6,10,1687,7,100,175,100,384,3,1179,396,1179,1303
1.027,17,2,925,1,548,0,548,576,1,321,0,321,349
0.014,6,2,80,1,0,0,0,40,1,0,0,0,40
0.011,17,2,349,1,48,0,48,76,1,245,0,245,273
9.583,17,96,50756,30,303,330,1350,9951,66,590,146,1350,40805
11.597,6,25,8453,13,275,966,275,1078,12,983,761,1420,7375
0.106,17,2,904,2,424,106,548,904,0,0,0,0,0
257.065,6,30,7432,13,158,21422,267,1317,17,543,16061,1400,6115
0.044,6,4,160,0,0,0,0,0,4,0,0,0,160
188.408,6,30,7432,13,158,15700,267,1317,17,543,11770,1400,6115
280.249,17,4,296,2,30,280234,30,116,2,62,280235,62,180
3.011,17,7,1496,4,30,1000,30,232,3,393,1499,468,1264
1772.759,6,180,15480,120,69,14897,69,8940,60,69,30042,69,6540
30.716,6,2,166,0,0,0,0,0,2,31,30716,31,166
811.393,6,43,3360,23,65,24620,65,1635,20,48,42699,59,1725
240.334,6,54,18384,28,810,8900,1418,15249,26,221,9612,580,3135
4.827,6,44,8369,21,227,241,314,4022,23,427,207,1152,4347
4.98,17,4,306,2,36,4963,36,128,2,61,4961,70,178
142.089,17,6,456,6,48,28417,48,456,0,0,0,0,0
1.803,6,25,8759,15,284,128,585,1457,10,985,181,1420,7302
56.001,17,4,240,2,32,56000,32,120,2,32,55999,32,120
1776.769,17,142,11360,71,48,25381,48,5396,71,56,25381,56,5964
0.293,17,20,7797,9,502,36,1350,4771,11,247,25,1350,3026
823.367,6,165,17895,77,502,10833,841,6215,88,84,9462,1535,11680
1.024,17,16,6905,7,535,170,1350,3946,9,300,81,1350,2959
2.337,6,12,2919,8,100,333,100,424,4,1165,690,1179,2495
3.121,17,3,186,3,34,1560,34,186,0,0,0,0,0
53.419,17,4,3621,4,877,17806,1451,3621,0,0,0,0,0
18.182,6,27,4885,12,205,1652,722,1657,15,271,1283,1408,3228
1787.905,6,365,23225,210,69,8554,69,12678,155,69,11609,69,10547
1781.762,6,359,22709,209,69,8566,69,12569,150,69,11958,69,10140
1.208,6,24,8004,13,164,85,267,1340,11,1014,102,2423,6664
0.099,17,2,2752,2,1348,99,1348,2752,0,0,0,0,0
137.512,1,4,224,4,28,45837,28,224,0,0,0,0,0
842.265,2,9,288,9,8,105283,8,288,0,0,0,0,0
0.681,6,26,6095,13,108,56,147,959,13,658,55,1430,5136
6.872,6,32,7584,13,155,572,267,1306,19,367,381,1420,6278
4.725,6,40,7309,19,218,262,314,3383,21,440,222,1152,3926
280.248,6,29,7392,14,158,21557,267,1357,15,678,20011,3436,6035
5.007,17,4,530,2,36,5003,36,128,2,173,5002,187,402
36.16,17,40,5880,20,48,1902,48,1520,20,190,1902,308,4360
5.703,6,8,460,4,0,1901,0,220,4,0,1005,0,240
1792.253,17,180,14040,180,50,10012,50,14040,0,0,0,0,0
1069.187,17,12,969,6,31,213828,37,355,6,74,213828,136,614
1787.062,6,102,8364,68,66,26672,66,4964,34,60,54148,60,3400
1799.043,17,448,39896,403,35,4475,288,25676,45,288,40018,288,14220
1.312,6,58,21927,32,921,42,1360,16066,26,400,45,1360,5861
197.551,17,4,240,2,32,197549,32,120,2,32,197550,32,120
0.107,17,2,363,1,29,0,29,57,1,278,0,278,306
1783.047,17,75,3144,74,14,24425,14,3108,1,8,0,8,36
1680.887,1,15,870,15,30,120063,30,870,0,0,0,0,0
3.913,17,23,8577,10,437,434,1350,4659,13,273,231,1350,3918
1771.671,6,105,9759,68,65,26442,65,5758,37,59,49210,59,4001
1745.693,6,95,7203,63,38,28156,205,4476,32,33,56298,98,2727
1786.856,17,87,3648,86,14,21021,14,3612,1,8,0,8,36
1755.036,6,218,19064,111,115,15954,208,13885,107,31,16550,31,5179
661.751,2,9,288,9,8,82718,8,288,0,0,0,0,0
0.007,17,2,384,1,58,0,58,86,1,270,0,270,298
4.996,17,4,558,2,36,4991,36,128,2,187,4990,187,430
1776.605,6,180,15480,120,69,14929,69,8940,60,69,30106,69,6540
1786.106,6,102,8296,68,65,26658,65,4930,34,59,54121,59,3366
9.779,6,17,4288,6,92,1955,92,400,11,368,958,1408,3888
7.866,6,18,6767,9,275,983,275,643,9,1150,892,1414,6124
0.02,17,4,398,2,46,12,46,148,2,97,13,103,250
50.357,17,4,352,2,60,50356,60,176,2,60,50356,60,176
842.244,2,9,288,9,8,105280,8,288,0,0,0,0,0
1727.116,17,12,498,11,14,172711,14,462,1,8,0,8,36
235.814,17,4,352,2,60,235813,60,176,2,60,235813,60,176
1798.975,17,448,39896,403,35,4475,288,25676,45,288,40019,288,14220
1786.591,17,87,3648,86,14,21018,14,3612,1,8,0,8,36
1794.027,6,329,21371,192,69,9392,69,11682,137,69,13191,69,9689
219.14,6,48,14297,24,451,9527,1360,4650,24,618,9519,2134,9647
1786.08,1,178,9968,178,28,10090,28,9968,0,0,0,0,0
0.048,17,4,624,2,36,0,36,128,2,220,0,292,496
0.014,6,10,1514,5,503,3,503,771,5,475,2,475,743
1760.729,17,168,14050,156,30,11359,37,9090,12,385,154635,463,4960
1798.134,1,59,4956,59,56,31002,56,4956,0,0,0,0,0
146.491,6,22,9126,12,304,73,597,1425,10,1214,16255,3081,7701
1313.559,2,14,448,14,8,101043,8,448,0,0,0,0,0
5.99,6,3,180,3,0,0,0,180,0,0,0,0,0
122.547,6,215,55435,130,365,949,1440,23230,85,342,1458,1328,32205
1795.012,17,448,39896,403,35,4465,288,25676,45,288,40024,288,14220
1.009,6,23,6401,13,311,83,895,2081,10,979,110,1699,4320
1797.655,17,448,39384,403,35,4471,288,25412,45,282,40017,288,13972
0.47,6,4,286,1,27,0,27,79,3,27,235,27,207
0.259,6,21,5908,12,181,23,537,1526,9,651,30,1448,4382
0.35,17,2,194,1,61,0,61,89,1,77,0,77,105
1684.904,17,14,1036,7,30,280815,30,406,7,62,280815,62,630
301.069,6,40,10186,22,615,14336,1360,4619,18,402,518,2667,5567
1742.926,1,72,6048,72,56,24548,56,6048,0,0,0,0,0
25.312,6,131,106095,82,820,312,1360,9054,49,2160,524,9520,97041
3.566,6,69,25402,35,941,104,1440,14703,34,518,100,1440,10699
1744.747,6,96,7255,62,38,28602,205,4424,34,33,52864,98,2831
1799.554,1,62,5208,0,0,0,0,0,62,56,29500,56,5208
0.568,6,16,1825,8,288,55,288,640,8,284,57,434,1185
201.708,6,57,9626,21,117,6102,267,1902,36,202,5762,1420,7724
5.922,17,2,152,2,48,5922,48,152,0,0,0,0,0
9.018,17,4,336,2,48,9008,48,152,2,64,9007,64,184
1748.627,6,96,7255,62,38,28666,205,4424,34,33,52975,98,2831
1765.523,6,124,12700,77,69,23230,722,6641,47,95,38376,1408,6059
1.382,17,2,120,2,32,1382,32,120,0,0,0,0,0
1.192,6,10,1687,7,100,198,100,384,3,1179,465,1179,1303
4.911,6,21,5686,12,197,446,501,1275,9,1011,472,3151,4411
103.372,17,4,1344,4,308,34457,308,1344,0,0,0,0,0
0.095,17,2,212,1,46,0,46,74,1,110,0,110,138
1757.714,6,188,11912,94,52,18900,208,7191,94,31,18897,31,4721
195.75,17,9,3008,9,306,24468,308,3008,0,0,0,0,0
1.334,6,39,8294,19,321,74,1164,2718,20,433,61,1360,5576
1740.467,17,30,7050,30,207,60016,207,7050,0,0,0,0,0
140.189,17,4,240,2,32,140188,32,120,2,32,140188,32,120
1.281,17,14,6688,7,576,213,1350,4230,7,323,204,1350,2458
5.001,17,4,558,2,36,4990,36,128,2,187,4990,187,430
1.015,6,4,220,2,0,1015,0,100,2,0,307,0,120
1785.829,6,465,28275,229,69,7832,69,13783,236,36,7599,48,14492
1789.648,17,87,3648,86,14,21054,14,3612,1,8,0,8,36
372.431,6,25,1651,17,177,23276,177,1117,8,110,9246,110,534
46.536,6,27,7177,13,155,3878,267,1306,14,530,3579,3417,5871
5.011,17,4,558,2,36,5004,36,128,2,187,5006,187,430
0.088,1,2,112,2,28,88,28,112,0,0,0,0,0
1785.005,17,140,11200,70,48,25869,48,5320,70,56,25869,56,5880
291.804,6,33,6973,16,262,19450,517,1628,17,744,18235,1418,5345
2.054,6,29,10373,17,368,128,837,1789,12,1012,178,1420,8584
840.894,17,8,592,4,30,280291,30,232,4,62,280293,62,360
2.957,17,3,1021,2,308,1957,308,672,1,321,0,321,349
1772.067,6,180,15480,120,69,14891,69,8940,60,69,30033,69,6540
1.356,6,51,20027,27,941,52,1440,14291,24,433,51,1440,5736
0.002,17,2,180,1,30,0,30,58,1,94,0,94,122
27.9,17,4,1344,4,308,9300,308,1344,0,0,0,0,0
17.332,6,23,6769,7,154,2888,267,752,16,447,1153,1420,6017
240.304,6,41,8855,20,524,12647,1418,5764,21,221,12014,618,3091
1777.7,17,142,11360,71,48,25395,48,5396,71,56,25395,56,5964
111.254,6,63,29379,37,563,3084,1368,11591,26,1259,4448,3722,17788
0.653,17,2,677,1,300,0,300,328,1,321,0,321,349
7.272,6,5,240,1,0,0,0,48,4,0,2421,0,192
244.246,6,20,2535,5,483,61061,483,751,15,83,17442,83,1784
0.507,17,3,451,2,39,433,39,134,1,289,0,289,317
0.008,17,2,339,1,33,0,33,61,1,250,0,250,278
0.124,6,15,5770,9,290,15,517,1045,6,1101,23,1408,4725
1752.998,17,16,1265,8,30,250423,37,471,8,71,250423,136,794
1.28,17,15,9795,8,822,182,1350,6803,7,399,179,1350,2992
4.524,6,3,132,3,0,0,0,132,0,0,0,0,0
152.755,6,69,48379,45,1189,3471,1408,40397,24,960,2678,3847,7982
0.151,17,2,146,1,37,0,37,65,1,53,0,53,81
35.489,1,10,840,10,56,3943,56,840,0,0,0,0,0
0.019,17,4,336,2,34,10,34,124,2,78,10,84,212
0.089,17,2,322,1,33,0,33,61,1,233,0,233,261
22.938,6,31,8016,15,188,1638,721,1923,16,778,1517,2840,6093
1799.755,6,370,24901,214,87,8449,469,14314,156,69,11610,69,10587
0.256,6,22,5040,11,137,25,267,1132,11,692,24,2800,3908
1771.166,6,101,9344,66,65,27248,65,5577,35,59,52090,59,3767
1787.612,6,102,8296,68,65,26680,65,4930,34,59,54166,59,3366
0.53,6,13,3769,7,171,88,171,555,6,964,105,1448,3214
0.024,17,2,384,1,32,0,32,60,1,296,0,296,324
22.34,6,23,3944,14,179,1718,517,1824,9,411,2790,499,2120
0.386,6,27,7296,14,155,29,267,1341,13,603,31,2036,5955
1778.163,17,346,82640,346,210,5154,422,82640,0,0,0,0,0
70.639,6,34,19739,19,421,3924,620,2331,15,2077,4975,8341,17408
2.03,17,3,216,2,31,2030,31,118,1,70,0,70,98
5.014,17,4,288,2,36,4991,36,128,2,52,4997,52,160
240.205,6,57,17675,30,736,8282,1402,14820,27,180,9238,580,2855
0.209,6,46,22643,27,1104,8,1420,17662,19,467,11,1883,4981
317.027,6,59,18831,29,528,11322,1360,9650,30,398,10926,1360,9181
374.732,6,27,1767,18,177,22043,177,1181,9,110,8687,110,586
873.406,1,12,672,12,28,79400,28,672,0,0,0,0,0
0.11,6,10,1514,5,503,27,503,771,5,475,27,475,743
0.265,6,22,5040,10,137,29,267,1092,12,577,23,1400,3948
12.329,6,15,2297,9,211,1539,211,898,6,545,2464,904,1399
1670.548,1,7,392,7,28,278424,28,392,0,0,0,0,0
0.941,6,32,12176,17,525,58,1360,3362,15,745,55,1360,8814
1782.28,17,140,11200,70,48,25830,48,5320,70,56,25830,56,5880
60.2,2,2,64,2,8,60200,8,64,0,0,0,0,0
51.109,6,44,8770,21,367,618,786,2034,23,414,2317,2720,6736
111.111,6,72,35207,41,776,58,1360,12560,31,1069,3699,1877,22647
12.014,6,25,8473,13,275,1001,275,1078,12,986,926,1440,7395
1786.962,6,102,8364,68,66,26671,66,4964,34,60,54147,60,3400
1792.453,1,236,25016,236,78,7627,78,25016,0,0,0,0,0
8.399,6,15,5673,5,106,2098,106,314,10,823,932,1420,5359
5.828,6,9,880,3,283,2828,283,447,6,105,1131,105,433
127.81,17,11,4182,11,352,12781,548,4182,0,0,0,0,0
357.408,17,4,1588,4,369,119136,548,1588,0,0,0,0,0
0.083,17,7,2375,7,311,13,355,2375,0,0,0,0,0
0.052,6,7,423,4,43,3,43,259,3,0,25,0,164
3.416,17,4,1564,4,363,1138,363,1564,0,0,0,0,0
0.538,6,25,7544,15,273,38,663,2168,10,967,55,1946,5376
5.437,6,1660,1579724,1074,1395,4,1408,1544588,586,776,8,1408,35136
12.078,17,16,2352,8,48,1723,48,608,8,190,1723,308,1744
0.023,17,2,591,1,36,0,36,64,1,499,0,499,527
3.131,17,4,624,4,128,1043,128,624,0,0,0,0,0
280.45,6,29,7392,13,158,23370,267,1317,16,603,18694,2760,6075
0.251,17,2,157,1,31,0,31,59,1,70,0,70,98
11.0,6,18,4266,10,275,1222,275,958,8,992,851,1440,3308
16.32,6,19,9416,6,98,3262,106,445,13,844,1359,1420,8971
1772.773,6,180,15480,120,69,14897,69,8940,60,69,30038,69,6540
4.365,6,37,13311,20,694,229,1360,5735,17,762,261,1360,7576
0.96,6,50,13789,24,551,41,1429,4840,26,464,37,1986,8949
0.072,17,2,572,1,39,0,39,67,1,477,0,477,505
1765.662,6,66,3432,33,0,55156,0,1716,33,0,55171,0,1716
0.309,6,24,6064,12,181,28,537,1526,12,651,27,1448,4538
1744.659,2,23,736,23,8,79302,8,736,0,0,0,0,0
300.329,6,46,29630,25,190,12513,444,2117,21,1760,12100,5608,27513
0.093,17,2,215,1,37,0,37,65,1,122,0,122,150
280.268,6,28,7352,13,158,23355,267,1317,15,678,20015,4200,6035
282.505,6,29,7392,13,158,23542,267,1317,16,603,18829,2800,6075
317.263,6,35,11157,14,158,24404,267,1357,21,688,15860,2036,9800
0.325,6,20,7151,11,318,31,600,1854,9,964,39,1471,5297
1788.799,6,364,25392,212,100,8477,469,14896,152,69,11845,69,10496
0.041,17,2,164,1,46,0,46,74,1,62,0,62,90
1647.985,1,7,742,7,78,274664,78,742,0,0,0,0,0
1786.034,6,104,8444,68,66,26657,66,4964,36,60,51027,60,3480
241.79,6,45,5600,22,205,11513,517,2613,23,161,10990,851,2987
6.061,6,46,8449,23,227,275,314,4102,23,427,263,1152,4347
1787.913,6,373,26359,215,104,8354,469,15623,158,69,11387,69,10736
469.124,6,45,14074,29,377,16754,1360,6870,16,655,31263,3494,7204
0.029,17,2,921,1,317,0,317,345,1,548,0,548,576
17.246,6,2540,2389342,1605,1409,10,1448,2336034,935,776,18,1448,53308
4.106,17,8,1176,4,48,1365,48,304,4,190,1365,308,872
0.121,6,31,7961,17,289,7,517,1857,14,553,8,1889,6104
1785.908,6,102,8296,68,65,26655,65,4930,34,59,54115,59,3366
782.103,2,8,256,8,8,111729,8,256,0,0,0,0,0
0.995,6,10,2191,6,188,199,245,620,4,1407,170,1407,1571
207.608,6,16,1167,10,65,23067,65,660,6,53,41500,59,507
820.355,6,12,728,8,31,117193,31,444,4,31,273443,31,284
1778.003,17,79,3312,78,14,23090,14,3276,1,8,0,8,36
1786.093,6,111,11682,72,132,25156,1291,7635,39,69,47000,241,4047
60.177,2,2,64,2,8,60177,8,64,0,0,0,0,0
0.062,17,2,2380,2,1162,62,1162,2380,0,0,0,0,0
1.399,6,48,18919,27,870,53,1360,13303,21,476,60,2715,5616
1779.912,17,140,11200,70,48,25795,48,5320,70,56,25795,56,5880
0.204,6,4,493,2,241,204,241,321,2,92,3,92,172
33.574,6,28,4950,14,180,2582,722,1818,14,400,2568,1408,3132
93.787,6,52,32432,31,327,3126,947,3049,21,1488,3001,4224,29383
0.807,6,27,5927,13,156,67,267,1462,14,780,56,1460,4465
1789.951,6,358,22669,209,69,8605,69,12500,149,69,12094,69,10169
8.312,1,5,140,5,0,0,0,140,0,0,0,0,0
15.615,17,17,6533,8,483,2220,1350,4094,9,243,1940,1350,2439
1790.344,1,219,23214,219,78,8212,78,23214,0,0,0,0,0
122.544,6,27,9180,12,541,81,1286,2137,15,714,8741,1631,7043
15.781,17,22,12048,10,522,1749,1350,5508,12,517,1431,1350,6540
240.218,6,57,20348,31,830,8006,1418,17395,26,199,9608,580,2953
5.709,17,338,210354,191,943,30,1350,185625,147,140,37,1350,24729
0.018,17,2,165,1,37,0,37,65,1,72,0,72,100
7.602,6,25,6864,11,165,760,267,1109,14,518,569,1420,5755
45.177,6,28,7217,13,155,3764,267,1306,15,482,3226,1997,5911
1751.621,6,97,7338,64,38,27803,205,4528,33,33,54726,98,2810
2.236,6,15,3543,8,125,319,245,700,7,1279,331,1407,2843
84.656,6,45,9973,21,631,627,1360,4087,24,307,3672,1360,5886
173.387,17,4,352,2,60,173385,60,176,2,60,173386,60,176
1795.208,17,80,3354,79,14,23015,14,3318,1,8,0,8,36
1.831,6,27,10195,16,287,122,595,1507,11,1030,166,1420,8688
1700.646,17,13,534,11,14,170047,14,462,2,8,1700472,8,72
1743.082,1,56,4704,0,0,0,0,0,56,56,31692,56,4704
1790.781,6,376,26217,218,98,8252,469,15412,158,69,11405,69,10805
1796.237,17,448,39612,404,35,4457,288,25708,44,288,40952,288,13904
180.469,2,2,64,2,8,180469,8,64,0,0,0,0,0
80.001,6,33,7780,10,156,614,267,1192,23,314,3635,1420,6588
1796.404,17,96,7680,48,48,38221,48,3648,48,56,38221,56,4032
3.783,17,6,370,5,31,945,31,295,1,47,0,47,75
1.015,6,28,8160,15,222,59,540,1964,13,944,69,1591,6196
280.21,6,29,7392,14,158,21554,267,1357,15,678,20010,3436,6035
1776.997,17,140,11200,70,48,25753,48,5320,70,56,25753,56,5880
0.057,6,11,911,6,181,11,181,489,5,77,4,133,422
1786.789,6,102,8296,68,65,26668,65,4930,34,59,54140,59,3366
375.979,1,12,672,12,28,34179,28,672,0,0,0,0,0
2.03,17,2,672,2,308,2030,308,672,0,0,0,0,0
0.138,6,13,2131,7,329,23,595,1019,6,396,20,580,1112
4.592,6,35,6209,18,206,270,314,2784,17,548,270,1179,3425
29.78,6,24,5238,6,256,3939,722,1344,18,246,1741,1408,3894
332.867,6,81,12672,35,166,9138,1189,4065,46,241,7396,1420,8607
0.017,6,32,7991,17,131,0,131,1023,15,475,1,1000,6968
141.878,17,14,1064,14,48,10913,48,1064,0,0,0,0,0
286.191,6,27,2917,14,324,22011,585,1397,13,282,23844,580,1520
367.083,6,18,1242,14,180,28237,180,916,4,110,20063,110,326
12.121,6,1921,1675023,1164,1383,10,1420,1640522,757,467,16,1883,34501
365.722,6,18,1242,14,180,28132,180,916,4,110,20065,110,326
5.684,17,7,1219,4,39,992,39,268,3,289,2716,289,951
1715.791,6,135,19887,76,87,22877,721,7674,59,410,12001,2391,12213
280.674,6,28,7352,13,158,23389,267,1317,15,678,20040,2045,6035
145.489,17,4,352,2,60,145488,60,176,2,60,145488,60,176
9.425,6,84,25130,42,550,229,1152,19309,42,459,223,1179,5821
0.181,17,4,668,2,32,5,32,120,2,246,0,246,548
1765.618,6,4288,3997831,1620,126,1090,343,93825,2668,1450,662,2816,3904006
255.995,6,181,138160,112,1295,2306,1408,125014,69,596,2278,1408,13146
157.612,17,4,352,2,60,157611,60,176,2,60,157611,60,176
1745.343,6,94,7151,62,38,28612,205,4424,32,33,56286,98,2727
1741.958,6,153,9516,81,48,21774,208,5737,72,31,24530,31,3779
3.751,17,3,350,2,54,501,54,164,1,158,0,158,186
0.072,6,9,1340,5,145,18,145,349,4,827,18,827,991
16.565,17,15,6780,8,539,2361,1350,4539,7,292,2755,1350,2241
0.136,6,3,212,1,46,0,46,86,2,46,136,46,126
0.029,17,2,904,1,300,0,300,328,1,548,0,548,576
190.524,6,9,528,2,112,190510,112,200,7,0,31751,0,328
126.675,2,2,64,2,8,126675,8,64,0,0,0,0,0
1788.461,6,356,22520,208,69,8639,69,12460,148,69,12166,69,10060
117.186,17,4,352,2,60,117185,60,176,2,60,117185,60,176
1789.466,6,373,26028,216,98,8323,469,15263,157,69,11470,69,10765
1787.082,6,102,8364,68,66,26672,66,4964,34,60,54148,60,3400
1791.026,6,415,24880,208,69,8652,69,12460,207,34,8694,69,12420
869.288,1,16,1344,0,0,0,0,0,16,56,57952,56,1344
1796.947,6,366,25610,213,99,8476,469,15005,153,69,11819,69,10605
183.354,17,4,352,2,60,183353,60,176,2,60,183353,60,176
1776.94,17,142,11360,71,48,25384,48,5396,71,56,25384,56,5964
4.582,17,2,656,2,300,4582,300,656,0,0,0,0,0
228.867,6,182,77897,95,760,527,1152,69168,87,403,2658,1179,8729
93.684,6,10,520,10,0,0,0,520,0,0,0,0,0
15.647,17,23,13226,12,888,1419,1350,10994,11,174,1561,1350,2232
35.505,17,3,1232,3,382,17752,548,1232,0,0,0,0,0
240.213,6,55,17808,30,783,8282,1418,14879,25,202,10008,580,2929
224.787,17,4,240,2,32,224786,32,120,2,32,224786,32,120
0.407,6,29,10202,14,252,31,647,1756,15,850,27,1438,8446
2.758,6,2,88,2,0,0,0,88,0,0,0,0,0
0.365,6,20,7252,12,337,32,674,1980,8,1212,51,1906,5272
11.489,6,17,2437,9,211,1435,211,934,8,545,1638,904,1503
186.635,17,4,352,2,60,186634,60,176,2,60,186634,60,176
1786.783,6,110,8864,71,66,25525,66,5084,39,60,47018,60,3780
1742.174,1,58,4872,0,0,0,0,0,58,56,30564,56,4872
281.458,6,32,7853,14,158,21650,267,1357,18,524,16554,1400,6496
1796.399,6,778,67220,387,51,4653,1448,30354,391,84,4605,1983,36866
0.259,17,2,178,1,29,0,29,57,1,93,0,93,121
1.245,6,25,8044,13,164,103,267,1328,12,869,82,1440,6716
1744.615,6,95,7203,63,38,28138,205,4476,32,33,56270,98,2727
145.579,17,7,532,7,48,24263,48,532,0,0,0,0,0
0.044,1,2,112,2,28,44,28,112,0,0,0,0,0
1783.984,6,362,22829,210,69,8535,69,12678,152,69,11799,69,10151
1681.246,17,14,3843,7,30,280206,30,406,7,463,280206,463,3437
33.807,6,30,5055,15,154,2401,722,1871,15,400,2401,1402,3184
23.125,6,42,8772,20,378,532,786,2014,22,366,1095,2720,6758
300.287,6,26,8092,15,417,21449,1114,2470,11,720,3966,2899,5622
149.795,6,25,10302,13,372,61,808,1680,12,1016,13607,3056,8622
1795.109,17,80,3354,79,14,23014,14,3318,1,8,0,8,36
8.89,6,17,5391,9,275,1111,275,643,8,1104,1108,1440,4748
179.746,6,23,1675,17,43,11234,43,1315,6,0,35947,0,360
0.112,17,3,1015,3,310,56,354,1015,0,0,0,0,0
0.54,6,27,9008,13,243,45,611,1668,14,941,37,1368,7340
1786.849,6,102,8364,68,66,26669,66,4964,34,60,54142,60,3400
1.015,6,31,13360,17,511,63,1360,3279,14,950,63,1360,10081
1.95,6,15,6305,9,141,243,275,646,6,1805,245,2828,5659
0.39,6,21,7011,12,293,35,517,1817,9,943,47,1906,5194
240.183,6,53,17851,28,808,8895,1402,15213,25,166,10007,580,2638
2.188,6,24,5755,14,158,167,370,1355,10,999,242,1737,4400
11.953,6,1909,1654448,1157,1375,10,1420,1620123,752,467,15,1883,34325
1771.839,6,182,15629,121,69,14765,69,8980,61,69,29530,69,6649
173.407,6,204,34040,115,304,1521,304,24884,89,83,1968,83,9156
0.074,17,2,317,1,43,0,43,71,1,218,0,218,246
1.46,6,3,160,2,0,971,0,120,1,0,0,0,40
32.169,6,50,14729,27,945,353,1360,8702,23,339,1454,2667,6027
300.801,6,52,10618,26,433,12032,910,3310,26,312,602,1460,7308
0.86,6,10,1687,7,100,143,100,384,3,1179,306,1179,1303
55.196,17,2,72,1,8,0,8,36,1,8,0,8,36
815.482,1,10,560,10,28,90609,28,560,0,0,0,0,0
0.067,17,2,158,1,34,0,34,62,1,68,0,68,96
1772.49,1,58,4872,58,56,31096,56,4872,0,0,0,0,0
98.729,6,14,1080,4,226,126,226,442,10,110,10949,110,638
1772.124,6,180,15480,120,69,14891,69,8940,60,69,30031,69,6540
62.51,6,7,292,4,0,20836,0,164,3,0,30674,0,128
67.753,6,30,5946,16,107,4516,159,1354,14,967,5211,1669,4592
1706.897,1,8,448,8,28,243842,28,448,0,0,0,0,0
69.53,6,28,7286,13,155,5794,267,1306,15,488,4965,3417,5980
36.213,17,6,1236,3,48,18101,48,228,3,308,18100,308,1008
1740.495,17,28,29568,28,1028,64462,1028,29568,0,0,0,0,0
7.646,17,55,24431,27,535,294,1350,15212,28,301,223,1350,9219
77.867,17,6,456,6,48,15573,48,456,0,0,0,0,0
1.524,6,15,1432,8,256,215,256,840,7,304,251,304,592
300.803,6,34,15852,19,195,16711,431,1812,15,1104,4737,3574,14040
0.12,17,2,239,1,59,0,59,87,1,124,0,124,152
2.772,17,104,140938,103,1339,27,1472,140898,1,12,0,12,40
10.086,17,4,782,2,47,10075,47,150,2,288,10076,296,632
4.064,6,188,134887,97,883,42,1440,13630,91,1416,43,1493,121257
0.499,17,3,451,2,39,271,39,134,1,289,0,289,317
1785.035,17,101,33997,101,308,17850,342,33997,0,0,0,0,0
0.143,17,2,214,1,39,0,39,67,1,119,0,119,147
0.301,17,16,8899,8,612,43,1350,5120,8,444,33,1350,3779
8.499,6,38,7501,19,231,472,314,3314,19,489,382,1179,4187
260.484,1,15,1260,15,56,18606,56,1260,0,0,0,0,0
120.288,2,2,64,2,8,120288,8,64,0,0,0,0,0
1383.693,2,10,320,10,8,153743,8,320,0,0,0,0,0
8.633,6,1364,1182701,838,1361,10,1380,1156939,526,421,16,1923,25762
1.021,17,4,502,3,32,502,32,180,1,294,0,294,322
1786.663,6,102,8296,68,65,26666,65,4930,34,59,54138,59,3366
0.024,17,2,438,1,33,0,33,61,1,349,0,349,377
2.777,6,30,7128,13,154,226,267,1604,17,691,169,1420,5524
1.333,6,46,19122,27,891,51,1360,13586,19,476,64,2715,5536
0.963,6,2,80,1,0,0,0,40,1,0,0,0,40
11.67,6,1860,1612745,1128,1374,10,1420,1579244,732,467,15,1883,33501
280.518,6,32,7512,13,158,23376,267,1317,19,543,15577,1380,6195
15.113,17,12,5269,6,490,3016,1350,3109,6,332,3016,1350,2160
0.023,17,4,768,2,39,14,39,134,2,289,14,289,634
0.019,17,2,503,1,40,0,40,68,1,407,0,407,435
37.667,17,5,380,5,48,9416,48,380,0,0,0,0,0
0.176,6,3,132,1,0,0,0,52,2,0,176,0,80
256.093,6,22,4737,8,272,280,517,1141,14,275,19693,1452,3596
1772.681,6,180,15480,120,69,14896,69,8940,60,69,30042,69,6540
305.935,6,33,6397,17,286,19120,1314,2405,16,334,20394,1460,3992
1750.868,6,264,21110,74,55,22415,131,5414,190,52,9263,276,15696
0.055,17,8,1670,8,180,7,219,1670,0,0,0,0,0
1774.993,6,180,15480,120,69,14915,69,8940,60,69,30077,69,6540
24.174,6,30,7456,11,165,2417,267,1109,19,371,1342,2840,6347
0.31,6,19,6168,10,88,34,88,576,9,1305,38,1880,5592
1688.901,2,13,416,13,8,140741,8,416,0,0,0,0,0
1778.148,1,78,6552,0,0,0,0,0,78,56,23092,56,6552
0.14,17,11,6679,7,513,23,1350,3792,4,693,22,1350,2887
21.19,6,20,1499,10,222,2353,222,852,10,231,2353,231,647
89.995,17,6,456,3,48,44989,48,228,3,48,44833,48,228
0.018,17,2,198,1,37,0,37,65,1,105,0,105,133
280.404,6,29,7392,13,158,23367,267,1317,16,678,18691,3456,6075
1788.627,6,112,11712,72,131,25190,1286,7626,40,69,45859,240,4086
1778.521,17,140,11200,70,48,25775,48,5320,70,56,25775,56,5880
1796.403,1,260,14560,260,28,6935,28,14560,0,0,0,0,0
61.792,6,9,515,5,43,15448,43,299,4,0,20595,0,216
96.55,6,11,719,11,31,9655,31,719,0,0,0,0,0
1792.889,1,58,4872,58,56,31454,56,4872,0,0,0,0,0
377.719,6,50,6701,21,113,18885,722,2340,29,149,13482,1408,4361
1764.428,2,15,480,15,8,126030,8,480,0,0,0,0,0
16.006,6,37,13221,20,770,842,1460,6227,17,787,988,1553,6994
0.036,17,2,180,1,30,0,30,58,1,94,0,94,122
4.509,6,37,7189,19,218,250,314,3383,18,513,248,1179,3806
1779.719,6,285,37048,115,149,15610,1360,17609,170,146,10530,3302,19439
9.38,2,2,64,2,8,9380,8,64,0,0,0,0,0
128.03,17,4,304,2,48,128029,64,152,2,48,128029,64,152
5.002,17,2,128,2,36,5002,36,128,0,0,0,0,0
2.033,17,6,460,3,40,1004,41,206,3,56,1002,57,254
1788.911,17,141,11276,71,48,25555,48,5396,70,56,25926,56,5880
2.412,6,14,2351,8,188,344,245,700,6,703,431,1152,1651
0.165,17,2,2754,2,1349,165,1349,2754,0,0,0,0,0
112.139,6,36,7946,13,155,9344,267,1306,23,317,5093,1460,6640
0.138,6,9,1339,5,145,34,145,349,4,826,27,826,990
0.328,6,22,7333,12,334,29,663,1969,10,806,35,1408,5364
1681.689,17,18,1413,9,30,210207,37,529,9,70,210207,136,884
183.515,6,28,6646,11,220,5707,516,1325,17,331,11464,1452,5321
0.047,17,2,152,1,48,0,48,76,1,48,0,48,76
1743.951,6,95,7203,63,38,28128,205,4476,32,33,56250,98,2727
5.4,6,12,3152,6,92,1080,92,504,6,1164,946,1440,2648
1797.913,17,285,62721,285,192,6330,422,62721,0,0,0,0,0
0.313,6,27,8914,13,231,26,563,1608,14,938,23,1408,7306
281.423,6,32,7516,14,158,21647,267,1357,18,543,16548,1400,6159
0.734,17,2,144,1,36,0,36,64,1,52,0,52,80
1786.287,6,103,8464,68,66,26661,66,4964,35,60,52535,60,3500
317.165,6,54,12489,29,141,11327,615,3596,25,463,13209,4649,8893
368.896,6,18,1239,14,177,28376,177,913,4,110,20057,110,326
153.8,17,10,585,10,30,17088,31,585,0,0,0,0,0
1680.432,1,14,784,14,28,129264,28,784,0,0,0,0,0
4.781,6,38,7229,19,218,265,314,3383,19,513,251,1179,3846
3.427,17,4,368,4,64,1142,64,368,0,0,0,0,0
0.071,17,4,420,2,33,0,33,122,2,121,3,145,298
1790.063,17,180,11520,180,36,10000,36,11520,0,0,0,0,0
0.497,17,3,451,2,39,245,39,134,1,289,0,289,317
0.269,6,14,3566,7,75,44,75,447,7,1373,44,1448,3119
3.714,6,87,59291,51,1216,74,1368,51334,36,982,100,2491,7957
1797.512,1,345,28980,345,56,5225,56,28980,0,0,0,0,0
37.639,17,22,1672,22,48,1792,48,1672,0,0,0,0,0
15.281,17,22,11891,12,555,1386,1350,7003,10,460,1694,1350,4888
5.634,6,7,519,0,0,0,0,0,7,31,939,31,519
1789.374,17,142,11360,71,48,25562,48,5396,71,56,25562,56,5964
0.65,17,6,2075,6,317,130,355,2075,0,0,0,0,0
73.039,6,37,8377,18,371,526,797,1865,19,478,4048,2720,6512
11.486,6,89,26693,46,548,255,1152,20491,43,447,267,1179,6202
4.906,6,39,7269,20,218,258,314,3423,19,440,257,1152,3846
0.519,17,8,2758,8,316,74,355,2758,0,0,0,0,0
0.001,6,3,120,0,0,0,0,0,3,0,0,0,120
854.856,17,124,9424,124,48,6950,48,9424,0,0,0,0,0
1652.63,17,40,13440,40,308,42375,308,13440,0,0,0,0,0
5.506,6,22,7491,10,262,604,517,1328,12,923,492,2447,6163
1770.264,6,103,9448,66,65,27234,65,5577,37,59,49170,59,3871
1778.349,1,240,13440,240,28,7440,28,13440,0,0,0,0,0
4.315,6,38,7229,19,218,239,314,3383,19,513,225,1179,3846
116.553,6,24,15302,13,476,60,1360,2459,11,2478,11641,4725,12843
0.486,17,3,451,2,39,23,39,134,1,289,0,289,317
52.486,17,4,352,2,60,52485,60,176,2,60,52484,60,176
0.48,6,10,968,5,256,107,256,460,5,304,110,304,508
0.008,1,2,112,2,28,8,28,112,0,0,0,0,0
0.016,17,2,192,1,37,0,37,65,1,99,0,99,127
280.405,6,28,7352,12,158,25491,267,1277,16,603,18688,1400,6075
0.045,6,2,123,1,0,0,0,40,1,31,0,31,83
0.006,17,2,394,1,33,0,33,61,1,305,0,305,333
1771.622,6,99,9240,66,65,27255,65,5577,33,59,55360,59,3663
301.188,6,70,53335,46,1240,6693,1368,47074,24,715,1343,1571,6261
1.571,6,51,19000,29,863,56,1360,13299,22,400,65,1360,5701
1.305,6,50,19455,27,903,50,1440,13759,23,433,50,1440,5696
148.261,17,14,1232,7,48,24708,48,532,7,72,24708,72,700
0.378,6,11,1008,6,256,73,256,500,5,304,91,304,508
301.127,6,29,10752,15,538,21495,1360,3361,14,852,23148,1360,7391
242.254,17,10,3390,10,311,26917,329,3390,0,0,0,0,0
756.902,2,4,128,4,8,252300,8,128,0,0,0,0,0
17.555,17,24,7357,10,305,1947,1350,3337,14,259,1347,1350,4020
0.585,1,5,140,5,0,0,0,140,0,0,0,0,0
376.034,6,18,1242,14,180,28925,180,916,4,110,20066,110,326
1744.447,6,94,7151,62,38,28597,205,4424,32,33,56264,98,2727
34.371,6,47,9059,22,419,828,944,2243,25,386,1426,1360,6816
1.637,6,13,2311,8,188,233,245,700,5,1407,348,1407,1611
100.868,6,146,109349,89,1297,1146,1440,95489,57,679,1796,1440,13860
12.157,17,10,1965,5,33,3035,33,305,5,304,3036,304,1660
15.507,17,15,7627,8,664,2209,1350,5543,7,269,2577,1350,2084
2.738,6,2,88,2,0,0,0,88,0,0,0,0,0
10.935,6,46,25306,23,884,497,1360,6269,23,1131,485,1696,19037
1791.46,1,162,17172,162,78,11127,78,17172,0,0,0,0,0
0.627,1,10,840,10,56,69,56,840,0,0,0,0,0
294.933,1,4,224,4,28,98311,28,224,0,0,0,0,0
93.505,6,6,928,0,0,0,0,0,6,137,18701,160,928
1089.538,6,224,19904,127,166,8349,1189,11398,97,110,11349,421,8506
1.846,6,15,1072,8,222,261,222,550,7,230,304,230,522
3.425,17,2,778,2,361,3425,361,778,0,0,0,0,0
3.848,6,16,4681,8,49,549,92,535,8,621,100,1408,4146
212.477,17,4,304,2,48,212475,64,152,2,48,212475,64,152
3.854,17,3,2906,3,940,1927,1451,2906,0,0,0,0,0
48.289,17,4,272,2,40,48288,47,136,2,40,48288,47,136
5.065,17,4,304,4,48,1688,48,304,0,0,0,0,0
1.681,6,25,8704,15,275,120,557,1429,10,981,167,1420,7275
7.873,6,18,6871,9,275,984,275,643,9,1171,632,1440,6228
1796.4,17,448,39896,403,35,4468,288,25676,45,288,40020,288,14220
280.285,6,30,7432,13,158,23357,267,1317,17,543,17517,1400,6115
1796.299,1,230,12880,230,28,7844,28,12880,0,0,0,0,0
6.614,6,39,7269,20,218,348,314,3423,19,513,353,1179,3846
0.916,6,10,1687,7,100,152,100,384,3,1179,325,1179,1303
0.245,6,24,4571,12,165,22,456,1446,12,415,21,888,3125
300.67,6,35,8164,20,241,15824,619,1810,15,574,609,4848,6354
1792.826,6,367,23236,212,69,8496,69,12896,155,69,11640,69,10340
60.572,6,26,7137,12,155,5506,267,1266,14,530,4658,2006,5871
927.258,6,221,13496,116,69,8063,69,6917,105,42,8900,69,6579
1798.33,17,449,39928,404,35,4462,288,25708,45,288,40017,288,14220
0.126,6,20,9025,10,121,14,121,649,10,1121,14,1448,8376
1104.01,6,16,1384,16,46,73600,62,1384,0,0,0,0,0
85.188,6,773,380625,423,840,201,1152,360779,350,389,243,1152,19846
0.388,6,10,968,5,256,93,256,460,5,304,93,304,508
1796.337,17,445,39232,401,35,4490,288,25328,44,288,40948,288,13904
64.914,6,21,8279,11,525,88,1237,2048,10,1163,7193,3151,6231
1.556,6,51,19685,27,916,59,1460,13949,24,433,58,1460,5736
120.529,6,7,1567,4,100,40176,100,264,3,1179,60136,1179,1303
1787.063,6,102,8296,68,65,26672,65,4930,34,59,54147,59,3366
1681.81,17,14,1036,7,30,280294,30,406,7,62,280293,62,630
1706.547,1,8,448,8,28,243792,28,448,0,0,0,0,0
9.128,6,1507,1260851,876,1384,10,1420,1231330,631,467,14,1883,29521
2.29,6,53,13914,25,549,95,1429,4876,28,439,78,1986,9038
1.056,17,2,154,1,33,0,33,61,1,65,0,65,93
30.498,17,4,352,2,60,30497,60,176,2,60,30497,60,176
300.539,6,16,1159,8,177,42910,177,637,8,110,42910,110,522
22.113,6,16,3125,5,593,5528,593,849,11,212,2083,212,2276
61.809,6,75,52034,46,1210,1373,1408,42386,29,813,2199,1408,9648
30.374,6,3855,3496624,2319,1420,12,1448,3405116,1536,776,19,1448,91508
106.043,6,123,87367,75,1254,1433,1408,76673,48,742,2090,3847,10694
0.94,6,10,1687,7,100,156,100,384,3,1179,339,1179,1303
1554.894,1,7,392,7,28,259149,28,392,0,0,0,0,0
5.897,6,42,8577,21,239,294,314,3953,21,472,253,1179,4624
1786.409,6,104,8376,68,65,26662,65,4930,36,59,51037,59,3446
280.488,6,28,7352,12,158,25498,267,1277,16,603,18689,1400,6075
0.293,6,26,8946,13,244,24,618,1663,13,1099,24,2816,7283
280.453,6,29,7392,14,158,21573,267,1357,15,678,20028,3456,6035
0.132,17,2,146,1,37,0,37,65,1,53,0,53,81
1776.895,17,73,3060,72,14,25026,14,3024,1,8,0,8,36
0.004,17,2,549,1,30,0,30,58,1,463,0,463,491
27.491,17,8,3148,8,365,3927,373,3148,0,0,0,0,0
1788.096,17,87,3648,86,14,21036,14,3612,1,8,0,8,36
0.169,2,3,96,3,8,84,8,96,0,0,0,0,0
111.953,6,23,8214,11,520,95,1223,2034,12,812,10161,1440,6180
1779.846,6,355,22549,207,69,8640,69,12420,148,69,12107,69,10129
0.718,17,24,17634,14,1038,51,1350,14934,10,242,71,1350,2700
0.246,1,2,112,2,28,246,28,112,0,0,0,0,0
95.786,1,4,589,4,119,31928,142,589,0,0,0,0,0
1796.288,6,367,25650,214,99,8433,469,15045,153,69,11814,69,10605
364.315,6,23,1535,16,177,24287,177,1053,7,110,10357,110,482
8.225,6,566,461829,339,1292,23,1368,445361,227,776,35,1473,16468
201.094,6,47,6637,25,138,8378,722,2828,22,204,9562,1408,3809
1747.132,6,95,7203,63,38,28179,205,4476,32,33,56351,98,2727
10.933,6,20,4442,11,275,1093,275,998,9,768,768,1440,3444
1795.645,2,15,480,15,8,128260,8,480,0,0,0,0,0
1770.94,6,101,9410,66,66,27245,66,5610,35,60,52083,60,3800
1779.887,17,142,11360,71,48,25426,48,5396,71,56,25426,56,5964
1799.938,17,144,11520,72,48,25351,48,5472,72,56,25351,56,6048
10.179,6,22,3613,12,211,925,211,1102,10,665,1130,904,2511
34.871,17,40,5880,20,48,1834,48,1520,20,190,1834,308,4360
0.27,6,26,6066,13,164,22,453,1494,13,555,21,1542,4572
300.987,6,41,15259,22,977,14332,1460,9697,19,399,489,1460,5562
1.627,6,40,8427,21,321,81,1164,2846,19,437,77,2715,5581
1.312,6,11,1727,7,100,218,100,384,4,589,346,1152,1343
0.031,17,2,144,1,36,0,36,64,1,52,0,52,80
0.19,17,2,2384,2,1164,190,1164,2384,0,0,0,0,0
0.934,17,2,134,2,39,934,39,134,0,0,0,0,0
235.011,1,60,1680,60,0,0,0,1680,0,0,0,0,0
0.519,17,4,668,2,32,514,32,120,2,246,511,246,548
50.835,17,16,18211,16,1110,3389,1451,18211,0,0,0,0,0
30.128,6,20,4448,12,271,2738,515,1299,8,565,4266,1452,3149
116.253,17,8,2688,8,308,16607,308,2688,0,0,0,0,0
142.565,6,21,7979,11,525,85,1237,2048,10,919,15821,1591,5931
2.175,6,52,19638,27,910,83,1440,13862,25,433,81,1440,5776
9.947,6,79,24669,39,560,261,1152,18928,40,459,246,1179,5741
11.591,6,22,6817,12,275,1053,275,1038,10,1073,731,1420,5779
0.08,17,2,425,1,36,0,36,64,1,333,0,333,361
1.74,6,39,9888,20,502,91,1460,4352,19,433,84,1460,5536
1.956,6,15,2623,6,288,355,288,560,9,422,222,434,2063
1783.183,6,354,22440,207,69,8656,69,12420,147,69,12213,69,10020
0.077,17,2,586,1,46,0,46,74,1,484,0,484,512
1795.563,17,142,11360,71,48,25650,48,5396,71,56,25650,56,5964
1744.734,2,29,928,29,8,62311,8,928,0,0,0,0,0
1.508,6,24,8004,12,164,118,267,1288,12,1014,118,2491,6716
1.072,6,37,8284,19,254,59,671,1810,18,441,54,1440,6474
0.989,17,17,8161,8,577,136,1350,4845,9,340,116,1350,3316
0.799,6,24,6580,13,336,66,1020,2206,11,786,79,1420,4374
14.153,6,36,7502,17,154,869,722,2023,19,407,775,2026,5479
175.374,17,2,72,1,8,0,8,36,1,8,0,8,36
0.833,17,11,4968,5,468,208,1350,2482,6,386,95,1350,2486
0.558,6,120,87945,54,131,10,232,2689,66,1354,8,2860,85256
1797.47,1,266,14896,266,28,6782,28,14896,0,0,0,0,0
175.214,6,61,39258,39,1128,4610,1408,31374,22,841,2927,2439,7884
1773.255,6,181,15589,120,69,14901,69,8940,61,69,29552,69,6649
1.599,6,41,11378,22,547,76,1360,5842,19,476,76,2715,5536
1783.424,17,83,3480,82,14,22017,14,3444,1,8,0,8,36
1774.689,6,180,15480,120,69,14913,69,8940,60,69,30074,69,6540
1788.574,17,348,26448,348,48,5154,48,26448,0,0,0,0,0
214.883,6,192,29715,103,304,2106,304,20172,89,83,2426,83,9543
1799.497,17,449,39928,404,35,4465,288,25708,45,288,40022,288,14220
0.476,6,26,8890,13,232,39,569,1614,13,941,36,1438,7276
20.494,17,8,1176,4,48,6827,48,304,4,190,6827,308,872
2.944,17,3,468,3,128,1472,128,468,0,0,0,0,0
299.582,6,6,364,4,31,99860,31,222,2,31,299558,31,142
842.996,17,8,592,4,30,280992,30,232,4,62,280993,62,360
30.958,6,9,372,7,0,5159,0,284,2,0,1157,0,88
19.941,17,4,352,2,48,19931,48,152,2,72,19930,72,200
3.993,6,10,420,6,0,798,0,248,4,0,985,0,172
611.491,6,100,6710,45,46,13897,46,2992,55,46,11323,46,3718
0.875,6,23,6460,13,323,72,954,2140,10,979,96,1731,4320
1665.091,1,7,392,7,28,277515,28,392,0,0,0,0,0
1.317,6,47,19521,27,916,50,1360,13945,20,433,60,1360,5576
38.288,6,33,9071,10,146,1068,267,1138,23,412,1739,1420,7933
1795.801,17,449,39928,404,35,4456,288,25708,45,288,40017,288,14220
280.29,6,29,7392,13,158,23357,267,1317,16,603,18682,2036,6075
0.432,6,12,1653,6,288,79,288,548,6,426,52,434,1105
299.543,6,6,364,4,31,99847,31,222,2,31,299524,31,142
631.179,6,44,8307,27,132,14649,498,2668,17,330,39443,1420,5639
4.945,17,4,288,2,36,4897,36,128,2,52,4897,52,160
2.981,17,32,8665,15,337,210,1350,5488,17,158,184,1350,3177
2.902,17,4,518,3,39,712,39,201,1,289,0,289,317
1702.062,1,8,848,8,78,243151,78,848,0,0,0,0,0
1.118,6,24,8004,12,164,86,267,1288,12,1014,86,2411,6716
1060.549,6,237,23383,116,117,9222,1189,9361,121,145,8837,1420,14022
1788.697,6,129,15381,82,89,22082,510,6875,47,161,38881,1380,8506
14.54,6,99,27945,48,508,309,1152,20741,51,430,285,1179,7204
0.111,6,6,328,4,0,37,0,216,2,0,67,0,112
1786.394,17,87,3648,86,14,21016,14,3612,1,8,0,8,36
5.816,6,43,8329,22,227,276,314,4062,21,489,277,1179,4267
50.195,17,4,240,2,32,50194,32,120,2,32,50193,32,120
1682.901,17,14,3827,7,30,280481,30,406,7,460,280481,463,3421
1787.681,17,142,11360,71,48,25537,48,5396,71,56,25537,56,5964
0.076,6,3,136,2,0,76,0,88,1,0,0,0,48
374.764,6,25,1651,17,177,23422,177,1117,8,110,9257,110,534
7.008,6,29,7464,12,155,637,267,1266,17,423,437,3417,6198
2.525,6,20,4555,11,289,252,567,1311,9,575,296,1380,3244
27.568,6,36,8362,16,175,1703,721,2047,20,551,1441,1440,6315
0.002,6,5,260,0,0,0,0,0,5,0,0,0,260
1797.004,17,180,14040,180,50,10039,50,14040,0,0,0,0,0
12.686,6,2404,2240244,1537,1380,8,1408,2190496,867,931,14,2816,49748
31.003,1,20,560,20,0,0,0,560,0,0,0,0,0
376.604,6,19,1303,11,177,37660,177,769,8,110,9255,110,534
2.235,6,17,1593,9,222,277,222,1034,8,231,314,231,559
1.356,17,4,947,2,33,1344,37,123,2,384,1346,463,824
1.683,6,48,16873,27,840,64,1360,11212,21,400,72,1360,5661
0.582,6,59,25799,33,1069,18,1380,18537,26,475,21,1923,7262
1780.487,17,140,11200,70,48,25804,48,5320,70,56,25804,56,5880
1785.856,6,357,22629,208,69,8627,69,12460,149,69,12066,69,10169
1.43,6,38,8252,19,320,79,1162,2716,19,433,69,1440,5536
1081.615,6,131,18914,63,100,17442,721,5724,68,222,16140,1440,13190
1593.349,1,8,448,8,28,227621,28,448,0,0,0,0,0
1.155,6,27,9624,13,164,81,267,1396,14,936,75,1408,8228
6.008,6,18,3858,8,150,858,174,624,10,471,658,1452,3234
139.743,6,31,13276,15,488,346,1440,3075,16,954,9307,1440,10201
598.884,6,62,5309,41,69,14972,69,3089,21,69,29943,69,2220
61.31,6,37,16031,22,810,2919,1440,9253,15,665,4360,1440,6778
119.596,17,4,352,2,60,119595,60,176,2,60,119595,60,176
33.435,6,29,4991,14,180,2571,722,1808,15,342,2374,1448,3183
0.019,6,2,80,1,0,0,0,40,1,0,0,0,40
61.256,6,15,7788,5,174,15314,174,378,10,1399,6796,1452,7410
1780.569,17,138,11032,70,48,25805,48,5320,68,56,26575,56,5712
50.652,17,4,352,2,60,50651,60,176,2,60,50651,60,176
0.267,17,2,304,1,60,0,60,88,1,188,0,188,216
0.055,17,4,240,2,32,53,32,120,2,32,53,32,120
0.041,17,2,152,1,48,0,48,76,1,48,0,48,76
0.948,17,20,6982,9,429,118,1350,4118,11,232,88,1350,2864
228.859,17,12,1056,6,48,45770,48,456,6,72,45770,72,600
1.706,6,14,2351,8,188,243,245,700,6,703,288,1152,1651
0.017,17,5,740,4,64,0,64,368,1,344,0,344,372
6.813,17,37,8523,11,247,680,1350,3031,26,183,271,1350,5492
2.7,6,18,3257,10,99,280,182,924,8,477,360,1343,2333
2.544,6,56,14167,27,551,97,1429,5020,29,419,83,1986,9147
2.329,17,2,154,1,33,0,33,61,1,65,0,65,93
1777.668,1,82,4592,82,28,21946,28,4592,0,0,0,0,0
125.341,6,14,3144,7,92,20890,92,452,7,464,20860,1408,2692
22.673,6,47,13947,22,315,1071,721,3409,25,635,937,1440,10538
0.387,17,2,152,1,48,0,48,76,1,48,0,48,76
342.832,6,28,7050,16,169,22855,517,1659,12,490,31132,1452,5391
1.662,6,25,8763,15,285,118,587,1459,10,985,166,1420,7304
1783.545,17,124,9920,62,48,29237,48,4712,62,56,29237,56,5208
0.329,6,14,1117,10,182,36,182,746,4,77,99,134,371
0.0,6,3,450,0,0,0,0,0,3,165,0,261,450
0.062,6,2,104,1,0,0,0,64,1,0,0,0,40
1748.003,6,98,7402,64,38,27746,205,4559,34,33,52962,98,2843
0.043,17,2,350,1,36,0,36,64,1,258,0,258,286
0.114,1,2,112,2,28,114,28,112,0,0,0,0,0
240.363,2,2,64,2,8,240363,8,64,0,0,0,0,0
0.032,17,2,317,1,43,0,43,71,1,218,0,218,246
1771.094,6,101,9415,67,65,26834,65,5641,34,59,53666,59,3774
300.28,6,31,11821,17,592,18767,1402,4446,14,829,18479,1402,7375
739.976,6,46,3635,30,66,25516,66,2124,16,58,49325,60,1511
1792.413,6,355,22480,207,69,8701,69,12420,148,69,12193,69,10060
165.161,6,23,940,9,0,6070,0,364,14,0,12703,0,576
58.127,17,4,352,2,60,58126,60,176,2,60,58126,60,176
1774.57,6,184,15916,120,69,14912,69,8940,64,69,28164,69,6976
0.386,17,2,144,1,36,0,36,64,1,52,0,52,80
109.01,17,4,352,2,60,109009,60,176,2,60,109009,60,176
9.832,6,4,1183,0,0,0,0,0,4,341,3277,341,1183
1777.372,17,140,11200,70,48,25758,48,5320,70,56,25758,56,5880
2.798,17,23,6233,10,226,310,1350,2548,13,255,129,1350,3685
10.769,6,18,5610,10,275,1196,275,958,8,1440,816,1440,4652
10.768,6,18,5610,10,275,1196,275,958,8,1440,822,1440,4652
0.074,6,9,1002,5,213,18,213,417,4,421,21,421,585
4.316,17,17,15609,6,484,863,1350,3076,11,1111,311,1350,12533
34.286,6,33,7411,16,180,2285,721,1947,17,572,2128,2026,5464
1784.213,17,175,29763,175,142,10254,389,29763,0,0,0,0,0
303.205,6,30,10532,15,534,21657,1066,3460,15,628,2443,1448,7072
1795.843,1,162,9072,162,28,11154,28,9072,0,0,0,0,0
60.053,6,8,432,5,0,15013,0,268,3,0,30016,0,164
1683.539,17,14,1036,7,30,280586,30,406,7,62,280588,62,630
240.176,6,62,18937,33,799,7505,1402,15379,29,170,8577,580,3558
0.427,6,51,21431,28,1007,15,1380,16269,23,421,17,1923,5162
1782.673,17,83,3480,82,14,22008,14,3444,1,8,0,8,36
1782.328,6,102,8296,68,65,26601,65,4930,34,59,54006,59,3366
46.383,6,27,7177,13,155,3865,267,1306,14,530,3567,3417,5871
0.388,6,25,6073,13,181,32,537,1578,12,643,33,1440,4495
1792.84,1,58,4872,0,0,0,0,0,58,56,31453,56,4872
372.049,6,18,1242,14,180,28619,180,916,4,110,20055,110,326
709.007,1,20,1120,20,28,37316,28,1120,0,0,0,0,0
0.15,17,4,288,2,36,133,36,128,2,52,118,52,160
0.276,17,2,152,1,48,0,48,76,1,48,0,48,76
1795.811,6,349,29846,187,78,9654,267,12811,162,119,11154,1452,17035
23.643,6,26,6845,12,181,2149,267,1212,14,633,1815,2036,5633
1788.494,6,225,19861,83,82,21809,377,9105,142,70,12683,1062,10756
150.785,6,6,1257,4,327,50261,414,815,2,181,150621,270,442
0.013,6,4,232,3,0,6,0,180,1,0,0,0,52
5.878,6,44,8385,22,227,279,314,4062,22,491,267,1179,4323
119.901,17,6,360,3,32,59950,32,180,3,32,59950,32,180
1799.678,6,361,22858,210,69,8610,69,12678,151,69,11997,69,10180
1.125,6,24,8004,12,164,87,267,1288,12,1014,87,2804,6716
65.112,6,38,9296,16,327,191,1189,2615,22,413,3099,1460,6681
280.314,6,29,7392,13,158,23359,267,1317,16,603,18677,2036,6075
1799.376,17,449,39928,404,35,4464,288,25708,45,288,40019,288,14220
0.019,17,2,475,1,40,0,40,68,1,379,0,379,407
472.338,6,53,7245,25,116,12615,516,2405,28,176,17490,1452,4840
1770.929,6,110,11908,70,109,25665,823,7464,40,67,45406,192,4444
1793.63,6,319,49329,202,302,8923,302,36182,117,83,15462,83,13147
14.466,6,6,328,4,0,4822,0,216,2,0,14444,0,112
1786.807,6,106,8584,69,66,26276,66,5004,37,60,49630,60,3580
1785.859,6,381,26555,219,97,8191,469,15521,162,69,11092,69,11034
1786.912,6,112,8884,70,66,25897,66,5044,42,60,43573,60,3840
0.043,17,4,344,2,47,0,47,150,2,69,0,75,194
1798.553,1,288,16128,288,28,6266,28,16128,0,0,0,0,0
0.017,6,5,15736,1,0,0,0,40,4,3872,0,8448,15696
0.023,6,2,1540,1,1460,0,1460,1500,1,0,0,0,40
360.106,6,54,10503,32,266,11616,1360,4821,22,399,597,1360,5682
353.87,6,50,11025,30,320,12202,1360,5423,20,435,513,2667,5602
1798.645,17,449,39928,404,35,4463,288,25708,45,288,40018,288,14220
579.583,6,113,7349,63,69,9145,69,3831,50,69,11828,69,3518
297.298,17,4,304,2,48,297297,64,152,2,48,297297,64,152
1775.096,6,180,15480,120,69,14916,69,8940,60,69,30083,69,6540
300.283,6,44,29526,25,190,12511,444,2117,19,2031,13435,11264,27409
156.185,6,25,10343,13,433,100,990,1863,12,998,14187,1390,8480
0.029,17,2,322,1,33,0,33,61,1,233,0,233,261
372.378,6,23,1535,16,177,24825,177,1053,7,110,10379,110,482
2.834,17,4,624,4,128,944,128,624,0,0,0,0,0
12.711,6,8,336,4,0,4235,0,164,4,0,4234,0,172
186.488,6,29,6653,11,220,6526,516,1325,18,306,10964,1452,5328
1778.694,17,363,59449,363,135,4913,363,59449,0,0,0,0,0
1763.756,2,14,448,14,8,135673,8,448,0,0,0,0,0
19.106,17,35,12956,19,523,1058,1350,10480,16,126,1270,1350,2476
0.04,17,2,176,1,60,0,60,88,1,60,0,60,88
503.196,2,4,128,4,8,167732,8,128,0,0,0,0,0
159.833,6,25,9789,12,531,65,1460,2637,13,945,13307,1460,7152
43.231,1,8,3042,8,352,6175,353,3042,0,0,0,0,0
356.319,6,39,7478,19,143,15541,516,1910,20,280,18748,1452,5568
5.392,6,40,7325,20,218,283,314,3423,20,516,270,1179,3902
1799.575,6,360,22818,210,69,8610,69,12540,150,69,12077,69,10278
33.683,6,8,480,0,0,0,0,0,8,0,0,0,480
0.012,17,3,404,2,64,3,64,184,1,192,0,192,220
61.437,6,10,544,6,0,12287,0,320,4,0,20349,0,224
1.724,6,13,2311,8,188,246,245,700,5,1407,364,1407,1611
0.385,6,43,16801,24,900,16,1380,11798,19,468,19,3304,5003
1798.241,17,448,39896,403,35,4473,288,25676,45,288,40020,288,14220
582.707,6,35,2521,19,31,32372,31,1255,16,31,38710,31,1266
1678.717,1,8,848,8,78,239816,78,848,0,0,0,0,0
1.246,6,57,17523,36,335,35,1360,9530,21,714,54,4080,7993
1.555,6,116,87653,50,131,31,232,2529,66,1352,20,1430,85124
6.261,6,29,9083,13,265,521,764,1767,16,922,417,1408,7316
367.125,6,27,1767,18,177,21595,177,1181,9,110,8830,110,586
1.725,6,38,8344,20,351,90,1420,2560,18,506,101,1485,5784
57.71,6,8,615,2,267,57710,267,347,6,7,11505,7,268
1686.272,1,8,448,8,28,240896,28,448,0,0,0,0,0
14.932,6,107,32676,55,515,276,1152,24377,52,414,287,1179,8299
29.665,6,4351,4195501,2911,1365,10,1408,4115957,1440,776,20,1408,79544
601.623,6,35,6539,19,250,33423,1314,2516,16,307,40107,1420,4023
0.169,6,9,1144,5,145,42,145,349,4,631,40,631,795
104.979,17,101,27186,54,40,1980,41,3710,47,471,2273,505,23476
660.441,6,61,7459,36,88,18864,721,3379,25,174,27510,1448,4080
1756.202,6,104,6190,60,26,29765,27,3512,44,26,40840,26,2678
0.042,17,3,1066,3,327,21,355,1066,0,0,0,0,0
185.504,6,39,18138,19,682,156,1460,3593,20,980,9754,1460,14545
30.915,17,6,468,6,50,6183,50,468,0,0,0,0,0
0.007,17,2,162,1,34,0,34,62,1,72,0,72,100
0.086,17,2,386,1,46,0,46,74,1,284,0,284,312
1799.097,17,449,39928,404,35,4464,288,25708,45,288,40021,288,14220
0.062,17,4,608,2,60,46,60,176,2,188,15,188,432
1799.88,17,450,39960,405,35,4455,288,25740,45,288,40020,288,14220
1772.652,1,60,5040,0,0,0,0,0,60,56,30044,56,5040
166.781,17,2,136,2,40,166781,47,136,0,0,0,0,0
1785.151,6,318,55851,199,304,9015,304,41148,119,83,15128,83,14703
0.532,17,8,2750,8,315,76,354,2750,0,0,0,0,0
0.006,17,2,186,1,33,0,33,61,1,97,0,97,125
1789.301,6,105,8484,68,66,26705,66,4964,37,60,49700,60,3520
1786.514,6,102,8364,68,66,26664,66,4964,34,60,54134,60,3400
1116.628,17,220,16720,220,48,5098,48,16720,0,0,0,0,0
0.371,17,8,2742,8,314,53,353,2742,0,0,0,0,0
1793.399,17,142,11360,71,48,25619,48,5396,71,56,25619,56,5964
1770.146,6,223,19053,83,74,21585,301,8474,140,70,12734,1062,10579
1780.929,1,342,28728,342,56,5222,56,28728,0,0,0,0,0
0.633,17,6,450,3,37,315,37,195,3,57,314,65,255
24.972,17,4,320,2,48,24962,48,152,2,56,24961,56,168
1679.372,1,74,7844,74,78,23005,78,7844,0,0,0,0,0
0.557,17,4,1375,4,315,185,354,1375,0,0,0,0,0
149.232,17,4,1344,4,308,49744,308,1344,0,0,0,0,0
1.734,6,5,415,0,0,0,0,0,5,31,433,31,415
1795.091,17,80,3354,79,14,23013,14,3318,1,8,0,8,36
0.583,17,4,368,2,32,250,32,120,2,96,263,96,248
0.736,6,4,220,2,0,736,0,100,2,0,302,0,120
1787.063,17,87,3648,86,14,21024,14,3612,1,8,0,8,36
6.062,6,26,7927,16,364,404,1125,3193,10,721,659,1420,4734
1.391,6,10,1687,7,100,231,100,384,3,1179,531,1179,1303
1779.559,6,102,8228,68,64,26560,64,4896,34,58,53923,58,3332
15.815,6,30,8872,13,158,1317,267,1317,17,687,985,1400,7555
1797.224,6,365,25032,213,94,8477,469,14536,152,69,11901,69,10496
1780.66,17,327,54297,327,138,5462,366,54297,0,0,0,0,0
40.96,6,7,418,3,69,3794,69,189,4,69,13653,69,229
5.049,6,43,7429,22,218,240,314,3503,21,440,239,1152,3926
1680.516,17,12,498,11,14,168051,14,462,1,8,0,8,36
221.817,6,31,8912,14,158,17062,267,1357,17,763,13858,2600,7555
0.009,17,2,2072,2,1008,9,1008,2072,0,0,0,0,0
1.659,6,51,19325,29,887,59,1360,13624,22,400,67,1360,5701
18.756,17,4,824,2,48,18743,48,152,2,308,18742,308,672
258.937,1,6,336,6,28,51787,28,336,0,0,0,0,0
0.433,17,2,152,1,48,0,48,76,1,48,0,48,76
5.042,17,3,401,2,37,5002,37,130,1,243,0,243,271
936.031,6,118,8835,45,66,20591,293,4178,73,48,13000,78,4657
1772.543,6,180,15480,120,69,14895,69,8940,60,69,30040,69,6540
1779.91,6,111,9431,70,71,25795,292,5302,41,63,44495,247,4129
13.357,6,23,6508,11,280,1331,517,1422,12,744,1209,1408,5086
95.594,6,36,8254,11,142,4753,267,1301,25,283,3982,1420,6953
63.19,6,15,5846,4,106,21063,106,274,11,639,6301,1452,5572
4.26,6,14,3144,8,49,608,92,511,6,579,106,1448,2633
23.777,6,35,8320,17,378,536,786,1846,18,478,1391,2720,6474
64.844,6,34,8998,14,327,235,1189,2535,20,471,3412,1420,6463
101.137,6,133,49929,69,665,1487,1360,36708,64,380,1599,1360,13221
0.988,6,10,1687,7,100,164,100,384,3,1179,365,1179,1303
7.249,6,5,240,1,0,0,0,48,4,0,2413,0,192
1799.931,1,16,896,16,28,119995,28,896,0,0,0,0,0
541.439,2,6,192,6,8,108287,8,192,0,0,0,0,0
481.27,2,6,192,6,8,96254,8,192,0,0,0,0,0
0.37,6,12,3704,6,171,61,171,491,6,964,51,1448,3213
20.325,6,23,5533,13,107,1693,159,1126,10,966,2251,1708,4407
26.989,17,6,1236,3,48,13488,48,228,3,308,13488,308,1008
599.097,6,9,546,6,31,119819,31,333,3,31,299529,31,213
3.015,17,4,340,2,37,3008,37,130,2,77,3007,77,210
1.394,6,47,19463,27,912,53,1360,13887,20,433,63,1360,5576
1785.853,6,356,22520,208,69,8627,69,12460,148,69,12148,69,10060
2.711,17,4,1556,4,361,903,361,1556,0,0,0,0,0
0.151,17,4,420,2,33,1,33,122,2,121,131,145,298
154.083,17,8,336,8,14,22011,14,336,0,0,0,0,0
244.809,6,65,22237,33,852,7649,1368,18796,32,161,7896,580,3441
72.875,6,72,43543,41,1179,1821,1448,35176,31,749,2086,1448,8367
19.551,6,39,7285,17,218,613,314,3303,22,516,919,1179,3982
1797.156,1,58,4872,0,0,0,0,0,58,56,31529,56,4872
1788.294,6,209,24856,109,137,16558,721,14389,100,184,18059,4260,10467
0.227,17,2,212,1,46,0,46,74,1,110,0,110,138
1793.487,6,366,23196,212,69,8499,69,12896,154,69,11721,69,10300
21.961,6,6,946,6,105,4392,136,946,0,0,0,0,0
44.049,6,30,7432,13,158,3670,267,1317,17,543,2751,1400,6115
0.382,6,10,767,5,186,94,186,454,5,45,86,45,313
126.063,2,2,64,2,8,126063,8,64,0,0,0,0,0
1624.336,2,11,352,11,8,162433,8,352,0,0,0,0,0
1777.016,17,73,3060,72,14,25028,14,3024,1,8,0,8,36
851.299,6,10,1390,10,110,94588,110,1390,0,0,0,0,0
0.07,17,8,1670,8,180,10,219,1670,0,0,0,0,0
189.413,17,2,386,2,165,189413,165,386,0,0,0,0,0
61.786,6,27,7177,13,155,5148,267,1306,14,530,4752,3417,5871
7.28,6,3,136,2,0,7280,0,88,1,0,0,0,48
1.973,6,14,2351,8,188,281,245,700,6,703,345,1152,1651
1789.523,17,142,11360,71,48,25564,48,5396,71,56,25564,56,5964
0.018,6,9,1880,5,910,4,910,1178,4,486,5,486,702
9.975,17,36,7905,10,229,1108,1350,2576,26,176,397,1350,5329
1.948,17,15,5424,15,333,139,361,5424,0,0,0,0,0
0.989,17,4,368,2,64,988,64,184,2,64,988,64,184
1720.674,17,13,534,11,14,172047,14,462,2,8,1720489,8,72
1783.029,17,142,11360,71,48,25471,48,5396,71,56,25471,56,5964
28.283,6,6,505,2,245,28283,245,329,4,0,2424,0,176
1773.336,6,181,15589,120,69,14901,69,8940,61,69,29550,69,6649
1088.991,6,115,15064,64,304,17285,304,10364,51,83,21779,83,4700
280.519,6,30,7432,14,158,21578,267,1357,16,678,18695,3456,6075
1772.254,6,180,15480,120,69,14892,69,8940,60,69,30035,69,6540
0.356,17,2,180,1,30,0,30,58,1,94,0,94,122
1.366,6,47,19314,27,901,52,1360,13738,20,476,61,2715,5576
3.515,2,4,160,4,16,1171,16,160,0,0,0,0,0
1772.003,6,180,15480,120,69,14890,69,8940,60,69,30033,69,6540
124.305,6,23,11398,12,397,73,884,1717,11,1318,12416,3928,9681
1786.551,6,102,8296,68,65,26664,65,4930,34,59,54135,59,3366
280.157,6,28,7352,13,158,23346,267,1317,15,678,20010,2045,6035
0.116,17,2,372,1,34,0,34,62,1,282,0,282,310
4.074,6,12,1036,6,283,779,283,603,6,105,779,105,433
1782.957,6,356,22520,208,69,8613,69,12460,148,69,12128,69,10060
1775.835,1,54,4536,0,0,0,0,0,54,56,33506,56,4536
1779.122,17,142,11360,71,48,25415,48,5396,71,56,25415,56,5964
1786.017,17,544,62890,251,147,7144,1350,44093,293,36,6113,1350,18797
76.63,6,35,7909,13,162,6385,267,1503,22,367,3640,1460,6406
268.225,6,84,13477,42,239,5165,1189,5513,42,348,6541,4837,7964
280.357,6,31,7472,14,158,21565,267,1357,17,543,17520,1400,6115
59.936,6,623,284612,320,819,187,1152,266971,303,424,197,1179,17641
280.193,6,26,7272,12,158,25472,267,1277,14,775,21549,3445,5995
7.473,6,1122,1022835,729,1358,10,1380,1000790,393,558,18,1923,22045
11.836,6,25,8473,13,275,986,275,1078,12,986,866,1440,7395
127.427,6,358,275840,165,473,411,648,10543,193,1387,662,1782,265297
0.01,17,2,280,1,48,0,48,76,1,176,0,176,204
1796.296,6,368,26159,214,105,8433,469,15514,154,69,11739,69,10645
1794.368,17,144,11520,72,48,25272,48,5472,72,56,25272,56,6048
1783.807,6,414,24840,207,69,8659,69,12420,207,34,8659,69,12420
1598.314,1,8,448,8,28,228330,28,448,0,0,0,0,0
1771.597,6,128,11559,77,65,23310,65,6546,51,59,35429,59,5013
19.859,17,24,3528,12,48,1804,48,912,12,190,1804,308,2616
32.052,6,278,269357,95,131,340,316,5334,183,1421,176,2836,264023
1.29,6,47,19570,27,920,49,1460,13994,20,433,58,1460,5576
1777.582,17,79,3312,78,14,23085,14,3276,1,8,0,8,36
125.386,6,15,3196,7,92,20897,92,452,8,387,17885,1440,2744
0.159,6,29,7376,14,155,12,267,1341,15,543,10,1400,6035
18.232,6,26,4973,12,358,1656,1452,3712,14,231,1401,231,1261
240.376,6,47,8655,23,449,10925,1418,5712,24,187,10450,580,2943
47.222,17,13,988,13,48,3935,48,988,0,0,0,0,0
1417.278,1,12,672,12,28,128843,28,672,0,0,0,0,0
58.406,17,4,352,2,60,58405,60,176,2,60,58405,60,176
2.459,6,5,260,2,0,1701,0,104,3,0,1229,0,156
0.075,17,2,456,1,60,0,60,88,1,340,0,340,368
1720.707,17,12,498,11,14,172070,14,462,1,8,0,8,36
12.223,6,1990,1682372,1187,1363,10,1380,1645965,803,387,15,1923,36407
280.078,6,29,7392,13,158,23339,267,1317,16,603,18666,1400,6075
126.814,6,30,7432,13,158,10567,267,1317,17,543,7923,1400,6115
10.614,6,20,4442,11,275,1061,275,998,9,768,729,1440,3444
87.69,6,727,341597,378,840,232,1152,322846,349,398,251,1152,18751
1785.758,6,102,8364,68,66,26653,66,4964,34,60,54111,60,3400
1669.447,1,7,392,7,28,278241,28,392,0,0,0,0,0
21.954,6,21,4827,12,211,1995,211,1277,9,617,2744,904,3550
215.869,17,4,352,2,60,215868,60,176,2,60,215868,60,176
0.384,17,2,384,1,36,0,36,64,1,292,0,292,320
1370.918,6,274,17377,159,69,8676,69,9603,115,69,12025,69,7774
21.515,17,4,240,2,32,21514,32,120,2,32,21514,32,120
1797.123,6,355,22480,207,69,8723,69,12420,148,69,12225,69,10060
25.611,6,24,6232,14,117,1970,159,1337,10,727,2844,1418,4895
0.025,17,2,212,1,46,0,46,74,1,110,0,110,138
1680.948,1,15,840,15,28,120067,28,840,0,0,0,0,0
11.911,6,1754,1625275,1147,1365,10,1432,1596692,607,475,19,1871,28583
1772.67,6,180,15480,120,69,14896,69,8940,60,69,30041,69,6540
0.214,17,2,303,1,45,0,45,73,1,202,0,202,230
31.779,6,7,308,1,0,0,0,44,6,0,6287,0,264
0.685,6,23,5715,13,158,56,370,1315,10,999,75,1737,4400
36.533,6,30,7297,14,155,2810,267,1346,16,441,2435,1420,5951
524.575,6,68,10731,38,229,12006,981,5887,30,130,18088,421,4844
3.062,6,10,420,6,0,612,0,248,4,0,955,0,172
1203.899,17,307,28056,274,37,4409,288,17876,33,280,37522,288,10180
80.333,6,75,48805,45,1192,1825,1448,40513,30,747,2125,1448,8292
0.703,6,23,5715,13,158,58,370,1315,10,999,77,1731,4400
0.008,6,16,4036,10,101,0,101,629,6,771,1,1000,3407
0.199,17,2,194,1,61,0,61,89,1,77,0,77,105
11.736,6,21,4482,11,275,1173,275,998,10,768,1189,1440,3484
26.828,6,43,13565,21,330,1341,721,3158,22,732,1257,2840,10407
2.096,17,6,1525,3,40,1041,40,204,3,412,1041,423,1321
300.948,6,38,9598,21,540,15047,1360,4116,17,435,540,2667,5482
1787.681,6,106,8388,68,64,26681,64,4896,38,58,48313,58,3492
0.064,17,4,284,2,32,48,32,120,2,54,49,60,164
0.585,6,22,7342,12,335,52,668,1974,10,1210,64,1906,5368
1784.871,6,104,8376,68,65,26639,65,4930,36,59,50994,59,3446
0.866,6,15,3660,8,101,123,101,533,7,1373,144,1448,3127
619.156,17,9,780,6,32,123831,37,362,3,111,22696,136,418
1.674,6,29,9458,14,164,114,267,1571,15,885,106,1408,7887
1772.004,6,99,9240,66,65,27261,65,5577,33,59,55372,59,3663
280.054,6,29,7392,14,158,21542,267,1357,15,678,20000,3436,6035
37.076,6,17,2069,9,304,4634,304,1376,8,83,5118,83,693
0.026,6,10,1723,6,578,4,997,1400,4,159,8,159,323
176.824,17,4,352,2,60,176822,60,176,2,60,176823,60,176
161.819,17,6,753,6,97,32363,355,753,0,0,0,0,0
31.04,17,6,638,6,78,6208,84,638,0,0,0,0,0
1798.745,17,450,39960,405,35,4452,288,25740,45,288,40016,288,14220
14.556,6,973,875370,633,1312,22,1368,853014,340,776,42,1473,22356
21.711,6,28,7352,13,158,1809,267,1317,15,678,1547,2045,6035
176.659,17,4,352,2,60,176658,60,176,2,60,176658,60,176
1678.867,1,7,742,7,78,279811,78,742,0,0,0,0,0
1783.476,6,104,8354,68,63,26619,63,4862,36,57,50953,57,3492
313.888,6,18,1656,3,106,7779,106,234,15,79,22419,90,1422
11.363,6,1788,1569318,1086,1391,10,1420,1537017,702,467,16,1883,32301
0.085,6,19,4192,10,101,9,101,629,9,441,9,500,3563
1790.33,1,100,5600,100,28,18084,28,5600,0,0,0,0,0
0.019,6,10,1719,6,576,3,995,1396,4,159,6,159,323
1787.908,6,363,23007,211,69,8513,69,12787,152,69,11840,69,10220
163.452,17,4,272,2,40,163451,47,136,2,40,163451,47,136
185.527,17,4,240,2,32,185526,32,120,2,32,185526,32,120
3.223,6,2,142,1,0,0,0,40,1,62,0,62,102
278.549,17,4,352,2,60,278548,60,176,2,60,278548,60,176
45.057,6,7,376,2,0,44871,0,112,5,0,11217,0,264
1.004,17,4,314,2,31,972,31,118,2,70,972,70,196
4.312,6,39,7269,19,218,239,314,3383,20,440,212,1152,3886
0.832,6,21,5988,12,281,75,544,1328,9,716,93,1420,4660
240.235,6,54,18188,28,812,8897,1418,15277,26,193,9608,580,2911
1.348,6,54,23489,29,1032,48,1440,17713,25,433,47,1440,5776
16.296,17,18,2528,9,48,2035,48,684,9,176,2032,308,1844
0.038,17,2,116,1,30,0,30,58,1,30,0,30,58
1.7,6,14,2351,8,188,242,245,700,6,703,286,1152,1651
1798.865,1,58,4872,0,0,0,0,0,58,56,31559,56,4872
130.279,6,8,2940,1,0,0,0,60,7,501,21682,1408,2880
0.092,1,2,112,2,28,92,28,112,0,0,0,0,0
1.884,17,2,184,2,64,1884,64,184,0,0,0,0,0
175.18,17,2,72,1,8,0,8,36,1,8,0,8,36
4.137,17,5,337,3,33,2065,33,183,2,49,3587,49,154
79.679,6,38,5670,22,154,3794,722,2236,16,371,1091,2026,3434
2.601,6,14,3653,7,75,433,75,522,7,1373,433,1448,3131
17.031,6,15,2245,8,324,2433,585,1073,7,396,2836,580,1172
1797.284,1,248,13888,248,28,7276,28,13888,0,0,0,0,0
0.107,1,2,112,2,28,107,28,112,0,0,0,0,0
6.038,6,36,12191,17,336,377,721,2030,19,722,269,1440,10161
213.603,17,4,352,2,60,213602,60,176,2,60,213602,60,176
0.637,17,3,404,2,64,617,64,184,1,192,0,192,220
11.78,6,19,4402,11,275,1178,275,998,8,768,1537,1440,3404
54.019,6,12,1206,7,483,9003,483,855,5,83,13483,83,351
6.848,6,501,405043,295,1302,22,1368,389283,206,776,32,1473,15760
1744.1,6,95,7203,63,38,28130,205,4476,32,33,56255,98,2727
0.127,6,30,11506,17,107,7,186,1668,13,1017,10,2235,9838
42.615,6,29,7257,13,155,3551,267,1306,16,441,2840,1420,5951
1624.839,1,8,448,8,28,232119,28,448,0,0,0,0,0
0.695,6,37,11243,21,607,34,1188,7167,16,359,39,1048,4076
0.293,6,22,7219,12,257,26,748,1663,10,1005,31,2381,5556
1681.73,17,16,1265,8,30,240245,37,471,8,71,240245,136,794
1741.49,17,29,6815,29,207,62196,207,6815,0,0,0,0,0
1779.783,6,287,34627,118,140,15210,1360,17022,169,128,10593,1360,17605
369.698,1,87,7308,87,56,4298,56,7308,0,0,0,0,0
240.176,6,52,17732,27,784,9237,1402,14741,25,210,10007,580,2991
201.824,17,3,181,3,32,100912,33,181,0,0,0,0,0
0.151,6,3,156,2,0,0,0,104,1,0,0,0,52
180.364,2,2,64,2,8,180364,8,64,0,0,0,0,0
1772.406,6,180,15480,120,69,14894,69,8940,60,69,30035,69,6540
1744.16,6,94,7151,62,38,28592,205,4424,32,33,56250,98,2727
182.671,2,4,128,4,8,60890,8,128,0,0,0,0,0
1.572,17,19,13101,11,936,157,1350,10607,8,283,135,1350,2494
1.272,6,10,1687,7,100,212,100,384,3,1179,499,1179,1303
5.339,17,4,288,2,36,4988,36,128,2,52,5000,52,160
1786.797,6,117,13795,75,81,24145,501,5950,42,162,43578,1420,7845
1741.041,6,90,6521,59,31,30017,31,3998,31,31,58034,31,2523
7.051,6,504,424379,310,1302,22,1368,409627,194,776,35,2736,14752
0.068,17,5,738,4,32,1,32,240,1,470,0,470,498
1787.907,6,367,25581,213,99,8433,469,15005,154,69,11685,69,10576
1770.21,6,99,9306,66,66,27234,66,5610,33,60,55316,60,3696
1746.812,6,103,7755,66,38,26874,205,4663,37,33,48516,98,3092
1677.286,6,93,6725,59,31,28918,31,4022,34,31,50825,31,2703
61.349,6,37,15881,22,795,2921,1448,9103,15,665,4363,1448,6778
582.603,1,6,489,6,53,116520,78,489,0,0,0,0,0
1771.16,6,101,9344,66,65,27248,65,5577,35,59,52089,59,3767
1751.172,6,183,11234,92,47,19243,208,6695,91,31,19454,31,4539
1777.335,1,212,11872,212,28,8423,28,11872,0,0,0,0,0
34.31,17,40,5880,20,48,1805,48,1520,20,190,1805,308,4360
13.156,17,4,352,2,48,13138,48,152,2,72,13141,72,200
95.584,6,891,433970,477,841,200,1152,411223,414,386,230,1152,22747
17.668,17,16,6258,8,480,2518,1350,4067,8,245,2518,1350,2191
300.586,6,36,8391,20,291,15820,786,1997,16,522,561,3488,6394
1.435,17,2,672,2,308,1435,308,672,0,0,0,0,0
0.605,17,2,204,1,34,0,34,62,1,114,0,114,142
823.09,17,32,10930,32,313,26551,548,10930,0,0,0,0,0
0.007,17,2,308,1,34,0,34,62,1,218,0,218,246
6.375,6,1603,1468198,1002,1388,6,1408,1432282,601,931,10,2801,35916
0.293,17,8,2750,8,315,41,354,2750,0,0,0,0,0
1.348,6,48,21295,28,971,49,1460,15719,20,433,61,1460,5576
5.805,6,41,7365,21,218,290,314,3463,20,516,291,1179,3902
0.11,6,13,2100,7,329,18,500,1030,6,375,21,500,1070
21.822,17,4,240,2,32,21821,32,120,2,32,21820,32,120
1771.777,6,187,11487,93,47,19258,208,6735,94,31,19048,31,4752
92.778,6,121,87701,73,1263,1288,1448,77092,48,675,1969,1448,10609
34.154,1,12,1248,0,0,0,0,0,12,76,3104,76,1248
1798.636,17,142,11360,71,48,25694,48,5396,71,56,25694,56,5964
1787.025,17,87,3648,86,14,21023,14,3612,1,8,0,8,36
4.607,6,14,3201,6,92,921,92,424,8,1164,628,1408,2777
1725.804,1,74,4144,74,28,23641,28,4144,0,0,0,0,0
6.329,6,46,8449,25,227,263,314,4182,21,489,303,1179,4267
367.087,6,18,1242,14,180,28237,180,916,4,110,20061,110,326
0.28,6,22,5040,10,137,31,267,1092,12,577,23,1400,3948
1.302,6,15,5084,7,150,217,174,584,8,835,167,1452,4500
0.024,17,2,656,2,300,24,300,656,0,0,0,0,0
0.938,17,4,368,2,64,936,64,184,2,64,937,64,184
4.916,6,10,1102,6,483,983,483,803,4,83,1635,83,299
0.374,6,12,1653,6,288,74,288,548,6,426,39,434,1105
130.922,6,29,7392,13,158,10910,267,1317,16,678,8725,2760,6075
1795.215,17,86,3606,85,14,21371,14,3570,1,8,0,8,36
405.264,17,10,3328,10,304,45029,308,3328,0,0,0,0,0
12.336,6,9,376,5,0,3083,0,204,4,0,4108,0,172
920.044,6,116,21613,48,237,19575,1460,9103,68,195,13728,3098,12510
300.805,2,5,160,5,8,75201,8,160,0,0,0,0,0
0.14,17,4,284,2,32,0,32,120,2,54,95,60,164
7.597,6,895,754489,513,1389,14,1448,729949,382,776,19,1448,24540
1.772,6,9,527,5,43,443,43,311,4,0,589,0,216
80.977,6,122,90954,74,1296,1109,1448,80341,48,675,1718,1448,10613
1797.898,6,256,24548,155,75,11674,267,11195,101,134,17978,1452,13353
0.931,6,10,861,5,222,231,222,426,5,231,231,231,435
1743.361,6,103,7455,65,31,27240,31,4439,38,31,47116,31,3016
1789.509,1,74,6216,74,56,24513,56,6216,0,0,0,0,0
26.056,6,46,13988,20,891,46,1360,7960,26,276,1034,1360,6028
0.349,6,20,7229,12,334,31,663,1969,8,1209,49,1906,5260
241.792,6,37,4302,17,180,15111,595,2008,20,178,12725,580,2294
26.827,6,48,10415,22,533,721,910,3107,26,312,1067,1460,7308
9.032,6,18,1851,9,222,1124,222,1252,9,231,1122,231,599
289.811,6,33,7657,15,149,20700,267,1502,18,678,17043,3456,6155
0.865,6,10,1687,7,100,144,100,384,3,1179,308,1179,1303
1.335,6,46,19410,27,911,51,1360,13874,19,476,62,2715,5536
1764.189,2,14,448,14,8,135706,8,448,0,0,0,0,0
0.062,1,6,2068,6,316,12,344,2068,0,0,0,0,0
38.921,6,51,10213,24,450,687,766,2865,27,312,1490,1360,7348
1.028,6,3,120,1,0,0,0,40,2,0,1028,0,80
1782.474,6,354,22440,207,69,8652,69,12420,147,69,12208,69,10020
299.546,6,6,364,4,31,99848,31,222,2,31,299526,31,142
1799.313,1,345,28980,345,56,5230,56,28980,0,0,0,0,0
0.488,6,12,1653,6,288,91,288,548,6,426,51,434,1105
1680.491,1,15,840,15,28,120035,28,840,0,0,0,0,0
300.261,6,33,11960,18,589,17662,1438,4502,15,833,17179,1488,7458
207.685,6,25,7693,8,267,278,502,1126,17,420,12974,1420,6567
9.762,6,73,38205,37,717,271,1448,6227,36,1114,274,2896,31978
15.559,6,8,344,3,0,7779,0,124,5,0,3885,0,220
0.2,17,2,2756,2,1350,200,1350,2756,0,0,0,0,0
697.029,6,73,9387,37,135,19361,722,4893,36,187,19909,1448,4494
108.06,6,47,10208,20,533,1302,910,3015,27,406,4151,1360,7193
1795.175,17,448,39896,403,35,4465,288,25676,45,288,40016,288,14220
1.275,6,48,19256,27,894,49,1360,13640,21,433,55,1360,5616
2.506,6,34,7623,17,111,156,267,1579,17,670,147,1452,6044
27.851,6,26,7867,12,402,2531,721,1690,14,561,1754,2840,6177
251.755,17,4,240,2,32,251753,32,120,2,32,251754,32,120
40.726,17,6,528,3,48,20334,48,228,3,72,20354,72,300
1.046,6,28,8160,15,222,61,540,1964,13,944,71,1591,6196
1775.689,17,140,11200,70,48,25734,48,5320,70,56,25734,56,5880
239.95,17,4,352,2,60,239949,60,176,2,60,239949,60,176
90.867,17,20,1760,10,48,10095,48,760,10,72,10095,72,1000
280.2,6,26,7272,12,158,25472,267,1277,14,775,21551,2800,5995
65.856,6,10,2889,6,36,13171,38,385,4,765,21908,1522,2504
1383.692,2,18,576,18,8,81393,8,576,0,0,0,0,0
1790.575,1,60,5040,60,56,30348,56,5040,0,0,0,0,0
1684.524,2,14,448,14,8,129578,8,448,0,0,0,0,0
1788.684,17,87,3648,86,14,21043,14,3612,1,8,0,8,36
0.005,17,4,352,2,37,2,37,130,2,83,1,89,222
7.246,6,1072,919450,620,1401,11,1448,891282,452,776,15,1448,28168
1747.487,6,96,7286,63,38,28185,205,4476,33,33,54601,98,2810
11.513,6,17,2349,9,324,1439,585,1125,8,396,1612,580,1224
5.215,6,39,7269,19,218,289,314,3383,20,513,259,1179,3886
0.026,17,2,152,1,40,0,40,68,1,56,0,56,84
366.54,17,6,5698,6,921,73308,1451,5698,0,0,0,0,0
0.872,6,11,1727,7,100,145,100,384,4,589,206,1152,1343
0.49,17,6,2030,6,310,98,354,2030,0,0,0,0,0
299.534,6,6,364,4,31,99844,31,222,2,31,299523,31,142
1172.516,6,185,41700,98,411,9507,1293,23662,87,255,13633,1420,18038
1322.589,17,105,8396,53,48,25434,48,4028,52,56,25932,56,4368
63.247,1,2,232,2,88,63247,88,232,0,0,0,0,0
4.794,6,35,6209,20,206,252,314,2864,15,548,323,1179,3345
0.115,17,2,136,1,32,0,32,60,1,48,0,48,76
23.256,6,33,8095,16,188,1550,721,1962,17,681,1440,2840,6133
9.473,6,1392,1294319,863,1422,10,1448,1262147,529,776,17,1448,32172
5.025,17,4,288,2,36,5008,36,128,2,52,5006,52,160
3.786,6,2,88,2,0,0,0,88,0,0,0,0,0
19.813,17,4,824,2,48,19802,48,152,2,308,19801,308,672
0.007,17,2,178,1,31,0,31,59,1,91,0,91,119
64.159,17,4,352,2,60,64158,60,176,2,60,64158,60,176
301.727,6,56,17084,31,630,10057,1402,9233,25,363,2786,1402,7851
9.699,6,59,14805,29,619,346,1460,3802,30,425,324,1460,11003
0.023,17,2,176,1,60,0,60,88,1,60,0,60,88
0.382,17,2,152,1,48,0,48,76,1,48,0,48,76
1791.496,6,382,35275,171,67,10537,659,13022,211,101,8530,1638,22253
250.524,17,6,1984,6,302,50104,308,1984,0,0,0,0,0
28.282,6,46,13947,22,289,1346,721,3491,24,730,1185,1420,10456
280.252,6,30,7432,13,158,23354,267,1317,17,543,17514,1300,6115
247.487,6,53,8639,26,124,9899,346,2304,27,327,9518,2801,6335
205.026,17,4,240,2,32,205025,32,120,2,32,205024,32,120
1786.272,17,87,3648,86,14,21014,14,3612,1,8,0,8,36
1.221,17,2,572,1,39,0,39,67,1,477,0,477,505
15.866,17,19,13190,11,969,1577,1350,10975,8,248,2253,1350,2215
5.043,17,3,208,2,36,5005,36,128,1,52,0,52,80
1786.617,6,102,8296,68,65,26665,65,4930,34,59,54136,59,3366
97.714,6,64,44338,42,1181,2383,1408,36459,22,961,2928,3847,7879
0.626,17,4,624,2,64,624,64,184,2,192,362,192,440
1740.536,17,30,31650,30,1027,60018,1027,31650,0,0,0,0,0
139.697,6,838,404397,449,834,311,1152,383689,389,428,359,1179,20708
0.068,17,2,272,1,60,0,60,88,1,156,0,156,184
170.977,6,32,24714,19,884,30,1360,6097,13,2260,14237,6099,18617
0.145,6,9,1338,5,549,36,549,753,4,421,32,421,585
8.482,6,1726,1585209,1085,1382,7,1408,1547213,641,776,12,1408,37996
1638.635,1,7,392,7,28,273105,28,392,0,0,0,0,0
45.183,6,47,8844,22,358,814,728,2059,25,412,1876,1360,6785
91.04,6,11,806,11,26,9104,26,806,0,0,0,0,0
0.137,6,23,9045,13,237,11,695,1857,10,951,14,2584,7188
0.483,6,54,21617,28,1012,17,1380,16335,26,383,18,1380,5282
1.479,6,47,18738,26,926,59,1460,13122,21,433,64,1460,5616
360.997,2,5,160,5,8,90249,8,160,0,0,0,0,0
0.259,17,8,2750,8,315,37,354,2750,0,0,0,0,0
194.194,6,165,137056,111,1320,1765,1408,123319,54,642,2987,2439,13737
1783.163,1,342,28728,342,56,5229,56,28728,0,0,0,0,0
1785.425,6,370,25770,215,99,8343,469,15154,155,69,11590,69,10616
0.085,6,10,1514,5,503,21,503,771,5,475,21,475,743
1796.432,6,219,17366,82,75,22176,336,8477,137,50,13208,143,8889
3.538,6,30,6431,14,181,272,537,1650,16,652,233,2201,4781
280.241,6,27,7312,13,158,23353,267,1317,14,775,21554,2800,5995
11.799,6,280,232444,167,1338,71,1368,221426,113,899,103,1473,11018
0.073,17,2,672,2,308,73,308,672,0,0,0,0,0
1750.22,17,12,498,11,14,175022,14,462,1,8,0,8,36
1786.804,6,104,8376,68,65,26668,65,4930,36,59,51049,59,3446
11.189,6,85,24973,45,561,254,1152,19216,40,461,280,1179,5757
11.065,6,17,4652,10,147,1229,202,835,7,689,60,1607,3817
1745.394,6,95,7203,63,38,28151,205,4476,32,33,56293,98,2727
1774.476,1,58,4872,58,56,31131,56,4872,0,0,0,0,0
6.136,6,732,650085,460,1343,12,1368,631277,272,931,21,2736,18808
1773.42,6,180,15480,120,69,14902,69,8940,60,69,30049,69,6540
1790.618,6,105,6777,65,46,27978,208,4185,40,31,45901,31,2592
0.095,17,4,284,2,32,58,32,120,2,54,39,60,164
2.644,6,48,15449,24,789,114,1360,9677,24,433,105,1360,5772
0.465,17,21,5991,9,330,57,1350,3225,12,202,39,1350,2766
285.776,6,26,2853,14,324,21978,585,1385,12,282,25976,580,1468
0.624,17,2,144,1,36,0,36,64,1,52,0,52,80
282.606,6,30,7432,13,158,23550,267,1317,17,543,17658,1400,6115
58.739,6,36,8430,18,401,519,888,1956,18,478,3445,2720,6474
1775.189,17,73,3060,72,14,25002,14,3024,1,8,0,8,36
23.251,6,37,8339,17,175,1453,722,2086,20,605,1212,1380,6253
4.393,6,38,7229,19,218,244,314,3383,19,513,230,1179,3846
0.057,17,2,194,1,61,0,61,89,1,77,0,77,105
1.911,17,3,468,3,128,955,128,468,0,0,0,0,0
170.281,17,8,480,4,32,56760,32,240,4,32,56760,32,240
268.775,17,4,240,2,32,268774,32,120,2,32,268774,32,120
382.356,6,248,199956,160,1294,2404,1408,183090,88,646,1772,3847,16866
11.331,6,1791,1567966,1086,1390,10,1420,1535317,705,467,16,1883,32649
0.472,17,2,154,1,33,0,33,61,1,65,0,65,93
3.997,17,4,244,4,33,1332,33,244,0,0,0,0,0
0.004,6,3,2840,1,0,0,0,40,2,1360,0,1360,2800
1790.535,1,150,8400,150,28,12017,28,8400,0,0,0,0,0
0.839,6,27,5927,13,156,69,267,1462,14,780,58,1460,4465
63.087,6,44,9900,23,140,2867,361,2352,21,608,3147,1702,7548
1785.018,6,104,8376,68,65,26642,65,4930,36,59,50998,59,3446
1791.05,1,132,7392,132,28,13672,28,7392,0,0,0,0,0
117.333,6,28,12660,14,824,75,1460,4714,14,819,9015,1460,7946
1741.435,17,30,31680,30,1028,60049,1028,31680,0,0,0,0,0
1785.413,6,104,8444,68,66,26647,66,4964,36,60,51009,60,3480
11.156,6,20,4088,10,209,1239,267,1663,10,404,960,1179,2425
0.108,17,4,368,2,32,108,32,120,2,96,70,96,248
55.446,6,27,8752,13,158,4620,267,1317,14,981,4260,3445,7435
2.206,6,51,18922,29,856,78,1360,13221,22,400,95,1360,5701
1797.012,1,58,4872,0,0,0,0,0,58,56,31526,56,4872
1780.815,6,352,22360,205,69,8729,69,12340,147,69,12196,69,10020
1772.62,6,180,15480,120,69,14895,69,8940,60,69,30038,69,6540
10.764,6,19,4350,10,275,1196,275,958,9,755,743,1414,3392
61.989,6,44,8959,21,410,470,882,2162,23,345,2812,1360,6797
1799.066,17,449,39928,404,35,4464,288,25708,45,288,40017,288,14220
0.156,6,10,1383,6,145,31,145,389,4,830,47,830,994
240.238,6,58,18568,30,772,8283,1402,15481,28,202,8897,580,3087
9.611,6,14,1247,7,222,1594,222,728,7,231,1593,231,519
83.741,6,34,9554,10,174,241,267,1453,24,375,3640,1420,8101
11.591,6,1837,1596380,1108,1384,10,1420,1562999,729,467,15,1883,33381
34.747,17,20,1760,10,48,3859,48,760,10,72,3859,72,1000
280.192,6,30,7432,14,158,21553,267,1357,16,603,18677,2036,6075
1.268,6,50,19209,27,885,48,1360,13513,23,433,49,1360,5696
71.798,6,43,26555,22,884,38,1360,6293,21,1386,3582,6800,20262
4.03,17,12,13969,3,932,2015,1350,2881,9,1204,292,1350,11088
374.664,6,18,1242,14,180,28820,180,916,4,110,20065,110,326
1772.535,1,60,5040,0,0,0,0,0,60,56,30042,56,5040
6.312,6,41,7349,20,218,332,314,3423,21,513,301,1179,3926
1777.288,6,79,4160,40,26,45570,26,2106,39,26,46769,26,2054
0.911,6,10,1687,7,100,151,100,384,3,1179,323,1179,1303
1799.221,1,266,28196,266,78,6789,78,28196,0,0,0,0,0
1744.979,1,56,4704,56,56,31726,56,4704,0,0,0,0,0
3.812,17,4,244,4,33,1270,33,244,0,0,0,0,0
0.499,6,3,184,2,0,499,0,80,1,64,0,64,104
1784.597,6,356,22520,208,69,8621,69,12460,148,69,12139,69,10060
0.141,6,11,911,6,181,28,181,489,5,77,4,133,422
0.005,17,4,368,2,35,1,35,126,2,93,0,99,242
29.929,17,4,240,2,32,29928,32,120,2,32,29928,32,120
273.137,6,19,2734,15,180,19509,180,2408,4,110,20061,110,326
256.664,17,12,960,6,48,51331,48,456,6,56,51331,56,504
1796.364,17,448,39896,403,35,4468,288,25676,45,288,40021,288,14220
15.217,17,14,5444,7,418,2530,1350,3124,7,303,2530,1350,2320
1786.347,6,355,22480,207,69,8671,69,12420,148,69,12151,69,10060
1680.884,17,13,534,11,14,168069,14,462,2,8,1680692,8,72
2.993,6,51,25568,29,975,106,1460,14910,22,812,132,1460,10658
1.254,6,11,1727,7,100,209,100,384,4,589,331,1152,1343
95.114,17,21,22692,21,1052,4755,1056,22692,0,0,0,0,0
4.988,17,4,288,2,36,4987,36,128,2,52,4988,52,160
61.338,6,36,15980,22,810,2920,1402,9253,14,748,4697,2451,6727
20.274,6,24,5585,13,107,1689,159,1126,11,966,2023,1708,4459
1796.953,17,448,39896,403,35,4470,288,25676,45,288,40018,288,14220
1774.228,17,140,11200,70,48,25713,48,5320,70,56,25713,56,5880
0.019,17,2,339,1,33,0,33,61,1,250,0,250,278
1797.911,17,447,39864,402,35,4483,288,25644,45,288,40014,288,14220
931.013,6,103,33947,48,514,19044,1460,12347,55,553,17237,1460,21600
9.493,6,84,26637,44,568,220,1152,20539,40,449,236,1179,6098
1786.263,6,106,8524,68,66,26660,66,4964,38,60,48274,60,3560
1.513,6,19,3781,10,234,168,564,1452,9,463,162,1343,2329
253.153,6,29,8832,14,158,19473,267,1357,15,981,18073,4836,7475
1745.113,6,95,7203,63,38,28146,205,4476,32,33,56283,98,2727
49.994,17,13,610,12,15,4544,58,526,1,56,0,56,84
0.004,17,2,544,1,45,0,45,73,1,443,0,443,471
6.458,6,41,7349,21,218,322,314,3463,20,440,324,1152,3886
1772.433,6,180,15480,120,69,14894,69,8940,60,69,30037,69,6540
1780.966,6,102,8296,68,65,26581,65,4930,34,59,53966,59,3366
5.046,17,3,433,2,37,5005,37,130,1,275,0,275,303
7.428,17,6,528,3,48,3653,48,228,3,72,3655,72,300
15.414,6,673,610367,407,1432,37,1448,591347,266,931,56,2761,19020
0.0,17,2,2754,2,1349,0,1349,2754,0,0,0,0,0
0.178,6,44,20250,26,1017,7,1420,15309,18,467,10,1883,4941
0.018,17,4,368,2,32,0,32,120,2,96,0,96,248
4.825,6,38,7229,20,218,253,314,3423,18,513,267,1179,3806
57.793,6,1237,1053912,768,1347,75,1360,1026340,469,205,123,2720,27572
39.78,17,22,1936,11,48,3976,48,836,11,72,3977,72,1100
140.869,1,3,168,3,28,70434,28,168,0,0,0,0,0
0.019,17,2,467,1,33,0,33,61,1,378,0,378,406
1782.149,6,354,22440,207,69,8651,69,12420,147,69,12206,69,10020
0.114,17,2,157,1,31,0,31,59,1,70,0,70,98
0.032,17,2,130,1,37,0,37,65,1,37,0,37,65
2.319,6,49,13209,24,321,100,1164,2966,25,543,88,1460,10243
1741.39,17,29,30624,29,1028,62192,1028,30624,0,0,0,0,0
1785.524,6,359,22709,209,69,8584,69,12569,150,69,11983,69,10140
2.982,17,2,136,1,32,0,32,60,1,48,0,48,76
15.351,17,15,7572,8,660,2186,1350,5509,7,266,2551,1350,2063
125.774,2,2,64,2,8,125774,8,64,0,0,0,0,0
1192.86,6,141,15414,76,71,15902,721,6637,65,237,18635,2828,8777
11.946,6,13,2193,7,211,1989,211,794,6,545,2381,904,1399
17.534,17,19,7033,10,436,1944,1350,4641,9,237,2187,1350,2392
3.055,6,2,88,2,0,0,0,88,0,0,0,0,0
2.36,17,2,178,1,29,0,29,57,1,93,0,93,121
38.24,17,22,1936,11,48,3820,48,836,11,72,3820,72,1100
1789.957,6,358,22669,209,69,8605,69,12569,149,69,12094,69,10100
0.368,17,2,694,1,317,0,317,345,1,321,0,321,349
0.074,17,8,1670,8,180,10,219,1670,0,0,0,0,0
211.301,2,5,160,5,8,52825,8,160,0,0,0,0,0
1795.389,1,214,11984,214,28,8429,28,11984,0,0,0,0,0
1.071,6,32,13315,18,529,63,1360,3422,14,1035,67,3921,9893
0.252,6,19,8973,10,121,28,121,649,9,1308,31,1802,8324
0.018,17,3,434,2,60,10,60,176,1,230,0,230,258
22.123,17,43,14714,20,273,1162,1350,6038,23,349,1002,1350,8676
0.072,17,2,701,2,322,72,353,701,0,0,0,0,0
1783.555,6,314,21047,186,69,9640,69,11718,128,69,14043,69,9329
1741.252,6,92,6668,60,31,29512,31,4062,32,31,56168,31,2606
36.486,17,4,352,2,60,36485,60,176,2,60,36485,60,176
1777.169,6,227,19820,84,79,21410,336,9018,143,70,12514,1062,10802
1.032,6,32,13325,17,529,64,1360,3394,15,847,61,1360,9931
629.99,2,4,128,4,8,209996,8,128,0,0,0,0,0
4.892,6,21,3806,11,143,489,293,1450,10,488,460,1179,2356
1.563,6,53,19009,29,857,55,1360,13228,24,400,59,1360,5781
1745.688,1,8,448,8,28,249384,28,448,0,0,0,0,0
280.41,6,30,7432,13,158,23367,267,1317,17,543,17523,1400,6115
1775.326,17,56,18736,56,306,32278,308,18736,0,0,0,0,0
0.139,17,2,925,1,548,0,548,576,1,321,0,321,349
2.317,17,4,580,2,40,2034,40,136,2,194,2008,194,444
72.338,6,52,12414,21,280,3616,1189,3091,31,403,2406,1420,9323
1776.027,17,140,11200,70,48,25739,48,5320,70,56,25739,56,5880
0.046,17,4,284,2,32,28,32,120,2,54,25,60,164
83.591,17,4,352,2,60,83590,60,176,2,60,83590,60,176
280.257,6,31,7472,13,158,23354,267,1317,18,543,16483,1400,6155
1.113,17,4,772,2,46,1000,46,148,2,284,113,308,624
855.23,6,75,8778,41,90,21380,722,3930,34,133,25910,1408,4848
5.362,6,39,7285,21,218,268,314,3463,18,516,300,1179,3822
1797.522,17,448,39896,403,35,4471,288,25676,45,288,40017,288,14220
85.845,6,36,16062,17,452,156,1440,2577,19,1058,4761,1440,13485
30.522,6,33,9061,14,158,2347,267,1357,19,578,1683,1400,7704
1765.149,1,264,14784,264,28,6711,28,14784,0,0,0,0,0
1786.529,6,102,8228,68,64,26664,64,4896,34,58,54134,58,3332
156.978,6,1219,586828,641,848,245,1152,556807,578,383,271,1152,30021
1741.388,17,29,6815,29,207,62192,207,6815,0,0,0,0,0
312.498,17,965,175720,916,161,341,172,173440,49,18,4570,172,2280
13.75,6,22,5782,12,275,1250,275,1042,10,1440,969,1440,4740
681.226,6,82,7006,49,74,14192,138,3961,33,69,21287,69,3045
0.407,6,3,156,2,0,329,0,116,1,0,0,0,40
0.154,6,14,4334,7,111,25,111,483,7,869,25,1448,3851
0.94,6,27,8420,14,266,59,540,1924,13,994,64,1791,6496
240.202,6,52,17421,27,779,9238,1402,14668,25,180,10008,580,2753
1791.327,6,356,22727,206,69,8738,69,12449,150,69,12020,69,10278
0.415,6,13,1693,7,288,69,288,588,6,284,40,434,1105
101.508,17,28,9408,28,308,3759,308,9408,0,0,0,0,0
240.247,6,60,18019,29,777,8580,1408,14741,31,207,8008,580,3278
0.475,6,50,21238,28,997,17,1380,16116,22,421,21,1923,5122
1746.296,6,96,7286,63,38,28166,205,4476,33,33,54559,98,2810
94.969,17,4,304,4,48,31656,48,304,0,0,0,0,0
1786.472,17,87,3648,86,14,21017,14,3612,1,8,0,8,36
0.019,6,13,26656,1,0,0,0,40,12,2166,0,4104,26616
1740.189,6,87,6322,58,31,30529,31,3915,29,31,62143,31,2407
9.972,6,82,24837,42,561,243,1152,19096,40,413,249,1152,5741
1772.202,6,180,15480,120,69,14892,69,8940,60,69,30035,69,6540
1786.461,6,113,12215,74,81,24472,501,5910,39,128,47009,1420,6305
0.297,17,2,167,1,39,0,39,67,1,72,0,72,100
1786.876,6,102,8296,68,65,26669,65,4930,34,59,54143,59,3366
4.166,6,38,7245,19,218,231,314,3383,19,516,217,1179,3862
34.186,17,20,1760,10,48,3797,48,760,10,72,3797,72,1000
2.891,17,3,183,3,33,1445,33,183,0,0,0,0,0
29.385,6,12,1313,7,185,4897,185,557,5,244,7312,476,756
280.469,6,29,7392,13,158,23372,267,1317,16,775,18692,4836,6075
1777.388,17,137,10956,69,48,26137,48,5244,68,56,26527,56,5712
1746.4,1,55,4620,55,56,32340,56,4620,0,0,0,0,0
1790.77,6,295,36917,120,137,15047,1360,17234,175,142,10291,1360,19683
285.593,6,85,30567,46,593,6346,1408,11323,39,819,7515,2816,19244
472.999,17,14,4734,14,310,36384,329,4734,0,0,0,0,0
7.438,6,68,20558,35,554,218,1152,15811,33,427,224,1152,4747
1752.703,1,57,4788,57,56,31298,56,4788,0,0,0,0,0
0.317,17,8,2750,8,315,45,354,2750,0,0,0,0,0
31.44,6,6,288,1,0,0,0,48,5,0,7857,0,240
44.634,17,4,240,2,32,44633,32,120,2,32,44633,32,120
1.533,6,13,2311,8,188,219,245,700,5,1407,319,1407,1611
626.739,6,135,18404,62,98,10274,615,6027,73,171,8702,1360,12377
39.043,6,27,4810,16,176,2602,517,2087,11,428,3903,499,2723
377.221,6,25,1651,17,177,23576,177,1117,8,110,9277,110,534
0.204,17,2,188,1,58,0,58,86,1,74,0,74,102
2.061,6,28,8764,13,164,158,267,1376,15,733,135,1408,7388
1.166,6,4,184,2,0,1166,0,88,2,0,1023,0,96
1752.35,6,127,10907,80,66,22181,205,6632,47,40,38084,98,4275
1650.346,1,8,448,8,28,235763,28,448,0,0,0,0,0
0.394,6,12,3704,6,171,68,171,491,6,964,63,1448,3213
176.539,17,4,352,2,60,176538,60,176,2,60,176538,60,176
3.883,17,2,178,1,29,0,29,57,1,93,0,93,121
240.46,6,35,6419,18,168,14144,517,1956,17,595,15028,1418,4463
1.151,6,10,1687,7,100,191,100,384,3,1179,453,1179,1303
0.07,17,2,778,2,361,70,361,778,0,0,0,0,0
280.258,17,4,1098,2,30,280247,30,116,2,463,280248,463,982
280.427,6,31,7472,14,158,21571,267,1357,17,603,17524,2760,6115
1744.525,6,97,7307,63,38,28137,205,4476,34,33,52852,98,2831
1785.933,6,160,20729,94,316,19203,316,14704,66,83,27475,83,6025
767.106,6,55,18070,20,514,241,1460,3986,35,468,22556,1460,14084
1776.447,17,251,50635,251,173,7105,373,50635,0,0,0,0,0
0.434,6,27,9043,13,252,35,647,1692,14,945,32,1408,7351
296.758,17,4,240,2,32,296757,32,120,2,32,296757,32,120
246.509,6,471,404947,172,758,1441,1418,27160,299,1341,827,2836,377787
91.781,1,4,224,4,28,30593,28,224,0,0,0,0,0
1.023,17,5,804,3,32,509,32,180,2,284,4,294,624
15.797,17,17,6490,8,483,2247,1350,4093,9,238,1965,1350,2397
1767.981,1,142,7952,142,28,12538,28,7952,0,0,0,0,0
9.553,17,4,1344,4,308,3184,308,1344,0,0,0,0,0
1772.637,6,180,15480,120,69,14896,69,8940,60,69,30040,69,6540
11.264,6,94,28839,49,572,234,1152,22557,45,447,250,1179,6282
1750.8,17,167,35010,167,181,10546,422,35010,0,0,0,0,0
1740.575,6,87,6322,58,31,30536,31,3915,29,31,62161,31,2407
299.574,6,6,364,4,31,99858,31,222,2,31,299554,31,142
299.522,6,6,364,4,31,99840,31,222,2,31,299514,31,142
1763.914,2,19,608,19,8,97995,8,608,0,0,0,0,0
0.004,17,2,412,1,53,0,53,81,1,303,0,303,331
0.217,17,2,2386,2,1165,217,1165,2386,0,0,0,0,0
0.465,6,10,1380,6,145,93,145,389,4,827,152,827,991
1.313,6,11,1727,7,100,218,100,384,4,589,355,1152,1343
1797.926,17,450,39960,405,35,4450,288,25740,45,288,40020,288,14220
0.183,17,2,152,1,48,0,48,76,1,48,0,48,76
1.667,6,38,8278,19,321,92,1164,2742,19,476,78,2715,5536
0.236,1,2,163,2,53,236,78,163,0,0,0,0,0
1772.295,6,180,15480,120,69,14893,69,8940,60,69,30036,69,6540
1.251,17,28,15637,14,755,96,1350,10965,14,305,69,1350,4672
227.015,6,29,7392,13,158,18917,267,1317,16,603,15131,2036,6075
25.186,17,32,4704,16,48,1678,48,1216,16,190,1678,308,3488
292.318,1,8,448,8,28,41759,28,448,0,0,0,0,0
1771.949,6,180,15480,120,69,14890,69,8940,60,69,30031,69,6540
0.073,6,10,1852,6,108,14,108,428,4,1208,22,1208,1424
1772.054,6,180,15480,120,69,14891,69,8940,60,69,30034,69,6540
240.223,6,54,18480,29,791,8579,1418,15761,25,176,10008,580,2719
1.211,6,24,8028,12,164,93,267,1312,12,1014,93,2816,6716
1799.14,1,58,4872,58,56,31563,56,4872,0,0,0,0,0
7.953,17,57,45378,23,328,361,1350,8202,34,1065,212,1350,37176
126.384,6,30,7432,13,158,10532,267,1317,17,543,7896,1400,6115
95.103,17,8,704,4,48,31698,48,304,4,72,31698,72,400
1.428,6,48,19184,27,889,54,1460,13568,21,433,61,1460,5616
1796.245,17,448,39896,403,35,4468,288,25676,45,288,40019,288,14220
0.045,17,2,263,1,36,0,36,64,1,171,0,171,199
0.228,17,2,2386,2,1165,228,1165,2386,0,0,0,0,0
0.195,6,9,1343,5,145,48,145,349,4,830,32,830,994
0.222,6,25,7216,12,155,20,267,1261,13,678,17,2045,5955
1767.477,17,80,7378,40,33,45319,37,2446,40,95,45319,136,4932
281.179,17,4,288,2,36,280957,36,128,2,52,281062,52,160
0.053,17,2,216,1,45,0,45,73,1,115,0,115,143
172.735,6,21,8712,11,314,73,634,1415,10,1147,19177,2568,7297
152.849,17,1059,835199,1048,768,145,1252,834759,11,12,3474,12,440
47.165,17,2,672,2,308,47165,308,672,0,0,0,0,0
64.252,6,11,452,5,0,6070,0,204,6,0,12847,0,248
4.113,17,3,201,3,39,2056,39,201,0,0,0,0,0
280.591,6,29,7392,13,158,23382,267,1317,16,603,18694,2076,6075
20.177,6,22,5743,13,107,1681,159,1138,9,825,2521,1669,4605
1.272,6,46,19478,27,916,48,1360,13942,19,476,61,2720,5536
280.38,6,30,7432,13,158,23365,267,1317,17,543,17521,1400,6115
107.929,6,865,434814,492,823,219,1152,415103,373,435,289,1179,19711
1740.682,17,29,30624,29,1028,62167,1028,30624,0,0,0,0,0
31.693,6,7,308,1,0,0,0,44,6,0,5717,0,264
371.312,6,25,1651,17,177,23207,177,1117,8,110,9234,110,534
227.989,17,4,352,2,60,227988,60,176,2,60,227988,60,176
1.359,6,51,19767,27,922,52,1460,14031,24,433,49,1460,5736
0.018,17,2,330,1,30,0,30,58,1,244,0,244,272
1.268,6,36,8172,19,320,70,1162,2716,17,476,68,2715,5456
1786.379,6,102,8364,68,66,26662,66,4964,34,60,54130,60,3400
1790.272,17,179,13962,179,50,10057,50,13962,0,0,0,0,0
33.752,6,31,5093,15,154,2410,722,1859,16,342,2238,1448,3234
0.015,17,4,284,2,32,7,32,120,2,54,9,60,164
1.693,17,2,154,1,41,0,41,69,1,57,0,57,85
9.203,6,10,1691,5,100,2300,100,304,5,589,2236,1152,1387
4.222,17,5,295,5,31,1055,31,295,0,0,0,0,0
1792.004,6,366,23127,211,69,8533,69,12787,155,69,11636,69,10340
139.0,17,50,7468,25,48,5791,48,1900,25,194,5791,308,5568
301.738,6,52,16711,27,624,11605,1408,8936,25,461,2941,2688,7775
7.963,6,18,6791,9,275,995,275,643,9,1155,680,1420,6148
25.439,6,43,16591,23,1115,405,1460,10989,20,399,1329,1460,5602
369.818,6,2125,1995791,1391,1410,266,1440,1954495,734,161,105,1440,41296
4.005,17,8,616,4,33,1334,33,244,4,65,1330,65,372
3.819,17,3,1167,3,361,1909,361,1167,0,0,0,0,0
153.716,6,39,8416,16,123,10247,267,1633,23,344,6986,3426,6783
0.17,17,4,1423,4,327,56,354,1423,0,0,0,0,0
1795.56,6,356,22520,208,69,8674,69,12460,148,69,12214,69,10060
1.439,6,25,8994,13,208,119,475,1418,12,1012,113,1360,7576
1773.765,6,181,15589,120,69,14905,69,8940,61,69,29555,69,6649
0.124,6,3,151,2,31,0,31,111,1,0,0,0,40
1.385,6,41,8429,21,320,69,1162,2808,20,437,63,2715,5621
17.795,17,34,20608,19,785,986,1350,15458,15,315,1268,1350,5150
1749.326,6,97,7307,63,38,28214,205,4476,34,33,53001,98,2831
4.056,17,35,13666,17,363,251,1350,6651,18,361,236,1350,7015
1792.139,17,140,11200,70,48,25972,48,5320,70,56,25972,56,5880
1699.605,17,13,534,11,14,169941,14,462,2,8,1699430,8,72
4.415,6,40,7309,19,218,245,314,3383,21,440,208,1152,3926
7.991,6,14,1226,9,275,998,275,918,5,96,1471,96,308
281.505,6,27,7312,12,158,25591,267,1277,15,678,20097,2800,6035
1744.992,6,95,7203,63,38,28145,205,4476,32,33,56278,98,2727
1781.35,6,102,8228,68,64,26587,64,4896,34,58,53977,58,3332
1771.271,6,99,9306,66,66,27250,66,5610,33,60,55349,60,3696
5.484,6,43,7429,23,218,249,314,3543,20,440,275,1152,3886
240.32,6,44,8449,22,449,11443,1418,5648,22,206,11443,580,2801
27.846,6,42,8571,22,171,1326,721,2259,20,687,1412,2840,6312
7.668,2,2,64,2,8,7668,8,64,0,0,0,0,0
5.018,17,3,208,2,36,5006,36,128,1,52,0,52,80
24.72,6,37,8369,17,175,1545,721,2085,20,548,1278,1440,6284
20.819,6,1003,862869,640,1275,32,1368,839317,363,776,56,2736,23552
1744.412,6,97,7307,63,38,28135,205,4476,34,33,52848,98,2831
6.319,1,4,224,4,28,2106,28,224,0,0,0,0,0
1744.609,2,29,928,29,8,62307,8,928,0,0,0,0,0
1771.437,6,101,9344,66,65,27252,65,5577,35,59,52098,59,3767
31.302,6,8,348,2,0,33,0,84,6,0,6256,0,264
377.345,2,4,128,4,8,125781,8,128,0,0,0,0,0
485.584,17,10,3390,10,311,53953,329,3390,0,0,0,0,0
1797.576,6,356,22520,208,69,8683,69,12460,148,69,12228,69,10060
41.689,17,48,7056,24,48,1812,48,1824,24,190,1812,308,5232
0.884,6,30,7353,14,161,68,537,1707,16,684,56,1448,5646
0.0,17,1,1053,1,1025,0,1025,1053,0,0,0,0,0
0.67,6,32,11277,18,637,39,1188,7305,14,539,44,1188,3972
0.323,17,2,784,2,364,323,364,784,0,0,0,0,0
0.078,6,13,5578,6,106,15,106,354,7,987,2,1917,5224
0.035,17,6,552,3,32,10,32,180,3,96,10,96,372
1770.72,6,99,9240,66,65,27241,65,5577,33,59,55332,59,3663
112.463,17,4,240,2,32,112462,32,120,2,32,112462,32,120
280.354,6,29,7392,13,158,23362,267,1317,16,603,18685,1400,6075
622.831,17,30,4573,30,124,21476,354,4573,0,0,0,0,0
0.107,17,2,136,1,32,0,32,60,1,48,0,48,76
1772.141,6,180,15480,120,69,14891,69,8940,60,69,30030,69,6540
1.484,6,50,19729,29,918,53,1460,14068,21,437,64,2615,5661
521.819,17,104,7904,104,48,5066,48,7904,0,0,0,0,0
0.106,17,2,386,1,46,0,46,74,1,284,0,284,312
0.063,17,2,602,1,46,0,46,74,1,500,0,500,528
8.19,6,19,6792,7,275,1365,275,834,12,683,631,1440,5958
135.567,17,4,240,2,32,135566,32,120,2,32,135566,32,120
5.005,17,4,514,2,36,5000,36,128,2,165,5000,187,386
1.066,17,4,776,2,36,1062,36,128,2,296,1062,318,648
632.385,6,97,14580,59,117,10903,1077,5879,38,210,17081,1460,8701
0.336,6,20,7229,12,334,29,663,1969,8,1209,46,1906,5260
560.446,17,6,1647,3,30,280187,30,174,3,463,280220,463,1473
0.304,17,2,152,1,48,0,48,76,1,48,0,48,76
4.158,6,34,6169,18,206,244,314,2784,16,548,259,1179,3385
301.485,1,4,224,4,28,100495,28,224,0,0,0,0,0
374.752,6,23,1535,16,177,24983,177,1053,7,110,10404,110,482
1.425,6,47,18188,26,882,57,1460,12572,21,476,61,2615,5616
21.895,17,45,7350,20,140,1150,1350,3363,25,131,910,1350,3987
368.787,6,21,1419,15,177,26341,177,989,6,110,14315,110,430
287.47,1,4,224,4,28,95823,28,224,0,0,0,0,0
1463.089,17,67,2814,67,14,22168,14,2814,0,0,0,0,0
50.489,17,16,18211,16,1110,3365,1451,18211,0,0,0,0,0
0.992,17,2,677,1,300,0,300,328,1,321,0,321,349
1770.728,1,66,5544,66,56,27241,56,5544,0,0,0,0,0
3.01,17,3,264,3,60,1505,60,264,0,0,0,0,0
396.002,6,55,10984,33,312,12375,1460,5195,22,349,479,2567,5789
0.89,6,10,1687,7,100,148,100,384,3,1179,317,1179,1303
287.262,6,33,9275,11,152,28718,267,1364,22,438,13677,2760,7911
78.392,6,690,318958,361,822,217,1152,299952,329,417,238,1179,19006
0.059,17,4,336,2,45,0,45,146,2,67,10,73,190
1794.385,6,361,22858,210,69,8585,69,12678,151,69,11960,69,10180
1771.67,6,99,9306,66,66,27256,66,5610,33,60,55361,60,3696
1.48,6,47,18070,26,875,59,1360,12454,21,476,63,2715,5616
1786.282,6,102,8296,68,65,26660,65,4930,34,59,54125,59,3366
710.033,6,54,7351,30,110,20587,516,2746,24,173,30853,1452,4605
1785.437,17,87,3648,86,14,21005,14,3612,1,8,0,8,36
139.789,6,41,12478,21,633,6989,1360,4699,20,535,7347,1360,7779
41.341,6,98,96283,26,131,1653,232,1569,72,1370,581,1430,94714
249.551,6,30,2212,8,46,17140,46,596,22,46,11883,46,1616
1791.67,6,354,22440,206,69,8739,69,12380,148,69,12187,69,10060
1786.501,6,218,25649,138,104,13040,469,12722,80,127,22611,1420,12927
262.396,6,520,435933,291,201,904,230,16629,229,1818,1150,8448,419304
1796.383,17,449,39928,404,35,4457,288,25708,45,288,40020,288,14220
364.45,1,32,1792,32,28,11756,28,1792,0,0,0,0,0
120.962,6,56,16585,23,249,5498,1189,3171,33,575,3779,1926,13414
1785.277,6,112,11717,72,131,25144,1271,7631,40,69,45774,240,4086
94.391,1,20,560,20,0,0,0,560,0,0,0,0,0
0.049,17,2,482,1,37,0,37,65,1,389,0,389,417
9.337,6,90,29031,45,581,212,1152,22733,45,449,206,1179,6298
62.956,6,126,30457,60,462,1067,1440,17315,66,283,966,1702,13142
240.502,6,57,24659,26,539,9619,1402,6212,31,1051,8016,2804,18447
14.027,17,2,908,2,426,14027,687,908,0,0,0,0,0
1782.218,17,83,3480,82,14,22002,14,3444,1,8,0,8,36
364.304,17,6,2184,6,336,72860,548,2184,0,0,0,0,0
0.261,17,2,152,1,48,0,48,76,1,48,0,48,76
1776.957,17,142,11360,71,48,25384,48,5396,71,56,25384,56,5964
1744.667,2,25,800,25,8,72694,8,800,0,0,0,0,0
1.442,17,52,40659,31,1104,45,1350,35095,21,236,67,1350,5564
3.036,17,4,332,2,47,3030,47,150,2,63,3030,63,182
28.454,6,7,328,2,0,28454,0,88,5,0,3866,0,240
15.107,17,12,5345,6,490,3015,1350,3108,6,344,3015,1350,2237
0.141,6,12,1587,6,507,28,507,779,6,556,28,556,808
1588.06,6,108,12947,64,83,24210,500,5156,44,150,36929,1420,7791
16.968,17,32,17739,17,666,1058,1350,11801,15,367,1209,1350,5938
0.002,1,2,788,2,366,2,366,788,0,0,0,0,0
21.395,17,35,14527,19,591,1187,1350,11770,16,144,1424,1350,2757
0.043,17,4,336,2,34,0,34,124,2,78,1,84,212
0.242,17,2,152,1,48,0,48,76,1,48,0,48,76
1785.166,17,87,3648,86,14,21001,14,3612,1,8,0,8,36
1187.151,1,5,280,5,28,296787,28,280,0,0,0,0,0
7.667,6,42,8305,21,227,383,314,4022,21,491,370,1179,4283
142.498,6,22,9920,11,433,74,990,1771,11,1099,14236,1440,8149
106.438,17,3768,4639555,384,79,277,1350,41110,3384,1330,31,1350,4598445
27.81,1,4,224,4,28,9270,28,224,0,0,0,0,0
1464.898,6,358,40887,159,346,9271,751,18266,199,70,7389,1538,22621
0.326,6,28,9191,13,257,27,667,1739,15,833,22,1408,7452
1777.206,1,88,4928,88,28,20427,28,4928,0,0,0,0,0
4.066,17,13,12722,4,708,1355,1350,2945,9,1058,359,1350,9777
370.26,6,17,1190,13,180,30855,180,864,4,110,20114,110,326
368.375,6,18,1242,14,180,28336,180,916,4,110,20064,110,326
103.585,6,18,999,9,31,12928,31,515,9,31,12927,31,484
24.461,6,16,5719,4,112,8150,112,280,12,706,2222,1460,5439
0.237,6,9,1146,5,357,59,357,561,4,421,61,421,585
0.364,6,22,4442,11,165,36,456,1394,11,493,34,888,3048
4.091,6,32,6089,17,206,255,314,2744,15,548,273,1179,3345
0.005,17,2,410,1,63,0,63,91,1,291,0,291,319
3.575,17,4,352,2,48,3564,48,152,2,72,3564,72,200
61.69,6,10,648,10,31,6854,31,648,0,0,0,0,0
0.109,6,10,1671,6,552,21,948,1348,4,159,36,159,323
6.028,6,42,7389,22,218,287,314,3503,20,513,304,1179,3886
0.699,6,12,1163,6,222,138,222,688,6,231,138,231,475
1789.505,17,138,11040,69,48,26316,48,5244,69,56,26316,56,5796
0.154,1,2,112,2,28,154,28,112,0,0,0,0,0
133.725,6,14,1031,5,177,33431,177,445,9,110,16451,110,586
1795.853,17,448,39896,403,35,4467,288,25676,45,288,40019,288,14220
1740.454,17,29,30566,29,1026,62159,1026,30566,0,0,0,0,0
3.275,6,32,8056,16,188,218,721,1963,16,681,205,1414,6093
1772.655,1,182,10192,182,28,9793,28,10192,0,0,0,0,0
1.692,6,13,2311,8,188,241,245,700,5,1407,357,1407,1611
1.838,6,13,1811,8,100,262,100,424,5,589,384,1152,1387
0.082,17,2,219,1,50,0,50,78,1,113,0,113,141
30.597,6,36,10815,13,156,154,267,998,23,493,1390,1420,9817
1797.248,17,140,11200,70,48,26046,48,5320,70,56,26046,56,5880
118.836,17,4,1344,4,308,39612,308,1344,0,0,0,0,0
7.532,17,12,1764,6,48,1504,48,456,6,190,1503,308,1308
288.598,17,4,1344,4,308,96199,308,1344,0,0,0,0,0
1790.971,6,356,22520,208,69,8652,69,12460,148,69,12183,69,10060
5.013,17,4,288,2,36,5003,36,128,2,52,5004,52,160
5.006,17,4,288,2,36,5005,36,128,2,52,5005,52,160
45.972,6,9,527,5,43,11493,43,311,4,0,15321,0,216
1730.058,1,8,448,8,28,247151,28,448,0,0,0,0,0
1744.645,2,28,896,28,8,64616,8,896,0,0,0,0,0
555.147,6,1501,1360063,562,195,989,955,32569,939,1392,591,1418,1327494
240.688,17,4,352,2,60,240687,60,176,2,60,240687,60,176
4.853,6,39,7269,20,218,255,314,3423,19,513,255,1179,3846
0.012,17,2,128,1,36,0,36,64,1,36,0,36,64
1.434,6,39,8294,19,321,79,1164,2718,20,433,65,1460,5576
9.103,17,8,1684,4,47,3030,47,300,4,318,3029,318,1384
78.484,6,71,47189,44,1185,1825,1368,39048,27,961,2388,3887,8141
240.194,6,55,18444,30,770,8282,1402,15436,25,212,10007,580,3008
1762.514,17,168,14034,156,30,11371,37,9090,12,384,154793,463,4944
0.252,6,2,80,1,0,0,0,40,1,0,0,0,40
280.331,6,28,7352,12,158,25484,267,1277,16,603,18686,1400,6075
289.746,6,330,54598,194,304,1501,304,39180,136,83,2146,83,15418
1798.725,6,356,22520,208,69,8689,69,12460,148,69,12235,69,10060
0.626,17,4,624,2,64,624,64,184,2,192,506,192,440
40.52,17,44,6468,22,48,1929,48,1672,22,190,1929,308,4796
0.261,17,2,154,1,33,0,33,61,1,65,0,65,93
4.307,6,20,6326,10,268,470,517,1334,10,893,468,2451,4992
0.177,6,5,373,3,36,88,38,229,2,40,1,40,144
0.451,6,10,1992,5,288,106,288,508,5,424,61,434,1484
1795.344,17,83,3480,82,14,22164,14,3444,1,8,0,8,36
2.097,17,6,460,3,40,993,41,206,3,56,1041,57,254
0.264,17,3,451,2,39,247,39,134,1,289,0,289,317
220.994,17,8,2688,8,308,31570,308,2688,0,0,0,0,0
1090.767,17,216,16416,216,48,5073,48,16416,0,0,0,0,0
20.146,6,21,5418,12,107,1831,159,1074,9,773,2516,1402,4344
280.392,6,30,7432,13,158,23366,267,1317,17,543,17516,1400,6115
68.132,6,17,2324,7,302,11355,302,1290,10,83,7567,83,1034
78.212,17,2,244,2,94,78212,94,244,0,0,0,0,0
1797.999,1,38,2128,38,28,48594,28,2128,0,0,0,0,0
1.3,6,41,10025,23,440,59,1360,4484,18,437,66,2715,5541
0.016,17,2,212,1,46,0,46,74,1,110,0,110,138
1795.132,17,210,49077,210,205,8589,422,49077,0,0,0,0,0
0.679,6,10,1671,6,552,135,948,1348,4,159,226,159,323
233.949,6,32,7901,14,217,4315,502,1432,18,383,13756,1420,6469
1.575,6,19,3781,10,234,175,564,1452,9,463,173,1343,2329
3.289,6,4,176,1,0,0,0,44,3,0,1521,0,132
0.004,17,2,410,1,36,0,36,64,1,318,0,318,346
287.743,17,4,352,2,60,287742,60,176,2,60,287742,60,176
21.554,17,2,642,1,300,0,300,328,1,286,0,286,314
2.134,6,20,3833,11,234,213,564,1504,9,463,243,1343,2329
300.669,6,45,8966,22,291,14317,787,2137,23,327,594,1460,6829
3.919,17,5,295,5,31,979,31,295,0,0,0,0,0
240.157,6,55,16204,29,691,8576,1402,13288,26,172,9606,580,2916
672.154,6,82,5580,31,46,22405,46,2390,51,46,13440,46,3190
1.603,6,13,2311,7,188,267,245,660,6,703,267,1152,1651
240.117,6,49,10273,26,197,9604,752,2754,23,574,10914,2347,7519
1793.297,17,357,53788,176,207,10247,1350,41476,181,40,9962,1350,12312
0.007,17,2,179,1,27,0,27,55,1,96,0,96,124
0.03,17,2,212,1,46,0,46,74,1,110,0,110,138
0.119,1,2,112,2,28,119,28,112,0,0,0,0,0
81.729,17,4,352,2,60,81728,60,176,2,60,81727,60,176
280.228,6,29,7392,14,158,21556,267,1357,15,678,20013,4200,6035
1036.582,17,204,15504,204,48,5106,48,15504,0,0,0,0,0
25.193,6,35,8260,17,175,1574,721,2087,18,681,1470,2840,6173
167.953,17,4,352,2,60,167952,60,176,2,60,167951,60,176
249.616,17,5,380,5,48,62404,48,380,0,0,0,0,0
0.027,17,2,152,1,48,0,48,76,1,48,0,48,76
1700.587,17,12,498,11,14,170058,14,462,1,8,0,8,36
2.886,6,3,151,0,0,0,0,0,3,31,1443,31,151
0.31,6,24,8291,12,264,28,677,1688,12,995,26,1438,6603
280.222,6,29,7392,13,158,23351,267,1317,16,603,18677,2800,6075
1786.535,6,154,25566,91,483,19850,483,19705,63,83,28814,83,5861
300.793,6,49,10486,25,433,12533,910,3258,24,329,546,2128,7228
4.946,6,39,7269,19,218,274,314,3383,20,440,246,1152,3886
0.252,17,3,451,2,39,139,39,134,1,289,0,289,317
267.625,1,2,112,2,28,267625,28,112,0,0,0,0,0
365.714,17,7,2312,7,302,60952,308,2312,0,0,0,0,0
5.901,6,41,7349,21,218,295,314,3463,20,440,297,1152,3886
1685.628,1,8,448,8,28,240804,28,448,0,0,0,0,0
126.124,6,11,1727,5,100,130,100,304,6,1179,25176,1179,1423
12.206,6,88,27053,45,560,277,1152,20851,43,447,283,1179,6202
115.047,6,118,49433,59,793,1983,1360,36505,59,406,1980,1360,12928
0.334,17,2,167,1,39,0,39,67,1,72,0,72,100
1776.194,1,8,448,8,28,253742,28,448,0,0,0,0,0
1749.258,6,95,7203,63,38,28213,205,4476,32,33,56419,98,2727
755.894,2,6,192,6,8,151178,8,192,0,0,0,0,0
78.764,6,9808,9489733,6598,1361,11,1408,9318149,3210,776,24,1408,171584
376.504,6,9,496,6,112,75298,112,360,3,0,188245,0,136
1.454,6,46,18769,26,932,58,1460,13193,20,476,66,2615,5576
1658.809,1,14,784,14,28,127600,28,784,0,0,0,0,0
16.652,17,13,6578,7,613,2762,1350,4487,6,320,3142,1350,2091
0.006,17,2,263,1,36,0,36,64,1,171,0,171,199
1773.905,6,180,15480,120,69,14906,69,8940,60,69,30062,69,6540
1783.811,6,367,25581,214,99,8374,469,15045,153,69,11735,69,10536
1383.65,2,11,352,11,8,138365,8,352,0,0,0,0,0
57.115,1,2,237,2,90,57115,93,237,0,0,0,0,0
297.357,2,4,128,4,8,99119,8,128,0,0,0,0,0
9.143,17,8,1792,4,46,3043,46,296,4,346,3043,346,1496
280.034,6,27,7312,12,158,25457,267,1277,15,678,20000,2045,6035
1.239,17,19,13802,11,1018,121,1350,11508,8,258,172,1350,2294
0.505,6,57,25065,33,1004,15,1380,16515,24,630,19,3303,8550
1.012,17,4,932,2,30,1000,30,116,2,380,996,468,816
1787.145,1,342,28728,342,56,5240,56,28728,0,0,0,0,0
841.023,17,8,592,4,30,280335,30,232,4,62,280331,62,360
93.895,6,31,7472,14,158,7222,267,1357,17,543,5866,1400,6115
37.251,6,29,7392,13,158,3104,267,1317,16,603,2479,1400,6075
1628.313,1,16,896,16,28,108554,28,896,0,0,0,0,0
3.235,6,21,6366,10,268,354,517,1333,11,744,319,1418,5033
0.93,17,4,1116,2,32,925,32,120,2,470,924,470,996
1786.312,6,104,8444,68,66,26661,66,4964,36,60,51035,60,3480
300.956,6,44,10157,23,433,13679,910,3142,21,385,775,2128,7015
20.567,17,29,2135,20,40,1081,41,1373,9,56,1867,57,762
5.062,17,3,208,2,36,5008,36,128,1,52,0,52,80
4.995,17,13,6985,7,613,832,1350,4492,6,387,637,1350,2493
1796.937,1,342,28728,342,56,5269,56,28728,0,0,0,0,0
29.451,17,20,12070,10,663,3272,1350,6913,10,487,44,1350,5157
0.433,17,27,20973,15,775,30,1350,12050,12,715,33,1350,8923
18.15,6,32,8426,13,152,1512,267,1444,19,517,992,1933,6982
1784.717,17,75,3141,73,13,24787,14,3061,2,12,600080,16,80
1772.395,6,240,17880,120,69,14894,69,8940,120,34,14893,64,8940
0.093,17,2,144,1,36,0,36,64,1,52,0,52,80
222.107,17,4,240,2,32,222105,32,120,2,32,222106,32,120
1786.685,6,104,8376,68,65,26666,65,4930,36,59,51045,59,3446
0.017,17,4,352,2,37,7,37,130,2,83,10,89,222
1679.825,17,12,498,11,14,167982,14,462,1,8,0,8,36
23.208,6,34,8135,16,188,1547,721,1962,18,605,1352,1440,6173
0.085,17,4,284,2,32,0,32,120,2,54,3,60,164
0.02,17,4,284,2,32,12,32,120,2,54,11,60,164
550.463,6,46,7803,18,127,17664,516,2002,28,179,20374,1452,5801
0.958,17,4,624,2,64,956,64,184,2,192,841,192,440
2.114,6,20,3833,11,234,211,564,1504,9,463,241,1343,2329
1.025,6,24,8893,14,203,78,458,1406,10,1415,89,3926,7487
1743.322,6,95,7203,63,38,28118,205,4476,32,33,56226,98,2727
1740.863,6,87,6322,58,31,30541,31,3915,29,31,62173,31,2407
0.651,6,14,1745,7,288,76,288,600,7,426,73,434,1145
301.25,6,29,10067,14,135,23173,223,1289,15,997,17232,1438,8778
12.526,6,6,328,4,0,4175,0,216,2,0,12510,0,112
68.082,6,39,8544,19,371,1810,766,1929,20,446,3576,3488,6615
59.551,6,44,8873,21,371,747,766,2045,23,346,2701,2720,6828
72.774,2,3,96,3,8,36387,8,96,0,0,0,0,0
0.76,17,18,8023,8,468,108,1350,3972,10,377,51,1350,4051
299.531,6,6,364,4,31,99843,31,222,2,31,299515,31,142
1501.963,2,10,320,10,8,166884,8,320,0,0,0,0,0
36.243,6,22,3234,13,183,3020,517,1613,9,381,4528,499,1621
1.536,6,52,20027,28,909,56,1380,14813,24,421,65,1923,5214
0.959,6,10,1687,7,100,159,100,384,3,1179,352,1179,1303
0.3,17,2,180,1,30,0,30,58,1,94,0,94,122
411.297,6,121,20475,54,272,6964,1189,8428,67,228,6231,1420,12047
5.044,17,4,288,2,36,5010,36,128,2,52,5012,52,160
415.631,17,8,2672,8,306,59375,308,2672,0,0,0,0,0
1784.364,1,114,12084,114,78,15790,78,12084,0,0,0,0,0
1795.727,17,447,39864,402,35,4478,288,25644,45,288,40021,288,14220
304.999,6,50,18878,25,988,12654,1360,12890,25,276,12700,1360,5988
10.899,6,92,27453,46,567,242,1152,21131,46,407,236,1152,6322
0.004,17,2,428,1,41,0,41,69,1,331,0,331,359
1.342,6,46,18792,27,867,51,1360,13256,19,476,64,2715,5536
13.627,6,27,4866,13,154,1116,722,1766,14,394,1034,1402,3100
739.722,17,79,6727,73,30,10273,37,4255,6,384,135985,463,2472
5.024,17,4,288,2,36,5005,36,128,2,52,5006,52,160
1775.949,17,73,3060,72,14,25013,14,3024,1,8,0,8,36
550.197,1,50,2800,50,28,11228,28,2800,0,0,0,0,0
135.218,6,39,9724,14,327,57,1189,2535,25,309,5633,1420,7189
0.08,6,12,1955,6,105,15,105,377,6,1326,15,1326,1578
1799.929,17,4572,219456,2287,20,787,20,109776,2285,20,788,20,109680
42.401,6,16,3262,9,210,5299,210,908,7,664,7066,904,2354
2.981,17,7,1286,4,32,992,32,240,3,320,1015,470,1046
1776.522,17,73,3060,72,14,25021,14,3024,1,8,0,8,36
252.081,2,2,64,2,8,252081,8,64,0,0,0,0,0
0.912,6,11,1727,7,100,152,100,384,4,589,216,1152,1343
126.241,2,2,64,2,8,126241,8,64,0,0,0,0,0
1.687,6,61,44187,39,1253,44,1408,37138,22,1179,72,3819,7049
0.776,6,16,2894,8,411,110,585,1646,8,396,107,580,1248
0.586,6,19,7099,12,318,53,600,1906,7,1205,84,1851,5193
96.002,6,3671,2746181,1809,219,53,230,112001,1862,1364,51,2736,2634180
1680.557,17,12,498,11,14,168055,14,462,1,8,0,8,36
0.086,6,10,1669,6,551,17,947,1346,4,159,28,159,323
5.162,6,40,7309,21,201,258,314,3463,19,513,272,1179,3846
143.187,17,17,18914,17,1084,8949,1451,18914,0,0,0,0,0
0.031,17,2,456,1,60,0,60,88,1,340,0,340,368
280.069,6,32,7512,15,158,20004,267,1397,17,543,17500,1400,6115
1773.055,6,181,15589,120,69,14899,69,8940,61,69,29548,69,6649
0.168,17,4,284,2,32,87,32,120,2,54,120,60,164
0.029,17,4,588,2,48,19,48,152,2,190,18,308,436
2.137,6,23,6002,13,108,178,147,959,10,927,212,2602,5043
365.758,6,25,1654,17,180,22859,180,1120,8,110,9267,110,534
3.93,17,3,1000,3,305,1965,308,1000,0,0,0,0,0
28.77,6,48,13314,23,188,1307,721,2812,25,730,1156,1414,10502
1743.861,1,70,7420,70,78,25273,78,7420,0,0,0,0,0
0.606,17,2,152,1,48,0,48,76,1,48,0,48,76
0.988,6,1000,1048913,315,332,3,343,18385,685,1463,1,4739,1030528
0.389,17,4,560,2,64,387,64,184,2,160,264,160,376
15.294,6,2028,1835504,1242,1400,12,1448,1789956,786,776,19,1448,45548
20.587,6,9,577,0,0,0,0,0,9,31,2573,31,577
290.053,6,153,129460,99,430,2959,647,6542,54,2354,1301,8448,122918
1742.491,6,95,7203,63,38,28104,205,4476,32,33,56195,98,2727
0.537,17,4,288,2,36,490,36,128,2,52,494,52,160
1787.642,17,142,11360,71,48,25537,48,5396,71,56,25537,56,5964
1.011,6,26,9300,14,442,77,1404,2948,12,715,79,4455,6352
300.639,6,36,8348,20,280,15823,775,1954,16,522,564,2720,6394
1796.67,17,449,39928,404,35,4458,288,25708,45,288,40019,288,14220
2.147,17,4,420,2,33,0,33,122,2,121,0,145,298
9.372,6,86,24997,44,561,217,1152,19176,42,413,222,1152,5821
280.268,6,30,7432,13,158,23355,267,1317,17,543,17515,1400,6115
0.333,17,2,167,1,39,0,39,67,1,72,0,72,100
1785.202,17,46,15471,46,308,39671,323,15471,0,0,0,0,0
300.817,2,4,128,4,8,100272,8,128,0,0,0,0,0
0.046,6,26,14253,13,126,3,126,810,13,1275,3,1448,13443
164.774,6,23,940,9,0,6016,0,364,14,0,12674,0,576
514.953,1,7,769,7,81,85825,88,769,0,0,0,0,0
5.336,17,4,536,2,54,5283,54,164,2,158,5291,158,372
10.685,6,20,4442,11,275,1068,275,998,9,768,738,1440,3444
184.754,6,32,15255,19,860,10261,1343,9605,13,622,15392,1571,5650
0.037,6,3,192,3,0,0,0,192,0,0,0,0,0
33.376,6,21,3182,12,183,3034,517,1561,9,381,4168,499,1621
4.868,17,19,2582,19,107,270,360,2582,0,0,0,0,0
1776.189,17,142,11360,71,48,25374,48,5396,71,56,25374,56,5964
1772.59,6,180,15480,120,69,14895,69,8940,60,69,30039,69,6540
0.739,17,4,624,2,64,739,64,184,2,192,695,192,440
0.15,17,2,152,1,48,0,48,76,1,48,0,48,76
53.624,6,11,1583,11,127,5362,127,1583,0,0,0,0,0
1787.651,6,104,8308,68,64,26681,64,4896,36,58,51073,58,3412
126.177,2,2,64,2,8,126177,8,64,0,0,0,0,0
1.495,6,47,18775,26,929,59,1460,13159,21,433,64,1460,5616
24.198,17,12,1056,6,48,4808,48,456,6,72,4820,72,600
5.036,17,3,208,2,36,5003,36,128,1,52,0,52,80
378.02,2,3,96,3,8,189010,8,96,0,0,0,0,0
1745.432,6,99,7814,65,45,27272,205,4850,34,35,52880,98,2964
1790.728,6,423,26689,215,69,8367,69,13292,208,43,8650,69,13397
1799.244,17,449,39928,404,35,4464,288,25708,45,288,40012,288,14220
293.923,17,4,352,2,60,293921,60,176,2,60,293922,60,176
0.527,17,2,778,2,361,527,361,778,0,0,0,0,0
1774.729,6,362,42271,156,136,11449,1360,20565,206,126,8656,1360,21706
1793.949,1,58,4872,58,56,31472,56,4872,0,0,0,0,0
0.583,6,7,295,4,0,194,0,164,3,7,200,7,131
0.312,17,2,144,1,36,0,36,64,1,52,0,52,80
0.39,6,15,1773,8,288,53,288,628,7,284,36,434,1145
1786.959,6,104,8376,68,65,26671,65,4930,36,59,51053,59,3446
1.204,17,2,136,1,32,0,32,60,1,48,0,48,76
113.889,6,46,10324,22,541,478,910,3127,24,366,4945,3488,7197
126.081,2,2,64,2,8,126081,8,64,0,0,0,0,0
0.353,6,14,2185,7,324,58,585,1009,7,396,51,580,1176
0.16,17,2,222,1,30,0,30,58,1,136,0,136,164
382.471,6,27,1767,18,177,22498,177,1181,9,110,9609,110,586
0.12,17,2,158,1,34,0,34,62,1,68,0,68,96
15.386,6,16,884,9,0,1922,0,492,7,0,2562,0,392
280.379,6,30,7432,13,158,23364,267,1317,17,603,17520,2076,6115
1740.426,6,87,6322,58,31,30533,31,3915,29,31,62157,31,2407
1770.432,6,105,9618,66,66,27237,66,5610,39,60,46587,60,4008
10.947,6,83,24525,44,550,254,1152,18824,39,459,280,1179,5701
1764.282,1,60,5040,60,56,29903,56,5040,0,0,0,0,0
1794.076,17,144,11520,72,48,25268,48,5472,72,56,25268,56,6048
1779.659,6,259,25980,106,66,16945,659,9794,153,132,11707,2720,16186
1.988,17,5,1272,3,40,994,41,206,2,505,989,505,1066
100.583,6,18,4604,8,309,14369,722,1660,10,344,5833,1448,2944
1787.41,6,104,8308,68,64,26677,64,4896,36,58,51065,58,3412
4.984,2,2,64,2,8,4984,8,64,0,0,0,0,0
1741.279,17,30,31620,30,1026,60044,1026,31620,0,0,0,0,0
1747.679,6,95,7236,62,38,28650,205,4424,33,33,54607,98,2812
1680.444,1,15,840,15,28,120031,28,840,0,0,0,0,0
619.857,6,98,23730,43,333,14758,1360,10470,55,290,11475,1360,13260
1773.711,6,180,15480,120,69,14905,69,8940,60,69,30060,69,6540
1740.462,6,89,6500,58,31,30534,31,3927,31,31,58015,31,2573
0.629,6,2,208,1,0,0,0,40,1,128,0,128,168
0.005,17,2,349,1,48,0,48,76,1,245,0,245,273
0.064,17,2,176,1,48,0,48,76,1,72,0,72,100
1793.498,6,419,66066,256,304,7033,304,48024,163,83,11070,83,18042
20.134,6,22,5470,12,107,1830,159,1074,10,773,2235,1402,4396
1777.887,1,272,28832,272,78,6560,78,28832,0,0,0,0,0
175.826,17,4,240,2,32,175825,32,120,2,32,175825,32,120
1786.974,6,231,33957,144,302,12496,302,24702,87,83,20778,83,9255
1775.709,6,192,12143,100,48,17855,208,7502,92,32,19509,62,4641
0.638,6,110,87381,54,131,12,232,2689,56,1616,10,2760,84692
15.147,17,4,352,2,48,15123,48,152,2,72,15126,72,200
1739.168,6,132,8282,74,46,23824,208,5063,58,31,30504,31,3219
2.865,6,16,7059,9,498,358,721,1360,7,1805,329,2828,5699
0.986,17,4,820,2,36,981,36,128,2,318,981,318,692
224.054,6,162,124953,101,1305,2240,1448,112283,61,632,1413,1448,12670
1791.196,17,144,11520,72,48,25227,48,5472,72,56,25227,56,6048
0.912,6,10,1687,7,100,152,100,384,3,1179,323,1179,1303
1786.135,6,102,8364,68,66,26658,66,4964,34,60,54122,60,3400
1781.016,17,142,11360,71,48,25442,48,5396,71,56,25442,56,5964
211.978,17,4,352,2,60,211977,60,176,2,60,211977,60,176
1795.211,17,80,3354,79,14,23015,14,3318,1,8,0,8,36
2.136,6,8,339,4,0,712,0,164,4,7,582,7,175
0.171,6,22,1357,2,0,149,0,128,20,189,8,189,1229
1789.779,1,138,14628,138,78,13064,78,14628,0,0,0,0,0
1796.32,17,435,37208,394,33,4570,288,24252,41,288,44023,288,12956
280.416,6,30,7432,13,158,23368,267,1317,17,543,17517,1400,6115
383.939,6,45,9212,22,140,12973,501,2010,23,313,17447,1420,7202
218.534,6,162,120102,97,1274,2276,1368,108343,65,676,1806,1368,11759
1772.33,6,180,15480,120,69,14893,69,8940,60,69,30034,69,6540
4.519,6,38,7245,19,218,251,314,3383,19,516,236,1179,3862
1.161,17,6,552,3,32,565,32,180,3,96,564,96,372
316.099,6,60,12867,30,136,10899,615,3682,30,419,10895,4649,9185
15.601,6,8,344,3,0,7800,0,124,5,0,3898,0,220
7.509,6,6,280,2,0,7509,0,88,4,0,2364,0,192
1786.823,6,102,8364,68,66,26669,66,4964,34,60,54143,60,3400
0.042,17,2,144,1,36,0,36,64,1,52,0,52,80
1.311,6,24,8004,12,164,101,267,1288,12,1014,101,2331,6716
0.006,17,2,152,1,48,0,48,76,1,48,0,48,76
842.255,2,7,224,7,8,140375,8,224,0,0,0,0,0
1759.086,6,123,12203,76,62,23454,722,6287,47,88,38236,1408,5916
363.594,6,30,3161,14,324,27968,585,1405,16,226,24239,580,1756
10.962,6,20,4350,11,275,1096,275,998,9,992,780,1440,3352
1741.435,17,29,30624,29,1028,62194,1028,30624,0,0,0,0,0
1776.478,1,58,4872,0,0,0,0,0,58,56,31166,56,4872
2.651,17,18,12448,10,998,291,1350,10266,8,244,373,1350,2182
3.632,6,15,3197,8,49,518,92,511,7,463,38,1408,2686
64.96,6,7,420,7,0,0,0,420,0,0,0,0,0
178.461,6,52,20837,26,1010,2497,1360,11202,26,536,7131,1360,9635
1789.87,1,342,28728,342,56,5248,56,28728,0,0,0,0,0
11.192,2,3,96,3,8,5596,8,96,0,0,0,0,0
429.753,1,8,448,8,28,61393,28,448,0,0,0,0,0
1789.933,6,381,26555,217,97,8286,469,15510,164,69,10981,69,11045
1.356,6,51,21303,28,963,50,1460,15607,23,433,53,1460,5696
1791.17,6,370,25839,216,99,8331,469,15194,154,69,11704,69,10645
288.67,17,6,2016,6,308,57734,308,2016,0,0,0,0,0
1786.782,6,102,8228,68,64,26668,64,4896,34,58,54142,58,3332
1796.583,6,358,22738,208,69,8679,69,12460,150,69,12057,69,10278
5.033,17,4,288,2,36,5015,36,128,2,52,5016,52,160
1789.082,17,83,3480,82,14,22087,14,3444,1,8,0,8,36
4.005,17,5,337,4,33,1333,33,244,1,65,0,65,93
0.234,17,2,148,1,32,0,32,60,1,60,0,60,88
1790.976,17,86,3606,85,14,21321,14,3570,1,8,0,8,36
11.981,1,8,832,0,0,0,0,0,8,76,1711,76,832
1740.078,1,15,840,15,28,124291,28,840,0,0,0,0,0
1785.442,1,8,448,8,28,255063,28,448,0,0,0,0,0
0.025,17,2,490,1,41,0,41,69,1,393,0,393,421
15.339,6,83,30271,38,940,410,1460,22314,45,204,344,1460,7957
1772.407,6,180,15480,120,69,14894,69,8940,60,69,30032,69,6540
0.208,6,46,21425,26,1096,8,1420,16404,20,467,10,1883,5021
0.009,17,2,330,1,30,0,30,58,1,244,0,244,272
1787.192,17,87,3648,86,14,21025,14,3612,1,8,0,8,36
1798.056,1,345,28980,345,56,5226,56,28980,0,0,0,0,0
1.343,6,49,18246,26,882,53,1460,12550,23,433,53,1460,5696
1772.292,6,180,15480,120,69,14893,69,8940,60,69,30035,69,6540
0.776,6,28,5967,14,156,59,267,1502,14,650,55,1420,4465
2.842,17,29,13900,14,690,218,1350,10057,15,228,111,1350,3843
1786.523,6,102,8364,68,66,26664,66,4964,34,60,54134,60,3400
0.361,17,2,384,1,36,0,36,64,1,292,0,292,320
45.846,6,36,12206,15,450,182,1189,3764,21,584,2289,2086,8442
85.608,17,8,2688,8,308,12229,308,2688,0,0,0,0,0
61.279,6,6,1255,4,327,20426,413,814,2,180,61097,269,441
1719.505,17,12,498,11,14,171950,14,462,1,8,0,8,36
6.255,6,23,4490,12,213,568,597,1689,11,552,603,1767,2801
0.543,6,12,1653,6,288,103,288,548,6,426,60,434,1105
53.259,17,4,240,2,32,53258,32,120,2,32,53258,32,120
194.918,17,11,4168,11,350,19491,548,4168,0,0,0,0,0
1743.864,17,423,69792,423,136,4132,376,69792,0,0,0,0,0
0.004,17,2,334,1,32,0,32,60,1,246,0,246,274
760.653,17,241,42377,128,170,5989,1209,25356,113,122,319,1252,17021
3.175,6,5,296,2,0,3000,0,112,3,0,1500,0,184
1791.86,1,266,14896,266,28,6761,28,14896,0,0,0,0,0
143.269,6,214,170987,133,1330,1085,1448,155891,81,604,1788,1448,15096
1764.639,2,14,448,14,8,135741,8,448,0,0,0,0,0
1.536,6,2,175,1,0,0,0,40,1,83,0,83,135
1787.936,6,104,8308,68,64,26685,64,4896,36,58,51081,58,3412
1788.655,1,280,29680,280,78,6410,78,29680,0,0,0,0,0
1786.194,6,104,8444,68,66,26659,66,4964,36,60,51031,60,3480
0.721,6,16,6345,9,141,90,275,646,7,1353,84,1414,5699
1331.878,6,98,10470,60,72,22574,722,5228,38,112,35991,1440,5242
81.906,17,58,15022,58,231,1436,388,15022,0,0,0,0,0
449.18,6,51,6787,24,112,19522,722,2602,27,174,17269,1408,4185
0.913,6,30,10827,17,529,57,1360,3370,13,865,62,3921,7457
134.628,6,29,7392,13,158,11219,267,1317,16,603,8972,2036,6075
20.352,6,24,6256,14,117,1565,159,1361,10,727,2260,1408,4895
121.943,6,73,51161,47,1194,2650,1368,43072,26,841,2475,2519,8089
9.035,6,6,432,0,0,0,0,0,6,48,1807,48,432
1786.654,6,102,8364,68,66,26666,66,4964,34,60,54138,60,3400
0.653,17,5,1687,5,309,163,354,1687,0,0,0,0,0
300.599,6,50,9168,25,286,12524,766,2260,25,327,622,1460,6908
50.49,6,29,7257,14,155,3883,267,1346,15,482,3605,2840,5911
0.403,6,52,19964,29,964,14,1380,12834,23,475,16,1923,7130
0.54,17,4,768,2,39,531,39,134,2,289,12,289,634
1772.812,6,180,15480,120,69,14897,69,8940,60,69,30042,69,6540
0.032,17,4,608,2,60,16,60,176,2,188,15,188,432
29.075,6,17,5750,10,272,3230,516,1220,7,849,111,1452,4530
2.18,6,11,1731,7,100,363,100,384,4,1179,638,1179,1347
428.085,17,4,304,4,48,142695,48,304,0,0,0,0,0
1787.281,6,102,8228,68,64,26675,64,4896,34,58,54155,58,3332
0.073,17,4,284,2,32,0,32,120,2,54,20,60,164
0.224,6,9,1343,5,145,56,145,349,4,830,36,830,994
1793.47,6,362,22898,210,69,8581,69,12678,152,69,11877,69,10220
1794.254,17,180,11520,180,36,10023,36,11520,0,0,0,0,0
1786.702,6,104,8240,68,63,26667,63,4862,36,57,51044,57,3378
0.01,17,2,519,1,40,0,40,68,1,423,0,423,451
252.201,2,3,96,3,8,126100,8,96,0,0,0,0,0
11.591,6,25,8473,13,275,965,275,1078,12,986,758,1440,7395
915.894,6,194,28816,89,230,10407,1360,13783,105,146,8805,4649,15033
1.374,6,51,20679,27,987,52,1460,14943,24,433,52,1460,5736
0.366,6,3,144,2,0,366,0,92,1,0,0,0,52
1794.427,6,135,9349,76,65,23925,208,6059,59,31,30933,31,3290
0.248,6,10,2027,6,553,49,949,1350,4,513,81,513,677
1748.629,6,95,7203,63,38,28203,205,4476,32,33,56396,98,2727
1.383,6,51,20254,28,893,51,1360,14558,23,433,54,1360,5696
19.987,6,3054,2872695,1986,1368,9,1408,2812495,1068,931,18,2816,60200
1770.797,6,99,9174,66,64,27243,64,5544,33,58,55334,58,3630
173.854,6,20791,20045844,13971,1357,12,1408,19686540,6820,776,25,1408,359304
1319.996,6,176,22244,113,112,11785,469,11515,63,157,18751,3423,10729
0.096,6,10,1800,6,616,18,1073,1477,4,159,22,159,323
1773.33,6,184,15778,122,69,14655,69,9020,62,69,29068,69,6758
1744.626,2,17,544,17,8,109039,8,544,0,0,0,0,0
1773.476,6,180,15480,120,69,14903,69,8940,60,69,30050,69,6540
300.25,6,30,11748,17,588,18765,1438,4425,13,948,20016,1488,7323
1779.863,17,138,11040,69,48,26174,48,5244,69,56,26174,56,5796
1770.902,6,116,10639,73,65,24595,65,6184,43,59,42162,59,4455
1783.595,6,360,24694,210,94,8533,469,14347,150,69,11969,69,10347
255.191,6,12,716,4,106,85060,106,274,8,90,36454,90,442
0.007,17,2,553,1,62,0,62,90,1,435,0,435,463
1794.87,17,83,3480,82,14,22158,14,3444,1,8,0,8,36
1784.411,6,418,25021,209,69,8578,69,12500,209,34,8578,48,12521
136.114,17,4,240,2,32,136113,32,120,2,32,136113,32,120
11.575,6,24,8413,13,275,964,275,1078,11,1147,829,2840,7335
1788.659,6,356,22520,208,69,8640,69,12460,148,69,12167,69,10060
115.999,17,4,1344,4,308,38666,308,1344,0,0,0,0,0
1783.952,17,49,16396,49,306,37165,308,16396,0,0,0,0,0
1799.826,6,356,22520,208,69,8694,69,12460,148,69,12243,69,10060
2.713,6,2,100,1,0,0,0,40,1,0,0,0,60
11.94,6,1736,1622055,1145,1365,10,1432,1594124,591,475,20,1871,27931
29.983,6,48,13909,22,299,1427,721,3280,26,599,1185,2840,10629
1.333,6,51,19226,27,883,51,1360,13490,24,433,49,1360,5736
8.4,6,22,9370,11,275,840,275,723,11,1170,525,1414,8647
1754.819,6,143,20580,86,251,20644,1258,14242,57,94,31336,248,6338
1795.762,17,448,39896,403,35,4467,288,25676,45,288,40019,288,14220
25.529,6,25,4420,14,183,1963,517,1689,11,428,2551,499,2731
1782.555,17,83,3480,82,14,22006,14,3444,1,8,0,8,36
38.871,17,11,836,11,48,3887,48,836,0,0,0,0,0
44.971,6,48,12886,23,986,700,1460,6929,25,290,1866,1460,5957
1747.576,6,99,7473,65,38,27305,205,4580,34,33,52950,98,2893
0.113,17,2,572,1,39,0,39,67,1,477,0,477,505
69.29,17,4,5508,4,1349,23096,1349,5508,0,0,0,0,0
1772.36,6,180,15480,120,69,14893,69,8940,60,69,30035,69,6540
66.428,17,4,824,2,48,66416,48,152,2,308,66414,308,672
0.11,17,2,672,2,308,110,308,672,0,0,0,0,0
1.713,17,4,580,2,40,1681,40,136,2,194,1669,194,444
1.166,2,3,96,3,8,583,8,96,0,0,0,0,0
2.331,6,14,2351,8,188,333,245,700,6,703,412,1152,1651
1789.33,6,358,22669,209,69,8602,69,12500,149,69,12089,69,10169
89.112,6,22,9037,11,328,85,677,1458,11,1187,8892,2720,7579
80.232,6,24,10168,12,549,82,1360,2709,12,1161,7277,2574,7459
240.185,6,53,17366,29,770,8577,1408,14613,24,187,10442,580,2753
1786.702,6,105,8475,68,65,26667,65,4930,37,59,49628,59,3545
121.642,6,25,6271,9,267,97,501,1165,16,343,8103,1420,5106
1773.582,6,180,15480,120,69,14904,69,8940,60,69,30051,69,6540
1772.045,6,180,15480,120,69,14891,69,8940,60,69,30032,69,6540
0.021,17,2,231,1,34,0,34,62,1,141,0,141,169
1795.503,1,57,4788,57,56,32062,56,4788,0,0,0,0,0
1797.095,6,365,23087,211,69,8557,69,12787,154,69,11742,69,10300
240.227,6,44,7939,23,139,10919,346,2050,21,532,12011,2800,5889
0.245,17,6,2117,6,324,49,354,2117,0,0,0,0,0
789.023,17,13,4437,13,313,65751,342,4437,0,0,0,0,0
1.399,6,48,19811,27,934,53,1460,14195,21,476,60,2615,5616
1787.771,6,366,25541,213,100,8432,469,14936,153,69,11758,69,10605
1.141,6,25,8056,12,164,88,267,1288,13,869,80,1440,6768
10.828,6,7,380,4,0,3609,0,216,3,0,5405,0,164
374.997,6,18,1239,14,177,28845,177,913,4,110,23579,110,326
280.346,6,28,7352,12,158,25486,267,1277,16,603,18685,1400,6075
1793.729,17,87,3648,86,14,21102,14,3612,1,8,0,8,36
1783.208,6,116,13755,76,81,23776,501,5990,40,162,45720,1420,7765
281.827,17,4,240,2,32,281826,32,120,2,32,281825,32,120
1668.587,1,7,392,7,28,278097,28,392,0,0,0,0,0
0.06,17,2,232,1,49,0,49,77,1,127,0,127,155
0.035,17,3,244,2,32,21,32,120,1,96,0,96,124
1682.836,17,14,1036,7,30,280463,30,406,7,62,280462,62,630
9.117,6,38,10981,20,395,479,668,5018,18,706,534,1368,5963
178.347,1,4,224,4,28,59449,28,224,0,0,0,0,0
1401.457,17,12,897,6,30,280286,30,348,6,63,280288,71,549
1.014,6,4,220,2,0,1014,0,100,2,0,307,0,120
1772.473,6,180,15480,120,69,14894,69,8940,60,69,30035,69,6540
40.191,17,22,1672,22,48,1913,48,1672,0,0,0,0,0
1795.48,17,448,39896,403,35,4466,288,25676,45,288,40018,288,14220
1.238,6,38,8254,19,321,68,1164,2718,19,433,59,1360,5536
1786.417,6,408,24888,215,69,8347,69,12740,193,42,9304,69,12148
1740.513,17,30,31680,30,1028,60017,1028,31680,0,0,0,0,0
1743.554,6,95,7203,63,38,28121,205,4476,32,33,56176,98,2727
131.799,6,38,11910,22,541,6276,863,6045,16,712,2700,1448,5865
197.923,6,44,10243,17,123,5993,267,1673,27,340,7612,2840,8570
1681.586,17,16,1265,8,30,240224,37,471,8,71,240225,136,794
1680.556,17,28,6468,28,203,62242,203,6468,0,0,0,0,0
1.601,6,48,19611,27,920,61,1360,13995,21,433,70,1360,5616
1745.044,6,96,7286,63,38,28145,205,4476,33,33,54525,98,2810
0.005,17,2,471,1,47,0,47,75,1,368,0,368,396
300.896,6,50,13453,26,804,12035,1360,7567,24,307,669,1360,5886
211.588,17,4,352,2,60,211586,60,176,2,60,211587,60,176
5.781,6,459,343199,245,1327,22,1368,327395,214,776,26,1473,15804
1796.774,17,335,87511,335,233,5379,422,87511,0,0,0,0,0
505.599,1,3,336,3,84,252799,100,336,0,0,0,0,0
8.974,6,48,7950,25,224,373,314,3920,23,442,395,1152,4030
2.125,6,11,1731,7,100,354,100,384,4,1179,620,1179,1347
1.346,6,222,188696,143,1349,9,1432,181236,79,389,16,1432,7460
1639.164,17,36,12096,36,308,46833,308,12096,0,0,0,0,0
1799.834,17,448,39896,403,35,4477,288,25676,45,288,40023,288,14220
1773.996,6,180,15480,120,69,14907,69,8940,60,69,30059,69,6540
1773.05,6,87,25395,49,506,36938,1360,15687,38,389,47915,2720,9708
4.198,6,40,7309,19,218,233,314,3383,21,440,197,1152,3926
280.572,6,30,7432,13,158,23381,267,1317,17,543,17530,1400,6115
1.838,6,50,21499,28,979,68,1440,15843,22,433,78,1440,5656
9.257,6,599,537591,392,1303,23,1368,522163,207,776,43,2736,15428
1786.851,6,102,8228,68,64,26669,64,4896,34,58,54144,58,3332
1738.455,1,116,6496,116,28,15117,28,6496,0,0,0,0,0
0.009,6,13,4387,7,92,1,92,464,6,1201,1,2121,3923
0.922,6,10,1687,7,100,153,100,384,3,1179,341,1179,1303
0.079,17,2,182,1,37,0,37,65,1,89,0,89,117
120.816,6,2,176,0,0,0,0,0,2,48,120816,48,176
137.978,6,95,69850,62,1233,2261,1408,59993,33,677,3152,1408,9857
9.91,6,22,6456,7,154,1651,267,752,15,566,683,1452,5704
0.005,17,2,527,1,82,0,82,110,1,389,0,389,417
10.781,6,20,4402,11,275,1078,275,998,9,758,750,1420,3404
93.485,6,33,9018,13,258,65,486,1383,20,487,4913,2720,7635
3.899,17,5,295,5,31,974,31,295,0,0,0,0,0
1793.566,17,179,13962,179,50,10076,50,13962,0,0,0,0,0
280.378,6,30,7432,13,158,23364,267,1317,17,543,17515,1400,6115
1786.617,17,87,3648,86,14,21019,14,3612,1,8,0,8,36
10.033,6,84,25098,42,549,244,1152,19277,42,459,238,1179,5821
0.005,6,3,120,2,0,5,0,80,1,0,0,0,40
315.978,6,58,18209,33,387,9874,1360,9550,25,546,13159,1360,8659
0.55,6,10,924,5,283,93,283,551,5,105,92,105,373
1.473,6,49,18535,27,840,56,1360,12879,22,476,60,2715,5656
1.002,17,8,688,4,47,333,47,300,4,69,333,75,388
0.22,17,2,154,1,33,0,33,61,1,65,0,65,93
3.983,17,4,4253,4,1035,1327,1350,4253,0,0,0,0,0
40.591,17,4,1344,4,308,13530,308,1344,0,0,0,0,0
2.212,6,14,2351,8,188,316,245,700,6,703,391,1152,1651
1788.839,6,365,24563,211,88,8518,469,13987,154,69,11688,69,10576
422.489,6,89,14335,35,179,12425,959,4716,54,260,7971,2425,9619
5.019,17,4,558,2,36,5000,36,128,2,187,5007,187,430
20.301,6,24,5586,13,107,1691,159,1126,11,967,2025,1709,4460
0.189,6,118,110364,44,181,4,253,2851,74,1439,2,2896,107513
1791.159,17,74,3099,72,13,25227,14,3019,2,12,175497,16,80
28.362,6,46,13126,22,200,1350,721,2690,24,728,1197,1440,10436
1798.344,17,449,39928,404,35,4462,288,25708,45,288,40021,288,14220
121.09,1,33,3464,4,84,25917,84,448,29,76,847,76,3016
1.676,6,13,2311,8,188,239,245,700,5,1407,355,1407,1611
1772.336,6,203,22359,130,75,13739,267,10057,73,135,24610,4260,12302
111.695,17,10,585,10,30,12410,31,585,0,0,0,0,0
1796.004,17,448,39896,403,35,4467,288,25676,45,288,40021,288,14220
0.011,17,2,394,1,37,0,37,65,1,301,0,301,329
1797.558,6,367,25650,214,99,8439,469,15045,153,69,11825,69,10605
1779.812,17,141,11276,71,48,25425,48,5396,70,56,25794,56,5880
1775.84,6,181,15589,120,69,14923,69,8940,61,69,29589,69,6649
0.311,17,4,502,2,31,298,31,118,2,164,300,164,384
0.374,17,2,152,1,48,0,48,76,1,48,0,48,76
1.295,6,41,9968,21,440,64,1360,4392,20,433,58,1360,5576
280.438,6,31,7472,14,158,21572,267,1357,17,678,17524,3456,6115
9.488,6,16,3436,5,92,2372,92,348,11,416,906,1448,3088
0.678,17,2,776,2,360,678,360,776,0,0,0,0,0
1799.858,17,449,39928,404,35,4466,288,25708,45,288,40020,288,14220
17.459,17,34,6713,15,179,1244,1350,3111,19,161,968,1350,3602
9.925,6,84,24565,42,550,242,1152,18744,42,459,234,1179,5821
4.376,6,37,7189,19,218,243,314,3383,18,513,242,1179,3806
31.469,6,6,288,1,0,0,0,48,5,0,7567,0,240
4.884,6,41,7349,21,218,244,314,3463,20,440,243,1152,3886
14.686,6,8,822,4,304,4893,304,512,4,102,4891,102,310
1.343,6,42,8471,21,321,67,1164,2810,21,400,58,1460,5661
42.285,17,48,7056,24,48,1838,48,1824,24,190,1837,308,5232
0.43,17,4,560,2,64,428,64,184,2,160,316,160,376
1773.114,6,180,15480,120,69,14900,69,8940,60,69,30045,69,6540
1770.766,6,99,9306,66,66,27242,66,5610,33,60,55333,60,3696
244.223,6,89,23105,42,488,1891,1440,12985,47,316,5306,1702,10120
35.615,17,22,1936,11,48,3556,48,836,11,72,3555,72,1100
1741.382,17,30,31620,30,1026,60047,1026,31620,0,0,0,0,0
4.088,17,5,295,5,31,1022,31,295,0,0,0,0,0
0.199,17,4,284,2,32,0,32,120,2,54,121,60,164
1785.856,6,365,25432,213,100,8423,469,14936,152,69,11826,69,10496
15.338,6,17,2341,8,324,2191,585,1073,9,396,1893,580,1268
1741.475,17,30,31620,30,1026,60050,1026,31620,0,0,0,0,0
0.138,17,2,180,1,30,0,30,58,1,94,0,94,122
52.465,6,42,12107,14,144,738,267,1437,28,502,1942,1917,10670
0.145,17,2,136,1,32,0,32,60,1,48,0,48,76
1788.323,17,142,11360,71,48,25547,48,5396,71,56,25547,56,5964
2.629,6,14,2355,7,188,438,245,660,7,703,395,1152,1695
1.34,6,48,19533,27,914,51,1460,13917,21,433,58,1460,5616
1.237,6,24,8004,12,164,95,267,1288,12,1014,95,2423,6716
316.136,6,187,40476,95,419,3363,1440,26200,92,227,3472,1440,14276
10.727,6,11,2029,7,324,1787,585,1021,4,396,16,580,1008
250.712,1,2,112,2,28,250712,28,112,0,0,0,0,0
0.323,6,21,6055,11,284,31,517,1716,10,952,35,2816,4339
1739.228,6,88,6374,58,31,30512,31,3915,30,31,59972,31,2459
3.2,6,5,232,2,0,3200,0,88,3,0,1524,0,144
17.869,6,947,869965,609,1357,29,1368,846388,338,680,52,2736,23577
1774.9,17,140,11200,70,48,25723,48,5320,70,56,25723,56,5880
1143.008,2,13,416,13,8,95250,8,416,0,0,0,0,0
41.017,17,37,2809,20,40,2158,41,1371,17,56,2559,57,1438
1797.717,17,449,39928,404,35,4460,288,25708,45,288,40019,288,14220
1796.552,17,448,39896,403,35,4469,288,25676,45,288,40026,288,14220
1799.952,17,73849,2953956,36925,8,48,8,1329300,36924,16,48,16,1624656
373.385,6,18,1242,14,180,28721,180,916,4,110,20063,110,326
1740.642,1,56,4704,0,0,0,0,0,56,56,31648,56,4704
1743.954,6,106,7942,68,38,26029,205,4767,38,32,47129,98,3175
1787.829,6,102,8296,68,65,26684,65,4930,34,59,54174,59,3366
13.972,6,31,7290,15,154,982,722,1907,16,568,919,2026,5383
10.75,6,18,5610,10,275,1194,275,958,8,1440,821,1440,4652
1773.363,6,204,22399,129,75,13854,267,10017,75,132,23958,1452,12382
1.24,6,24,8004,12,164,96,267,1288,12,1014,96,2331,6716
403.229,6,21,6603,4,186,64186,267,541,17,413,25201,1460,6062
5.872,6,27,11714,14,507,451,1460,2620,13,1223,477,1460,9094
1795.614,17,448,39896,403,35,4466,288,25676,45,288,40016,288,14220
5.879,6,20,6318,10,268,640,517,1334,10,893,640,2451,4984
1.598,17,2,152,1,48,0,48,76,1,48,0,48,76
171.032,6,21,3242,12,181,15548,595,1722,9,261,21377,580,1520
1793.825,6,322,28909,187,90,9644,1093,13568,135,134,13386,1420,15341
1738.955,6,87,6322,58,31,30507,31,3915,29,31,62104,31,2407
1779.601,17,140,11200,70,48,25791,48,5320,70,56,25791,56,5880
2.245,17,4,1564,4,363,748,363,1564,0,0,0,0,0
4.12,17,4,244,4,33,1373,33,244,0,0,0,0,0
0.015,6,11,3650,6,170,2,170,490,5,1446,3,2675,3160
244.205,17,4,352,2,60,244204,60,176,2,60,244204,60,176
170.276,6,30,26772,18,667,66,1360,4088,12,3170,15463,10880,22684
0.011,17,2,224,1,31,0,31,59,1,137,0,137,165
13.741,17,16,2352,8,48,1961,48,608,8,190,1961,308,1744
10.228,6,86,25013,45,561,232,1152,19216,41,415,249,1152,5797
731.794,6,48,3781,31,64,24393,64,2200,17,56,45730,58,1581
3.991,6,11,467,6,0,798,0,248,5,7,739,7,219
1779.738,1,342,28728,342,56,5219,56,28728,0,0,0,0,0
0.038,17,2,259,1,53,0,53,81,1,150,0,150,178
5.037,6,40,7309,21,218,251,314,3463,19,513,266,1179,3846
1.857,6,13,2311,8,188,265,245,700,5,1407,399,1407,1611
2.475,6,432,348610,252,1374,9,1420,337189,180,467,13,1883,11421
0.063,17,2,128,1,36,0,36,64,1,36,0,36,64
3.927,17,5,295,5,31,981,31,295,0,0,0,0,0
1.48,6,20,3833,11,234,148,564,1504,9,463,162,1343,2329
4.684,6,17,2033,9,370,584,666,1474,8,231,667,231,559
363.156,6,23,1547,15,177,25939,177,1013,8,110,9225,110,534
126.143,2,2,64,2,8,126143,8,64,0,0,0,0,0
240.55,6,41,8648,20,571,12660,1418,5617,21,241,12027,580,3031
2.739,6,28,8830,16,353,182,626,3314,12,1210,246,3314,5516
0.534,17,3,451,2,39,508,39,134,1,289,0,289,317
235.665,6,18,4317,12,257,21424,722,1660,6,1164,7872,1448,2657
3.104,17,2,516,1,60,0,60,88,1,400,0,400,428
1794.924,6,363,22764,208,69,8671,69,12322,155,60,11655,69,10442
660.174,6,90,6808,36,68,18858,364,3311,54,47,12456,78,3497
0.183,6,7,384,4,36,1,42,233,3,31,91,31,151
240.143,6,42,5365,21,205,12007,517,2549,21,213,12006,851,2816
73.302,6,96,20935,60,311,1242,331,11459,36,267,2090,276,9476
3.709,6,613,507395,360,1375,10,1420,493030,253,467,14,1883,14365
1.669,6,25,8787,15,289,119,599,1471,10,987,165,1452,7316
15.937,17,4,1344,4,308,5312,308,1344,0,0,0,0,0
2.331,6,14,2351,8,188,333,245,700,6,703,414,1152,1651
35.003,17,10,490,9,17,4375,58,406,1,56,0,56,84
52.067,6,46,10249,22,533,418,910,3083,24,344,2258,1460,7166
1.575,6,29,10365,17,367,98,833,1785,12,1012,135,1420,8580
0.066,17,4,284,2,32,46,32,120,2,54,50,60,164
289.396,17,4,352,2,60,289394,60,176,2,60,289394,60,176
1783.903,6,106,8524,68,66,26625,66,4964,38,60,48211,60,3560
11.85,6,17,5570,9,275,1481,275,918,8,1440,831,1440,4652
1798.55,6,373,26428,216,104,8365,469,15663,157,69,11526,69,10765
1742.864,6,96,7286,63,38,28110,205,4476,33,33,54453,98,2810
6.58,6,5,232,2,0,6580,0,88,3,0,1516,0,144
0.529,6,22,7345,13,334,44,663,2021,9,1209,61,1946,5324
24.173,6,37,8288,16,188,1611,722,1964,21,498,1190,1380,6324
1774.553,6,180,15480,120,69,14912,69,8940,60,69,30070,69,6540
15.364,6,22,6817,12,275,1396,275,1038,10,1073,1150,1440,5779
1777.963,6,100,7525,65,38,27780,205,4611,35,33,52286,98,2914
0.563,17,2,167,1,39,0,39,67,1,72,0,72,100
1771.14,6,99,9240,66,65,27248,65,5577,33,59,55345,59,3663
6.294,6,14,3178,6,92,1258,92,400,8,1165,812,1448,2778
448.162,2,3,96,3,8,224081,8,96,0,0,0,0,0
39.587,6,5570,5353783,3713,1365,10,1408,5252555,1857,931,21,2801,101228
1778.081,17,142,11360,71,48,25400,48,5396,71,56,25400,56,5964
0.039,17,2,306,1,33,0,33,61,1,217,0,217,245
337.663,6,43,9303,16,151,14554,501,1705,27,271,12983,1420,7598
2.058,6,26,7506,12,265,187,764,1703,14,1010,157,2380,5803
9.143,6,2157,2015184,1378,1385,6,1408,1970012,779,931,11,2801,45172
9.919,6,737,599911,439,1292,22,1368,579751,298,931,32,2736,20160
1792.041,1,342,28728,342,56,5255,56,28728,0,0,0,0,0
11.327,17,3,228,3,48,5663,48,228,0,0,0,0,0
1.407,17,3,1167,3,361,703,361,1167,0,0,0,0,0
53.552,6,35,8320,18,378,513,786,1886,17,522,3338,3488,6434
10.113,17,4,5476,4,1341,3371,1346,5476,0,0,0,0,0
18.652,6,2,1175,1,0,0,0,40,1,1095,0,1095,1135
2.504,17,3,543,2,39,983,39,134,1,381,0,381,409
0.213,6,44,20906,26,1064,8,1420,15965,18,467,12,1883,4941
1796.113,6,127,11006,79,70,23027,721,7001,48,36,38208,98,4005
72.337,6,32,7717,11,155,85,267,1226,21,331,3615,1460,6491
151.932,6,24,10186,12,553,55,1360,2727,12,1161,13800,2574,7459
1715.62,1,8,448,8,28,245088,28,448,0,0,0,0,0
146.974,6,33,18692,18,702,50,1360,4967,15,1311,10488,3510,13725
3.559,6,53,19814,26,921,142,1440,13958,27,433,120,1440,5856
2.22,17,2,265,1,41,0,41,69,1,168,0,168,196
0.017,6,4,220,3,0,8,0,168,1,0,0,0,52
1797.131,17,180,14040,180,50,10039,50,14040,0,0,0,0,0
0.059,17,4,420,2,51,0,51,158,2,103,0,109,262
1799.5,17,205,50933,205,220,8821,422,50933,0,0,0,0,0
1.004,17,23,9833,12,369,88,1350,4766,11,432,96,1350,5067
1776.829,17,73,3060,72,14,25025,14,3024,1,8,0,8,36
10.901,17,4,352,2,48,10885,48,152,2,72,10884,72,200
300.788,6,34,16012,20,195,15830,431,1876,14,1914,5393,6613,14136
1725.57,17,12,498,11,14,172557,14,462,1,8,0,8,36
73.546,6,14,3888,8,127,10506,127,467,6,1056,14700,1704,3421
12.079,17,8,704,4,48,4022,48,304,4,72,4021,72,400
300.324,6,44,29555,25,190,12513,444,2117,19,2034,13443,9856,27438
3.785,17,4,1564,4,363,1261,363,1564,0,0,0,0,0
18.546,6,8,440,5,0,4636,0,268,3,0,8839,0,172
376.258,6,19,1303,14,177,28942,177,925,5,110,15174,110,378
251.903,2,2,64,2,8,251903,8,64,0,0,0,0,0
0.614,6,21,10149,11,433,61,990,1771,10,1138,54,2568,8378
1.972,1,30,840,30,0,0,0,840,0,0,0,0,0
423.245,1,24,2544,24,78,18401,78,2544,0,0,0,0,0
178.122,1,8,448,8,28,25446,28,448,0,0,0,0,0
115.07,6,140,103893,86,1263,1353,1368,92957,54,738,2042,2519,10936
1796.962,1,345,28980,345,56,5223,56,28980,0,0,0,0,0
139.012,6,23,9705,11,380,69,832,1613,12,950,12625,1460,8092
93.563,6,48,26103,29,1052,3341,1448,18363,19,749,3407,1448,7740
116.931,6,25,10113,12,531,58,1360,2661,13,988,9733,1360,7452
1792.262,6,375,23763,213,69,8454,69,13143,162,69,11131,69,10620
73.313,17,10,760,10,48,8145,48,760,0,0,0,0,0
58.35,6,23,8878,14,411,4488,591,1958,9,1074,7290,2808,6920
1795.148,17,142,11360,71,48,25644,48,5396,71,56,25644,56,5964
1.993,17,3,201,3,39,996,39,201,0,0,0,0,0
0.013,17,2,322,1,36,0,36,64,1,230,0,230,258
19.02,17,38,9369,18,222,1116,1350,4507,20,215,999,1350,4862
1787.584,6,416,24920,208,69,8635,69,12460,208,34,8635,64,12460
1.005,6,23,7940,13,164,83,267,1328,10,1216,91,2816,6612
0.073,6,2,100,1,0,0,0,60,1,0,0,0,40
1745.103,6,95,7203,63,38,28146,205,4476,32,33,56281,98,2727
240.183,6,56,16946,31,727,8005,1402,13997,25,205,10007,580,2949
2.887,6,7,288,4,0,962,0,164,3,0,681,0,124
12.066,6,1918,1662015,1160,1377,10,1420,1627474,758,420,15,1420,34541
24.521,6,9,588,3,106,12255,106,234,6,90,4901,90,354
1793.351,17,169,10816,169,36,10674,36,10816,0,0,0,0,0
1788.257,1,273,15288,273,28,6574,28,15288,0,0,0,0,0
280.273,6,21,6934,10,181,31141,267,1128,11,893,28021,3445,5806
941.681,17,84,7704,76,30,12555,37,4436,8,380,127273,463,3268
38.359,6,29,7257,14,155,2950,267,1346,15,482,2739,2840,5911
1796.819,17,449,39928,404,35,4458,288,25708,45,288,40011,288,14220
12.004,6,21,4482,11,275,1200,275,998,10,768,1225,1440,3484
834.418,6,2304,368872,1164,269,582,1440,263421,1140,143,732,1440,105451
114.983,6,25,9908,12,549,55,1460,2709,13,952,9571,1460,7199
300.596,6,37,8562,20,315,15820,882,2129,17,478,527,1968,6433
0.12,17,2,396,1,39,0,39,67,1,301,0,301,329
3.348,6,20,7223,10,498,372,721,1400,10,1353,328,1414,5823
1792.055,17,180,14040,180,50,10011,50,14040,0,0,0,0,0
1787.412,6,103,8336,68,65,26677,65,4930,35,59,52567,59,3406
1740.121,6,92,6668,60,31,29493,31,4062,32,31,56132,31,2606
0.066,6,2,80,1,0,0,0,40,1,0,0,0,40
5.025,17,3,208,2,36,5002,36,128,1,52,0,52,80
9.56,6,87,26842,43,572,227,1152,20600,44,447,216,1179,6242
380.597,1,33,3853,33,88,11893,107,3853,0,0,0,0,0
1.234,6,25,8056,13,164,88,267,1340,12,869,95,1440,6716
0.405,6,10,968,5,256,97,256,460,5,304,97,304,508
1781.014,6,360,22818,209,69,8562,69,12638,151,69,11873,69,10180
1769.875,6,99,9306,66,66,27228,66,5610,33,60,55305,60,3696
354.637,17,16,5248,16,300,23642,300,5248,0,0,0,0,0
1.399,6,50,19265,27,889,53,1460,13569,23,433,55,1460,5696
8.648,6,77,24834,39,568,227,1152,19173,38,459,227,1179,5661
280.691,6,30,7773,13,158,23390,267,1317,17,577,17541,1400,6456
18.052,6,7,388,4,0,6017,0,216,3,0,9016,0,172
9.465,6,1512,1194499,788,1415,11,1448,1146295,724,776,12,1448,48204
1772.809,1,57,4788,57,56,31657,56,4788,0,0,0,0,0
1.468,6,50,19955,27,939,56,1440,14259,23,433,56,1440,5696
0.548,6,23,7397,13,334,45,663,2021,10,967,54,1471,5376
280.414,6,30,7432,13,158,23367,267,1317,17,543,17521,1400,6115
0.691,6,21,7203,13,318,57,600,1958,8,964,91,1471,5245
0.02,17,2,162,1,36,0,36,64,1,70,0,70,98
1773.46,17,138,11040,69,48,26080,48,5244,69,56,26080,56,5796
300.258,6,47,29682,25,190,12510,444,2117,22,1650,11518,6599,27565
240.196,6,53,18141,28,807,8895,1402,15192,25,205,10007,580,2949
15.364,6,24,6993,13,275,1280,275,1078,11,910,1034,1414,5915
1.266,6,47,20353,27,976,48,1460,14777,20,433,57,1460,5576
100.042,6,32,7853,14,158,7695,267,1357,18,524,5884,1400,6496
1790.845,6,356,22520,208,69,8651,69,12460,148,69,12182,69,10060
234.182,6,18,5839,10,784,26020,1360,3538,8,247,33422,272,2301
1793.602,17,180,11520,180,36,10020,36,11520,0,0,0,0,0
1.489,6,50,19033,28,936,55,1460,13332,22,400,62,1460,5701
2.013,17,6,1340,4,40,671,41,274,2,505,2,505,1066
1787.517,6,102,8364,68,66,26679,66,4964,34,60,54163,60,3400
11.09,17,17,18044,17,1033,693,1450,18044,0,0,0,0,0
0.97,6,28,5780,13,125,80,267,1275,15,650,63,1452,4505
233.545,17,2,244,2,94,233545,94,244,0,0,0,0,0
369.413,6,25,1651,17,177,23088,177,1117,8,110,9235,110,534
0.852,6,5,272,3,0,426,0,164,2,0,374,0,108
4.897,17,4,928,4,204,1632,204,928,0,0,0,0,0
1.289,6,32,11105,18,562,75,1360,4137,14,799,84,3494,6968
0.063,17,2,193,1,46,0,46,74,1,91,0,91,119
0.007,17,2,165,1,36,0,36,64,1,73,0,73,101
46.855,6,27,7177,13,155,3904,267,1306,14,530,3603,3417,5871
240.552,6,498,421650,287,460,841,1408,19805,211,1964,1145,7040,401845
159.233,6,5,293,4,31,53077,31,222,1,31,0,31,71
0.51,6,12,1653,6,288,94,288,548,6,426,63,434,1105
1794.608,17,320,41351,160,169,11286,1350,31562,160,33,11286,201,9789
1784.044,6,317,21374,189,69,9489,69,11976,128,69,14042,69,9398
193.163,6,151,125393,93,1371,849,1460,110723,58,881,3385,1572,14670
2.247,6,11,1731,7,100,374,100,384,4,1179,666,1179,1347
2.347,6,13,2311,8,188,335,245,700,5,1407,523,1407,1611
4.266,6,437,481563,147,537,29,1396,9813,290,1596,14,2792,471750
33.608,6,31,5305,16,180,2227,721,1921,15,371,2387,2026,3384
49.269,6,19,8165,8,176,7038,722,1481,11,1221,1901,1448,6684
1684.537,2,13,416,13,8,140378,8,416,0,0,0,0,0
78.993,6,32,25637,18,741,43,1360,3717,14,2668,6065,5440,21920
1744.61,2,27,864,27,8,67100,8,864,0,0,0,0,0
32.007,6,289,278899,99,119,326,279,5505,190,1416,169,2836,273394
70.923,6,30,7432,13,158,5910,267,1317,17,543,4431,1400,6115
6.145,6,13,1811,6,100,1229,100,344,7,1179,980,1179,1467
1786.683,6,102,8364,68,66,26666,66,4964,34,60,54138,60,3400
1001.554,6,57,4483,33,45,31298,205,2451,24,34,38605,98,2032
1740.291,6,87,6322,58,31,30531,31,3915,29,31,62152,31,2407
2.792,6,13,1499,7,299,464,299,679,6,246,557,459,820
452.902,17,8,2688,8,308,64700,308,2688,0,0,0,0,0
9.523,6,82,24565,41,552,238,1152,18784,41,413,231,1152,5781
1772.817,6,180,15480,120,69,14897,69,8940,60,69,30040,69,6540
59.993,6,4,185,2,0,28062,0,104,2,1,31939,1,81
3.138,6,10,1687,6,100,627,100,344,4,589,698,1152,1343
189.144,6,11,788,7,92,31524,92,556,4,0,1053,0,232
0.199,17,2,146,1,37,0,37,65,1,53,0,53,81
1.414,6,38,8258,19,321,78,1168,2722,19,433,68,1360,5536
0.056,6,12,2989,7,695,9,860,1763,5,479,13,939,1226
0.124,17,2,372,1,34,0,34,62,1,282,0,282,310
300.52,6,30,11781,17,592,18782,1408,4458,13,1106,20058,2816,7323
14.74,1,4,224,4,28,4913,28,224,0,0,0,0,0
0.479,17,8,2750,8,315,68,354,2750,0,0,0,0,0
1788.714,17,140,11200,70,48,25923,48,5320,70,56,25923,56,5880
1786.846,6,373,25959,215,99,8349,469,15154,158,69,11378,69,10805
15.325,17,11,4877,5,508,3823,1350,2684,6,337,3058,1350,2193
4.017,17,8,616,4,33,1333,33,244,4,65,1332,65,372
0.066,6,3,144,1,0,0,0,52,2,0,66,0,92
1796.53,17,448,39896,403,35,4468,288,25676,45,288,40020,288,14220
1792.737,6,281,36212,115,164,15724,1360,18640,166,130,10864,1360,17572
281.57,6,30,7570,13,158,23464,267,1317,17,618,17572,3465,6253
0.036,6,16,7476,8,88,5,88,464,8,1670,3,3340,7012
2.86,17,30,9816,15,269,201,1350,4467,15,328,201,1350,5349
1776.676,6,79,4198,40,26,45554,26,2118,39,26,46753,26,2080
3.008,6,3,168,1,0,0,0,52,2,0,3008,0,116
10.997,6,20,4442,11,275,1099,275,998,9,768,778,1440,3444
0.189,1,2,112,2,28,189,28,112,0,0,0,0,0
61.919,6,72,50503,46,1176,1375,1368,42415,26,841,2467,2519,8088
0.214,1,2,112,2,28,214,28,112,0,0,0,0,0
0.207,6,115,105596,41,332,5,332,2804,74,1393,2,1438,102792
1755.169,6,185,11553,93,50,19077,208,6912,92,31,19284,31,4641
1799.497,17,449,39928,404,35,4465,288,25708,45,288,40016,288,14220
918.909,6,121,23398,50,252,18753,1460,10861,71,189,13125,1629,12537
240.204,6,56,18710,30,749,8282,1418,15814,26,192,9607,580,2896
60.724,6,31,9617,16,217,4039,698,1976,15,624,4327,2816,7641
0.027,17,2,656,1,300,0,300,328,1,300,0,300,328
9.376,6,34,7653,19,135,520,269,1943,15,612,652,1533,5710
1560.005,6,116,11745,68,67,23281,722,5779,48,96,33187,1408,5966
11.612,6,45,8409,23,227,527,314,4102,22,489,540,1179,4307
0.905,17,4,368,2,32,889,32,120,2,96,886,96,248
1752.483,1,7,392,7,28,292080,28,392,0,0,0,0,0
1773.011,6,180,15480,120,69,14899,69,8940,60,69,30045,69,6540
1772.529,6,180,15480,120,69,14895,69,8940,60,69,30034,69,6540
0.01,17,4,336,2,34,3,34,124,2,78,2,84,212
3.642,6,254,173305,127,1003,28,1360,18045,127,1328,27,1490,155260
1787.317,6,104,8376,68,65,26676,65,4930,36,59,51063,59,3446
0.014,6,10,1510,5,657,3,657,925,5,317,3,317,585
6.245,17,21,8220,9,519,780,1350,4924,12,246,558,1350,3296
1784.119,6,80,4656,40,36,45745,36,2116,40,460,45745,460,2540
1.96,17,3,222,3,46,980,46,222,0,0,0,0,0
11.909,6,1939,1640975,1157,1364,10,1380,1605453,782,468,15,3303,35522
1773.506,6,205,22439,130,75,13748,267,10057,75,132,23960,1460,12382
6.267,6,45,8409,22,227,298,314,4062,23,489,259,1179,4347
1.455,6,49,19942,27,941,55,1440,14286,22,433,60,1440,5656
0.902,17,2,778,2,361,902,361,778,0,0,0,0,0
109.737,17,4,1344,4,308,36579,308,1344,0,0,0,0,0
13.056,6,25,7097,12,155,1186,267,1266,13,589,1087,3426,5831
202.72,6,28,7038,10,199,266,293,1602,18,392,11910,1179,5436
1720.5,17,12,498,11,14,172050,14,462,1,8,0,8,36
0.917,6,10,1687,7,100,152,100,384,3,1179,336,1179,1303
0.412,6,10,1669,6,551,82,947,1346,4,159,137,159,323
1789.091,1,138,7728,138,28,13059,28,7728,0,0,0,0,0
768.008,6,10,865,10,46,85334,62,865,0,0,0,0,0
3.112,17,3,201,3,39,1556,39,201,0,0,0,0,0
1.09,6,24,8004,12,164,84,267,1288,12,1014,84,2816,6716
38.461,17,11,836,11,48,3846,48,836,0,0,0,0,0
1786.778,6,104,8376,68,65,26668,65,4930,36,59,51048,59,3446
1194.493,17,45,15318,45,312,27147,329,15318,0,0,0,0,0
2.628,17,2,154,1,33,0,33,61,1,65,0,65,93
858.488,17,24,8072,24,308,37325,326,8072,0,0,0,0,0
3.507,17,5,290,5,30,876,30,290,0,0,0,0,0
9.051,6,16,8640,4,112,3013,112,280,12,1122,821,1460,8360
0.43,6,13,1693,6,288,83,288,548,7,426,38,434,1145
1622.234,1,7,392,7,28,270372,28,392,0,0,0,0,0
9.602,6,91,28927,45,577,218,1152,22605,46,447,207,1179,6322
19.492,6,59,23715,29,960,696,1440,17527,30,433,664,1440,6188
0.175,6,9,1343,5,145,43,145,349,4,830,31,830,994
166.702,17,8,2688,8,308,23814,308,2688,0,0,0,0,0
1791.349,1,58,4872,58,56,31427,56,4872,0,0,0,0,0
15.142,6,23,6120,12,286,1376,326,1221,11,1076,1513,1408,4899
1781.463,17,142,11360,71,48,25449,48,5396,71,56,25449,56,5964
15.28,17,23,11077,11,506,1525,1350,5874,12,405,1386,1350,5203
1786.658,6,104,8308,68,64,26666,64,4896,36,58,51044,58,3412
1799.042,6,161,16246,85,66,21417,722,6539,76,141,23166,2007,9707
1.007,6,27,8420,15,222,60,540,1964,12,1192,74,3151,6456
1780.973,6,104,8167,68,45,26581,205,5037,36,34,50872,98,3130
14.86,1,8,448,8,28,2122,28,448,0,0,0,0,0
1799.063,17,449,39928,404,35,4464,288,25708,45,288,40020,288,14220
272.09,17,4,352,2,60,272086,60,176,2,60,272089,60,176
0.448,1,2,112,2,28,448,28,112,0,0,0,0,0
159.849,6,83,59602,53,1213,3074,1368,51306,30,841,2330,2736,8296
1772.256,6,180,15480,120,69,14892,69,8940,60,69,30033,69,6540
1772.491,17,134,10720,67,48,26855,48,5092,67,56,26855,56,5628
3.429,6,25,5795,13,158,284,370,1315,12,799,310,1420,4480
0.495,6,25,6055,14,108,38,147,999,11,768,48,1581,5056
1742.596,1,83,6972,0,0,0,0,0,83,56,21251,56,6972
1782.21,17,83,3480,82,14,22002,14,3444,1,8,0,8,36
10.253,6,1625,1419219,987,1386,10,1420,1389478,638,420,16,1420,29741
1.972,6,15,2391,9,125,246,245,740,6,1407,341,1407,1651
0.007,6,2,88,1,0,0,0,44,1,0,0,0,44
11.829,6,1862,1633560,1133,1386,10,1420,1600179,729,420,16,1420,33381
661.76,2,6,192,6,8,132352,8,192,0,0,0,0,0
29.322,6,27,7177,13,155,2443,267,1306,14,530,2254,3417,5871
300.791,6,45,10021,25,540,12532,1360,4312,20,349,451,2667,5709
0.514,17,4,240,2,32,513,32,120,2,32,513,32,120
1203.207,2,11,352,11,8,120320,8,352,0,0,0,0,0
2.703,6,2,88,2,0,0,0,88,0,0,0,0,0
1772.427,6,180,15480,120,69,14894,69,8940,60,69,30033,69,6540
0.124,6,64,55262,24,273,5,517,2077,40,1419,2,1709,53185
281.045,6,30,7432,13,158,23420,267,1317,17,603,17558,2760,6115
0.655,17,2,152,1,48,0,48,76,1,48,0,48,76
1785.632,6,356,22520,208,69,8626,69,12460,148,69,12147,69,10060
20.127,6,20,2460,11,189,2012,517,1338,9,323,2514,499,1122
12.281,6,1921,1678435,1180,1367,10,1380,1642733,741,468,16,3303,35702
300.842,6,43,13608,23,881,13674,1460,8006,20,399,455,1460,5602
1777.497,17,140,11200,70,48,25760,48,5320,70,56,25760,56,5880
367.291,6,25,1651,17,177,22955,177,1117,8,110,9198,110,534
31.322,6,11,476,4,0,13,0,168,7,0,5217,0,308
1744.585,6,127,11571,70,99,25283,205,7428,57,31,31145,35,4143
1786.488,6,102,8364,68,66,26664,66,4964,34,60,54133,60,3400
5.016,17,4,542,2,36,5007,36,128,2,179,5004,187,414
0.024,17,2,158,1,34,0,34,62,1,68,0,68,96
1770.931,6,105,9828,68,66,26431,66,5792,37,60,49189,60,4036
0.978,6,23,6368,13,297,81,830,2011,10,1317,107,3151,4357
0.191,17,4,904,4,198,63,356,904,0,0,0,0,0
3.062,17,4,386,2,46,3055,46,148,2,91,3055,91,238
239.519,2,2,64,2,8,239519,8,64,0,0,0,0,0
1681.537,1,7,392,7,28,280256,28,392,0,0,0,0,0
1785.854,6,367,25250,213,94,8423,469,14536,154,69,11672,69,10714
119.855,6,5801,5074703,3736,1279,32,1368,4962635,2065,931,57,2841,112068
1762.41,6,80,3680,40,0,45189,0,2080,40,0,45189,0,1600
218.516,6,1798,955725,1053,845,207,1152,915955,745,383,293,1179,39770
5.19,17,4,352,2,48,5049,48,152,2,72,5057,72,200
1797.352,1,138,7728,138,28,13119,28,7728,0,0,0,0,0
1796.796,17,449,39928,404,35,4458,288,25708,45,288,40018,288,14220
0.011,17,2,378,1,30,0,30,58,1,292,0,292,320
0.247,6,22,4442,11,165,24,456,1394,11,493,23,888,3048
739.164,6,138,19041,71,172,10559,1189,7858,67,257,7725,1460,11183
5.111,17,4,558,2,36,5105,36,128,2,187,5105,187,430
22.833,6,16,7051,7,49,3805,92,471,9,1221,2817,1448,6580
0.263,17,2,384,1,39,0,39,67,1,289,0,289,317
604.153,17,13,5472,13,392,50346,1238,5472,0,0,0,0,0
0.029,17,4,360,2,30,5,30,116,2,94,12,94,244
0.007,6,2,294,1,202,0,202,254,1,0,0,0,40
1786.469,6,184,15640,123,69,14643,69,9060,61,69,29059,69,6580
11.418,17,2,152,2,48,11418,48,152,0,0,0,0,0
1.593,6,26,8817,16,287,106,594,1506,10,986,157,1420,7311
1787.528,6,104,8252,68,63,26679,64,4868,36,57,51069,58,3384
88.365,17,6,1993,6,304,17673,318,1993,0,0,0,0,0
265.552,6,40,9742,13,273,22128,469,2713,27,282,10213,1460,7029
166.672,17,2,768,2,356,166672,356,768,0,0,0,0,0
1786.961,6,359,22709,209,69,8591,69,12569,150,69,11992,69,10140
570.883,6,39,3292,29,64,20388,64,2312,10,58,54141,58,980
1777.746,17,142,11360,71,48,25395,48,5396,71,56,25395,56,5964
349.261,6,66,13938,29,99,9905,267,2567,37,308,9701,1917,11371
1797.916,1,342,28728,342,56,5272,56,28728,0,0,0,0,0
7.241,6,1581,1514080,1038,1384,6,1408,1481180,543,776,13,1408,32900
1786.557,6,102,8296,68,65,26665,65,4930,34,59,54135,59,3366
1.103,17,24,12028,13,517,88,1350,7092,11,420,105,1350,4936
150.247,6,28,6570,10,217,6294,502,1272,18,304,8832,1420,5298
1772.35,6,180,15480,120,69,14893,69,8940,60,69,30032,69,6540
253.49,6,60,21831,28,162,9388,653,2661,32,795,8176,1438,19170
0.281,6,26,8868,13,227,23,547,1592,13,1098,23,2816,7276
0.511,6,11,3287,6,81,102,81,401,5,872,127,1448,2886
8.91,6,71,20678,36,533,254,1152,15851,35,427,254,1152,4827
0.2,6,9,1146,5,357,50,357,561,4,421,54,421,585
1787.182,17,207,53435,207,230,8675,422,53435,0,0,0,0,0
1788.606,17,87,3648,86,14,21042,14,3612,1,8,0,8,36
4.248,6,36,6249,20,206,223,314,2864,16,548,267,1179,3385
0.362,6,7,716,4,226,120,226,442,3,110,90,110,274
240.197,6,54,19435,29,841,8578,1418,16665,25,182,10007,580,2770
1751.242,17,12,498,11,14,175124,14,462,1,8,0,8,36
240.242,6,53,17804,28,785,8897,1418,14823,25,209,10009,580,2981
0.367,6,10,968,5,256,89,256,460,5,304,89,304,508
282.632,6,31,7472,14,158,21740,267,1357,17,543,17662,1400,6115
4.93,6,41,7349,22,218,234,314,3503,19,513,260,1179,3846
1681.497,17,14,1036,7,30,280247,30,406,7,62,280247,62,630
1797.26,1,345,28980,345,56,5224,56,28980,0,0,0,0,0
0.181,17,2,2378,2,1161,181,1161,2378,0,0,0,0,0
1775.176,17,139,11116,70,48,25726,48,5320,69,56,26105,56,5796
160.66,6,170,136667,110,1285,1473,1368,124034,60,633,2718,1368,12633
1.752,6,118,152216,56,281,31,873,4671,62,2531,28,8448,147545
1798.588,17,142,11360,71,48,25693,48,5396,71,56,25693,56,5964
1793.518,6,360,22887,209,69,8622,69,12569,151,69,11956,69,10318
1720.457,17,12,498,11,14,172045,14,462,1,8,0,8,36
1.169,6,10,1687,7,100,194,100,384,3,1179,458,1179,1303
1799.727,6,100,7702,66,40,27688,205,4730,34,35,54525,108,2972
0.181,6,9,1340,5,145,45,145,349,4,827,29,827,991
0.001,6,3,168,1,0,0,0,40,2,0,0,0,128
1794.333,17,174,37863,174,189,10371,377,37863,0,0,0,0,0
257.299,6,29,7001,13,229,183,498,1672,16,390,17147,1420,5329
1786.23,17,87,3648,86,14,21014,14,3612,1,8,0,8,36
1753.372,6,184,18414,114,94,15516,205,10539,70,60,25404,144,7875
12.026,6,96,28050,49,547,250,1152,21688,47,447,254,1179,6362
0.963,6,10,1687,7,100,160,100,384,3,1179,358,1179,1303
0.002,17,2,172,2,58,2,58,172,0,0,0,0,0
562.702,1,6,489,6,53,112540,78,489,0,0,0,0,0
1.369,6,50,21559,28,983,50,1440,15903,22,433,56,1440,5656
0.124,6,3,151,1,0,0,0,40,2,31,72,31,111
2.35,6,54,15243,29,502,83,1460,4808,25,523,89,2615,10435
0.07,17,2,389,1,34,0,34,62,1,299,0,299,327
1748.377,17,66,2766,65,14,27318,14,2730,1,8,0,8,36
15.067,6,16,1327,8,222,2151,222,768,8,231,2151,231,559
0.475,6,38,21448,23,171,21,313,1890,15,2346,33,11264,19558
1772.353,6,180,15480,120,69,14893,69,8940,60,69,30032,69,6540
20.361,6,21,5588,12,115,1851,159,1233,9,773,2539,1418,4355
1770.528,17,190,45326,190,210,9367,422,45326,0,0,0,0,0
4.421,6,38,7229,20,218,232,314,3423,18,513,244,1179,3806
1.515,6,40,8391,21,321,75,1164,2810,19,437,73,2720,5581
299.178,1,4,326,4,53,99726,78,326,0,0,0,0,0
1789.432,17,142,11360,71,48,25563,48,5396,71,56,25563,56,5964
0.139,17,2,312,1,64,0,64,92,1,192,0,192,220
27.564,17,4,1312,4,300,9188,300,1312,0,0,0,0,0
0.162,6,45,20863,26,1057,6,1420,15882,19,420,8,1420,4981
11.269,6,27,11355,13,275,939,275,1078,14,1078,833,1414,10277
1765.58,1,58,4872,58,56,30975,56,4872,0,0,0,0,0
60.867,17,6,528,3,48,30429,48,228,3,72,30428,72,300
305.209,6,122,80520,61,162,5086,230,4062,61,1332,5083,1453,76458
3.215,17,5,295,5,31,803,31,295,0,0,0,0,0
1796.571,17,448,39896,403,35,4469,288,25676,45,288,40015,288,14220
1787.356,6,102,8228,68,64,26676,64,4896,34,58,54157,58,3332
424.225,17,6,1972,6,300,84845,304,1972,0,0,0,0,0
1756.344,6,95,7234,62,38,28792,205,4424,33,33,54878,98,2810
217.942,17,10,1588,5,48,54483,48,380,5,213,54482,308,1208
0.383,17,2,632,1,288,0,288,316,1,288,0,288,316
0.192,17,8,2758,8,316,27,355,2758,0,0,0,0,0
0.07,17,2,212,1,46,0,46,74,1,110,0,110,138
1796.684,17,449,39928,404,35,4458,288,25708,45,288,40014,288,14220
1799.012,1,247,13832,247,28,7313,28,13832,0,0,0,0,0
1782.131,17,83,3480,82,14,22001,14,3444,1,8,0,8,36
38.247,17,22,1936,11,48,3823,48,836,11,72,3823,72,1100
1676.113,1,7,392,7,28,279352,28,392,0,0,0,0,0
280.609,6,33,8952,15,158,20043,267,1397,18,621,16505,1400,7555
23.111,17,55,16520,27,371,887,1350,10792,28,176,854,1350,5728
300.627,6,46,9016,23,301,13664,860,2218,23,345,443,1460,6798
1772.351,6,180,15480,120,69,14893,69,8940,60,69,30035,69,6540
0.09,17,4,420,2,33,3,33,122,2,121,84,145,298
1776.687,6,78,4108,39,26,46753,26,2054,39,26,46753,26,2054
1790.629,1,80,4480,80,28,22666,28,4480,0,0,0,0,0
1772.039,6,180,15480,120,69,14891,69,8940,60,69,30032,69,6540
1385.552,2,11,352,11,8,138555,8,352,0,0,0,0,0
1771.363,6,99,9240,66,65,27251,65,5577,33,59,55352,59,3663
1798.995,6,355,22480,207,69,8732,69,12420,148,69,12237,69,10060
0.007,6,2,664,1,572,0,572,624,1,0,0,0,40
337.37,17,20,6720,20,308,17756,308,6720,0,0,0,0,0
1628.129,1,8,448,8,28,232589,28,448,0,0,0,0,0
63.56,6,38,8194,13,140,5295,267,1513,25,298,2647,1420,6681
266.946,6,16,3785,7,150,1697,174,584,9,472,33357,2642,3201
0.492,17,3,451,2,39,363,39,134,1,289,0,289,317
280.226,6,26,7272,12,158,25475,267,1277,14,678,21554,2045,5995
39.475,1,3,312,3,76,19737,76,312,0,0,0,0,0
0.03,17,4,398,2,46,17,46,148,2,97,16,103,250
0.035,17,3,234,2,39,9,39,134,1,72,0,72,100
1.301,6,47,19396,27,907,50,1360,13820,20,476,59,2715,5576
7.965,6,18,6791,9,275,995,275,643,9,1155,882,1420,6148
1797.078,6,355,22480,207,69,8723,69,12420,148,69,12224,69,10060
0.397,17,2,166,1,47,0,47,75,1,63,0,63,91
280.157,6,29,7392,13,158,23346,267,1317,16,603,18676,2800,6075
0.0,17,2,132,2,38,0,38,132,0,0,0,0,0
1.292,6,24,6041,12,108,117,147,919,12,773,99,1430,5122
1167.365,6,239,15080,138,69,8520,69,8349,101,69,11673,69,6731
0.314,6,22,7333,12,334,28,663,1969,10,1209,34,1906,5364
136.757,17,18,4068,18,198,8044,207,4068,0,0,0,0,0
1777.537,17,142,11360,71,48,25393,48,5396,71,56,25393,56,5964
1791.289,1,342,28728,342,56,5253,56,28728,0,0,0,0,0
3.151,17,3,174,3,30,1575,30,174,0,0,0,0,0
73.124,17,4,240,2,32,73123,32,120,2,32,73123,32,120
3.824,17,4,268,4,39,1274,39,268,0,0,0,0,0
1.525,6,58,18034,28,707,56,1360,8925,30,438,52,1360,9109
23.489,17,45,14969,21,203,1172,1350,4853,24,393,1020,1350,10116
291.5,6,31,7182,13,230,160,502,1676,18,318,17141,1420,5506
18.847,17,41,12912,21,432,940,1350,9669,20,134,990,1350,3243
280.202,6,29,7392,13,158,23350,267,1317,16,603,18678,1400,6075
1.017,17,2,144,1,36,0,36,64,1,52,0,52,80
0.527,17,8,2750,8,315,75,354,2750,0,0,0,0,0
280.231,6,29,7392,13,158,23352,267,1317,16,603,18680,1400,6075
1783.817,6,366,25541,213,100,8414,469,14936,153,69,11735,69,10605
3.366,17,5,295,5,31,841,31,295,0,0,0,0,0
0.401,6,10,1669,6,551,80,947,1346,4,159,133,159,323
1.504,6,42,11418,22,547,71,1360,5842,20,476,69,2715,5576
280.756,6,30,7432,13,158,23396,267,1317,17,543,17541,1400,6115
0.003,6,3,151,1,0,0,0,40,2,31,3,31,111
1729.968,1,8,848,8,78,247138,78,848,0,0,0,0,0
300.551,6,19,1279,6,177,60076,177,497,13,110,25031,110,782
1775.417,17,355,57929,355,135,5015,366,57929,0,0,0,0,0
118.903,17,4,240,2,32,118902,32,120,2,32,118902,32,120
256.11,6,19,6477,3,101,128050,112,331,16,422,17073,1420,6146
1667.027,1,7,392,7,28,277837,28,392,0,0,0,0,0
40.042,17,21,7802,10,449,4445,1350,4770,11,247,4000,1350,3032
1.649,6,13,2311,8,188,235,245,700,5,1407,349,1407,1611
4.931,6,39,7269,21,218,246,314,3463,18,513,274,1179,3806
0.098,17,2,588,1,39,0,39,67,1,493,0,493,521
1790.805,6,400,34815,227,117,7923,1189,17747,173,133,10411,1460,17068
5.023,17,4,288,2,36,4991,36,128,2,52,4991,52,160
219.364,17,12,4006,12,305,19942,322,4006,0,0,0,0,0
4.352,17,23,14084,13,856,362,1350,11502,10,230,455,1350,2582
6.423,6,3,1690,3,785,3211,785,1690,0,0,0,0,0
0.774,6,23,5715,13,158,64,370,1315,10,999,85,1731,4400
108.562,6,31,14351,15,1002,76,1440,6658,16,782,7225,1440,7693
4.15,17,35,17675,17,758,259,1350,13378,18,210,198,1350,4297
185.653,1,8,448,8,28,26521,28,448,0,0,0,0,0
15.602,17,14,6653,7,613,2591,1350,4490,7,281,2585,1350,2163
287.114,17,4,240,2,32,287113,32,120,2,32,287113,32,120
1.703,6,48,20069,28,878,63,1360,14397,20,441,80,2720,5672
0.24,17,2,180,1,30,0,30,58,1,94,0,94,122
0.017,17,2,335,1,61,0,61,89,1,218,0,218,246
0.115,17,2,144,1,36,0,36,64,1,52,0,52,80
1.873,6,27,6245,14,157,144,267,1820,13,780,149,1420,4425
1084.202,6,80,12706,45,102,19731,498,3955,35,222,31885,1420,8751
6.007,17,4,802,2,44,6002,44,144,2,301,6001,317,658
1742.929,6,97,7338,64,38,27665,205,4528,33,33,54455,98,2810
0.004,17,2,136,1,32,0,32,60,1,48,0,48,76
0.675,6,3,132,2,0,500,0,92,1,0,0,0,40
1381.35,6,140,12017,92,69,15179,69,6923,48,69,29390,69,5094
1798.092,6,366,24603,213,87,8481,469,14136,153,69,11828,69,10467
2.321,17,4,1568,4,364,773,364,1568,0,0,0,0,0
1772.759,6,122,12255,77,62,23325,722,6402,45,94,40284,1408,5853
0.056,17,4,420,2,33,0,33,122,2,121,41,145,298
13.366,17,4,4385,4,1068,4455,1451,4385,0,0,0,0,0
10.873,6,18,5610,10,275,1208,275,958,8,1440,838,1440,4652
373.577,6,25,1651,17,177,23348,177,1117,8,110,9254,110,534
42.125,17,24,2112,12,48,3828,48,912,12,72,3828,72,1200
950.149,6,121,9444,46,74,21111,375,4604,75,49,12837,143,4840
99.016,6,66,45065,43,1163,2357,1408,37135,23,960,2800,3847,7930
0.291,17,4,240,2,32,290,32,120,2,32,290,32,120
0.359,17,8,2766,8,317,51,356,2766,0,0,0,0,0
377.359,6,24,1551,14,177,29027,177,913,10,110,9683,110,638
329.814,1,5,437,5,59,82453,83,437,0,0,0,0,0
1779.334,17,141,11276,71,48,25418,48,5396,70,56,25787,56,5880
108.54,17,4,240,2,32,108538,32,120,2,32,108539,32,120
6.097,6,42,7389,22,218,290,314,3503,20,513,305,1179,3886
0.379,6,13,1693,7,288,63,288,588,6,426,41,434,1105
15.81,17,10,760,10,48,1756,48,760,0,0,0,0,0
1783.32,6,179,17606,97,67,18576,722,7840,82,158,22012,2007,9766
1795.076,6,367,25788,212,99,8507,469,14965,155,69,11655,69,10823
280.606,17,4,240,2,32,280605,32,120,2,32,280604,32,120
1.287,6,50,19690,27,920,49,1460,13994,23,433,50,1460,5696
0.883,17,4,502,2,31,871,31,118,2,164,871,164,384
39.685,6,751,678174,523,1333,75,1360,661206,228,211,174,4027,16968
1422.481,17,140,11743,130,30,11026,37,7575,10,388,151422,463,4168
335.449,1,11,616,11,28,33544,28,616,0,0,0,0,0
82.654,6,34,7802,13,155,6887,267,1306,21,353,4132,1420,6496
300.145,6,44,11071,23,736,13635,1360,5384,21,371,14998,1360,5687
305.526,6,71,11927,31,188,10183,1189,3698,40,254,7833,1420,8229
12.042,6,2024,1888929,1304,1370,9,1408,1846825,720,931,16,2816,42104
1770.33,6,101,9410,66,66,27235,66,5610,35,60,52065,60,3800
23.277,6,3161,2992624,2072,1365,11,1368,2926194,1089,792,21,2736,66430
1744.745,6,97,7307,63,38,28141,205,4476,34,33,52858,98,2831
1764.116,2,14,448,14,8,135701,8,448,0,0,0,0,0
0.043,17,2,246,1,67,0,67,95,1,123,0,123,151
1704.39,17,198,44374,198,196,8651,422,44374,0,0,0,0,0
0.236,6,4,493,2,241,236,241,321,2,92,9,92,172
115.251,17,2,72,1,8,0,8,36,1,8,0,8,36
0.061,6,11,1880,5,102,15,102,370,6,1190,12,1190,1510
1788.234,1,258,27348,258,78,6958,78,27348,0,0,0,0,0
417.006,6,63,10454,29,99,14893,267,2567,34,224,12630,1460,7887
0.052,17,2,196,1,46,0,46,74,1,94,0,94,122
1769.875,6,101,9410,66,66,27228,66,5610,35,60,52052,60,3800
0.168,6,46,21666,27,1039,6,1420,16685,19,467,8,1883,4981
17.397,6,3105,2970448,2044,1376,8,1408,2910612,1061,931,16,2816,59836
1799.381,6,371,25948,215,99,8408,469,15154,156,69,11608,69,10794
1.31,6,51,19770,29,918,46,1360,14069,22,437,53,2715,5701
3.259,17,4,1568,4,364,1086,364,1568,0,0,0,0,0
1791.829,17,138,11016,72,48,25236,48,5472,66,56,27566,56,5544
30.582,17,8,704,4,48,10191,48,304,4,72,10189,72,400
1.119,17,8,704,4,37,370,37,260,4,83,370,89,444
219.038,17,4,352,2,60,219037,60,176,2,60,219037,60,176
197.737,17,52,3982,26,40,7898,41,1783,26,56,7906,57,2199
1798.049,6,330,31403,162,306,11086,841,10925,168,72,10766,1418,20478
0.079,17,4,284,2,32,70,32,120,2,54,10,60,164
1777.488,6,180,43320,120,483,14936,483,35220,60,83,30126,83,8100
0.035,17,6,912,3,60,9,60,264,3,188,7,188,648
0.888,6,10,1687,7,100,148,100,384,3,1179,314,1179,1303
1378.466,1,105,5880,105,28,13254,28,5880,0,0,0,0,0
1.433,6,23,7952,12,164,112,267,1288,11,1216,124,3859,6664
0.016,17,2,241,1,52,0,52,80,1,133,0,133,161
0.232,6,9,1002,5,213,58,213,417,4,421,64,421,585
1774.79,6,180,15480,120,69,14914,69,8940,60,69,30078,69,6540
1328.123,1,96,5376,96,28,13980,28,5376,0,0,0,0,0
1771.825,6,102,9396,66,65,27258,65,5577,36,59,50620,59,3819
803.977,17,10,821,5,31,200985,37,297,5,76,200986,136,524
285.788,6,20,1471,10,344,31753,344,872,10,83,31753,83,599
90.974,17,19,1444,19,48,5054,48,1444,0,0,0,0,0
1794.122,17,80,3354,79,14,23001,14,3318,1,8,0,8,36
111.439,17,4,352,2,60,111438,60,176,2,60,111438,60,176
1770.589,6,103,9448,66,65,27239,65,5577,37,59,49178,59,3871
2.326,17,4,377,2,33,2313,37,123,2,99,2314,136,254
1636.987,1,34,4413,34,101,49605,320,4413,0,0,0,0,0
3.423,17,10,1450,5,40,847,40,340,5,194,847,194,1110
0.659,6,129,85645,70,1291,9,1432,78994,59,427,10,1432,6651
1.624,6,13,2311,8,188,232,245,700,5,1407,344,1407,1611
0.04,1,2,689,2,316,40,327,689,0,0,0,0,0
122.395,6,21,11420,6,321,4504,517,975,15,804,8729,1408,10445
1797.156,1,36,4291,36,91,51347,173,4291,0,0,0,0,0
90.084,1,2,237,2,90,90084,93,237,0,0,0,0,0
1772.677,6,180,15480,120,69,14896,69,8940,60,69,30038,69,6540
162.879,17,8,704,4,48,54290,48,304,4,72,54290,72,400
1787.689,17,140,11200,70,48,25908,48,5320,70,56,25908,56,5880
300.521,6,11,863,6,177,60069,177,497,5,110,75088,110,366
1791.438,17,87,3648,86,14,21075,14,3612,1,8,0,8,36
378.072,2,4,128,4,8,126024,8,128,0,0,0,0,0
0.18,17,2,554,1,30,0,30,58,1,468,0,468,496
256.65,6,51,6912,20,209,13507,585,2936,31,138,8554,580,3976
586.535,1,28,2352,28,56,21723,56,2352,0,0,0,0,0
4.012,17,31,10379,14,232,306,1350,3649,17,367,248,1350,6730
4.022,17,6,1356,6,198,804,207,1356,0,0,0,0,0
721.989,2,6,192,6,8,144397,8,192,0,0,0,0,0
369.867,6,25,1651,17,177,23116,177,1117,8,110,9219,110,534
315.954,6,76,19659,39,324,8314,1360,10060,37,352,8772,1929,9599
1777.692,1,126,7056,126,28,14221,28,7056,0,0,0,0,0
36.716,6,5282,4978161,3445,1366,10,1408,4877973,1837,931,19,2801,100188
1.398,6,38,8254,19,321,77,1164,2718,19,433,67,1360,5536
1792.894,17,142,11360,71,48,25612,48,5396,71,56,25612,56,5964
0.088,1,5,1805,5,333,22,333,1805,0,0,0,0,0
1777.141,6,187,11425,94,47,19109,208,6806,93,31,19314,31,4619
365.276,1,3,180,3,32,182638,32,180,0,0,0,0,0
122.713,17,4,352,2,60,122712,60,176,2,60,122711,60,176
1786.083,6,108,8890,68,65,26657,65,4930,40,59,45794,59,3960
1680.417,1,15,840,15,28,120029,28,840,0,0,0,0,0
1771.905,6,180,15480,120,69,14889,69,8940,60,69,30030,69,6540
377.407,6,18,1242,14,180,29031,180,916,4,110,20064,110,326
17.883,6,47,7605,23,218,812,314,3543,24,442,764,1152,4062
1797.319,6,373,26428,216,104,8359,469,15663,157,69,11519,69,10765
1798.699,17,134,10720,67,48,27252,48,5092,67,56,27252,56,5628
93.065,17,10,880,5,48,23264,48,380,5,72,23264,72,500
0.195,1,2,112,2,28,195,28,112,0,0,0,0,0
1680.821,17,12,498,11,14,168082,14,462,1,8,0,8,36
1.379,6,5,200,3,0,689,0,120,2,0,199,0,80
2.732,17,6,870,3,40,1350,40,204,3,194,1348,194,666
1619.636,1,13,754,13,30,134969,30,754,0,0,0,0,0
1788.796,6,110,8612,69,64,26305,64,5000,41,58,44716,58,3612
1771.013,6,207,14513,104,71,17192,208,9463,103,31,17361,31,5050
5.733,6,10,4495,4,188,1911,245,540,6,1237,1071,1407,3955
0.564,6,21,7290,13,335,47,668,2026,8,968,74,1475,5264
26.145,6,30,12570,17,832,1634,1360,4899,13,1019,2162,3111,7671
270.839,17,35,2590,35,46,7965,46,2590,0,0,0,0,0
8.887,6,27,7177,13,155,740,267,1306,14,530,682,3417,5871
0.037,6,10,1512,5,503,9,503,771,5,473,9,473,741
7.096,6,5,240,1,0,0,0,48,4,0,2360,0,192
0.14,17,2,154,1,33,0,33,61,1,65,0,65,93
252.911,17,16,5376,16,308,16860,308,5376,0,0,0,0,0
1738.864,2,22,704,22,8,82803,8,704,0,0,0,0,0
8.093,6,1432,1313350,903,1377,8,1408,1281178,529,931,15,2816,32172
5.773,6,27,9021,13,108,481,147,959,14,937,435,1608,8062
7.403,6,6,324,2,0,7403,0,100,4,0,2403,0,224
280.954,6,31,7813,14,158,21611,267,1357,17,577,17554,2036,6456
0.158,6,3,120,1,0,0,0,40,2,0,59,0,80
0.419,6,122,87703,55,131,7,232,2729,67,1349,6,1420,84974
34.044,6,30,5952,15,154,2431,722,1860,15,551,2414,1408,4092
1786.235,17,87,3648,86,14,21014,14,3612,1,8,0,8,36
5.444,6,38,7229,20,218,286,314,3423,18,513,304,1179,3806
0.505,17,2,476,1,39,0,39,67,1,381,0,381,409
0.046,17,5,550,3,32,15,32,180,2,157,20,157,370
0.362,6,27,9064,13,252,30,646,1694,14,947,26,1438,7370
1789.551,1,226,12656,226,28,7953,28,12656,0,0,0,0,0
20.178,6,21,5417,13,107,1681,159,1126,8,966,2880,1674,4291
10.773,6,20,7050,11,275,1077,275,998,9,1420,750,1420,6052
2.817,17,23,12888,10,473,309,1350,5014,13,577,231,1350,7874
2.828,6,29,8650,14,297,217,830,2051,15,749,200,1420,6599
143.28,6,71,15365,31,327,4776,1189,5836,40,293,3672,1420,9529
92.658,6,26,8330,13,417,64,950,1829,13,663,7711,2720,6501
0.605,6,10,861,5,222,149,222,426,5,231,149,231,435
0.292,17,19,9619,8,484,41,1350,4102,11,473,22,1350,5517
0.149,17,2,167,1,39,0,39,67,1,72,0,72,100
1787.721,17,87,3648,86,14,21032,14,3612,1,8,0,8,36
1.215,6,8,342,4,0,405,0,164,4,7,253,7,178
123.784,17,4,240,2,32,123783,32,120,2,32,123783,32,120
0.086,6,7,423,4,43,18,43,259,3,0,36,0,164
0.091,17,4,352,2,37,0,37,130,2,83,0,89,222
1786.349,6,106,8388,68,64,26661,64,4896,38,58,48276,58,3492
344.195,6,42,10656,21,146,17209,516,2159,21,478,17205,1452,8497
1779.401,6,103,8395,68,65,26558,65,4930,35,59,52333,59,3465
0.05,17,2,184,1,32,0,32,60,1,96,0,96,124
1772.568,6,180,15480,120,69,14895,69,8940,60,69,30035,69,6540
8.055,17,12,1764,6,48,1608,48,456,6,190,1608,308,1308
291.053,17,4,352,2,60,291051,60,176,2,60,291052,60,176
15.133,17,33,22398,19,985,838,1350,19252,14,196,1161,1350,3146
1781.875,17,86,3606,85,14,21212,14,3570,1,8,0,8,36
1792.139,17,284,61395,284,188,6332,422,61395,0,0,0,0,0
1.392,6,37,8214,19,321,77,1164,2718,18,476,69,2720,5496
3.093,6,5,216,2,0,11,0,84,3,0,1542,0,132
0.251,6,23,5080,11,137,25,267,1132,12,577,22,1400,3948
573.669,1,6,336,6,28,114733,28,336,0,0,0,0,0
1767.45,17,30,20190,30,645,60946,645,20190,0,0,0,0,0
291.933,1,4,326,4,53,97311,78,326,0,0,0,0,0
38.655,17,44,6468,22,48,1837,48,1672,22,190,1835,308,4796
0.875,6,13,2076,7,329,145,500,1030,6,363,175,500,1046
0.622,17,16,9185,8,822,88,1350,6803,8,269,64,1350,2382
0.408,6,43,16547,24,956,17,1420,11521,19,386,22,1420,5026
18.442,17,4,352,2,60,18441,60,176,2,60,18441,60,176
1793.789,17,464,56750,220,158,8190,1350,41068,244,36,7379,1350,15682
1746.401,6,95,7203,63,38,28167,205,4476,32,33,56329,98,2727
1787.306,6,104,8376,68,65,26676,65,4930,36,59,51063,59,3446
1749.809,17,13,534,11,14,174962,14,462,2,8,1749594,8,72
4.974,17,6,1404,6,206,994,206,1404,0,0,0,0,0
1.355,17,3,1176,3,364,677,364,1176,0,0,0,0,0
5.018,17,4,288,2,36,5000,36,128,2,52,4998,52,160
1.503,17,2,778,2,361,1503,361,778,0,0,0,0,0
908.533,1,14,784,14,28,69887,28,784,0,0,0,0,0
1799.096,17,449,39928,404,35,4464,288,25708,45,288,40021,288,14220
61.578,6,10,544,6,0,12315,0,320,4,0,20065,0,224
1794.532,17,276,57034,276,178,6525,422,57034,0,0,0,0,0
0.486,17,3,451,2,39,64,39,134,1,289,0,289,317
0.021,17,2,912,1,308,0,308,336,1,548,0,548,576
1792.769,6,369,23385,213,69,8456,69,13005,156,69,11565,69,10380
319.54,6,28,7360,6,156,63908,267,718,22,338,15213,1926,6642
6.961,6,33,8243,18,363,409,774,1889,15,522,481,3488,6354
1791.554,17,338,131144,338,360,5316,360,131144,0,0,0,0,0
33.627,6,29,4990,14,180,2586,722,1808,15,342,2389,1448,3182
1679.557,1,15,840,15,28,119968,28,840,0,0,0,0,0
6.086,6,23,6474,11,262,601,517,1380,12,744,545,1368,5094
0.005,17,2,453,1,36,0,36,64,1,361,0,361,389
1796.337,17,142,11360,71,48,25661,48,5396,71,56,25661,56,5964
218.278,6,6,1257,4,327,72759,414,815,2,181,218114,270,442
27.385,17,16,1408,8,48,3908,48,608,8,72,3910,72,800
1.445,6,27,6040,14,150,111,267,1615,13,780,108,1460,4425
21.09,1,8,832,0,0,0,0,0,8,76,3012,76,832
0.058,17,2,214,1,39,0,39,67,1,119,0,119,147
1741.169,17,30,20190,30,645,60040,645,20190,0,0,0,0,0
502.631,1,8,448,8,28,71804,28,448,0,0,0,0,0
6.515,6,29,8606,16,274,425,746,2764,13,644,535,1408,5842
371.992,6,25,1651,17,177,23249,177,1117,8,110,9226,110,534
1787.337,6,102,8364,68,66,26676,66,4964,34,60,54158,60,3400
1799.66,17,3527,169296,1755,20,1026,20,84240,1772,20,1015,20,85056
1586.172,6,153,19978,87,316,18443,316,14012,66,83,24402,83,5966
1741.653,2,24,768,24,8,75724,8,768,0,0,0,0,0
12.11,6,25,8473,13,275,1009,275,1078,12,986,955,1440,7395
0.084,17,4,284,2,32,0,32,120,2,54,32,60,164
12.205,17,20,4125,10,37,1354,37,650,10,319,1355,331,3475
156.543,17,4,240,2,32,156542,32,120,2,32,156542,32,120
0.195,1,2,112,2,28,195,28,112,0,0,0,0,0
1783.495,17,83,3480,82,14,22018,14,3444,1,8,0,8,36
86.406,17,6,360,3,32,43202,32,180,3,32,43202,32,180
0.376,17,2,152,1,48,0,48,76,1,48,0,48,76
0.003,17,4,300,2,39,0,39,134,2,55,1,55,166
571.38,6,36,6579,19,250,31743,1314,2516,17,307,35710,1420,4063
0.303,17,2,193,1,43,0,43,71,1,94,0,94,122
0.239,6,20,4960,10,137,26,267,1092,10,866,25,2867,3868
1744.159,6,96,7286,63,38,28131,205,4476,33,33,54498,98,2810
31.947,6,9,396,2,0,3505,0,88,7,0,5309,0,308
299.529,6,6,364,4,31,99843,31,222,2,31,299511,31,142
10.952,6,20,4442,11,275,1095,275,998,9,768,772,1440,3444
1768.887,1,58,4872,0,0,0,0,0,58,56,31033,56,4872
48.684,6,25,2199,12,595,4425,595,1247,13,212,3953,212,952
252.524,6,11,7734,2,174,16886,174,258,9,1420,31554,1420,7476
0.265,6,24,5980,12,164,24,453,1442,12,781,22,2224,4538
280.262,6,29,7392,14,158,21558,267,1357,15,678,20016,3436,6035
0.506,6,21,7281,13,334,42,663,2021,8,967,66,1471,5260
0.07,17,2,912,1,308,0,308,336,1,548,0,548,576
0.071,17,4,420,2,33,0,33,122,2,121,1,145,298
0.513,6,21,7281,13,334,42,663,2021,8,967,69,1946,5260
96.812,6,44,13266,19,181,5375,267,2216,25,669,4033,1400,11050
0.171,17,2,2382,2,1163,171,1163,2382,0,0,0,0,0
280.242,6,26,7272,12,158,25476,267,1277,14,775,21553,3445,5995
4.895,17,10,1918,5,36,1222,36,320,5,291,1222,318,1598
1754.734,6,187,11456,94,47,18868,208,6806,93,31,19070,31,4650
1772.074,6,180,15480,120,69,14891,69,8940,60,69,30031,69,6540
0.017,17,4,420,2,33,0,33,122,2,121,0,145,298
1789.653,6,357,22629,208,69,8645,69,12460,149,69,12089,69,10169
4.952,6,40,7309,19,218,275,314,3383,21,513,233,1179,3926
0.663,17,2,685,1,308,0,308,336,1,321,0,321,349
1.003,6,25,6081,13,108,83,147,959,12,773,90,1608,5122
378.149,2,3,96,3,8,189074,8,96,0,0,0,0,0
658.411,2,6,192,6,8,131682,8,192,0,0,0,0,0
1772.978,6,183,15738,121,69,14774,69,8980,62,69,29058,69,6758
1.566,6,46,16047,25,783,65,1360,10431,21,433,66,1360,5616
50.259,1,4,224,4,28,16753,28,224,0,0,0,0,0
240.207,6,42,26894,22,224,11438,224,1376,20,1439,12640,1462,25518
1744.686,6,98,7452,63,38,28140,205,4476,35,33,51302,98,2976
316.187,6,66,18888,40,306,8107,1360,10235,26,584,12641,1360,8653
1796.641,17,296,22496,296,48,6090,48,22496,0,0,0,0,0
22.022,6,13,2010,7,163,3670,267,841,6,285,2616,568,1169
1744.514,2,16,512,16,8,116300,8,512,0,0,0,0,0
37.099,17,10,1588,5,48,9273,48,380,5,213,9272,308,1208
12.123,6,101,31278,51,583,242,1152,24796,50,447,242,1179,6482
1799.937,1,16,896,16,28,119995,28,896,0,0,0,0,0
1773.652,6,180,15480,120,69,14904,69,8940,60,69,30057,69,6540
0.046,17,5,1000,3,60,18,60,264,2,340,34,340,736
1786.563,6,104,8376,68,65,26665,65,4930,36,59,51042,59,3446
53.164,17,4,240,2,32,53163,32,120,2,32,53163,32,120
11.473,6,26,11958,13,275,956,275,1078,13,1293,920,1414,10880
1797.813,17,446,39264,403,35,4472,288,25676,43,288,40971,288,13588
1735.802,17,28,9184,28,300,64288,300,9184,0,0,0,0,0
19.198,6,46,12114,18,201,1129,226,1600,28,446,670,1360,10514
0.368,6,11,1006,6,256,72,256,500,5,302,90,302,506
1796.143,17,140,11200,70,48,26030,48,5320,70,56,26030,56,5880
1770.494,6,101,9344,66,65,27238,65,5577,35,59,52070,59,3767
63.701,6,33,7805,11,155,23,267,1226,22,316,3032,1460,6579
133.04,6,34,18732,18,702,50,1360,4967,16,1192,8860,2720,13765
1789.332,17,142,11360,71,48,25561,48,5396,71,56,25561,56,5964
0.064,17,2,245,1,32,0,32,60,1,157,0,157,185
1764.698,2,17,544,17,8,110293,8,544,0,0,0,0,0
291.664,6,31,7745,14,147,22435,267,1448,17,510,18213,2800,6297
3.615,17,4,1556,4,361,1205,361,1556,0,0,0,0,0
1789.638,6,366,25541,213,100,8441,469,14936,153,69,11770,69,10605
1096.652,6,110,9437,73,69,15231,69,5404,37,69,30462,69,4033
300.782,6,67,53462,46,1249,6684,1368,47394,21,828,1600,1571,6068
300.985,6,39,22114,24,1067,13086,1408,13036,15,1184,3771,2899,9078
0.111,1,2,163,2,53,111,78,163,0,0,0,0,0
1794.958,17,66,22144,66,307,27614,308,22144,0,0,0,0,0
240.238,6,60,20614,32,836,7749,1418,17568,28,175,8897,580,3046
575.904,1,6,336,6,28,115180,28,336,0,0,0,0,0
1787.104,6,104,8444,68,66,26673,66,4964,36,60,51055,60,3480
47.243,6,49,9020,23,345,720,720,2071,26,327,1884,1460,6949
152.882,17,4,352,2,60,152881,60,176,2,60,152880,60,176
223.734,6,30,7432,13,158,18644,267,1317,17,543,13977,1400,6115
0.366,6,251,202707,143,179,2,179,7623,108,1804,2,2736,195084
300.545,6,37,8526,20,315,15818,882,2093,17,478,525,2128,6433
1789.424,17,142,11360,71,48,25563,48,5396,71,56,25563,56,5964
1774.182,6,180,15480,120,69,14909,69,8940,60,69,30062,69,6540
280.47,6,28,7352,13,158,23372,267,1317,15,775,20030,2760,6035
60.513,6,121,34198,54,718,1141,1440,22378,67,270,909,1702,11820
247.45,6,5871,5527051,2177,391,113,420,136710,3694,1409,62,2816,5390341
300.619,6,35,18878,19,417,16701,1114,2666,16,1281,3467,4307,16212
1741.355,17,29,19517,29,645,62191,645,19517,0,0,0,0,0
1746.301,6,95,7203,63,38,28166,205,4476,32,33,56319,98,2727
1350.566,1,100,5600,100,28,13642,28,5600,0,0,0,0,0
1773.204,6,180,15480,120,69,14900,69,8940,60,69,30049,69,6540
1740.678,17,29,30624,29,1028,62167,1028,30624,0,0,0,0,0
1.395,6,44,10145,23,440,63,1360,4484,21,437,60,2715,5661
237.554,6,30,7432,13,158,19796,267,1317,17,543,14846,1400,6115
13.305,6,36,13817,22,672,617,949,11637,14,404,997,1179,2180
97.108,6,54,14483,17,290,2391,1189,2724,37,354,2697,1420,11759
0.004,17,2,500,1,60,0,60,88,1,384,0,384,412
1740.641,17,30,31680,30,1028,60022,1028,31680,0,0,0,0,0
206.756,6,61,9588,23,120,4931,267,2136,38,282,5587,1452,7452
212.466,17,4,352,2,60,212465,60,176,2,60,212465,60,176
0.107,6,10,1673,6,553,20,949,1350,4,159,34,159,323
1782.594,6,102,8296,68,65,26605,65,4930,34,59,54015,59,3366
3.398,17,2,656,2,300,3398,300,656,0,0,0,0,0
11.69,6,1693,1593253,1125,1365,10,1420,1566242,568,475,20,1883,27011
141.197,17,4,240,2,32,141196,32,120,2,32,141196,32,120
1776.345,17,142,11360,71,48,25376,48,5396,71,56,25376,56,5964
0.518,17,2,440,1,39,0,39,67,1,345,0,345,373
10.669,6,1734,1479665,1045,1362,10,1380,1447863,689,421,15,1923,31802
0.962,6,23,6389,13,309,79,883,2069,10,979,106,2720,4320
1788.557,17,87,3648,86,14,21041,14,3612,1,8,0,8,36
1.278,6,23,7952,11,164,108,267,1236,12,1014,99,2736,6716
5.066,17,4,396,2,37,5003,37,130,2,105,5007,105,266
24.71,6,10,636,4,106,8236,106,274,6,90,4897,90,362
1263.379,2,11,352,11,8,126337,8,352,0,0,0,0,0
2.905,17,2,778,2,361,2905,361,778,0,0,0,0,0
3.344,17,4,624,4,128,1114,128,624,0,0,0,0,0
11.37,6,2,80,1,0,0,0,40,1,0,0,0,40
1772.328,6,180,15480,120,69,14893,69,8940,60,69,30032,69,6540
1785.86,6,367,23236,212,69,8463,69,12896,155,69,11596,69,10340
19.412,17,30,11786,12,408,1762,1350,5242,18,335,1140,1350,6544
171.443,6,98,63790,55,1234,3174,1368,54723,43,747,1576,1368,9067
11.79,1,16,1664,0,0,0,0,0,16,76,786,76,1664
0.007,1,2,112,2,28,7,28,112,0,0,0,0,0
1787.027,6,102,8228,68,64,26672,64,4896,34,58,54149,58,3332
2.0,6,26,8868,13,227,166,547,1592,13,941,135,1438,7276
34.968,6,29,6876,13,216,2910,517,1551,16,641,2328,1418,5325
101.914,6,37,7346,21,160,824,293,3103,16,359,6500,643,4243
77.786,6,15,1132,4,226,119,226,442,11,110,7760,110,690
268.194,17,4,352,2,60,268193,60,176,2,60,268193,60,176
0.455,1,9,756,9,56,56,56,756,0,0,0,0,0
240.534,6,68,24954,36,547,6872,1408,6840,32,865,7759,2816,18114
1.239,6,6,248,4,0,413,0,164,2,0,210,0,84
328.637,6,20,1946,8,275,46922,275,878,12,96,29860,96,1068
1.287,6,41,10025,22,502,61,1440,4444,19,400,61,1440,5581
0.288,6,26,9038,13,262,24,690,1735,13,1103,23,2816,7303
17.41,17,14,5408,7,423,2895,1350,3161,7,293,2895,1350,2247
117.745,6,136,50413,70,664,1706,1360,36728,66,355,1804,1360,13685
17.807,6,9,372,5,0,4450,0,204,4,0,5933,0,168
1790.138,17,87,3648,86,14,21060,14,3612,1,8,0,8,36
0.298,17,7,2368,7,310,49,354,2368,0,0,0,0,0
0.556,17,22,15995,13,995,45,1350,13311,9,270,65,1350,2684
0.173,1,2,163,2,53,173,78,163,0,0,0,0,0
1772.507,6,203,22290,130,75,13740,267,10057,73,134,24612,2009,12233
1.749,6,30,8759,15,252,113,561,2401,15,820,112,1440,6358
0.577,6,11,3650,6,170,112,170,490,5,1446,119,2675,3160
0.06,6,3,120,1,0,0,0,40,2,0,1,0,80
281.244,6,31,7481,13,158,23437,267,1317,18,544,16540,1380,6164
0.005,6,2,1444,1,0,0,0,40,1,1352,0,1352,1404
1.512,6,48,19199,27,890,58,1360,13583,21,433,66,1360,5616
4.921,17,4,240,2,32,4919,32,120,2,32,4920,32,120
1775.555,17,73,3060,72,14,25007,14,3024,1,8,0,8,36
13.661,6,17,5570,9,275,1707,275,918,8,1440,820,1440,4652
12.645,6,1738,1644736,1160,1368,10,1380,1616338,578,421,21,1923,28398
0.135,6,9,1340,5,145,33,145,349,4,827,27,827,991
6.38,17,6,791,5,40,1046,40,340,1,423,0,423,451
60.219,2,2,64,2,8,60219,8,64,0,0,0,0,0
1772.88,6,180,15480,120,69,14898,69,8940,60,69,30040,69,6540
187.437,17,30,35412,30,1152,6463,1449,35412,0,0,0,0,0
300.57,6,20,1391,10,177,33377,177,765,10,110,33377,110,626
287.412,6,34,3485,17,324,17963,585,1589,17,169,17963,580,1896
0.619,17,2,677,1,300,0,300,328,1,321,0,321,349
76.256,6,126,49616,67,739,1155,1360,36735,59,420,1312,1360,12881
1772.994,6,180,15480,120,69,14899,69,8940,60,69,30045,69,6540
97.122,6,76,61240,49,1307,2023,1448,54872,27,828,3735,1448,6368
0.361,6,23,6159,12,284,31,517,1768,11,762,34,1402,4391
1786.291,6,354,22440,207,69,8671,69,12420,147,69,12234,69,10020
33.549,6,28,4227,14,60,2580,92,1097,14,399,2566,1408,3130
11.978,6,1856,1613295,1133,1369,10,1380,1578928,723,421,16,2760,34367
6.298,6,32,9021,14,158,484,267,1357,18,630,355,1400,7664
0.956,6,26,7927,16,364,63,1125,3193,10,721,103,1420,4734
1785.922,6,356,22520,208,69,8627,69,12460,148,69,12148,69,10060
32.821,6,39,8691,20,230,1727,721,2419,19,687,1764,1420,6272
0.931,6,27,8506,15,229,54,583,2007,12,1201,69,2720,6499
1.661,6,25,8703,15,275,118,557,1429,10,981,165,1420,7274
1797.797,17,449,39928,404,35,4461,288,25708,45,288,40019,288,14220
1783.216,6,354,22440,207,69,8656,69,12420,147,69,12213,69,10020
1793.417,17,87,3648,86,14,21099,14,3612,1,8,0,8,36
15.71,6,14,1025,7,222,2615,222,506,7,231,2615,231,519
0.902,6,11,1727,7,100,150,100,384,4,589,217,1152,1343
99.975,6,44,9812,17,290,2840,1189,2724,27,352,3844,1420,7088
0.363,6,27,8914,13,231,30,563,1608,14,938,26,1448,7306
0.487,6,22,5961,12,108,44,147,919,10,927,52,1608,5042
7.718,6,5,264,3,0,3859,0,160,2,0,1007,0,104
126.01,2,2,64,2,8,126010,8,64,0,0,0,0,0
0.013,6,16,6004,8,88,1,88,452,8,1305,1,1880,5552
1790.543,6,217,25540,138,103,13069,469,12791,79,131,22951,2009,12749
1.715,17,14,6815,7,590,285,1350,4328,7,327,276,1350,2487
0.017,17,2,211,1,50,0,50,78,1,105,0,105,133
0.003,17,3,819,1,137,0,137,165,2,299,1,299,654
70.151,17,4,272,2,40,70150,47,136,2,40,70150,47,136
1791.857,17,144,11520,72,48,25237,48,5472,72,56,25237,56,6048
0.012,17,2,410,1,50,0,50,78,1,304,0,304,332
156.005,17,4,352,2,60,156004,60,176,2,60,156004,60,176
280.415,6,29,7392,12,158,25492,267,1277,17,678,17522,2085,6115
16.918,17,25,9836,13,342,1406,1350,4813,12,390,1534,1350,5023
1799.958,17,449,39928,404,35,4466,288,25708,45,288,40022,288,14220
97.583,6,38,11133,14,131,7506,267,1622,24,474,4240,1460,9511
253.232,17,10,3360,10,308,28136,308,3360,0,0,0,0,0
0.371,17,8,2766,8,317,53,356,2766,0,0,0,0,0
12.66,6,2066,1898838,1309,1372,9,1408,1854798,757,931,16,2816,44040
1785.901,6,104,8435,69,65,26263,65,4970,35,59,52523,59,3465
1.313,6,50,19468,27,902,50,1360,13772,23,433,51,1360,5696
0.024,17,4,360,2,30,0,30,116,2,94,0,94,244
172.699,6,20819,20086323,14015,1356,12,1408,19727839,6804,931,25,2801,358484
1785.242,17,87,3648,86,14,21002,14,3612,1,8,0,8,36
0.382,6,10,968,5,256,92,256,460,5,304,92,304,508
1744.333,6,94,7151,62,38,28595,205,4424,32,33,56256,98,2727
0.038,17,4,368,2,32,22,32,120,2,96,0,96,248
1785.858,6,374,25999,216,98,8306,469,15263,158,69,11374,69,10736
1323.49,2,13,416,13,8,110290,8,416,0,0,0,0,0
0.911,6,10,1687,7,100,151,100,384,3,1179,328,1179,1303
56.275,6,32,8952,14,158,4328,267,1357,18,624,3307,1400,7595
1780.352,6,102,8296,68,65,26572,65,4930,34,59,53947,59,3366
10.789,17,15,17706,15,1152,770,1449,17706,0,0,0,0,0
0.122,17,2,572,1,39,0,39,67,1,477,0,477,505
38.569,17,22,1936,11,48,3855,48,836,11,72,3855,72,1100
1.355,6,41,10820,21,546,67,1360,5244,20,433,61,1360,5576
0.652,6,10,924,5,283,111,283,551,5,105,109,105,373
1770.902,6,105,9759,68,65,26431,65,5758,37,59,49188,59,4001
2.088,17,10,3616,10,333,232,361,3616,0,0,0,0,0
7.047,6,643,582483,414,1344,16,1368,565899,229,776,30,1473,16584
0.241,6,9,1002,5,213,60,213,417,4,421,67,421,585
2.116,6,53,19807,27,919,81,1440,13991,26,433,70,1440,5816
283.899,17,4,352,2,60,283898,60,176,2,60,283898,60,176
1796.492,17,448,39896,403,35,4468,288,25676,45,288,40016,288,14220
0.201,17,2,2128,2,1036,201,1036,2128,0,0,0,0,0
14.714,17,22,9369,10,596,1634,1350,6249,12,232,1334,1350,3120
0.906,6,18,6377,11,141,90,275,726,7,1073,64,2840,5651
1799.758,17,448,39896,403,35,4477,288,25676,45,288,40021,288,14220
16.607,17,28,21743,13,838,1378,1350,11266,15,670,1180,1350,10477
0.563,6,7,426,3,31,281,31,187,4,31,95,31,239
1026.049,1,16,896,16,28,68403,28,896,0,0,0,0,0
58.669,6,13,1079,12,43,5333,43,1019,1,0,0,0,60
185.687,6,37,10857,19,390,10306,1246,3730,18,476,10913,1368,7127
114.914,6,74,51394,47,1199,2498,1408,43256,27,747,2369,1408,8138
132.735,6,64,32572,33,746,340,1360,6673,31,1071,4419,1696,25899
0.827,17,2,925,1,548,0,548,576,1,321,0,321,349
3.015,17,8,1822,4,33,1001,33,244,4,366,1001,404,1578
0.099,17,2,602,1,46,0,46,74,1,500,0,500,528
0.314,17,4,334,2,39,48,39,134,2,72,0,72,200
75.419,6,527,449198,352,1320,214,1360,435335,175,244,432,4027,13863
2.101,17,3,1167,3,361,1050,361,1167,0,0,0,0,0
880.771,17,283,19464,281,40,3145,41,19295,2,56,1014,57,169
1771.224,6,119,10937,75,65,23935,65,6312,44,59,41189,59,4625
1796.956,17,449,39928,404,35,4458,288,25708,45,288,40022,288,14220
1798.363,6,374,26068,217,98,8325,469,15303,157,69,11526,69,10765
1757.586,6,3445,3349243,1132,149,1554,985,70345,2313,1410,760,4254,3278898
0.024,17,4,364,2,52,0,52,160,2,74,0,80,204
12.134,6,21,6825,12,275,1103,275,1038,9,1353,890,1440,5787
94.864,6,25,11358,12,433,91,990,1823,13,1000,7892,1360,9535
17.284,6,432,315072,217,345,80,345,13061,215,1365,80,1368,302011
1799.898,6,350,28446,202,75,8954,267,13213,148,134,12243,1917,15233
1.756,6,50,20847,28,935,65,1360,15191,22,476,75,2715,5656
36.398,17,2,152,2,48,36398,48,152,0,0,0,0,0
1699.444,17,12,498,11,14,169944,14,462,1,8,0,8,36
145.864,17,4,352,2,60,145863,60,176,2,60,145863,60,176
1.853,17,21,14332,12,958,168,1350,11841,9,248,227,1350,2491
371.122,1,14,784,14,28,28547,28,784,0,0,0,0,0
0.064,17,2,166,1,39,0,39,67,1,71,0,71,99
1.176,6,31,10326,16,623,70,1460,3799,15,657,70,1460,6527
1783.505,17,142,11360,71,48,25477,48,5396,71,56,25477,56,5964
300.601,6,18,1275,9,177,37553,177,701,9,110,37553,110,574
1797.332,1,59,4956,59,56,30988,56,4956,0,0,0,0,0
1796.714,6,219,28219,118,304,15356,304,19080,101,83,17967,83,9139
1750.684,6,182,11194,91,48,19452,208,6624,91,31,19445,31,4570
1794.187,1,280,15680,280,28,6430,28,15680,0,0,0,0,0
0.017,6,17,6068,10,88,1,88,556,7,1740,2,1880,5512
39.693,17,11,836,11,48,3969,48,836,0,0,0,0,0
0.911,6,11,1727,7,100,151,100,384,4,589,217,1152,1343
300.154,6,51,17357,24,915,13043,1360,11060,27,273,11538,2667,6297
1782.77,6,102,8296,68,65,26608,65,4930,34,59,54020,59,3366
241.426,6,46,6312,21,213,12069,585,3025,25,197,10056,580,3287
521.988,6,52,9507,23,164,23723,517,2193,29,644,18640,1368,7314
2.976,6,26,6247,14,112,228,147,1125,12,773,243,1608,5122
37.759,17,44,6468,22,48,1797,48,1672,22,190,1797,308,4796
141.423,6,33,7828,12,158,12856,267,1277,21,407,7067,1400,6551
157.383,6,24,9172,12,401,90,925,1716,12,994,14292,1360,7456
0.164,6,19,18546,6,339,32,339,647,13,1565,9,2736,17899
803.141,17,160,12160,160,48,5051,48,12160,0,0,0,0,0
411.724,6,99,5994,46,69,9148,69,2806,53,38,7917,64,3188
2.898,17,3,468,3,128,1449,128,468,0,0,0,0,0
1796.322,1,68,7208,68,78,26810,78,7208,0,0,0,0,0
48.217,6,22,3198,13,304,4018,304,2220,9,83,6025,83,978
1008.255,2,7,224,7,8,168042,8,224,0,0,0,0,0
0.352,1,2,112,2,28,352,28,112,0,0,0,0,0
1790.912,1,341,28644,341,56,5267,56,28644,0,0,0,0,0
5.399,6,38,7229,19,218,299,314,3383,19,513,284,1179,3846
1799.999,6,220,17467,82,75,21851,338,8492,138,50,13138,143,8975
1.03,6,24,5755,13,158,85,370,1315,11,799,101,1420,4440
42.371,17,46,6644,23,48,1922,48,1748,23,184,1925,308,4896
1.111,6,30,12084,17,525,69,1360,3350,13,820,75,1380,8734
1795.576,17,140,11200,70,48,26022,48,5320,70,56,26022,56,5880
1796.726,1,58,4872,58,56,31521,56,4872,0,0,0,0,0
1792.0,6,356,22520,208,69,8657,69,12460,148,69,12190,69,10060
1515.874,1,46,4876,46,78,33686,78,4876,0,0,0,0,0
1786.989,6,102,8296,68,65,26671,65,4930,34,59,54146,59,3366
23.013,6,16,2357,9,211,2848,211,898,7,545,3805,904,1459
1795.949,17,447,39580,403,35,4467,288,25676,44,288,40950,288,13904
1772.469,6,180,15480,120,69,14894,69,8940,60,69,30034,69,6540
0.017,17,2,554,1,30,0,30,58,1,468,0,468,496
93.021,6,21,860,9,0,6088,0,364,12,0,8455,0,496
0.152,6,9,1339,5,145,38,145,349,4,826,36,826,990
0.812,6,26,5649,12,140,73,267,1184,14,650,57,1420,4465
0.512,17,3,451,2,39,164,39,134,1,289,0,289,317
1791.099,6,354,22440,206,69,8646,69,12380,148,69,12184,69,10060
12.14,6,20,12088,6,156,2428,156,436,14,1229,818,1360,11652
0.397,6,21,13400,12,212,36,347,1281,9,1663,36,4071,12119
3.988,17,26,7655,11,280,398,1350,3398,15,255,226,1350,4257
37.572,6,2220,1875538,1305,1375,28,1380,1829556,915,421,41,1923,45982
240.335,6,56,19706,28,841,8900,1418,16615,28,203,8900,580,3091
4.611,6,34,6185,18,206,271,314,2784,16,551,289,1179,3401
3.613,17,5,290,5,30,903,30,290,0,0,0,0,0
10.24,17,9,456,6,14,2048,24,252,3,40,110,40,204
1772.835,17,65,2724,64,14,28140,14,2688,1,8,0,8,36
1787.907,6,378,23952,216,69,8315,69,13332,162,69,11105,69,10620
1773.005,6,206,22479,132,75,13534,267,10137,74,133,24284,1997,12342
1235.528,6,71,5409,45,42,28076,205,3230,26,33,49413,98,2179
1749.163,6,95,7203,63,38,28212,205,4476,32,33,56418,98,2727
0.061,6,3,144,0,0,0,0,0,3,0,0,0,144
1787.91,6,368,25621,214,99,8393,469,15045,154,69,11685,69,10576
0.038,17,4,284,2,32,31,32,120,2,54,32,60,164
1785.371,6,102,8296,68,65,26647,65,4930,34,59,54099,59,3366
1787.162,6,102,8364,68,66,26674,66,4964,34,60,54152,60,3400
46.351,6,46,10335,22,533,777,910,3107,24,347,2009,3488,7228
1737.525,1,56,4704,56,56,31591,56,4704,0,0,0,0,0
0.031,17,4,1116,2,32,22,32,120,2,470,26,470,996
378.393,6,40,7622,19,142,15146,516,1905,21,270,18915,1452,5717
1.289,6,37,8214,19,321,71,1164,2718,18,476,64,2715,5496
116.076,17,4,352,2,60,116075,60,176,2,60,116075,60,176
127.072,6,6,262,3,0,63536,0,124,3,7,62913,7,138
5.1,6,40,7309,21,218,255,314,3463,19,513,269,1179,3846
0.136,6,43,21094,25,1080,5,1420,16153,18,467,7,1883,4941
0.134,17,2,158,1,34,0,34,62,1,68,0,68,96
12.193,17,10,2240,5,46,3044,46,370,5,346,3045,346,1870
0.015,17,2,382,1,33,0,33,61,1,293,0,293,321
1781.638,6,102,8160,68,63,26591,63,4862,34,57,53986,57,3298
0.483,6,12,1653,6,288,91,288,548,6,426,53,434,1105
0.083,17,8,2454,8,278,11,317,2454,0,0,0,0,0
0.299,17,2,162,1,34,0,34,62,1,72,0,72,100
186.872,1,4,224,4,28,62290,28,224,0,0,0,0,0
1762.698,6,126,14887,81,83,22033,498,6592,45,158,40059,1420,8295
0.078,6,2,116,1,0,0,0,64,1,0,0,0,52
748.767,1,8,448,8,28,106966,28,448,0,0,0,0,0
0.025,17,4,865,2,47,0,47,150,2,329,7,341,715
2.172,6,10,924,5,283,499,283,551,5,105,499,105,373
12.0,6,13,1007,6,275,2400,275,523,7,96,1545,96,484
1738.754,6,123,8161,71,53,24839,208,4934,52,31,34087,31,3227
1745.61,6,90,6540,60,31,29586,31,4050,30,31,60180,31,2490
1.492,6,27,8945,13,288,124,796,1707,14,952,95,1460,7238
1750.207,6,79,5070,39,36,46056,36,2100,40,445,44875,445,2970
0.203,6,18,3068,9,282,25,531,1606,9,493,18,828,1462
9.371,6,4,174,1,0,0,0,40,3,7,4610,7,134
23.148,6,32,8055,15,188,1653,721,1922,17,681,1435,1440,6133
0.049,6,2,402,1,0,0,0,40,1,322,0,322,362
0.162,17,2,290,1,40,0,40,68,1,194,0,194,222
257.134,6,28,6961,13,229,162,498,1672,15,390,18360,1420,5289
1787.907,6,460,26680,252,69,7123,69,14220,208,34,8637,64,12460
0.217,1,2,112,2,28,217,28,112,0,0,0,0,0
12.042,6,20,4402,11,275,1204,275,998,9,758,1418,1420,3404
52.299,6,43,8756,21,345,771,720,1967,22,368,2482,3488,6789
22.212,17,4,352,2,60,22211,60,176,2,60,22211,60,176
1785.862,6,355,22480,207,69,8669,69,12420,148,69,12148,69,10060
0.392,6,10,968,5,256,93,256,460,5,304,93,304,508
1.112,6,25,8056,12,164,86,267,1288,13,869,78,1448,6768
226.582,17,8,480,4,32,75526,32,240,4,32,75527,32,240
1770.61,6,101,9344,66,65,27240,65,5577,35,59,52074,59,3767
1741.334,17,30,20190,30,645,60046,645,20190,0,0,0,0,0
4.453,6,39,7269,19,218,247,314,3383,20,513,220,1179,3886
0.075,17,2,167,1,39,0,39,67,1,72,0,72,100
0.169,6,3,175,2,31,15,31,135,1,0,0,0,40
29.889,6,44,8949,22,199,1423,721,2481,22,557,1403,1420,6468
1784.443,6,394,31954,223,91,8038,1189,15173,171,136,10496,1917,16781
0.079,6,9,1002,5,213,19,213,417,4,421,21,421,585
1783.812,6,372,25919,215,98,8335,469,15223,157,69,11434,69,10696
0.121,6,9,1338,5,549,30,549,753,4,421,33,421,585
122.656,6,26,11484,14,579,9420,1448,4215,12,1104,11133,1448,7269
1798.961,1,58,4872,58,56,31560,56,4872,0,0,0,0,0
1773.849,6,180,15480,120,69,14906,69,8940,60,69,30058,69,6540
255.975,17,6,3488,6,553,51195,1451,3488,0,0,0,0,0
5.272,6,38,7229,20,218,277,314,3423,18,513,294,1179,3806
1778.054,6,105,8476,70,64,25768,64,5104,35,58,52159,58,3372
317.063,6,65,18789,37,338,8807,1360,9964,28,549,11736,1360,8825
28.108,17,16,1216,16,48,1873,48,1216,0,0,0,0,0
0.195,6,2,116,1,0,0,0,60,1,0,0,0,56
300.735,2,4,128,4,8,100245,8,128,0,0,0,0,0
1771.254,6,106,6322,60,27,30019,27,3525,46,27,39360,27,2797
378.156,2,4,128,4,8,126052,8,128,0,0,0,0,0
0.255,6,10,887,5,248,63,248,452,5,231,63,231,435
3.553,17,8,1216,4,60,1154,60,352,4,188,1154,188,864
42.337,17,34,2574,19,40,2348,41,1304,15,56,3014,57,1270
163.147,6,57,20920,37,657,4531,1360,15318,20,435,465,2667,5602
0.442,6,12,1653,6,288,84,288,548,6,426,49,434,1105
25.454,17,4,352,2,60,25453,60,176,2,60,25453,60,176
15.842,17,20,2940,10,48,1758,48,760,10,190,1758,308,2180
41.898,17,6,528,3,48,20938,48,228,3,72,20942,72,300
0.281,6,28,9123,13,247,23,624,1672,15,832,19,1408,7451
1.755,6,27,10107,16,289,117,599,1511,11,1019,157,1452,8596
1794.706,6,118,12683,78,80,23307,515,6279,40,126,46012,1452,6404
520.177,1,8,987,8,95,74311,125,987,0,0,0,0,0
7.369,6,56,19951,28,852,272,1440,13943,28,433,260,1440,6008
1786.777,6,103,8470,69,66,26276,66,5070,34,60,54141,60,3400
1795.716,1,58,4872,58,56,31503,56,4872,0,0,0,0,0
1795.733,17,448,39896,403,35,4466,288,25676,45,288,40020,288,14220
9.225,6,19,3445,10,211,1023,211,986,9,665,1149,904,2459
1.489,2,3,96,3,8,744,8,96,0,0,0,0,0
1770.689,6,101,9410,66,66,27241,66,5610,35,60,52074,60,3800
1.633,6,48,19511,27,913,62,1360,13895,21,433,71,1360,5616
298.496,1,4,224,4,28,99498,28,224,0,0,0,0,0
1786.218,1,67,5628,67,56,27063,56,5628,0,0,0,0,0
429.675,6,32,2687,15,65,21611,205,1236,17,35,26843,98,1451
1.375,2,3,96,3,8,687,8,96,0,0,0,0,0
5.016,17,4,558,2,36,5010,36,128,2,187,5006,187,430
1775.933,6,180,32460,120,302,14923,302,24360,60,83,30100,83,8100
1782.551,17,142,11360,71,48,25464,48,5396,71,56,25464,56,5964
61.29,6,35,15827,22,800,2918,1408,9153,13,855,5086,3847,6674
1260.516,2,9,288,9,8,157564,8,288,0,0,0,0,0
4.405,6,38,7229,19,218,244,314,3383,19,513,230,1179,3846
0.807,6,26,5649,12,140,73,267,1184,14,650,57,1420,4465
1798.214,17,140,11200,70,48,26060,48,5320,70,56,26060,56,5880
0.054,6,10,1495,5,507,13,507,727,5,556,13,556,768
0.028,17,4,480,3,60,9,60,264,1,188,0,188,216
0.627,17,4,624,2,64,626,64,184,2,192,507,192,440
1753.384,6,95,7203,63,38,28280,205,4476,32,33,56548,98,2727
1780.249,17,136,10880,68,48,26570,48,5168,68,56,26570,56,5712
1498.11,1,68,3808,68,28,22359,28,3808,0,0,0,0,0
290.992,17,4,240,2,32,290991,32,120,2,32,290991,32,120
185.299,6,4065,3688865,2098,379,88,420,120842,1967,1766,91,9856,3568023
0.084,6,2,80,1,0,0,0,40,1,0,0,0,40
300.578,6,39,8512,20,286,15819,797,2000,19,441,467,1360,6512
0.015,17,6,411,6,40,3,41,411,0,0,0,0,0
1798.411,17,87,3648,86,14,21157,14,3612,1,8,0,8,36
5.236,6,39,7269,20,218,275,314,3423,19,513,274,1179,3846
0.001,17,2,548,2,246,1,246,548,0,0,0,0,0
1796.841,6,356,22520,208,69,8680,69,12460,148,69,12223,69,10060
0.346,6,26,9039,13,266,28,705,1750,13,943,28,1402,7289
2.368,6,28,8903,17,288,148,597,1549,11,863,215,1456,7354
0.953,6,41,11003,25,147,39,615,3390,16,870,51,4080,7613
1740.358,1,61,5124,0,0,0,0,0,61,56,29005,56,5124
0.097,17,8,2750,8,315,13,354,2750,0,0,0,0,0
135.772,1,4,224,4,28,45257,28,224,0,0,0,0,0
0.023,6,16,6004,8,88,3,88,452,8,1305,3,1880,5552
1.693,17,5,1680,5,308,423,308,1680,0,0,0,0,0
0.105,17,2,2382,2,1163,105,1163,2382,0,0,0,0,0
582.39,6,33,2666,16,36,38820,36,904,17,445,36395,445,1762
1766.971,1,208,11648,208,28,8536,28,11648,0,0,0,0,0
18.02,17,27,8924,11,226,1798,1350,2803,16,354,1198,1350,6121
0.002,6,2,1440,1,0,0,0,40,1,1360,0,1360,1400
127.411,6,9,522,2,106,127399,106,194,7,0,21233,0,328
306.928,17,6,528,3,60,153463,60,264,3,60,153463,60,264
2.283,6,13,2311,8,188,326,245,700,5,1407,509,1407,1611
0.041,6,9,1340,5,145,10,145,349,4,827,11,827,991
0.617,6,3,151,1,0,0,0,40,2,31,389,31,111
1799.338,1,57,4788,57,56,32131,56,4788,0,0,0,0,0
377.266,6,22,2259,16,141,25151,141,813,6,398,4647,419,1446
294.328,1,4,326,4,53,98109,78,326,0,0,0,0,0
0.469,6,23,7307,12,318,41,600,1906,11,964,44,1471,5401
42.275,6,8,320,8,0,0,0,320,0,0,0,0,0
350.069,6,36,8223,13,140,29171,267,1513,23,321,15911,1917,6710
15.684,17,21,13136,11,953,1565,1350,10791,10,206,1739,1350,2345
17.49,6,20,1495,10,222,1940,222,848,10,231,1941,231,647
280.474,6,27,7312,13,158,23372,267,1317,14,678,21571,3456,5995
1663.652,1,8,848,8,78,237664,78,848,0,0,0,0,0
53.772,6,9,468,9,0,0,0,468,0,0,0,0,0
0.461,2,2,64,2,8,461,8,64,0,0,0,0,0
299.56,6,6,364,4,31,99853,31,222,2,31,299524,31,142
1319.313,6,108,11536,57,72,23556,722,5083,51,100,26382,1448,6453
33.845,6,33,7261,16,180,2256,721,1947,17,491,2104,1408,5314
1798.128,17,449,39928,404,35,4461,288,25708,45,288,40018,288,14220
49.436,17,18,18809,18,1016,2908,1451,18809,0,0,0,0,0
0.026,6,3,144,1,0,0,0,40,2,0,6,0,104
300.785,6,27,8061,15,173,21484,385,1483,12,849,21885,1368,6578
1798.858,17,449,39928,404,35,4463,288,25708,45,288,40018,288,14220
0.102,17,2,152,1,48,0,48,76,1,48,0,48,76
164.827,6,31,14262,15,835,64,1460,5656,16,883,10977,1460,8606
0.201,17,2,152,1,48,0,48,76,1,48,0,48,76
1211.909,1,50,2800,50,28,24732,28,2800,0,0,0,0,0
1777.707,6,193,16621,123,69,14571,69,9129,70,69,25760,69,7492
83.333,6,190,159950,124,1289,677,1368,147011,66,728,1279,2736,12939
251.798,17,4,240,2,32,251797,32,120,2,32,251797,32,120
1791.755,17,87,3648,86,14,21079,14,3612,1,8,0,8,36
1780.082,6,120,13650,78,80,23117,501,6037,42,156,43414,1420,7613
62.81,6,68,44254,41,1171,1570,1408,36117,27,840,2406,2439,8137
4.995,6,3,300,1,0,0,0,40,2,90,4864,90,260
1.283,6,40,9940,21,440,64,1360,4404,19,433,62,1360,5536
1793.793,6,356,22520,208,69,8665,69,12460,148,69,12202,69,10060
0.158,6,46,22543,27,1097,6,1420,17562,19,467,8,1883,4981
1795.111,6,356,22520,208,69,8672,69,12460,148,69,12211,69,10060
1624.296,2,16,512,16,8,108286,8,512,0,0,0,0,0
0.048,6,17,5771,9,134,6,134,526,8,1637,6,2920,5245
299.885,6,53,20493,30,1034,10338,1360,14726,23,402,13621,2667,5767
0.363,6,10,968,5,256,88,256,460,5,304,88,304,508
1.457,6,50,19245,27,888,56,1440,13549,23,433,57,1440,5696
1690.619,17,14,1036,7,30,281716,30,406,7,62,281725,62,630
282.696,6,57,8672,26,158,11307,267,1837,31,508,9400,1400,6835
12.244,17,9,613,5,33,3059,33,305,4,49,4079,49,308
1.445,6,51,21701,29,928,51,1360,16045,22,476,58,2715,5656
1.371,6,47,18814,27,866,52,1360,13238,20,476,62,2715,5576
0.346,17,12,4401,12,338,31,361,4401,0,0,0,0,0
1746.697,6,95,7203,63,38,28172,205,4476,32,33,56331,98,2727
0.689,6,13,3768,7,171,89,171,555,6,964,125,1448,3213
0.298,6,9,1343,5,145,74,145,349,4,830,39,830,994
1.405,6,38,8252,19,320,78,1162,2716,19,433,67,1460,5536
20.144,6,20,5365,12,107,1831,159,1074,8,966,2876,1658,4291
310.457,6,10,7183,10,678,34495,1192,7183,0,0,0,0,0
0.078,17,2,152,1,48,0,48,76,1,48,0,48,76
34.274,6,4782,4594574,3191,1363,10,1408,4507178,1591,776,21,1408,87396
0.006,17,3,474,2,36,3,36,128,1,318,0,318,346
0.537,17,2,290,1,47,0,47,75,1,187,0,187,215
8.777,6,1795,1687821,1159,1380,7,1408,1650085,636,931,13,2801,37736
53.288,6,85,24685,39,552,474,1152,18704,46,459,1178,1179,5981
661.784,2,8,256,8,8,94540,8,256,0,0,0,0,0
15.236,6,25,6154,12,255,1385,722,1667,13,543,1232,1408,4487
28.164,6,36,8896,20,131,1482,417,1749,16,649,1702,1642,7147
1726.813,1,14,1624,14,88,132831,88,1624,0,0,0,0,0
1793.451,1,150,8400,150,28,12036,28,8400,0,0,0,0,0
1.35,6,48,20193,27,961,51,1440,14577,21,433,57,1440,5616
240.391,6,44,9004,23,523,10926,1418,5918,21,248,12018,639,3086
1738.858,6,88,6417,58,31,30506,31,3927,30,31,59960,31,2490
0.007,17,2,303,1,45,0,45,73,1,202,0,202,230
94.435,6,124,92907,78,1263,1226,1408,82391,46,811,1823,3847,10516
410.284,6,47,8465,29,122,14653,498,2874,18,374,23554,1420,5591
0.017,17,4,352,2,37,12,37,130,2,83,12,89,222
11.012,6,18,4266,10,275,1223,275,958,8,992,890,1440,3308
147.356,17,4,352,2,60,147355,60,176,2,60,147354,60,176
3.456,17,20,12956,8,414,493,1350,3536,12,757,311,1350,9420
279.665,6,70,14373,35,770,8225,1418,10359,35,94,8224,580,4014
0.088,6,5,3271,1,0,0,0,40,4,1023,1,1440,3231
0.001,6,2,144,1,0,0,0,40,1,64,0,64,104
0.275,6,4,191,1,0,0,0,40,3,31,105,31,151
2.412,6,30,10406,18,367,141,833,1825,12,1012,211,1420,8581
0.247,6,20,4960,10,137,27,267,1092,10,692,24,1467,3868
20.529,17,36,7393,14,192,1576,1350,3090,22,167,976,1350,4303
365.317,6,20,1370,14,180,28101,180,940,6,110,12406,110,430
19.641,17,12,1056,6,48,3925,48,456,6,72,3925,72,600
1298.495,17,768,64802,740,40,1757,41,50798,28,472,2763,505,14004
1741.466,1,15,840,15,28,124390,28,840,0,0,0,0,0
0.016,6,2,84,1,0,0,0,44,1,0,0,0,40
0.273,17,2,130,1,29,0,29,57,1,45,0,45,73
0.93,17,4,974,2,40,925,40,136,2,391,924,391,838
1783.372,6,62,7000,28,36,65628,36,1672,34,445,54041,445,5328
10.009,17,4,280,2,34,10003,34,124,2,50,10002,50,156
1760.684,6,81,4302,41,26,44015,26,2184,40,26,45144,26,2118
3.508,17,5,295,5,31,877,31,295,0,0,0,0,0
120.309,2,3,96,3,8,60154,8,96,0,0,0,0,0
64.77,17,4,5496,4,1346,21590,1346,5496,0,0,0,0,0
0.06,6,11,1566,6,503,11,503,823,5,475,15,475,743
1798.787,6,376,26217,217,98,8327,469,15372,159,69,11383,69,10845
1778.583,6,132,8062,71,26,25407,26,4270,61,26,29642,26,3792
1.038,6,28,8503,15,225,60,561,1985,13,997,70,1791,6518
4.038,6,31,8912,14,158,310,267,1357,17,687,247,1400,7555
0.132,6,10,1669,6,551,26,947,1346,4,159,44,159,323
1789.148,17,142,11360,71,48,25559,48,5396,71,56,25559,56,5964
18.423,6,3170,3036028,2129,1351,8,1368,2977232,1041,776,17,2736,58796
280.436,6,28,7352,13,158,23369,267,1317,15,678,20027,3456,6035
130.285,6,1096,561365,619,840,210,1152,537478,477,436,273,1179,23887
5.095,17,4,772,2,46,5082,46,148,2,284,5081,284,624
8.598,6,2091,1823214,1190,1439,7,1448,1764910,901,776,9,1448,58304
1782.856,6,360,22818,210,69,8530,69,12678,150,69,11965,69,10140
382.639,6,70,13552,37,97,10628,267,2956,33,331,11957,3417,10596
4.541,6,674,614720,440,1360,10,1432,601069,234,475,19,1871,13651
1772.173,6,182,15698,120,69,14892,69,8940,62,69,29049,69,6758
1245.237,6,74,5984,48,66,26494,66,3504,26,60,49805,60,2480
4.444,6,33,6129,17,206,277,314,2744,16,548,279,1179,3385
1764.193,2,15,480,15,8,126013,8,480,0,0,0,0,0
1.702,6,16,4591,5,113,425,113,317,11,766,163,1420,4274
1793.279,1,58,4872,0,0,0,0,0,58,56,31461,56,4872
2.446,6,27,8825,16,281,163,577,1489,11,984,226,1452,7336
1794.784,6,356,22520,208,69,8670,69,12460,148,69,12209,69,10060
0.007,17,2,226,1,45,0,45,73,1,125,0,125,153
300.825,2,4,128,4,8,100275,8,128,0,0,0,0,0
313.027,6,61,35503,26,213,12521,444,2931,35,1181,7479,1461,32572
8.6,6,25,10879,12,275,781,275,1034,13,932,692,2840,9845
0.031,17,2,304,1,60,0,60,88,1,188,0,188,216
0.16,6,9,1002,5,213,40,213,417,4,421,41,421,585
5.241,1,10,840,10,56,582,56,840,0,0,0,0,0
3.187,17,32,8808,14,308,242,1350,4710,18,199,185,1350,4098
1764.193,2,17,544,17,8,110262,8,544,0,0,0,0,0
20.66,6,19,2428,11,189,2066,517,1350,8,323,2950,499,1078
1795.743,1,156,8736,156,28,11585,28,8736,0,0,0,0,0
260.938,6,16,5759,8,784,37276,1360,3458,8,247,37242,272,2301
1.105,6,36,9187,20,420,58,1188,4878,16,385,66,863,4309
1773.216,17,319,57270,319,151,5576,385,57270,0,0,0,0,0
136.095,17,8,2688,8,308,19442,308,2688,0,0,0,0,0
1785.064,17,140,11200,70,48,25870,48,5320,70,56,25870,56,5880
2.171,6,13,2311,8,188,310,245,700,5,1407,479,1407,1611
1787.909,6,378,26297,217,97,8277,469,15441,161,69,11174,69,10856
0.195,6,10,1671,6,552,38,948,1348,4,159,64,159,323
1773.107,6,180,15480,120,69,14900,69,8940,60,69,30048,69,6540
1680.546,17,12,498,11,14,168054,14,462,1,8,0,8,36
0.028,17,4,424,2,46,3,46,148,2,110,8,110,276
136.716,17,32,1280,26,12,5468,12,1040,6,12,2588,12,240
1796.762,6,371,26086,214,99,8435,469,15045,157,69,11515,69,11041
1634.951,1,8,448,8,28,233564,28,448,0,0,0,0,0
0.012,17,2,448,1,64,0,64,92,1,328,0,328,356
1786.631,6,104,8444,68,66,26666,66,4964,36,60,51043,60,3480
3.967,17,10,900,5,30,980,30,290,5,94,984,94,610
152.536,6,22,10238,11,304,80,597,1385,11,1200,15235,1460,8853
12.152,6,1888,1658493,1153,1383,10,1420,1624872,735,467,16,1883,33621
297.473,1,4,224,4,28,99157,28,224,0,0,0,0,0
63.127,17,4,352,2,60,63126,60,176,2,60,63126,60,176
139.523,17,4,352,2,60,139522,60,176,2,60,139522,60,176
241.344,6,385,386392,138,461,1761,1402,10875,247,1549,981,4206,375517
281.05,6,28,7352,12,158,25550,267,1277,16,603,18727,1400,6075
1.249,6,10,1687,7,100,208,100,384,3,1179,486,1179,1303
1772.889,6,180,15480,120,69,14898,69,8940,60,69,30047,69,6540
1800.0,6,221,18814,81,72,22125,317,8267,140,69,12949,1062,10547
100.16,6,31,14694,15,488,352,1440,3087,16,1095,6668,1440,11607
0.13,6,21,13994,13,127,9,127,811,8,2551,17,6801,13183
1.39,6,47,18779,27,863,53,1360,13203,20,529,63,4075,5576
1749.92,6,95,7203,63,38,28224,205,4476,32,33,56436,98,2727
1.415,6,37,8218,19,321,78,1168,2722,18,476,72,2715,5496
1.354,6,46,17036,25,865,56,1460,11420,21,433,58,1460,5616
0.897,17,4,624,2,64,895,64,184,2,192,772,192,440
3.033,17,4,332,2,47,3029,47,150,2,63,3029,63,182
0.143,17,2,187,1,43,0,43,71,1,88,0,88,116
188.529,17,4,352,2,60,188528,60,176,2,60,188528,60,176
0.947,17,2,586,1,46,0,46,74,1,484,0,484,512
1681.468,1,15,840,15,28,120104,28,840,0,0,0,0,0
11.467,6,1826,1586208,1109,1376,10,1420,1553295,717,467,16,1883,32913
44.28,2,2,64,2,8,44280,8,64,0,0,0,0,0
118.754,6,60,37754,30,718,56,1460,6276,30,1375,4089,4380,31478
11.745,6,1872,1623097,1132,1379,10,1420,1589252,740,467,15,1883,33845
15.464,17,15,5037,7,370,2572,1350,2791,8,252,2204,1350,2246
1.264,6,31,6467,16,164,84,267,1962,15,650,78,1452,4505
1779.747,17,140,11200,70,48,25793,48,5320,70,56,25793,56,5880
0.047,17,2,392,1,40,0,40,68,1,296,0,296,324
280.315,6,28,7352,13,158,23359,267,1317,15,678,20019,4200,6035
20.165,6,21,5417,12,107,1833,159,1074,9,966,2519,1674,4343
13.752,17,3,2906,3,940,6876,1451,2906,0,0,0,0,0
371.119,6,21,1419,15,177,26508,177,989,6,110,15677,110,430
300.138,6,62,24203,35,1037,8822,1360,18047,27,337,11537,1360,6156
2.06,17,4,240,2,32,2059,32,120,2,32,2059,32,120
0.013,17,2,144,1,36,0,36,64,1,52,0,52,80
292.083,17,4,352,2,60,292082,60,176,2,60,292082,60,176
5.908,6,6,1257,4,327,1969,414,815,2,181,5690,270,442
1786.487,6,363,23076,211,69,8507,69,12856,152,69,11828,69,10220
66.497,17,4,352,2,48,66485,48,152,2,72,66485,72,200
1.31,6,10,1687,7,100,218,100,384,3,1179,524,1179,1303
0.023,17,2,136,1,32,0,32,60,1,48,0,48,76
0.033,17,2,290,1,40,0,40,68,1,194,0,194,222
1788.847,17,87,3648,86,14,21045,14,3612,1,8,0,8,36
0.341,17,2,144,1,36,0,36,64,1,52,0,52,80
1.001,17,2,120,2,32,1001,32,120,0,0,0,0,0
30.024,6,12,1317,7,174,5004,174,546,5,251,7490,476,771
4.261,6,38,6329,20,187,224,293,2864,18,456,236,1152,3465
0.062,17,2,279,1,36,0,36,64,1,187,0,187,215
107.582,6,110,85411,71,1278,1536,1448,75269,39,675,2825,1448,10142
478.024,17,15,5008,15,305,34144,308,5008,0,0,0,0,0
276.842,6,14,1040,8,34,39548,38,586,6,35,55342,40,454
0.576,17,3,1085,3,333,288,354,1085,0,0,0,0,0
41.017,6,23,6616,8,138,5859,267,883,15,568,2928,1452,5733
563.531,1,6,336,6,28,112706,28,336,0,0,0,0,0
26.824,6,36,8453,17,207,1676,721,2138,19,555,1433,1440,6315
71.393,6,35,8039,13,162,1897,267,1503,22,353,3398,1917,6536
1.249,6,14,3439,6,288,246,288,548,8,639,154,853,2891
1.39,6,50,19462,27,903,53,1460,13766,23,433,54,1460,5696
41.443,17,5,380,5,48,10360,48,380,0,0,0,0,0
36.262,17,20,1520,20,48,1908,48,1520,0,0,0,0,0
316.044,6,76,19609,41,337,7901,1360,10136,35,383,9290,4649,9473
9.008,1,10,840,10,56,1000,56,840,0,0,0,0,0
245.361,17,4,240,2,32,245359,32,120,2,32,245360,32,120
180.768,6,1696,849483,943,835,191,1152,810416,753,372,240,1152,39067
1761.809,6,6148,5868295,2143,141,822,934,124591,4005,1412,440,4254,5743704
281.631,6,30,7570,12,158,25602,267,1277,18,506,16562,2036,6293
0.137,17,2,279,1,36,0,36,64,1,187,0,187,215
10.468,6,1120,940873,634,1397,16,1448,909089,486,931,21,2896,31784
240.18,6,49,9666,24,202,10442,832,2884,25,496,10007,1408,6782
1772.741,6,204,22330,130,75,13742,267,10057,74,132,24279,1460,12273
3.855,17,2,152,2,48,3855,48,152,0,0,0,0,0
279.59,17,2,150,2,47,279590,47,150,0,0,0,0,0
3.561,6,24,8197,13,150,296,374,1275,11,1079,355,1731,6922
5.471,6,44,8369,22,227,260,314,4062,22,489,248,1179,4307
5.082,1,10,280,10,0,0,0,280,0,0,0,0,0
1771.934,6,182,15629,121,69,14766,69,8980,61,69,29530,69,6649
223.94,17,4,240,2,32,223939,32,120,2,32,223939,32,120
0.477,6,12,1653,6,288,92,288,548,6,426,59,434,1105
10.786,6,6,328,4,0,3595,0,216,2,0,10770,0,112
0.259,17,3,451,2,39,106,39,134,1,289,0,289,317
0.149,6,43,21011,26,1075,5,1420,16110,17,467,8,1883,4901
301.317,6,112,76624,64,1373,4782,1460,69902,48,399,194,1460,6722
0.3,17,2,152,1,48,0,48,76,1,48,0,48,76
0.699,17,26,19425,14,1002,51,1350,14430,12,388,60,1350,4995
7.93,6,1284,1099108,769,1378,10,1420,1074287,515,467,15,1883,24821
62.189,6,79,55506,49,1206,1295,1368,47209,30,747,2135,1368,8297
317.007,6,112,36150,60,501,5373,1360,24995,52,302,6212,3289,11155
0.272,17,2,440,1,39,0,39,67,1,345,0,345,373
0.525,6,28,9209,13,273,43,733,1790,15,945,35,1368,7419
0.065,17,2,182,1,37,0,37,65,1,89,0,89,117
2.748,17,4,624,4,128,916,128,624,0,0,0,0,0
0.877,17,2,204,1,34,0,34,62,1,114,0,114,142
16.049,17,6,488,3,35,8020,37,190,3,71,8020,89,298
185.771,6,29,7392,13,158,15480,267,1317,16,603,12372,2036,6075
90.773,6,35,8130,18,311,512,618,1698,17,521,5665,3488,6432
10.232,6,83,24845,42,560,249,1152,19048,41,461,249,1179,5797
0.027,6,2,126,1,0,0,0,40,1,46,0,46,86
842.254,2,10,320,10,8,93583,8,320,0,0,0,0,0
1.322,6,38,9848,20,502,69,1460,4352,18,433,67,1460,5496
258.151,17,2,150,2,47,258151,47,150,0,0,0,0,0
0.022,17,2,427,1,39,0,39,67,1,332,0,332,360
0.753,6,14,2164,7,288,97,288,600,7,424,95,434,1564
0.256,6,17,2952,9,266,32,517,1542,8,493,33,828,1410
0.552,6,27,9053,13,255,46,661,1718,14,942,40,1368,7335
1772.013,6,180,15480,120,69,14890,69,8940,60,69,30032,69,6540
1744.657,2,14,448,14,8,134204,8,448,0,0,0,0,0
280.401,6,30,7432,13,158,23366,267,1317,17,603,17521,2760,6115
281.124,6,26,7272,13,158,23427,267,1317,13,905,23408,4845,5955
8.444,6,14,2245,8,211,1206,211,846,6,545,1688,904,1399
36.817,17,4,352,2,60,36816,60,176,2,60,36816,60,176
1782.122,17,83,3480,82,14,22001,14,3444,1,8,0,8,36
827.327,17,16,5572,16,320,55155,548,5572,0,0,0,0,0
1788.191,6,356,22520,208,69,8638,69,12460,148,69,12164,69,10060
5.084,6,37,7189,19,218,282,314,3383,18,513,282,1179,3806
0.035,17,4,1148,2,32,21,32,120,2,486,21,486,1028
1.098,17,4,792,3,60,505,60,264,1,500,0,500,528
9.393,6,14,1247,7,222,1564,222,728,7,231,1564,231,519
10.054,6,277,258080,104,348,97,348,7864,173,1427,58,1448,250216
122.969,6,24,10963,12,414,79,935,1768,12,1087,11165,2368,9195
240.6,6,54,10763,25,256,10024,681,3667,29,372,8592,1518,7096
52.835,6,12,1402,6,304,10567,304,916,6,83,10565,83,486
0.414,6,22,7342,12,335,37,668,1974,10,1210,45,1906,5368
0.231,6,9,1339,5,145,57,145,349,4,826,57,826,990
1.388,6,46,18120,25,882,57,1440,12504,21,433,60,1440,5616
4.92,6,42,8289,21,227,246,314,4022,21,489,232,1179,4267
0.989,6,12,3704,6,171,192,171,491,6,964,196,1448,3213
1796.049,17,470,86827,233,257,7741,1350,66526,237,57,7608,1350,20301
0.296,6,21,7302,12,335,26,668,1986,9,968,35,1475,5316
2.39,17,4,1556,4,361,796,361,1556,0,0,0,0,0
1785.859,6,370,25770,214,99,8384,469,15114,156,69,11521,69,10656
1772.003,6,180,15480,120,69,14890,69,8940,60,69,30032,69,6540
374.817,6,18,1242,14,180,28832,180,916,4,110,20059,110,326
0.017,6,3,120,2,0,17,0,80,1,0,0,0,40
65.417,6,13,982,5,180,16354,180,448,8,110,9310,110,534
280.381,6,30,7432,13,158,23365,267,1317,17,543,17521,1400,6115
180.865,17,4,360,2,30,180862,30,116,2,94,180852,94,244
0.0,6,2,287,2,103,0,138,287,0,0,0,0,0
0.488,17,8,2750,8,315,69,354,2750,0,0,0,0,0
1772.1,6,180,15480,120,69,14891,69,8940,60,69,30033,69,6540
378.686,2,3,96,3,8,189343,8,96,0,0,0,0,0
0.017,17,2,218,1,35,0,35,63,1,127,0,127,155
1683.851,17,14,3843,7,30,280641,30,406,7,463,280641,463,3437
1720.436,1,8,448,8,28,245776,28,448,0,0,0,0,0
1781.759,6,364,24923,211,94,8484,469,14456,153,69,11722,69,10467
1.011,17,2,677,1,300,0,300,328,1,321,0,321,349
128.307,6,220,187128,89,575,1457,1368,7895,131,1448,986,2736,179233
0.025,17,2,198,1,39,0,39,67,1,103,0,103,131
60.139,2,2,64,2,8,60139,8,64,0,0,0,0,0
130.231,17,4,352,2,60,130230,60,176,2,60,130230,60,176
20.97,17,45,15535,21,399,1046,1350,8986,24,244,910,1350,6549
1.681,6,50,21694,29,930,60,1360,16078,21,476,74,2715,5616
1.406,6,51,21366,28,967,52,1460,15670,23,433,55,1460,5696
1.232,6,25,8056,12,164,96,267,1288,13,869,88,1448,6768
0.041,17,4,330,2,33,1,33,122,2,76,36,82,208
119.276,17,50,7704,25,48,4969,48,1900,25,204,4969,308,5804
0.065,17,2,2754,2,1349,65,1349,2754,0,0,0,0,0
4.541,6,3,132,3,0,0,0,132,0,0,0,0,0
1.037,6,32,13126,19,695,57,1360,5674,13,865,71,3921,7452
394.414,6,590,581751,371,143,1065,213,21406,219,2577,1101,16896,560345
1795.784,17,445,38948,403,35,4467,288,25676,42,288,42949,288,13272
0.88,6,10,1687,7,100,146,100,384,3,1179,315,1179,1303
10.451,6,13,2311,8,125,1493,245,700,5,1407,195,1407,1611
8.27,6,731,837115,411,1132,20,1360,47056,320,2531,25,44880,790059
1795.934,6,128,8215,71,48,25656,208,4819,57,31,32065,31,3396
1.486,6,49,19989,26,944,59,1440,14293,23,433,59,1440,5696
64.414,6,34,8998,15,327,161,1189,2575,19,514,3577,1917,6423
0.527,17,3,543,2,39,387,39,134,1,381,0,381,409
6.804,1,9,936,0,0,0,0,0,9,76,850,76,936
0.027,17,2,394,1,128,0,128,156,1,210,0,210,238
240.272,6,43,9012,21,516,12013,1402,5746,22,234,11441,618,3266
1.687,6,25,8801,15,291,120,606,1478,10,988,167,1452,7323
0.183,6,2,80,1,0,0,0,40,1,0,0,0,40
1757.954,6,95,7203,63,38,28354,205,4476,32,33,56701,98,2727
9.102,6,43,18091,22,499,433,1193,4006,21,882,350,2119,14085
2.179,17,3,174,3,30,1089,30,174,0,0,0,0,0
56.47,6,14,5631,4,112,18820,112,280,10,706,6273,1420,5351
20.227,6,20,3130,12,183,1838,517,1561,8,381,2888,499,1569
0.011,17,2,239,1,59,0,59,87,1,124,0,124,152
16.29,17,27,5906,13,204,1355,1350,3028,14,177,1250,1350,2878
1767.323,6,100,7268,63,31,28505,31,4266,37,31,49087,31,3002
1.384,6,37,8212,19,320,76,1162,2716,18,476,71,2715,5496
187.963,6,29,7392,13,158,15663,267,1317,16,603,12526,1400,6075
1746.966,6,94,7120,61,38,29116,205,4372,33,33,54579,98,2748
4.714,17,2,2200,2,1072,4714,1072,2200,0,0,0,0,0
73.945,6,21,10156,11,397,60,884,1665,10,1346,8202,3928,8491
11.367,6,1801,1570790,1091,1386,10,1420,1538169,710,420,16,1420,32621
115.258,17,2,72,1,8,0,8,36,1,8,0,8,36
0.013,17,2,350,1,36,0,36,64,1,258,0,258,286
1796.342,17,449,39928,404,35,4457,288,25708,45,288,40025,288,14220
0.657,1,2,112,2,28,657,28,112,0,0,0,0,0
1774.325,6,181,15589,120,69,14910,69,8940,61,69,29569,69,6649
1.273,17,8,840,4,33,419,33,244,4,121,419,145,596
1799.101,17,142,11360,71,48,25700,48,5396,71,56,25701,56,5964
80.34,6,20,820,9,0,6163,0,364,11,0,8032,0,456
4.255,17,5,295,5,31,1063,31,295,0,0,0,0,0
0.455,6,20,7229,12,334,40,663,1969,8,1209,64,1906,5260
81.839,6,16,1747,5,284,222,517,836,11,47,8136,145,911
240.228,6,61,18888,31,783,8007,1418,15728,30,199,8283,580,3160
0.975,6,29,13282,16,511,65,1360,3239,13,1056,66,2720,10043
368.971,6,21,1419,15,177,26355,177,989,6,110,14352,110,430
1758.427,17,234,50468,234,187,7546,342,50468,0,0,0,0,0
169.762,6,170,131964,108,1276,1586,1408,119234,62,730,2093,3847,12730
0.009,6,2,149,1,69,0,69,109,1,0,0,0,40
231.616,17,4,288,2,36,231568,36,128,2,52,231568,52,160
131.278,6,28,3609,12,304,11737,304,2164,16,83,8750,83,1445
1745.41,6,100,7866,66,45,26852,205,4902,34,35,52879,98,2964
0.108,6,10,1669,6,551,21,947,1346,4,159,35,159,323
136.84,17,4,352,2,60,136839,60,176,2,60,136839,60,176
0.005,6,4,4540,1,0,0,0,40,3,1448,0,1448,4500
1760.596,6,120,8892,72,37,24797,205,5068,48,32,37453,98,3824
1789.551,1,217,23002,217,78,8284,78,23002,0,0,0,0,0
0.119,6,9,1343,5,145,29,145,349,4,830,36,830,994
280.191,6,28,7352,13,158,23349,267,1317,15,678,20013,3536,6035
0.038,17,4,352,2,60,20,60,176,2,60,25,60,176
1794.246,1,296,31376,296,78,6082,78,31376,0,0,0,0,0
0.048,17,4,344,2,47,40,47,150,2,69,40,75,194
726.273,17,26,2308,26,60,29050,355,2308,0,0,0,0,0
1799.729,6,370,25301,214,93,8449,469,14714,156,69,11611,69,10587
0.024,6,3,182,2,31,24,31,111,1,31,0,31,71
0.937,6,51,13829,24,551,40,1429,4840,27,464,35,2920,8989
2.458,6,18,3257,10,99,254,182,924,8,477,327,1343,2333
0.101,6,9,1789,5,658,25,658,926,4,647,33,647,863
0.109,6,11,1971,6,451,21,500,1222,5,481,27,481,749
11.685,6,1736,1598655,1129,1365,10,1432,1570060,607,427,19,1432,28595
0.355,17,4,588,2,48,228,48,152,2,190,211,308,436
7.993,17,2,672,2,308,7993,308,672,0,0,0,0,0
1.743,17,23,14885,12,888,155,1350,11002,11,325,170,1350,3883
76.828,17,8,640,4,48,25605,48,304,4,56,25604,56,336
34.343,17,10,760,10,48,3815,48,760,0,0,0,0,0
164.447,6,30,7432,13,158,13703,267,1317,17,543,10275,1380,6115
17.213,6,32,3409,27,211,661,211,2062,5,545,4215,904,1347
280.301,6,30,7432,13,158,23358,267,1317,17,543,17515,1400,6115
3.468,17,10,1472,5,40,864,40,340,5,198,865,216,1132
1740.51,17,30,7050,30,207,60017,207,7050,0,0,0,0,0
171.866,1,6,336,6,28,34373,28,336,0,0,0,0,0
240.53,6,48,6387,22,196,11452,585,3112,26,159,9619,580,3275
0.301,6,28,9146,13,257,25,669,1714,15,830,20,1402,7432
6.222,17,4,304,3,48,2974,48,228,1,48,0,48,76
0.999,6,2,120,2,0,0,0,120,0,0,0,0,0
1779.683,6,964,185623,452,316,3945,825,83730,512,238,3482,2381,101893
307.266,6,168,141432,115,1283,2695,1368,129160,53,679,1954,2519,12272
306.89,6,40,11861,14,153,16157,516,1640,26,436,12272,1452,10221
1.261,6,25,8056,12,164,97,267,1288,13,869,89,1408,6768
281.401,6,30,7570,13,158,23450,267,1317,17,556,17558,2045,6253
1784.513,6,359,22709,209,69,8579,69,12569,150,69,11974,69,10140
0.057,17,4,288,2,33,0,33,122,2,55,29,61,166
40.827,17,11,836,11,48,4082,48,836,0,0,0,0,0
84.601,6,10,532,2,0,193,0,112,8,0,12059,0,420
0.029,17,2,176,1,48,0,48,76,1,72,0,72,100
1789.955,6,368,25690,214,100,8403,469,14976,154,69,11699,69,10714
5.419,6,22,4426,12,213,492,597,1689,10,552,581,1767,2737
1772.965,6,180,15480,120,69,14898,69,8940,60,69,30044,69,6540
14.239,6,9,685,9,31,1779,31,685,0,0,0,0,0
321.796,1,6,336,6,28,64359,28,336,0,0,0,0,0
21.049,1,4,640,4,132,7016,141,640,0,0,0,0,0
4.729,17,3,1167,3,361,2364,361,1167,0,0,0,0,0
1232.847,6,84,7365,52,82,24173,293,4142,32,71,39765,248,3223
233.912,6,52,7320,23,153,10625,722,2920,29,152,8348,1408,4400
1772.413,6,180,15480,120,69,14894,69,8940,60,69,30035,69,6540
1503.997,2,13,416,13,8,125333,8,416,0,0,0,0,0
0.023,6,3,144,2,0,23,0,92,1,0,0,0,52
506.689,6,99,15362,46,294,11258,1368,7709,53,212,9743,1368,7653
1788.422,1,63,5292,63,56,28845,56,5292,0,0,0,0,0
1.557,6,38,9848,21,440,77,1360,4392,17,476,83,2720,5456
1770.844,6,101,9344,66,65,27243,65,5577,35,59,52080,59,3767
696.854,1,4,224,4,28,232284,28,224,0,0,0,0,0
249.096,17,10,880,5,48,62271,48,380,5,72,62271,72,500
280.51,6,29,7392,13,158,23375,267,1317,16,603,18695,2076,6075
1787.142,17,86,3606,85,14,21275,14,3570,1,8,0,8,36
15.808,17,11,4595,5,430,3872,1350,2294,6,355,3099,1350,2301
1772.512,6,204,22330,130,75,13740,267,10057,74,132,24280,1452,12273
1794.068,1,57,4788,57,56,32036,56,4788,0,0,0,0,0
1744.609,2,26,832,26,8,69784,8,832,0,0,0,0,0
0.013,6,14,4020,7,88,2,88,388,7,1113,2,1460,3632
1786.392,6,102,8364,68,66,26662,66,4964,34,60,54130,60,3400
300.715,6,38,8448,20,286,15827,797,1976,18,441,498,1460,6472
0.416,6,14,1733,7,288,65,288,588,7,284,37,434,1145
0.213,6,9,1339,5,145,53,145,349,4,826,40,826,990
0.302,17,2,152,1,48,0,48,76,1,48,0,48,76
213.582,17,4,352,2,60,213581,60,176,2,60,213580,60,176
0.033,17,2,263,1,42,0,42,70,1,165,0,165,193
1780.86,17,73,3060,72,14,25082,14,3024,1,8,0,8,36
295.515,6,81,55326,50,1199,6030,1368,46977,31,747,2067,1368,8349
28.158,6,5,221,1,0,0,0,40,4,7,9343,7,181
1793.808,1,290,16240,290,28,6206,28,16240,0,0,0,0,0
1744.674,2,25,800,25,8,72694,8,800,0,0,0,0,0
300.084,6,44,13964,20,892,15784,1360,7985,24,294,13039,4027,5979
0.025,17,6,816,3,60,0,60,264,3,156,0,156,552
21.859,6,9,527,5,43,5464,43,311,4,0,7248,0,216
2.733,17,4,624,4,128,911,128,624,0,0,0,0,0
1.376,6,25,8056,12,164,106,267,1288,13,1014,98,2736,6768
1786.439,6,102,8364,68,66,26663,66,4964,34,60,54130,60,3400
0.042,17,2,488,1,60,0,60,88,1,372,0,372,400
3.549,17,5,588,4,64,1178,64,368,1,192,0,192,220
0.681,17,8,2076,8,231,97,389,2076,0,0,0,0,0
304.987,6,80,81864,15,529,21784,1408,4509,65,1344,4765,1408,77355
1781.765,6,365,23087,211,69,8484,69,12787,154,69,11645,69,10300
1744.688,6,97,7307,63,38,28140,205,4476,34,33,52860,98,2831
1787.525,6,104,8308,68,64,26679,64,4896,36,58,51068,58,3412
1.597,17,3,1170,3,362,798,362,1170,0,0,0,0,0
1744.99,6,95,7203,63,38,28145,205,4476,32,33,56277,98,2727
1785.057,17,142,11360,71,48,25500,48,5396,71,56,25500,56,5964
34.027,6,34,5296,16,154,2268,722,1911,18,271,1988,1408,3385
197.019,17,4,352,2,60,197018,60,176,2,60,197018,60,176
2.743,6,10,1102,6,483,548,483,803,4,83,912,83,299
7.168,6,1434,1285099,883,1376,7,1408,1251783,551,931,12,2816,33316
1789.375,6,356,22520,208,69,8644,69,12460,148,69,12172,69,10060
0.116,17,2,136,1,32,0,32,60,1,48,0,48,76
0.096,17,2,210,1,53,0,53,81,1,101,0,101,129
29.794,6,14,2952,4,256,9931,256,420,10,304,2192,304,2532
0.017,17,2,369,1,64,0,64,92,1,249,0,249,277
205.536,17,4,352,2,60,205535,60,176,2,60,205535,60,176
0.136,17,2,276,1,41,0,41,69,1,179,0,179,207
1794.832,6,356,22520,208,69,8670,69,12460,148,69,12209,69,10060
1.18,6,4,184,2,0,1180,0,88,2,0,1006,0,96
1758.493,17,285,56062,285,168,6191,358,56062,0,0,0,0,0
3.075,17,36,13934,16,318,202,1350,5537,20,391,160,1350,8397
1787.006,6,104,8308,68,64,26671,64,4896,36,58,51055,58,3412
66.132,6,70,48787,45,1200,1503,1448,40757,25,746,2569,1448,8030
0.405,17,2,152,1,48,0,48,76,1,48,0,48,76
197.934,17,4,352,2,60,197933,60,176,2,60,197933,60,176
0.126,6,44,20545,26,1038,5,1420,15604,18,467,6,1883,4941
1773.288,6,180,15480,120,69,14901,69,8940,60,69,30048,69,6540
77.895,17,6,528,3,60,38946,60,264,3,60,38947,60,264
1787.069,6,356,22520,208,69,8633,69,12460,148,69,12156,69,10060
224.306,17,3,1016,3,310,112153,316,1016,0,0,0,0,0
1721.785,6,87,6042,43,29,40993,36,2348,44,348,40040,456,3694
1757.594,6,190,11607,95,47,18696,208,6877,95,31,18696,31,4730
0.218,17,5,4254,3,909,109,1350,2812,2,693,45,1350,1442
280.198,6,28,7352,13,158,23349,267,1317,15,678,20012,2800,6035
1772.585,6,180,15480,120,69,14895,69,8940,60,69,30039,69,6540
280.205,6,27,7312,13,158,23350,267,1317,14,775,21551,4836,5995
194.796,6,18,5839,10,784,21644,1360,3538,8,247,27797,272,2301
280.438,6,29,7392,14,158,21572,267,1357,15,678,20027,3456,6035
280.901,6,34,9253,15,175,20064,267,1658,19,621,15603,1400,7595
55.683,17,2,244,2,94,55683,94,244,0,0,0,0,0
82.334,6,72,46628,44,1165,1914,1408,38439,28,960,2281,3847,8189
41.464,6,5588,5349143,3728,1357,11,1408,5247673,1860,950,22,2801,101470
0.225,6,23,6673,10,181,18,267,1128,13,627,17,1400,5545
34.306,17,40,5880,20,48,1805,48,1520,20,190,1805,308,4360
0.418,6,6,324,4,0,139,0,216,2,0,225,0,108
35.041,6,28,4939,14,180,2695,722,1807,14,400,2666,1448,3132
0.231,17,2,136,1,32,0,32,60,1,48,0,48,76
398.456,6,21,1419,15,177,28461,177,989,6,110,12323,110,430
1786.934,6,106,8388,68,64,26670,64,4896,38,58,48293,58,3492
240.291,6,58,18023,30,752,8285,1418,15121,28,179,8899,580,2902
0.29,6,25,8981,13,264,24,696,1741,12,1101,25,2816,7240
1783.813,6,368,25690,213,99,8414,469,15005,155,69,11583,69,10685
0.203,17,2,214,1,39,0,39,67,1,119,0,119,147
0.007,17,2,375,1,37,0,37,65,1,282,0,282,310
1788.152,1,238,13328,238,28,7544,28,13328,0,0,0,0,0
226.125,17,4,240,2,32,226124,32,120,2,32,226124,32,120
2.232,17,6,474,3,34,1000,34,186,3,68,0,68,288
7.356,6,1482,1346804,923,1381,7,1408,1313072,559,931,12,2816,33732
1.001,17,4,288,2,36,969,36,128,2,52,968,52,160
315.85,6,71,19349,37,334,8773,1360,9870,34,405,9567,4649,9479
0.125,17,7,2375,7,311,20,355,2375,0,0,0,0,0
8.159,6,1636,1607900,1090,1400,7,1408,1575009,546,1116,14,1408,32891
1740.693,17,30,7050,30,207,60023,207,7050,0,0,0,0,0
1771.926,6,180,15480,120,69,14890,69,8940,60,69,30032,69,6540
11.017,6,20,7050,11,275,1101,275,998,9,1420,781,1420,6052
97.364,17,4,352,2,60,97363,60,176,2,60,97363,60,176
63.123,6,35,5316,20,154,3322,722,2132,15,342,1107,1448,3184
4.292,2,6,240,6,16,858,16,240,0,0,0,0,0
3.929,6,2,88,2,0,0,0,88,0,0,0,0,0
280.294,6,28,7352,13,158,23357,267,1317,15,678,20019,2045,6035
5.065,6,39,7269,19,218,281,314,3383,20,513,246,1179,3886
1.404,6,24,8004,11,164,120,267,1236,13,869,98,1368,6768
755.681,2,5,160,5,8,188920,8,160,0,0,0,0,0
5.151,17,3,208,2,36,5003,36,128,1,52,0,52,80
284.871,17,4,240,2,32,284870,32,120,2,32,284870,32,120
0.02,17,2,672,2,308,20,308,672,0,0,0,0,0
240.684,2,2,64,2,8,240684,8,64,0,0,0,0,0
1.058,6,23,6515,13,334,88,1009,2195,10,979,116,2840,4320
1.263,6,47,18578,27,849,48,1360,13002,20,476,57,2715,5576
1787.767,17,142,11360,71,48,25538,48,5396,71,56,25538,56,5964
252.24,2,2,64,2,8,252240,8,64,0,0,0,0,0
0.501,6,487,468613,182,194,2,230,10251,305,1460,1,4344,458362
184.555,17,4,352,2,60,184554,60,176,2,60,184554,60,176
1796.77,17,448,39896,403,35,4469,288,25676,45,288,40020,288,14220
1786.658,6,106,8456,68,65,26666,65,4930,38,59,48285,59,3526
0.182,17,4,284,2,32,1,32,120,2,54,11,60,164
0.146,17,4,588,2,48,136,48,152,2,190,134,308,436
0.023,17,4,284,2,32,16,32,120,2,54,11,60,164
1729.193,6,57,4180,38,33,46734,33,2603,19,31,96056,31,1577
1796.314,1,264,14784,264,28,6830,28,14784,0,0,0,0,0
43.059,6,18,740,10,0,4784,0,404,8,0,5276,0,336
39.405,6,7,280,0,0,0,0,0,7,0,0,0,280
1786.692,6,104,8376,68,65,26667,65,4930,36,59,51035,59,3446
2.275,6,15,5928,4,106,758,106,274,11,578,210,1420,5654
1787.907,6,356,22520,208,69,8637,69,12460,148,69,12162,69,10060
1776.26,17,73,3060,72,14,25017,14,3024,1,8,0,8,36
22.961,6,6,328,4,0,7653,0,216,2,0,22950,0,112
0.581,6,7,376,4,0,193,0,216,3,0,162,0,160
4.065,17,5,335,5,39,1016,39,335,0,0,0,0,0
1373.389,6,78,6009,47,41,29856,205,3396,31,34,45772,131,2613
372.731,17,9,3016,9,307,46591,308,3016,0,0,0,0,0
3.96,17,8,736,4,32,1316,32,240,4,96,1317,96,496
12.179,6,733,638609,472,1284,25,1368,620373,261,931,46,2736,18236
19.481,17,3,228,3,48,9740,48,228,0,0,0,0,0
0.41,17,2,212,1,46,0,46,74,1,110,0,110,138
31.745,6,7,396,1,0,0,0,60,6,0,6315,0,336
7.254,6,1476,1374510,943,1382,7,1408,1342130,533,931,13,2816,32380
15.739,17,16,6398,8,483,2238,1350,4092,8,260,2236,1350,2306
0.376,17,2,193,1,43,0,43,71,1,94,0,94,122
262.051,17,6,360,3,32,131025,32,180,3,32,131025,32,180
44.476,6,29,7257,13,155,3706,267,1306,16,441,2964,1420,5951
280.497,6,28,7352,12,158,25499,267,1277,16,678,18696,2760,6075
0.011,17,2,271,1,46,0,46,74,1,169,0,169,197
1745.322,6,95,7203,63,38,28150,205,4476,32,33,56287,98,2727
0.277,17,2,334,1,32,0,32,60,1,246,0,246,274
280.249,6,29,7392,13,158,23354,267,1317,16,603,18681,2236,6075
1799.394,1,342,28728,342,56,5276,56,28728,0,0,0,0,0
1777.023,17,79,3312,78,14,23078,14,3276,1,8,0,8,36
2.227,6,25,6082,13,108,185,147,959,12,773,179,1608,5123
240.329,6,42,8343,22,449,11443,1418,5648,20,205,12648,580,2695
300.768,6,41,12359,23,735,13671,1360,6837,18,435,507,2720,5522
0.078,17,2,158,1,34,0,34,62,1,68,0,68,96
1797.386,6,356,22520,208,69,8683,69,12460,148,69,12226,69,10060
1745.445,6,95,7203,63,38,28152,205,4476,32,33,56294,98,2727
0.02,6,5,200,3,0,10,0,120,2,0,0,0,80
3.816,17,4,240,4,32,1272,32,240,0,0,0,0,0
1796.683,17,142,11360,71,48,25666,48,5396,71,56,25666,56,5964
8.505,6,54,10033,27,218,327,314,4366,27,508,316,1152,5667
0.164,6,19,8973,10,121,18,121,649,9,1308,20,1802,8324
1790.772,17,140,11200,70,48,25953,48,5320,70,56,25953,56,5880
1799.232,17,449,39928,404,35,4464,288,25708,45,288,40020,288,14220
109.124,6,30,13779,15,958,58,1360,6393,15,846,7782,1725,7386
0.151,17,2,188,1,37,0,37,65,1,95,0,95,123
280.415,6,28,7352,12,158,25492,267,1277,16,603,18691,1400,6075
232.405,6,27,6552,11,220,6413,516,1326,16,352,15487,1452,5226
19.638,6,27,7177,13,155,1636,267,1306,14,530,1509,3417,5871
1790.208,6,299,26422,177,75,10171,267,12221,122,134,14794,1917,14201
1746.47,6,103,8022,65,45,27288,205,4850,38,35,47191,98,3172
0.617,6,13,1693,6,288,87,288,548,7,426,73,434,1145
345.185,17,6,528,3,60,172592,60,264,3,60,172592,60,264
0.153,6,44,21220,26,1087,6,1420,16279,18,467,8,1883,4941
19.276,6,3000,2753308,1893,1374,10,1408,2691080,1107,931,17,2816,62228
1796.922,6,359,22847,208,69,8680,69,12598,151,69,11979,69,10249
0.999,6,55,14499,28,549,37,1429,5032,27,440,37,1986,9467
5.399,17,14,7047,7,614,899,1350,4495,7,336,660,1350,2552
222.684,17,4,352,2,60,222683,60,176,2,60,222683,60,176
1793.111,6,466,26984,257,69,7004,69,14420,209,34,8620,64,12564
108.739,17,4,352,2,60,108738,60,176,2,60,108738,60,176
0.045,17,2,182,1,39,0,39,67,1,87,0,87,115
1799.478,6,394,27351,223,96,8105,469,16026,171,69,10584,69,11325
541.318,6,8,475,6,31,108263,31,333,2,31,299524,31,142
2.365,17,2,144,1,36,0,36,64,1,52,0,52,80
1786.882,17,142,11360,71,48,25526,48,5396,71,56,25526,56,5964
0.145,17,2,204,1,34,0,34,62,1,114,0,114,142
0.818,6,27,5927,13,156,68,267,1462,14,650,56,1452,4465
41.825,17,24,2112,12,48,3801,48,912,12,72,3801,72,1200
1787.329,17,85,3564,84,14,21534,14,3528,1,8,0,8,36
1441.303,2,10,320,10,8,160144,8,320,0,0,0,0,0
258.778,17,4,240,2,32,258777,32,120,2,32,258777,32,120
82.838,17,4,240,2,32,82837,32,120,2,32,82836,32,120
0.526,6,11,1408,5,304,130,304,880,6,102,104,102,528
24.86,6,26,7256,9,154,3107,267,832,17,478,1510,1917,6424
1726.716,17,12,498,11,14,172671,14,462,1,8,0,8,36
1.678,2,2,64,2,8,1678,8,64,0,0,0,0,0
1772.311,6,180,15480,120,69,14893,69,8940,60,69,30035,69,6540
1.975,6,26,8995,13,252,164,647,1692,13,945,147,1408,7303
1786.509,6,104,8444,68,66,26664,66,4964,36,60,51040,60,3480
0.008,6,2,126,1,0,0,0,40,1,46,0,46,86
1798.593,17,448,39896,403,35,4474,288,25676,45,288,40020,288,14220
252.477,2,3,96,3,8,126238,8,96,0,0,0,0,0
1.276,6,47,17900,26,862,51,1460,12284,21,433,55,1460,5616
0.146,17,2,196,1,62,0,62,90,1,78,0,78,106
972.99,17,190,14440,190,48,5148,48,14440,0,0,0,0,0
1788.24,17,87,3648,86,14,21038,14,3612,1,8,0,8,36
7.347,17,6,528,3,48,3668,48,228,3,72,3668,72,300
1.606,6,5,1564,1,0,0,0,40,4,341,298,341,1524
240.644,2,2,64,2,8,240644,8,64,0,0,0,0,0
18.383,17,19,6036,8,328,2625,1350,2850,11,261,1834,1350,3186
4.989,17,4,558,2,36,4984,36,128,2,187,4985,187,430
1.73,6,14,2351,8,188,247,245,700,6,703,293,1152,1651
0.177,6,46,22310,26,1080,7,1420,17289,20,420,8,1420,5021
185.959,17,17,1292,17,48,11622,48,1292,0,0,0,0,0
73.881,1,60,6240,0,0,0,0,0,60,76,1252,76,6240
563.533,17,16,6296,16,365,37568,373,6296,0,0,0,0,0
3.86,2,4,160,4,16,1286,16,160,0,0,0,0,0
6.69,6,739,685002,483,1351,13,1368,667014,256,776,25,1473,17988
21.206,6,8,536,5,92,5301,92,360,3,0,1684,0,176
1758.131,6,172,17378,87,51,20441,517,6062,85,205,20929,1418,11316
1795.464,6,355,22480,207,69,8715,69,12420,148,69,12213,69,10060
1792.344,6,420,35514,235,108,7659,1189,17768,185,139,9740,2760,17746
0.07,17,2,337,1,36,0,36,64,1,245,0,245,273
1772.182,6,180,15480,120,69,14892,69,8940,60,69,30031,69,6540
0.212,6,10,1379,5,145,53,145,349,5,826,35,826,1030
1.113,6,23,7952,12,164,85,267,1288,11,1216,94,3819,6664
86.45,6,21,9221,11,514,83,1236,2014,10,1132,9585,2279,7207
1779.281,17,142,11360,71,48,25418,48,5396,71,56,25418,56,5964
0.247,17,3,451,2,39,150,39,134,1,289,0,289,317
1785.732,6,108,8664,69,66,26260,66,5004,39,60,46981,60,3660
0.041,17,2,152,2,48,41,48,152,0,0,0,0,0
1779.033,1,58,4872,58,56,31211,56,4872,0,0,0,0,0
2.345,2,2,64,2,8,2345,8,64,0,0,0,0,0
1792.815,17,75,3141,73,13,24900,14,3061,2,12,340980,16,80
8.813,17,40,14123,15,562,628,1350,8850,25,182,365,1350,5273
49.979,6,29,8832,14,158,3844,267,1357,15,858,3568,3436,7475
31.634,6,7,336,1,0,0,0,48,6,0,6323,0,288
1.31,6,49,19211,27,888,50,1360,13555,22,433,54,1360,5656
0.628,6,14,1745,7,288,74,288,600,7,426,74,434,1145
1.637,6,50,20279,27,962,62,1440,14583,23,433,65,1440,5696
15.043,17,10,880,5,48,3758,48,380,5,72,3758,72,500
88.246,6,79,56419,51,1199,1764,1368,48226,28,961,2292,3887,8193
1795.843,17,449,39928,404,35,4456,288,25708,45,288,40020,288,14220
5.059,6,39,7285,20,218,266,314,3423,19,442,266,1152,3862
3.115,6,5,216,2,0,19,0,84,3,0,1552,0,132
0.044,17,4,330,2,33,6,33,122,2,76,40,82,208
1.327,17,4,464,3,64,655,64,276,1,160,0,160,188
1786.419,6,102,8364,68,66,26662,66,4964,34,60,54131,60,3400
1795.575,6,418,25021,209,69,8632,69,12500,209,34,8632,48,12521
1.359,6,46,18006,26,873,54,1360,12430,20,476,61,2715,5576
25.841,17,4,240,2,32,25840,32,120,2,32,25840,32,120
5.631,6,40,7309,21,218,281,314,3463,19,440,298,1152,3846
1780.086,17,140,11200,70,48,25798,48,5320,70,56,25798,56,5880
564.116,6,44,7730,24,483,24526,483,5603,20,83,29689,83,2127
0.49,17,3,451,2,39,458,39,134,1,289,0,289,317
1788.813,17,83,3480,82,14,22084,14,3444,1,8,0,8,36
0.423,6,13,1693,7,288,65,288,588,6,426,48,434,1105
3.027,17,5,1166,3,30,1006,30,174,2,468,3016,468,992
15.864,17,19,12263,11,893,1580,1350,10131,8,238,2255,1350,2132
0.629,1,2,291,2,117,629,142,291,0,0,0,0,0
280.451,6,28,7352,12,158,25495,267,1277,16,678,18694,2085,6075
65.363,6,38,10925,17,400,4085,766,3683,21,409,3225,1408,7242
280.268,6,28,7352,13,158,23355,267,1317,15,678,20012,2045,6035
1794.211,17,142,11360,71,48,25631,48,5396,71,56,25631,56,5964
138.818,6,25,9936,12,541,65,1440,2677,13,961,11556,1440,7259
0.02,17,2,338,1,33,0,33,61,1,249,0,249,277
6.02,17,34,10113,17,232,374,1350,4433,17,306,373,1350,5680
78.52,6,10,648,10,31,8724,31,648,0,0,0,0,0
1782.799,6,442,120377,208,517,8611,1360,89084,234,210,7650,2459,31293
3.005,17,7,735,4,46,999,46,296,3,118,1498,135,439
62.019,6,42,9801,19,256,3445,1189,3080,23,482,2817,2920,6721
39.993,17,22,1936,11,48,3998,48,836,11,72,3998,72,1100
240.214,6,56,20823,30,859,8282,1418,17895,26,196,9608,580,2928
1786.883,6,104,8376,68,65,26669,65,4930,36,59,51049,59,3446
1.244,6,15,2626,7,288,181,288,588,8,568,152,853,2038
1785.3,6,104,8376,68,65,26646,65,4930,36,59,51006,59,3446
1.828,17,20,5180,20,231,96,388,5180,0,0,0,0,0
5.391,6,42,7389,21,218,269,314,3463,21,440,256,1152,3926
1788.531,17,87,3648,86,14,21041,14,3612,1,8,0,8,36
21.778,6,44,27099,28,1075,806,1368,20827,16,1072,1437,2519,6272
352.099,6,22,11283,4,112,78,112,280,18,642,20710,1452,11003
1.226,6,24,6408,12,297,110,830,1971,12,790,110,1420,4437
731.313,1,14,784,14,28,56254,28,784,0,0,0,0,0
7.435,6,8,448,4,0,2419,0,240,4,0,2419,0,208
1795.501,17,189,67550,189,329,9550,548,67550,0,0,0,0,0
341.927,6,172,46519,81,878,4274,1440,25351,91,285,3797,1702,21168
295.959,17,8,2656,8,304,42279,308,2656,0,0,0,0,0
11.241,6,2112,1832627,1203,1430,9,1448,1773019,909,776,12,1448,59608
0.081,6,4,239,2,0,40,0,104,2,31,0,31,135
0.747,6,2,1235,1,0,0,0,40,1,1155,0,1155,1195
70.446,6,29,7395,13,155,5870,267,1306,16,453,4695,3417,6089
1633.878,1,8,848,8,78,233411,78,848,0,0,0,0,0
26.454,6,16,2299,8,329,3779,595,1083,8,396,3761,580,1216
3.102,6,58,33203,29,946,110,1440,11620,29,1074,104,1687,21583
280.535,6,29,7392,13,158,23377,267,1317,16,678,18695,3456,6075
52.37,6,30,7297,14,155,4028,267,1346,16,441,3490,1420,5951
0.156,6,27,7296,14,155,12,267,1341,13,678,12,3436,5955
124.061,17,4,352,2,60,124060,60,176,2,60,124059,60,176
8.105,6,1548,1406378,961,1384,8,1408,1371190,587,931,13,2801,35188
0.451,6,23,7771,12,257,41,745,1660,11,921,42,1418,6111
1682.683,17,14,1036,7,30,280441,30,406,7,62,280437,62,630
1745.551,6,98,7359,62,38,28615,205,4424,36,33,49861,98,2935
1745.922,6,95,7203,63,38,28160,205,4476,32,33,56305,98,2727
129.435,6,28,6540,11,189,7425,516,1392,17,372,8082,1452,5148
1764.189,1,135,14310,135,78,13165,78,14310,0,0,0,0,0
3.484,6,2,88,2,0,0,0,88,0,0,0,0,0
24.33,17,41,9521,18,268,1429,1350,5336,23,153,1104,1350,4185
115.173,17,6,528,3,48,57582,48,228,3,72,57581,72,300
1789.991,6,362,22898,210,69,8564,69,12678,152,69,11853,69,10220
5.93,6,635,601853,429,1340,13,1368,586477,206,776,27,1473,15376
4.112,17,2,148,2,46,4112,46,148,0,0,0,0,0
1798.027,17,180,14040,180,50,10044,50,14040,0,0,0,0,0
300.078,6,39,13637,20,897,15784,1360,8013,19,373,16661,2667,5624
1760.196,17,404,118732,404,265,4367,422,118732,0,0,0,0,0
1745.435,6,95,7203,63,38,28152,205,4476,32,33,56298,98,2727
240.2,6,52,18233,28,819,8895,1418,15395,24,226,10443,580,2838
300.602,6,36,8368,20,286,15821,797,1976,16,521,564,3488,6392
0.317,6,23,4494,11,165,31,456,1394,12,493,27,888,3100
300.639,6,44,8883,22,291,14316,786,2125,22,366,444,2128,6758
10.957,6,18,5610,10,275,1217,275,958,8,1440,847,1440,4652
1782.666,1,58,4872,0,0,0,0,0,58,56,31274,56,4872
730.363,6,62,9375,34,104,20240,516,3038,28,217,27046,1452,6337
1797.514,17,87,3648,86,14,21147,14,3612,1,8,0,8,36
280.291,6,29,7392,13,158,23357,267,1317,16,603,18681,2036,6075
1.436,6,9,1952,4,288,478,288,468,5,424,313,434,1484
1.405,6,52,21875,30,992,48,1460,16174,22,480,57,4075,5701
7.517,6,70,21266,35,544,221,1152,16098,35,470,213,1179,5168
93.804,6,22,9754,12,410,55,922,1742,10,1266,10407,2720,8012
1.015,6,24,9513,14,350,78,1042,1993,10,1184,91,2370,7520
2.483,6,88,62704,52,1222,48,1368,54034,36,956,65,2519,8670
76.795,6,34,9265,11,155,171,267,1226,23,374,3490,1420,8039
9.89,6,14,2245,8,211,1412,211,846,6,545,1973,904,1399
1786.806,6,104,8376,68,65,26668,65,4930,36,59,51047,59,3446
445.444,17,51,10994,51,187,8908,347,10994,0,0,0,0,0
1682.777,17,14,1036,7,30,280455,30,406,7,62,280454,62,630
0.696,17,2,167,1,39,0,39,67,1,72,0,72,100
1797.546,17,448,39896,403,35,4471,288,25676,45,288,40015,288,14220
1798.731,17,447,39580,403,35,4474,288,25676,44,288,40948,288,13904
1791.428,1,69,5796,69,56,26344,56,5796,0,0,0,0,0
0.053,17,2,224,1,58,0,58,86,1,110,0,110,138
0.008,17,4,272,2,29,0,29,114,2,51,1,57,158
1684.285,2,23,736,23,8,76558,8,736,0,0,0,0,0
54.275,17,4,352,2,60,54274,60,176,2,60,54274,60,176
368.814,6,27,1767,18,177,21694,177,1181,9,110,8801,110,586
1.556,6,48,19550,27,915,59,1360,13934,21,433,67,1360,5616
5.953,6,40,7325,21,218,297,314,3463,19,516,315,1179,3862
280.369,6,30,7432,13,158,23364,267,1317,17,543,17515,1400,6115
11.811,6,1842,1615087,1139,1362,10,1380,1582734,703,467,16,2760,32353
20.413,6,24,6232,14,117,1570,159,1337,10,727,2266,1402,4895
1776.082,17,142,11360,71,48,25372,48,5396,71,56,25371,56,5964
1.421,6,38,8256,19,321,78,1166,2720,19,433,68,1460,5536
1768.873,6,202,12689,100,51,17867,208,7555,102,31,17511,31,5134
280.319,6,29,7392,13,158,23359,267,1317,16,603,18686,2036,6075
10.62,6,87,26858,44,572,246,1152,20656,43,447,246,1179,6202
1797.963,17,449,39928,404,35,4461,288,25708,45,288,40019,288,14220
1771.47,6,99,9174,66,64,27253,64,5544,33,58,55354,58,3630
0.058,17,4,284,2,32,39,32,120,2,54,37,60,164
280.333,6,30,7432,13,158,23361,267,1317,17,603,17518,2036,6115
5.403,6,865,798004,550,1385,9,1408,776940,315,931,16,2801,21064
39.006,6,161,106577,83,242,475,626,5805,78,1306,506,2710,100772
1770.201,1,59,4956,59,56,30520,56,4956,0,0,0,0,0
1.435,6,49,19125,27,882,55,1360,13469,22,433,60,1360,5656
1779.316,17,140,11200,70,48,25787,48,5320,70,56,25787,56,5880
1797.156,17,83,3480,82,14,22187,14,3444,1,8,0,8,36
849.12,17,32,10752,32,308,27390,308,10752,0,0,0,0,0
0.152,6,46,21393,26,1093,6,1420,16372,20,467,7,1883,5021
89.849,6,32,7950,9,150,4375,267,1422,23,373,4083,1460,6528
4.631,17,35,17080,17,672,289,1350,11907,18,259,169,1350,5173
908.515,1,14,784,14,28,69885,28,784,0,0,0,0,0
152.192,17,4,352,2,60,152191,60,176,2,60,152191,60,176
842.274,2,7,224,7,8,140379,8,224,0,0,0,0,0
8.243,1,5,140,5,0,0,0,140,0,0,0,0,0
34.717,6,33,6065,16,154,2314,721,1921,17,407,2155,2026,4144
112.32,6,24,9863,12,410,50,922,1742,12,953,10199,2720,8121
0.138,6,40,17783,23,995,6,1420,12882,17,467,8,1883,4901
1790.205,1,345,28980,345,56,5204,56,28980,0,0,0,0,0
2.761,17,3,1173,3,363,1380,363,1173,0,0,0,0,0
1792.502,6,358,22669,209,69,8617,69,12500,149,69,12111,69,10169
218.221,6,1776,888235,972,846,224,1152,846787,804,386,271,1179,41448
2.981,6,31,13987,16,770,198,1360,6065,15,1218,199,2720,7922
0.026,17,2,235,1,36,0,36,64,1,143,0,143,171
4.116,17,4,232,4,30,1372,30,232,0,0,0,0,0
1111.332,6,66,5244,38,65,26222,65,2755,28,50,41157,59,2489
5.018,17,4,288,2,36,5003,36,128,2,52,4994,52,160
0.085,6,2,116,1,0,0,0,52,1,0,0,0,64
4.851,17,5,1880,5,348,1212,357,1880,0,0,0,0,0
60.932,6,15,1062,0,0,0,0,0,15,26,4352,26,1062
1792.984,17,140,11184,72,48,25248,48,5472,68,56,26758,56,5712
300.765,6,31,16199,15,195,21483,431,1568,16,1060,5123,5410,14631
19.434,17,492,427011,188,101,103,1350,24433,304,1296,63,1350,402578
1.547,6,13,2311,8,188,221,245,700,5,1407,322,1407,1611
99.221,6,434,354679,283,1316,351,1360,341703,151,230,660,2667,12976
1799.143,1,272,15232,272,28,6638,28,15232,0,0,0,0,0
1789.105,17,142,11360,71,48,25558,48,5396,71,56,25558,56,5964
280.22,6,30,7432,13,158,23351,267,1317,17,543,17513,1400,6115
186.562,6,43,8921,16,117,12437,267,1702,27,266,7169,1460,7219
280.066,6,26,7272,12,158,25460,267,1277,14,775,21538,3445,5995
0.843,6,28,8505,14,270,56,561,1969,14,852,52,1360,6536
1790.983,6,5138,4701620,1939,125,924,339,115792,3199,1414,560,2836,4585828
1198.643,6,61161,55922183,24316,195,49,198,1415488,36845,1427,30,2736,54506695
1784.787,6,130,10980,81,59,22309,205,6512,49,40,37175,98,4468
2.005,17,6,460,3,40,994,41,206,3,56,993,57,254
10.447,6,17,2422,9,210,1305,210,920,8,545,1489,904,1502
0.177,6,24,5385,13,89,14,147,1064,11,748,17,1668,4321
75.308,6,7,376,2,0,75123,0,112,5,0,18780,0,264
287.857,17,4,240,2,32,287856,32,120,2,32,287856,32,120
1741.342,17,29,30624,29,1028,62190,1028,30624,0,0,0,0,0
12.887,6,112,38526,56,642,234,1152,31788,56,449,229,1179,6738
81.657,6,25,9849,12,531,60,1440,2637,13,954,6793,1440,7212
0.086,17,2,181,1,32,0,32,60,1,93,0,93,121
64.498,6,12,927,4,177,111,177,393,8,110,9190,110,534
1.991,6,19,3781,10,234,221,564,1452,9,463,225,1343,2329
11.71,17,2,152,2,48,11710,48,152,0,0,0,0,0
574.273,17,10,880,5,48,143566,48,380,5,72,143566,72,500
5.586,6,46,8449,23,227,253,314,4102,23,427,242,1152,4347
1798.99,17,448,39896,403,35,4475,288,25676,45,288,40018,288,14220
1.561,6,26,8868,13,227,130,547,1592,13,941,109,1448,7276
1.34,1,10,840,10,56,148,56,840,0,0,0,0,0
0.179,6,47,21823,27,1046,6,1420,16802,20,467,8,1883,5021
1791.11,1,342,28728,342,56,5252,56,28728,0,0,0,0,0
0.818,6,19,5908,11,281,81,544,1288,8,859,104,2642,4620
206.935,17,4,1344,4,308,68978,308,1344,0,0,0,0,0
2.778,6,33,18120,18,768,163,1360,6130,15,1896,188,3934,11990
0.231,17,8,2742,8,314,33,353,2742,0,0,0,0,0
1799.468,1,16,896,16,28,119964,28,896,0,0,0,0,0
1791.019,17,180,11520,180,36,10005,36,11520,0,0,0,0,0
31.634,6,7,396,1,0,0,0,60,6,0,6291,0,336
4.168,6,13,2311,8,188,595,245,700,5,1407,977,1407,1611
7.787,6,18,6767,9,275,973,275,643,9,1150,879,1414,6124
5.22,6,6,272,2,0,5190,0,88,4,0,1729,0,184
0.791,17,2,178,1,29,0,29,57,1,93,0,93,121
1771.246,6,99,9306,66,66,27249,66,5610,33,60,55348,60,3696
1795.249,1,262,14672,262,28,6878,28,14672,0,0,0,0,0
0.388,17,8,2758,8,316,55,355,2758,0,0,0,0,0
80.466,6,22,10186,11,304,76,597,1385,11,1192,8029,1460,8801
249.42,17,2,1430,2,687,249420,687,1430,0,0,0,0,0
0.005,17,2,367,1,33,0,33,61,1,278,0,278,306
284.519,1,4,224,4,28,94839,28,224,0,0,0,0,0
237.926,2,2,64,2,8,237926,8,64,0,0,0,0,0
280.191,6,29,7392,14,158,21553,267,1357,15,678,20011,2800,6035
64.556,6,23,10989,12,380,71,832,1665,11,1267,6443,3928,9324
1743.936,6,96,7286,63,38,28128,205,4476,33,33,54488,98,2810
374.603,6,18,1242,14,180,28815,180,916,4,110,20061,110,326
0.057,17,4,588,2,48,52,48,152,2,190,50,308,436
435.282,17,88,6688,88,48,5003,48,6688,0,0,0,0,0
49.803,6,23,8878,14,411,3831,591,1958,9,1074,6223,2808,6920
5.003,17,4,834,2,44,4998,44,144,2,317,4998,317,690
8.737,6,4,240,4,0,0,0,240,0,0,0,0,0
0.901,6,12,1653,6,288,180,288,548,6,426,97,434,1105
1771.841,6,99,9240,66,65,27259,65,5577,33,59,55365,59,3663
368.358,6,18,1242,14,180,28335,180,916,4,110,20068,110,326
100.532,17,40,10360,40,231,2577,388,10360,0,0,0,0,0
0.14,17,4,624,2,64,138,64,184,2,192,26,192,440
0.47,6,18,3068,9,282,58,531,1606,9,493,43,828,1462
300.642,6,31,13080,16,780,20042,1408,6306,15,598,19033,3935,6774
1.437,6,15,2638,8,288,198,288,640,7,568,209,853,1998
1786.245,6,106,8524,68,66,26660,66,4964,38,60,48274,60,3560
0.24,6,26,7256,13,155,20,267,1301,13,603,19,2036,5955
280.38,6,27,7312,13,158,23365,267,1317,14,678,21564,3456,5995
280.548,6,30,7432,13,158,23379,267,1317,17,603,17531,2760,6115
280.566,6,25,7232,12,158,25506,267,1277,13,775,23375,3465,5955
22.944,6,28,7217,13,155,1912,267,1306,15,482,1638,1997,5911
1.079,6,4,220,3,0,78,0,180,1,0,0,0,40
368.986,6,27,1767,18,177,21705,177,1181,9,110,8662,110,586
0.053,6,7,423,4,43,5,43,259,3,0,26,0,164
102.231,6,29,10084,14,708,52,1360,3503,15,663,7293,2720,6581
0.158,17,2,154,1,33,0,33,61,1,65,0,65,93
40.448,6,45,9900,24,315,1758,721,3503,21,616,1679,1420,6397
2.624,6,54,13954,27,549,100,1429,4956,27,439,94,1986,8998
0.021,17,2,180,1,30,0,30,58,1,94,0,94,122
0.037,6,10,1794,6,613,7,1070,1471,4,159,11,159,323
300.795,6,49,13197,25,773,12533,1360,7280,24,309,664,2667,5917
1773.85,6,180,15480,120,69,14906,69,8940,60,69,30057,69,6540
1744.08,6,95,7203,63,38,28130,205,4476,32,33,56251,98,2727
1.068,17,4,708,2,36,1055,36,128,2,262,1044,262,580
1799.474,17,434,48973,191,152,9470,1350,34445,243,31,7434,60,14528
1782.79,17,86,3606,85,14,21223,14,3570,1,8,0,8,36
170.207,6,27,11134,14,537,480,1307,2261,13,1041,14170,1360,8873
64.489,6,30,7297,14,155,4960,267,1346,16,441,4298,1420,5951
0.02,17,2,136,1,32,0,32,60,1,48,0,48,76
1791.562,17,344,26144,344,48,5223,48,26144,0,0,0,0,0
1740.625,17,30,31561,30,1024,60021,1028,31561,0,0,0,0,0
1.363,6,52,22498,29,975,48,1440,16802,23,433,53,1440,5696
1.269,6,41,9968,21,440,63,1360,4392,20,433,57,1360,5576
0.411,6,3,120,1,0,0,0,40,2,0,399,0,80
8.037,6,32,14666,13,237,669,589,1670,19,923,443,1438,12996
0.65,6,21,5000,11,137,65,267,1132,10,692,61,1467,3868
20.1,6,18,2368,10,189,2233,517,1298,8,323,2870,499,1070
280.473,6,27,7312,12,158,25497,267,1277,15,678,20030,2085,6035
1796.94,17,142,11360,71,48,25670,48,5396,71,56,25670,56,5964
0.062,6,9,1345,5,145,15,145,349,4,832,14,832,996
7.337,6,6,260,2,0,19,0,84,4,0,2439,0,176
2.417,17,2,782,2,363,2417,363,782,0,0,0,0,0
81.417,6,40,8660,19,367,639,787,1942,21,391,4063,3488,6718
1713.593,1,8,448,8,28,244799,28,448,0,0,0,0,0
1.712,6,4,160,4,0,0,0,160,0,0,0,0,0
0.916,6,10,1687,7,100,152,100,384,3,1179,324,1179,1303
40.524,17,4,3964,4,963,13508,1451,3964,0,0,0,0,0
11.635,17,8,704,4,48,3873,48,304,4,72,3873,72,400
1682.657,17,14,1036,7,30,280434,30,406,7,62,280436,62,630
38.653,17,22,1672,22,48,1840,48,1672,0,0,0,0,0
2.976,17,3,1164,3,360,1488,360,1164,0,0,0,0,0
0.792,6,37,8232,19,241,44,619,1758,18,441,38,1360,6474
5.59,6,44,8369,22,227,266,314,4062,22,489,253,1179,4307
0.452,17,4,368,2,32,390,32,120,2,96,0,96,248
1.367,6,232,181251,138,1330,9,1420,173200,94,427,14,1420,8051
0.514,6,22,7345,13,334,42,663,2021,9,1209,60,1946,5324
17.361,17,35,6215,16,168,1155,1350,3148,19,133,962,1350,3067
1740.487,17,30,31680,30,1028,60016,1028,31680,0,0,0,0,0
0.006,6,4,208,1,0,0,0,64,3,0,0,0,144
1687.058,17,17,4236,17,221,105441,1072,4236,0,0,0,0,0
10.505,17,4,352,2,48,10474,48,152,2,72,10484,72,200
97.396,6,9,515,5,43,24349,43,299,4,0,32464,0,216
138.811,17,4,352,2,60,138810,60,176,2,60,138809,60,176
3.037,17,4,1556,4,361,1012,361,1556,0,0,0,0,0
31.435,17,8,1648,4,48,10473,48,304,4,308,10472,308,1344
33.749,6,32,5344,15,154,2410,722,1860,17,324,2095,1402,3484
3.192,6,2,88,2,0,0,0,88,0,0,0,0,0
261.262,17,8,2688,8,308,37323,308,2688,0,0,0,0,0
1773.361,6,180,15480,120,69,14902,69,8940,60,69,30055,69,6540
0.791,17,11,4616,5,432,197,1350,2302,6,357,125,1350,2314
87.033,6,28,9487,8,155,296,267,1106,20,473,4577,3457,8381
601.608,2,6,192,6,8,120321,8,192,0,0,0,0,0
3.936,17,5,295,5,31,984,31,295,0,0,0,0,0
1.842,17,23,6719,9,252,230,1350,2524,14,271,126,1350,4195
0.81,17,2,144,1,36,0,36,64,1,52,0,52,80
2.894,17,17,6101,8,389,406,1350,3342,9,278,355,1350,2759
349.789,17,10,880,5,48,87444,48,380,5,72,87443,72,500
2.533,6,29,6175,15,338,180,1314,2294,14,368,193,1420,3881
1740.246,6,87,6322,58,31,30530,31,3915,29,31,62151,31,2407
26.185,6,25,6488,12,158,2378,370,1275,13,669,2181,1691,5213
280.2,6,29,7392,14,158,21553,267,1357,15,678,20010,3436,6035
0.03,17,2,158,1,34,0,34,62,1,68,0,68,96
2.133,17,4,240,2,32,2132,32,120,2,32,2132,32,120
281.435,6,30,7432,13,158,23452,267,1317,17,543,17579,1400,6115
998.935,6,57,4130,32,31,32218,31,2160,25,31,41615,31,1970
0.379,6,13,1693,7,288,58,288,588,6,426,41,434,1105
1781.555,1,100,5600,100,28,17995,28,5600,0,0,0,0,0
4.241,17,5,290,5,30,1060,30,290,0,0,0,0,0
3.668,17,5,290,5,30,917,30,290,0,0,0,0,0
32.105,6,9,396,2,0,3481,0,88,7,0,5336,0,308
5.429,6,41,7349,21,218,271,314,3463,20,440,272,1152,3886
264.503,1,8,448,8,28,37786,28,448,0,0,0,0,0
35.742,6,1970,1709833,1228,1312,28,1368,1664637,742,776,47,2736,45196
149.397,6,34,16622,19,606,166,832,4429,15,1052,10661,2720,12193
97.79,6,8,1987,5,350,24447,413,1252,3,205,48790,269,735
7.117,6,30,7504,12,155,647,267,1266,18,393,418,1997,6238
98.451,17,4,1344,4,308,32817,308,1344,0,0,0,0,0
1.375,6,53,19623,29,902,49,1460,13842,24,400,51,1460,5781
58.437,6,25,7097,12,155,5312,267,1266,13,589,4869,3426,5831
280.566,6,30,7432,13,158,23380,267,1317,17,603,17532,2076,6115
1776.673,1,68,7208,68,78,26517,78,7208,0,0,0,0,0
85.707,17,4,304,4,48,28569,48,304,0,0,0,0,0
11.993,17,2,150,2,47,11993,47,150,0,0,0,0,0
1.83,6,10,5548,3,106,915,106,234,7,1005,275,1942,5314
0.0,6,1,116,1,64,0,64,116,0,0,0,0,0
51.349,1,4,224,4,28,17116,28,224,0,0,0,0,0
52.316,6,27,7177,13,155,4359,267,1306,14,530,4023,3417,5871
0.216,17,4,288,2,36,183,36,128,2,52,183,52,160
280.195,6,28,7352,13,158,23349,267,1317,15,678,20012,2800,6035
0.687,6,20,7654,11,692,57,1408,3348,9,638,71,1408,4306
0.221,6,9,1339,5,145,55,145,349,4,826,70,826,990
2.982,6,50,29988,30,790,102,1360,6787,20,2035,149,5440,23201
1744.116,6,97,7307,63,38,28130,205,4476,34,33,52842,98,2831
0.374,17,2,184,1,32,0,32,60,1,96,0,96,124
3.851,6,33,6145,17,206,240,314,2744,16,551,239,1179,3401
11.152,6,89,26213,44,550,259,1152,19931,45,447,246,1179,6282
1723.503,17,311,76345,311,217,5559,422,76345,0,0,0,0,0
19.544,17,43,14223,21,448,975,1350,10005,22,163,929,1350,4218
23.754,17,14,1064,14,48,1827,48,1064,0,0,0,0,0
1741.439,1,61,5124,61,56,29023,56,5124,0,0,0,0,0
0.01,17,2,337,1,48,0,48,76,1,233,0,233,261
174.903,17,3,1000,3,305,87451,308,1000,0,0,0,0,0
0.158,17,2,283,1,31,0,31,59,1,196,0,196,224
12.633,6,116,42338,61,651,210,1152,35656,55,447,229,1179,6682
15.879,6,10,560,6,0,3175,0,328,4,0,5285,0,232
1785.862,6,116,7106,60,26,30268,26,3574,56,25,32469,26,3532
1788.142,1,196,10976,196,28,9169,28,10976,0,0,0,0,0
0.493,17,3,451,2,39,290,39,134,1,289,0,289,317
0.331,6,16,6978,10,182,36,182,614,6,2037,34,4416,6364
51.742,6,529,246295,274,828,189,1152,230590,255,392,202,1152,15705
915.909,6,143,25080,66,259,14090,1360,11949,77,185,12049,1360,13131
128.387,17,12,960,6,48,25676,48,456,6,56,25675,56,504
1790.235,6,367,25788,211,99,8524,469,14925,156,69,11546,69,10863
3.674,6,34,6169,17,206,229,314,2744,17,456,213,1152,3425
127.345,17,4,352,2,60,127344,60,176,2,60,127344,60,176
0.394,6,2,111,1,0,0,0,40,1,31,0,31,71
1736.225,1,69,3864,69,28,25532,28,3864,0,0,0,0,0
11.309,6,86,26413,42,560,275,1152,20171,44,447,256,1179,6242
0.402,6,6,248,4,0,134,0,164,2,0,198,0,84
1.422,6,52,13890,25,551,59,1429,4892,27,416,51,1460,8998
0.247,6,23,4494,11,165,24,456,1394,12,493,21,888,3100
1752.184,6,97,7307,63,38,28261,205,4476,34,33,53085,98,2831
1793.12,17,441,59874,204,182,8833,1350,42949,237,43,7597,1350,16925
1795.758,6,127,12912,80,68,22731,722,6821,47,93,39029,1408,6091
0.091,17,2,152,1,48,0,48,76,1,48,0,48,76
2.768,6,6,1257,4,327,922,414,815,2,181,2581,270,442
1780.46,17,157,15509,157,70,11413,346,15509,0,0,0,0,0
1.394,6,39,9888,20,502,73,1460,4352,19,433,67,1460,5536
1786.483,6,128,17710,80,227,22613,1302,12287,48,87,38008,258,5423
11.465,6,1831,1586696,1100,1388,10,1414,1553211,731,467,15,1889,33485
0.301,6,25,6098,12,181,27,537,1526,13,555,23,1440,4572
9.621,6,20,2590,11,210,962,210,1036,9,545,1199,904,1554
1140.123,2,10,320,10,8,126680,8,320,0,0,0,0,0
26.476,17,16,1408,8,48,3781,48,608,8,72,3780,72,800
1740.507,6,146,15656,81,72,21756,721,6575,65,161,27191,2840,9081
122.199,17,4,1635,4,380,40733,392,1635,0,0,0,0,0
31.397,6,7,336,1,0,0,0,48,6,0,6278,0,288
2.94,17,3,468,3,128,1470,128,468,0,0,0,0,0
38.676,6,46,9855,26,132,1547,356,2400,20,511,1709,1460,7455
8.79,6,46,8465,24,227,382,314,4142,22,491,406,1179,4323
0.09,17,4,588,2,48,77,48,152,2,190,77,308,436
224.168,17,4,352,2,60,224167,60,176,2,60,224167,60,176
0.066,17,2,1358,2,651,66,651,1358,0,0,0,0,0
0.008,17,2,411,1,39,0,39,67,1,316,0,316,344
251.986,2,2,64,2,8,251986,8,64,0,0,0,0,0
9.97,17,37,8187,11,231,996,1350,2850,26,177,397,1350,5337
1.085,6,27,8951,13,232,90,567,1612,14,825,79,1438,7339
0.35,6,2,171,1,0,0,0,40,1,91,0,91,131
960.75,6,113,15000,56,119,17468,721,6683,57,262,16563,1440,8317
6.883,6,1736,1695030,1159,1388,5,1408,1660362,577,931,11,2801,34668
1771.752,6,265,32542,108,134,16557,1360,15555,157,137,11356,4662,16987
1.682,6,14,2351,8,188,240,245,700,6,703,285,1152,1651
0.026,17,2,198,1,39,0,39,67,1,103,0,103,131
2.427,6,57,23788,30,977,83,1360,17856,27,433,84,1360,5932
0.01,6,10,2025,6,729,2,1301,1702,4,159,3,159,323
1792.776,6,141,21794,79,85,22984,721,7959,62,493,12663,2535,13835
281.414,6,30,7432,13,158,23451,267,1317,17,543,17569,1400,6115
0.398,6,81,57283,50,1275,8,1432,51752,31,475,12,1871,5531
145.518,6,25,9968,12,549,67,1440,2709,13,961,12115,1440,7259
1787.871,6,102,8296,68,65,26684,65,4930,34,59,54175,59,3366
3.326,6,56,20688,30,897,114,1460,14705,26,409,116,1460,5983
10.029,17,4,5476,4,1341,3343,1346,5476,0,0,0,0,0
1.224,6,49,19393,27,901,47,1360,13737,22,476,50,2715,5656
300.521,6,20,1391,10,177,33372,177,765,10,110,33372,110,626
0.228,6,46,20780,26,1049,9,1420,15759,20,467,11,1883,5021
280.046,1,4,224,4,28,93348,28,224,0,0,0,0,0
33.557,6,27,4887,14,180,2581,722,1807,13,480,2780,1440,3080
0.756,17,4,768,2,39,746,39,134,2,289,746,289,634
0.588,6,10,1866,6,649,111,1142,1543,4,159,192,159,323
1.109,6,32,12162,17,525,69,1360,3350,15,820,64,1379,8812
0.85,6,10,1687,7,100,141,100,384,3,1179,302,1179,1303
1793.776,6,240,35580,150,302,12038,302,25920,90,83,20154,83,9660
191.28,6,9,490,7,106,31880,106,394,2,0,1035,0,96
79.716,6,628,312329,352,829,227,1152,299325,276,390,288,1152,13004
0.59,6,132,84114,69,1284,8,1420,77291,63,475,9,1883,6823
1741.234,1,56,4704,56,56,31658,56,4704,0,0,0,0,0
0.013,17,2,290,1,40,0,40,68,1,194,0,194,222
1771.735,1,59,4956,0,0,0,0,0,59,56,30547,56,4956
240.198,6,69,23406,36,747,6862,1408,18370,33,295,7506,778,5036
0.36,6,26,9034,13,257,30,667,1715,13,947,29,1408,7319
1.335,6,14,4945,7,125,221,125,497,7,1019,222,1448,4448
0.293,6,7,466,5,43,64,43,354,2,0,289,0,112
361.029,2,4,128,4,8,120343,8,128,0,0,0,0,0
0.03,17,2,128,1,36,0,36,64,1,36,0,36,64
1783.313,17,79,3312,78,14,23159,14,3276,1,8,0,8,36
39.985,17,44,6468,22,48,1903,48,1672,22,190,1903,308,4796
0.105,17,2,624,1,64,0,64,92,1,504,0,504,532
0.002,6,2,162,1,82,0,82,122,1,0,0,0,40
8.105,6,1866,1738893,1191,1382,6,1408,1699129,675,931,11,2816,39764
172.219,6,25,10133,12,531,58,1360,2681,13,988,14340,1360,7452
300.553,6,18,1227,6,177,60075,177,497,12,110,27306,110,730
7.197,6,14,2296,9,152,899,267,822,5,635,1723,1179,1474
1.498,6,51,19949,28,873,55,1360,14253,23,433,59,1360,5696
0.431,6,14,1733,7,288,68,288,588,7,426,39,434,1145
1773.143,6,180,15480,120,69,14900,69,8940,60,69,30052,69,6540
4.597,6,26,7753,13,214,366,721,1811,13,903,369,2840,5942
1755.851,6,242,35700,151,302,11705,302,25980,91,83,19509,83,9720
1.808,6,29,15577,15,144,129,256,1365,14,1225,133,2322,14212
91.877,6,25,2500,10,180,168,180,1260,15,110,6550,110,1240
7.239,6,1649,1539127,1054,1383,6,1408,1503523,595,931,11,2816,35604
0.023,6,11,572,0,0,0,0,0,11,0,0,0,572
1788.809,6,358,22669,209,69,8600,69,12500,149,69,12086,69,10169
27.541,6,15,2294,9,210,3440,210,896,6,545,5508,904,1398
9.964,6,16,3911,9,275,1245,275,643,7,992,833,1440,3268
1.902,6,27,10105,16,288,126,598,1510,11,1018,172,1452,8595
1586.972,1,8,448,8,28,226710,28,448,0,0,0,0,0
1745.645,6,95,7203,63,38,28155,205,4476,32,33,56302,98,2727
7.538,17,3,228,3,48,3769,48,228,0,0,0,0,0
2.014,17,6,1212,4,40,671,41,274,2,441,5,441,938
11.8,17,17,17220,17,984,737,1450,17220,0,0,0,0,0
17.474,17,35,19178,16,757,1162,1350,12564,19,320,968,1350,6614
1773.031,6,180,15480,120,69,14899,69,8940,60,69,30043,69,6540
2.141,17,4,1568,4,364,713,364,1568,0,0,0,0,0
61.8,6,77,49915,45,1186,1404,1408,41517,32,747,1986,1408,8398
1796.717,6,358,22669,209,69,8638,69,12569,149,69,12139,69,10100
0.041,6,2,100,1,0,0,0,40,1,0,0,0,60
2.074,1,2,112,2,28,2074,28,112,0,0,0,0,0
1.735,6,19,3781,10,234,192,564,1452,9,463,191,1343,2329
0.012,17,2,389,1,44,0,44,72,1,289,0,289,317
1738.857,6,88,6417,58,31,30506,31,3927,30,31,59959,31,2490
371.955,6,25,1651,17,177,23247,177,1117,8,110,9223,110,534
0.2,17,2,198,1,63,0,63,91,1,79,0,79,107
1.241,17,2,154,1,33,0,33,61,1,65,0,65,93
1750.539,17,12,498,11,14,175053,14,462,1,8,0,8,36
0.034,17,2,259,1,53,0,53,81,1,150,0,150,178
373.892,6,27,1767,18,177,21993,177,1181,9,110,8874,110,586
11.018,6,18,5610,10,275,1224,275,958,8,1440,858,1440,4652
23.942,6,19,5816,10,267,2660,502,1206,9,707,2981,1420,4610
1790.668,6,363,24345,212,88,8486,469,14027,151,69,11937,69,10318
1655.633,6,43,8213,25,349,68984,995,5572,18,160,97360,510,2641
0.19,6,41,15989,23,918,8,1420,11048,18,420,10,1420,4941
0.024,17,2,410,1,46,0,46,74,1,308,0,308,336
0.172,17,6,1841,6,278,34,316,1841,0,0,0,0,0
0.285,6,2,92,1,0,0,0,52,1,0,0,0,40
1196.215,17,224,17024,224,48,5364,48,17024,0,0,0,0,0
1772.702,6,180,15480,120,69,14896,69,8940,60,69,30038,69,6540
1594.758,6,97,13766,58,95,27978,721,6527,39,405,10085,2880,7239
280.225,6,28,7352,13,158,23352,267,1317,15,678,20011,2800,6035
1743.253,6,95,7203,63,38,28116,205,4476,32,33,56222,98,2727
6.15,6,47,8489,24,227,267,314,4142,23,427,268,1152,4347
0.82,6,13,1693,7,288,133,288,588,6,426,80,434,1105
240.171,6,54,17511,29,771,8577,1402,14627,25,197,10006,580,2884
1682.065,17,14,1036,7,30,280338,30,406,7,62,280335,62,630
1.66,17,3,1167,3,361,830,361,1167,0,0,0,0,0
13.686,6,27,4868,13,154,1122,722,1768,14,394,1039,1440,3100
375.895,6,25,1654,17,180,23493,180,1120,8,110,9160,110,534
1.997,1,3,252,3,56,998,56,252,0,0,0,0,0
125.671,2,2,64,2,8,125671,8,64,0,0,0,0,0
3.34,17,5,290,5,30,835,30,290,0,0,0,0,0
1787.909,6,464,26973,253,69,7094,69,14329,211,34,8513,64,12644
12.61,6,4,176,3,0,6305,0,128,1,0,0,0,48
1083.256,17,212,16112,212,48,5133,48,16112,0,0,0,0,0
1793.392,17,142,11360,71,48,25619,48,5396,71,56,25619,56,5964
0.019,17,2,206,1,44,0,44,72,1,106,0,106,134
1782.24,17,75,3141,73,13,24753,14,3061,2,12,530574,16,80
1796.284,17,448,39896,403,35,4468,288,25676,45,288,40020,288,14220
0.017,6,14,4919,7,100,2,100,472,7,1018,2,1448,4447
0.045,17,4,284,2,32,29,32,120,2,54,18,60,164
245.657,17,4,352,2,60,245655,60,176,2,60,245655,60,176
160.652,17,122,31659,122,231,1327,389,31659,0,0,0,0,0
0.284,17,2,167,1,39,0,39,67,1,72,0,72,100
1.263,6,52,21598,29,919,45,1360,15902,23,433,49,1360,5696
15.524,17,20,10875,11,642,1545,1350,7370,9,361,1931,1350,3505
0.03,17,4,420,2,33,0,33,122,2,121,17,145,298
6.379,6,13,7632,7,275,1063,275,559,6,1707,629,2828,7073
154.458,17,4,240,2,32,154457,32,120,2,32,154457,32,120
541.508,2,7,224,7,8,90251,8,224,0,0,0,0,0
0.034,17,2,144,1,36,0,36,64,1,52,0,52,80
10.861,17,15,17714,15,1152,775,1451,17714,0,0,0,0,0
109.954,6,21,9221,11,514,88,1236,2014,10,1132,12195,2720,7207
1.263,6,49,21107,28,955,46,1360,15491,21,433,54,1360,5616
5.856,17,73,89373,71,1229,54,1472,89293,2,12,5011,12,80
1786.168,17,87,3648,86,14,21013,14,3612,1,8,0,8,36
1780.636,1,342,28728,342,56,5221,56,28728,0,0,0,0,0
14.135,6,20,2617,12,211,1284,211,1114,8,545,2017,904,1503
6.347,6,1309,1268433,873,1382,7,1408,1241097,436,931,14,2801,27336
1786.924,6,356,22520,208,69,8632,69,12460,148,69,12153,69,10060
24.244,6,22,4567,10,256,2693,722,1540,12,342,2183,1408,3027
128.165,17,4,1328,4,304,42721,308,1328,0,0,0,0,0
0.641,6,14,2598,7,288,90,288,600,7,568,76,853,1998
7.896,6,31,8215,14,236,607,721,1980,17,555,475,1440,6235
16.213,17,23,11506,11,606,1618,1350,6976,12,349,1471,1350,4530
0.782,17,4,334,2,39,734,39,134,2,72,488,72,200
4.101,6,37,6289,19,187,227,314,2824,18,456,226,1152,3465
1.427,6,47,18555,26,912,57,1460,12939,21,433,61,1460,5616
4.031,6,38,7229,19,218,223,314,3383,19,440,210,1152,3846
1.371,6,50,18991,27,870,52,1360,13295,23,433,54,1360,5696
4.924,6,39,7269,19,218,273,314,3383,20,513,244,1179,3886
8.205,6,28,7217,13,155,683,267,1306,15,482,585,2840,5911
0.509,17,3,451,2,39,283,39,134,1,289,0,289,317
73.992,6,25,11118,12,433,74,990,1823,13,973,6153,1440,9295
1788.514,6,362,24774,211,94,8516,469,14387,151,69,11921,69,10387
0.113,6,10,1495,5,507,28,507,727,5,556,28,556,768
1.692,6,47,18714,27,859,65,1360,13138,20,476,77,2715,5576
1776.084,17,73,3060,72,14,25015,14,3024,1,8,0,8,36
299.884,1,4,326,4,53,99961,78,326,0,0,0,0,0
1.062,6,22,7900,11,164,90,267,1236,11,1216,90,3819,6664
1799.385,6,356,22520,208,69,8692,69,12460,148,69,12240,69,10060
248.356,6,14,5631,4,112,82781,112,280,10,706,27594,1420,5351
233.791,17,4,352,2,60,233789,60,176,2,60,233790,60,176
1.207,6,26,8108,13,164,85,267,1340,13,869,86,1408,6768
16.718,17,22,10942,10,394,1846,1350,4225,12,531,1513,1350,6717
7.442,6,8,448,4,0,2423,0,240,4,0,2423,0,208
28.161,17,39,12709,14,444,2163,1350,6618,25,215,1171,1350,6091
48.557,6,42,8572,20,311,649,619,1814,22,391,2306,2720,6758
0.35,17,4,560,2,64,319,64,184,2,160,289,160,376
133.081,1,2,257,2,100,133081,125,257,0,0,0,0,0
10.902,6,20,4390,11,275,1090,275,998,9,755,768,1414,3392
0.048,6,3,136,2,0,48,0,88,1,0,0,0,48
1796.695,1,342,28728,342,56,5268,56,28728,0,0,0,0,0
231.319,17,4,240,2,32,231318,32,120,2,32,231318,32,120
0.152,6,45,21484,26,1029,6,1420,16503,19,467,7,1883,4981
1740.5,17,30,31650,30,1027,60017,1027,31650,0,0,0,0,0
52.127,6,13,808,6,41,10397,46,405,7,41,8687,46,403
9.243,6,73,26717,36,935,264,1440,15616,37,457,240,1440,11101
5.76,6,40,7309,21,218,288,314,3463,19,513,305,1179,3846
15.171,6,5,706,3,46,7585,46,166,2,460,15024,460,540
64.715,1,4,224,4,28,21571,28,224,0,0,0,0,0
5.471,6,6,387,2,131,5226,131,215,4,0,1742,0,172
0.044,6,3,697,1,0,0,0,40,2,577,44,577,657
4.691,6,38,7229,20,218,246,314,3423,18,513,259,1179,3806
0.31,6,38,31476,18,183,18,230,1505,20,1606,12,7010,29971
0.066,17,2,234,1,33,0,33,61,1,145,0,145,173
182.284,17,5,1694,5,310,45571,318,1694,0,0,0,0,0
1741.183,6,87,6322,58,31,30547,31,3915,29,31,62184,31,2407
1.435,6,41,11973,22,613,68,1460,6437,19,433,68,1460,5536
1.745,6,38,8254,19,321,96,1164,2718,19,433,83,1440,5536
0.978,6,28,8496,15,222,62,540,2000,13,994,66,2720,6496
1783.488,6,194,21071,127,109,14154,965,12088,67,94,27018,917,8983
1.673,6,13,2311,8,188,239,245,700,5,1407,353,1407,1611
1.199,6,11,3618,6,125,237,125,445,5,1452,290,2740,3173
1792.691,17,140,11200,70,48,25980,48,5320,70,56,25980,56,5880
1798.333,17,138,11040,69,48,26446,48,5244,69,56,26446,56,5796
2.022,17,4,276,3,33,1000,33,183,1,65,0,65,93
0.0,1,1,36,1,8,0,8,36,0,0,0,0,0
0.511,6,118,87559,53,131,9,232,2649,65,1395,7,2860,84910
0.266,6,23,4494,11,165,26,456,1394,12,493,23,888,3100
302.354,6,60,31702,31,190,10078,444,2405,29,1157,8608,1438,29297
317.912,6,23,1547,15,177,22708,177,1013,8,110,9455,110,534
1263.36,2,14,448,14,8,97181,8,448,0,0,0,0,0
127.359,6,8,474,2,106,127350,106,194,6,0,25470,0,280
35.673,17,6,1236,3,48,17745,48,228,3,308,17682,308,1008
0.008,17,2,278,1,36,0,36,64,1,186,0,186,214
10.122,6,19,7650,10,283,1124,721,1820,9,1366,1228,2840,5830
483.914,6,106,18471,50,139,9870,721,6474,56,406,8793,1440,11997
1.554,6,44,19145,27,894,59,1360,13689,17,529,84,4075,5456
24.004,17,4,352,2,60,24003,60,176,2,60,24002,60,176
1682.799,17,14,1036,7,30,280455,30,406,7,62,280460,62,630
6.103,17,4,304,2,48,6083,48,152,2,48,6086,48,152
1.414,6,25,8056,12,164,108,267,1288,13,1014,101,2736,6768
5.2,17,4,288,2,36,5006,36,128,2,52,4998,52,160
3.197,6,6,336,3,0,1531,0,180,3,0,1531,0,156
7.69,6,1213,1098133,756,1375,9,1408,1069705,457,931,16,2801,28428
0.853,6,10,1687,7,100,142,100,384,3,1179,293,1179,1303
2.741,6,10,1102,6,483,548,483,803,4,83,911,83,299
3.067,17,4,304,2,48,3060,48,152,2,48,3060,48,152
0.027,17,2,152,1,48,0,48,76,1,48,0,48,76
5.13,6,39,7269,19,218,285,314,3383,20,513,253,1179,3886
240.285,6,37,7901,18,519,14133,1418,4579,19,332,13348,1050,3322
1785.859,6,365,24963,212,94,8463,469,14496,153,69,11749,69,10467
1741.739,6,87,6322,58,31,30556,31,3915,29,31,62204,31,2407
1741.682,1,67,5628,67,56,26389,56,5628,0,0,0,0,0
36.36,6,11,808,2,31,13,31,135,9,31,4545,31,673
1789.724,6,355,22480,207,69,8687,69,12420,148,69,12174,69,10060
0.04,6,10,1512,5,503,9,503,771,5,473,10,473,741
0.114,6,10,767,5,186,28,186,454,5,45,14,45,313
300.213,6,29,11718,17,592,18763,1408,4448,12,1106,21836,2816,7270
1740.483,17,29,19517,29,645,62160,645,19517,0,0,0,0,0
3.016,1,3,318,3,78,1508,78,318,0,0,0,0,0
240.241,6,54,17618,29,774,8579,1408,14684,25,203,10009,580,2934
125.912,17,2,672,2,308,125912,308,672,0,0,0,0,0
1785.631,6,104,8504,69,66,26259,66,5004,35,60,52508,60,3500
1766.602,6,98,7421,65,38,27603,205,4611,33,33,55200,98,2810
1791.619,17,138,11040,69,48,26347,48,5244,69,56,26347,56,5796
0.013,17,2,220,1,34,0,34,62,1,130,0,130,158
1741.035,6,89,6426,58,31,30544,31,3915,31,31,58032,31,2511
1.366,6,41,11378,21,616,68,1460,5802,20,433,61,1460,5576
263.47,6,35,5701,20,142,13866,516,1945,15,314,17344,1452,3756
85.38,6,25,7248,6,154,17076,267,712,19,412,4742,1420,6536
61.749,6,11,875,5,177,15437,177,445,6,110,12243,110,430
106.744,17,8,2688,8,308,15249,308,2688,0,0,0,0,0
6.734,6,4,208,2,0,6733,0,104,2,0,8,0,104
130.776,17,4,352,2,60,130775,60,176,2,60,130775,60,176
300.863,6,43,12655,24,863,13081,1460,7048,19,371,481,1460,5607
1743.344,6,95,6910,62,31,28579,31,4247,33,31,54478,31,2663
1796.987,1,294,31164,294,78,6133,78,31164,0,0,0,0,0
146.656,6,22,10202,12,433,74,990,1823,10,1327,16280,3928,8379
0.288,17,4,352,2,60,287,60,176,2,60,287,60,176
1.262,6,47,17593,26,838,50,1360,11977,21,476,54,2715,5616
1764.67,2,15,480,15,8,126047,8,480,0,0,0,0,0
1798.849,1,283,29998,283,78,6378,78,29998,0,0,0,0,0
280.204,6,30,7432,13,158,23350,267,1317,17,543,17511,1400,6115
1086.38,17,13,6004,13,433,90531,1438,6004,0,0,0,0,0
41.127,17,3,2906,3,940,20563,1451,2906,0,0,0,0,0
291.146,17,4,352,2,60,291145,60,176,2,60,291144,60,176
26.1,6,3579,3246339,2172,1408,11,1448,3163307,1407,776,18,1448,83032
992.466,6,78,8748,42,77,24202,722,3816,36,122,28351,1408,4932
4.839,6,39,7269,19,218,268,314,3383,20,513,240,1179,3886
1794.299,1,208,11648,208,28,8668,28,11648,0,0,0,0,0
0.549,17,2,152,1,48,0,48,76,1,48,0,48,76
1774.741,6,181,15589,121,69,14789,69,9049,60,69,30076,69,6540
1798.556,17,448,39896,403,35,4474,288,25676,45,288,40020,288,14220
0.524,6,22,7345,13,334,43,663,2021,9,1209,60,1946,5324
1700.519,17,12,498,11,14,170051,14,462,1,8,0,8,36
39.231,6,13,892,4,92,13004,92,308,9,92,4881,92,584
0.005,17,2,306,1,36,0,36,64,1,214,0,214,242
3.382,17,4,240,2,32,3381,32,120,2,32,3381,32,120
36.944,17,42,6056,21,48,1846,48,1596,21,184,1846,308,4460
4.482,6,39,7269,20,218,235,314,3423,19,513,235,1179,3846
280.272,6,30,7432,13,158,23356,267,1317,17,543,17512,1300,6115
22.637,6,662,742489,306,636,74,1368,21023,356,2008,63,8208,721466
1.913,17,2,672,2,308,1913,308,672,0,0,0,0,0
0.758,6,3,184,1,0,0,0,40,2,64,631,64,144
173.724,6,1607,809960,890,843,195,1152,774086,717,399,242,1179,35874
1772.003,6,206,22617,131,75,13630,267,10097,75,133,23944,3417,12520
2.412,6,24,8004,12,164,204,267,1288,12,1216,204,3819,6716
4.188,6,39,7269,19,218,232,314,3383,20,440,206,1152,3886
0.035,17,4,1148,2,32,30,32,120,2,486,30,486,1028
63.462,6,25,11358,12,433,90,990,1823,13,1000,5273,1360,9535
1.037,2,2,80,2,16,1037,16,80,0,0,0,0,0
68.864,6,54,15001,22,326,1252,469,4480,32,401,2221,1420,10521
15.231,17,22,15846,13,911,1266,1350,12211,9,375,1899,1350,3635
0.039,17,6,462,3,33,4,33,183,3,65,7,65,279
1740.284,6,87,6322,58,31,30531,31,3915,29,31,62151,31,2407
0.019,17,2,251,1,31,0,31,59,1,164,0,164,192
1.875,6,12,1304,6,256,371,256,756,6,304,371,304,548
0.098,17,2,349,1,36,0,36,64,1,257,0,257,285
1.297,6,48,18800,27,862,49,1360,13184,21,476,56,2715,5616
0.378,6,8,335,4,0,126,0,164,4,7,61,7,171
0.281,17,15,8339,8,705,40,1350,5871,7,324,37,1350,2468
0.004,17,2,394,1,37,0,37,65,1,301,0,301,329
125.376,17,8,2688,8,308,17910,308,2688,0,0,0,0,0
1.35,6,89,70347,56,351,24,351,3646,33,2240,41,7040,66701
0.596,6,21,7260,13,325,49,626,1996,8,968,80,1475,5264
0.003,6,2,214,1,134,0,134,174,1,0,0,0,40
241.049,6,30,4406,18,483,14179,483,3359,12,83,21908,83,1047
1722.531,1,12,1312,12,81,156593,88,1312,0,0,0,0,0
240.236,6,56,17986,28,748,8897,1402,14945,28,197,8897,580,3041
1786.103,6,1904,1780971,633,135,2826,387,39156,1271,1399,1406,2836,1741815
1679.753,17,12,498,11,14,167975,14,462,1,8,0,8,36
504.408,2,4,128,4,8,168136,8,128,0,0,0,0,0
1744.053,6,95,7203,63,38,28129,205,4476,32,33,56250,98,2727
1749.837,6,96,7286,63,38,28223,205,4476,33,33,54674,98,2810
1755.528,6,200,19533,104,81,17043,721,9137,96,159,18476,1414,10396
12.081,6,90,42772,51,1274,241,1460,32762,39,366,279,1460,10010
152.562,17,14971,14622597,4500,40,33,1350,307085,10471,1339,14,1350,14315512
130.737,6,20,3484,7,92,21789,92,452,13,235,10857,1408,3032
0.063,17,4,304,2,37,0,37,130,2,59,10,65,174
196.151,6,30,7773,13,158,16345,267,1317,17,524,12258,1400,6456
1769.917,1,68,5712,68,56,26416,56,5712,0,0,0,0,0
9.871,6,32,9333,13,155,822,267,1306,19,483,547,1997,8027
0.197,6,10,1669,6,551,39,947,1346,4,159,63,159,323
275.826,17,4,352,2,60,275824,60,176,2,60,275825,60,176
6.345,6,31,6255,16,338,423,1314,2334,15,331,451,1460,3921
64.793,6,12,976,4,226,118,226,442,8,110,9231,110,534
296.421,6,35,7087,16,262,19758,517,1628,19,744,16465,1418,5459
1788.061,6,361,22858,210,69,8555,69,12678,151,69,11920,69,10180
1794.047,6,373,23821,215,69,8383,69,12878,158,69,11427,69,10943
159.057,17,6,456,3,48,79522,48,228,3,48,79522,48,228
0.398,17,8,2750,8,315,56,354,2750,0,0,0,0,0
1607.013,17,75,3144,74,14,22013,14,3108,1,8,0,8,36
807.288,17,10,2578,5,31,201818,37,297,5,428,201819,463,2281
1787.061,6,104,8444,68,66,26672,66,4964,36,60,51055,60,3480
2.427,17,2,154,1,33,0,33,61,1,65,0,65,93
31.617,6,7,308,1,0,0,0,44,6,0,6300,0,264
1799.267,17,447,39580,403,35,4475,288,25676,44,288,40952,288,13904
1260.031,2,10,320,10,8,140003,8,320,0,0,0,0,0
1796.595,6,416,24920,208,69,8679,69,12460,208,34,8679,48,12460
0.84,6,50,13789,24,551,36,1429,4840,26,438,32,1460,8949
1720.18,1,35,4964,35,113,50593,335,4964,0,0,0,0,0
178.142,6,62,39202,38,1169,4814,1408,31212,24,841,2674,2439,7990
304.046,17,10,3360,10,308,33782,308,3360,0,0,0,0,0
41.763,6,29,7257,14,155,3212,267,1346,15,482,2982,2840,5911
0.931,6,10,1687,7,100,155,100,384,3,1179,335,1179,1303
8.265,6,21,6506,6,154,1653,267,712,15,518,567,1452,5794
280.217,6,28,7352,12,158,25474,267,1277,16,603,18678,1400,6075
82.826,6,745,366034,417,822,199,1152,348123,328,435,252,1179,17911
4.743,2,2,64,2,8,4743,8,64,0,0,0,0,0
15.167,6,14,2185,8,324,2166,585,1073,6,396,3021,580,1112
1771.178,6,105,9552,66,65,27248,65,5577,39,59,46607,59,3975
60.982,6,45,10209,21,533,440,910,3043,24,344,2645,1460,7166
1783.819,6,371,25810,215,99,8335,469,15154,156,69,11508,69,10656
202.205,6,37,7449,17,140,12637,501,1810,20,302,10571,1420,5639
1758.987,6,105,6270,60,27,29813,27,3525,45,27,39970,27,2745
3.282,6,6,360,2,0,1071,0,120,4,0,1033,0,240
1798.18,6,356,22520,208,69,8686,69,12460,148,69,12232,69,10060
377.321,2,3,96,3,8,188660,8,96,0,0,0,0,0
1772.069,6,180,15480,120,69,14891,69,8940,60,69,30033,69,6540
138.302,17,4,352,2,60,138301,60,176,2,60,138301,60,176
2.57,6,2,80,1,0,0,0,40,1,0,0,0,40
1797.444,2,22,704,22,8,85592,8,704,0,0,0,0,0
1202.906,2,11,352,11,8,120290,8,352,0,0,0,0,0
203.236,17,4,352,2,60,203235,60,176,2,60,203235,60,176
1.059,6,25,8044,13,164,88,267,1328,12,869,78,1408,6716
12.279,6,40,7602,20,224,646,314,3716,20,513,632,1179,3886
1.228,6,50,19179,27,883,47,1360,13483,23,476,48,2715,5696
1788.782,6,356,22589,207,69,8683,69,12420,149,69,12086,69,10169
1772.68,6,180,15480,120,69,14896,69,8940,60,69,30039,69,6540
7.743,6,25,6772,8,154,1106,267,800,17,479,470,1460,5972
1795.929,17,449,39928,404,35,4456,288,25708,45,288,40025,288,14220
0.481,17,4,352,2,60,480,60,176,2,60,479,60,176
1739.891,1,15,840,15,28,124277,28,840,0,0,0,0,0
5.386,6,39,7269,20,218,283,314,3423,19,513,285,1179,3846
64.807,6,37,11133,13,155,125,267,1306,24,442,2815,2077,9827
0.921,6,2,1175,1,0,0,0,40,1,1095,0,1095,1135
0.007,17,2,162,1,36,0,36,64,1,70,0,70,98
0.473,6,25,7455,16,302,31,693,2761,9,721,57,1420,4694
1796.324,6,360,22818,209,69,8636,69,12569,151,69,11975,69,10249
0.053,17,2,187,1,43,0,43,71,1,88,0,88,116
1.403,6,50,18900,27,863,53,1360,13204,23,433,55,1360,5696
1799.371,1,56,4704,56,56,32715,56,4704,0,0,0,0,0
1702.237,17,12,498,11,14,170223,14,462,1,8,0,8,36
1793.823,6,134,12813,82,94,22145,205,8508,52,33,35165,98,4305
1782.892,17,142,11360,71,48,25469,48,5396,71,56,25469,56,5964
1797.752,6,363,33045,207,102,8726,469,15695,156,150,11598,1942,17350
1720.441,17,12,498,11,14,172044,14,462,1,8,0,8,36
25.23,17,24,12010,10,356,2799,1350,3840,14,555,1938,1350,8170
628.406,1,38,2128,38,28,16983,28,2128,0,0,0,0,0
139.945,6,1015,496676,544,843,257,1152,472315,471,394,297,1152,24361
11.804,6,1885,1606303,1133,1363,10,1380,1569770,752,558,15,1923,36533
211.38,17,3,1008,3,308,105690,308,1008,0,0,0,0,0
0.949,6,10,1687,7,100,158,100,384,3,1179,342,1179,1303
22.06,17,28,14326,15,761,1573,1350,11847,13,162,1835,1350,2479
1779.219,17,141,11276,71,48,25417,48,5396,70,56,25785,56,5880
15.965,6,1889,1690305,1187,1370,13,1380,1656695,702,421,22,1923,33610
185.627,6,37,10886,20,394,9763,1275,3811,17,619,11591,5337,7075
215.42,6,1920,978174,1080,840,199,1152,935659,840,387,256,1179,42515
1769.633,6,102,9473,67,65,26812,65,5694,35,59,52044,59,3779
1770.011,6,99,9306,66,66,27230,66,5610,33,60,55310,60,3696
2.122,6,25,8793,15,290,151,602,1474,10,987,211,1452,7319
1778.365,6,27,4077,18,241,104609,241,2889,9,92,222273,92,1188
1798.511,17,448,39896,403,35,4473,288,25676,45,288,40019,288,14220
1791.021,6,354,22440,206,69,8736,69,12380,148,69,12183,69,10060
0.015,17,2,182,1,39,0,39,67,1,87,0,87,115
2.958,6,2,88,2,0,0,0,88,0,0,0,0,0
160.467,6,30,15774,17,972,52,1360,8489,13,1125,13357,2720,7285
1729.246,6,63,4601,41,33,43231,33,2825,22,31,82333,31,1776
1787.199,17,87,3648,86,14,21025,14,3612,1,8,0,8,36
0.279,6,3,258,2,69,279,69,149,1,69,0,69,109
0.093,6,9,1002,5,213,23,213,417,4,421,26,421,585
1777.943,1,206,11536,206,28,8672,28,11536,0,0,0,0,0
2.435,6,13,2311,8,188,347,245,700,5,1407,546,1407,1611
317.03,6,80,19518,36,376,9058,1460,9763,44,266,7369,1629,9755
0.132,6,3,128,2,0,132,0,84,1,0,0,0,44
1797.036,17,144,11520,72,48,25310,48,5472,72,56,25310,56,6048
0.537,6,14,1745,7,288,61,288,600,7,426,60,434,1145
241.753,6,47,9353,24,525,10510,1418,5993,23,215,10988,618,3360
143.469,6,30,7432,13,158,11955,267,1317,17,543,8964,1400,6115
27.627,6,17,13653,4,155,9153,185,491,13,1403,2288,2235,13162
24.395,17,4,240,2,32,24394,32,120,2,32,24394,32,120
1682.415,17,14,1045,7,30,280399,30,406,7,63,280317,71,639
6.795,6,46,8449,23,227,308,314,4102,23,489,296,1179,4347
310.249,6,20,1443,11,31,31024,31,727,9,31,26915,31,716
114.601,6,798,385392,428,839,268,1152,365460,370,427,308,1179,19932
1.61,6,52,19430,29,891,57,1360,13689,23,400,63,1360,5741
1740.659,6,87,6322,58,31,30537,31,3915,29,31,62166,31,2407
1795.535,17,448,40180,402,35,4477,288,25644,46,288,39128,288,14536
1736.332,2,25,800,25,8,72347,8,800,0,0,0,0,0
1747.872,6,95,7203,63,38,28191,205,4476,32,33,56369,98,2727
1787.066,6,104,8376,68,65,26672,65,4930,36,59,51047,59,3446
1791.014,17,142,11360,71,48,25585,48,5396,71,56,25585,56,5964
0.005,17,2,390,1,46,0,46,74,1,288,0,288,316
62.585,6,10,7069,0,0,0,0,0,10,729,6953,729,7069
4.254,6,727,595293,422,1372,10,1420,578428,305,467,13,1883,16865
0.143,17,4,284,2,32,52,32,120,2,54,94,60,164
1786.206,17,87,3648,86,14,21014,14,3612,1,8,0,8,36
1794.618,17,303,50658,303,139,5942,385,50658,0,0,0,0,0
17.516,17,23,12204,12,549,1589,1350,6928,11,451,1747,1350,5276
2.803,17,4,296,3,30,1361,30,174,1,94,0,94,122
1799.906,6,366,24603,213,87,8490,469,14136,153,69,11840,69,10467
1779.811,6,109,9061,68,52,26564,205,5276,41,40,44484,131,3785
1786.852,17,142,11360,71,48,25526,48,5396,71,56,25526,56,5964
1092.265,6,93,10047,53,81,21005,722,4707,40,98,27999,1408,5340
1792.873,1,220,12320,220,28,8186,28,12320,0,0,0,0,0
1773.101,6,180,15480,120,69,14900,69,8940,60,69,30052,69,6540
1785.666,6,362,22898,210,69,8543,69,12678,152,69,11825,69,10220
1777.799,17,73,3060,72,14,25039,14,3024,1,8,0,8,36
1784.545,6,189,33858,123,304,14627,304,25256,66,83,27454,83,8602
1783.5,6,362,24774,211,94,8492,469,14387,151,69,11889,69,10387
0.113,6,2,80,1,0,0,0,40,1,0,0,0,40
10.785,6,18,4266,10,275,1198,275,958,8,992,856,1440,3308
8.116,6,1562,1440033,989,1378,8,1408,1405573,573,931,13,2816,34460
145.532,6,16,3252,6,92,29106,92,400,10,1164,16149,1408,2852
1789.818,17,142,11360,71,48,25567,48,5396,71,56,25567,56,5964
17.167,6,32,9595,13,156,1430,267,1312,19,501,953,3417,8283
882.544,2,7,224,7,8,147090,8,224,0,0,0,0,0
1795.819,6,369,23385,213,69,8470,69,13005,156,69,11585,69,10380
1750.562,17,12,498,11,14,175056,14,462,1,8,0,8,36
1779.935,6,355,22549,207,69,8640,69,12420,148,69,12107,69,10129
21.387,17,35,7441,16,199,1423,1350,3636,19,172,1186,1350,3805
0.839,6,7,295,4,0,279,0,164,3,7,324,7,131
1794.682,17,87,3648,86,14,21113,14,3612,1,8,0,8,36
0.495,6,23,4506,11,165,49,456,1394,12,493,40,888,3112
1772.482,6,180,15480,120,69,14894,69,8940,60,69,30039,69,6540
0.157,6,10,1383,6,145,31,145,389,4,830,48,830,994
0.258,6,45,18586,25,964,10,1420,13553,20,467,13,1883,5033
240.214,6,55,18627,29,825,8578,1418,15558,26,189,9608,580,3069
1.029,6,30,12081,16,525,68,1360,3310,14,819,64,1379,8771
240.346,6,47,9306,24,517,10449,1418,5912,23,243,10924,638,3394
1782.795,17,356,59525,356,139,5021,401,59525,0,0,0,0,0
127.47,6,21,4863,6,243,25494,722,1280,15,311,9093,1408,3583
230.022,17,4,352,2,48,230011,48,152,2,72,230010,72,200
1789.294,6,360,22818,210,69,8561,69,12678,150,69,12008,69,10140
280.264,6,30,7432,13,158,23355,267,1317,17,543,17511,1300,6115
11.805,6,1872,1631592,1130,1389,10,1420,1597679,742,467,15,1883,33913
39.072,17,44,6468,22,48,1860,48,1672,22,190,1860,308,4796
5.581,6,38,7229,20,218,293,314,3423,18,513,311,1179,3806
20.135,6,23,5795,13,107,1677,159,1138,10,825,2236,1669,4657
5.903,6,1985,2956074,822,338,7,339,51619,1163,2507,5,8448,2904455
317.035,6,70,18638,38,311,8568,1360,9331,32,445,10222,4649,9307
0.512,17,3,451,2,39,505,39,134,1,289,0,289,317
378.497,6,18,1242,14,180,29115,180,916,4,110,20059,110,326
1.5,6,38,9848,20,502,78,1460,4352,18,433,76,1460,5496
1773.014,6,204,22330,130,75,13744,267,10057,74,132,24286,1452,12273
115.835,6,89,13397,49,304,2413,304,9312,40,83,2935,83,4085
0.265,17,2,632,1,288,0,288,316,1,288,0,288,316
1796.324,6,428,32981,225,137,8019,1189,18332,203,56,8892,74,14649
1754.951,1,77,6468,77,56,23091,56,6468,0,0,0,0,0
0.079,17,4,608,2,60,10,60,176,2,188,5,188,432
1.353,6,32,6507,15,164,96,267,1922,17,650,74,1452,4585
69.253,6,44,9859,22,638,723,1360,4177,22,435,3289,2720,5682
0.083,6,9,1344,5,145,20,145,349,4,831,23,831,995
7.516,6,16,1331,8,222,1072,222,768,8,231,1072,231,563
1613.718,1,8,848,8,78,230531,78,848,0,0,0,0,0
44.817,6,3079,2661261,1822,1373,24,1448,2587565,1257,776,35,1448,73696
1.566,6,139,98471,81,1302,19,1420,91839,58,389,27,1420,6632
4.485,6,3,132,3,0,0,0,132,0,0,0,0,0
1756.542,6,107,6374,60,27,29771,27,3525,47,27,38184,27,2849
272.597,17,4,352,2,60,272596,60,176,2,60,272596,60,176
1.006,17,2,685,1,308,0,308,336,1,321,0,321,349
11.171,6,27,11355,13,275,930,275,1078,14,1078,790,1414,10277
736.29,6,66,10021,40,109,18879,498,3566,26,235,29448,1420,6455
1786.797,6,104,8240,68,63,26668,63,4862,36,57,51048,57,3378
121.752,17,4376,5357385,492,65,247,1350,45922,3884,1339,31,1350,5311463
1796.5,6,381,26555,219,97,8240,469,15590,162,69,11156,69,10965
247.537,6,50,23301,22,442,11778,1360,4903,28,959,9161,2720,18398
0.159,17,4,284,2,32,81,32,120,2,54,81,60,164
1739.499,6,87,6322,58,31,30517,31,3915,29,31,62124,31,2407
0.865,6,11,1727,7,100,144,100,384,4,589,205,1152,1343
1791.634,1,342,28728,342,56,5254,56,28728,0,0,0,0,0
0.026,17,2,672,2,308,26,308,672,0,0,0,0,0
60.074,6,36,8372,18,378,512,786,1898,18,478,3524,2128,6474
0.025,17,2,312,1,64,0,64,92,1,192,0,192,220
1794.791,6,476,27458,264,69,6824,69,14838,212,34,8506,64,12620
1788.615,6,359,22709,209,69,8599,69,12569,150,69,12003,69,10140
10.559,6,21,5563,10,275,1173,275,683,11,738,819,1380,4880
3.251,6,2,87,1,0,0,0,40,1,7,0,7,47
12.165,6,26,7028,8,146,1328,267,1058,18,475,714,1452,5970
1.169,6,28,7480,17,306,73,1087,2826,11,701,116,1728,4654
280.43,6,30,7432,13,158,23369,267,1317,17,543,17522,1400,6115
35.914,6,9,540,0,0,0,0,0,9,0,0,0,540
1.478,6,41,9968,21,440,73,1360,4392,20,433,67,1360,5576
1.986,6,23,7428,14,273,152,663,2104,9,1209,244,1946,5324
9.295,6,1891,1736080,1195,1374,7,1408,1695224,696,931,13,2801,40856
0.253,17,2,154,1,33,0,33,61,1,65,0,65,93
8.883,6,1303,1191617,844,1364,10,1432,1168954,459,427,19,1432,22663
0.296,17,4,288,2,36,248,36,128,2,52,249,52,160
1795.495,17,448,39896,403,35,4466,288,25676,45,288,40019,288,14220
289.688,1,4,326,4,53,96562,78,326,0,0,0,0,0
0.624,6,7,4584,4,1247,135,1247,1407,3,1528,312,2720,3177
116.832,6,25,6318,9,272,97,516,1180,16,345,7783,1452,5138
1797.118,17,448,39896,403,35,4470,288,25676,45,288,40017,288,14220
32.011,6,9,396,2,0,3375,0,88,7,0,5321,0,308
200.107,1,6,336,6,28,40021,28,336,0,0,0,0,0
15.366,17,16,4958,7,360,2546,1350,2717,9,221,1911,1350,2241
11.737,17,4,824,2,48,11712,48,152,2,308,11719,308,672
1.296,6,79,64192,52,153,25,258,2797,27,2512,40,17040,61395
1755.861,6,104,6218,60,27,29759,27,3525,44,27,40832,27,2693
24.672,6,9,577,0,0,0,0,0,9,31,3084,31,577
1716.217,1,8,448,8,28,245173,28,448,0,0,0,0,0
1795.188,6,356,22520,208,69,8672,69,12460,148,69,12212,69,10060
1797.645,17,142,11360,71,48,25680,48,5396,71,56,25680,56,5964
1786.842,6,102,8296,68,65,26669,65,4930,34,59,54142,59,3366
62.645,6,44,8796,21,345,767,720,1967,23,346,2841,1928,6829
0.676,17,16,6049,7,475,106,1350,3527,9,252,80,1350,2522
240.284,6,42,5441,22,235,11441,751,2802,20,198,12644,697,2639
2.477,17,2,168,1,48,0,48,76,1,64,0,64,92
10.073,6,623,546386,399,1305,25,1368,530074,224,776,43,1473,16312
1744.655,2,28,896,28,8,64616,8,896,0,0,0,0,0
0.042,17,2,157,1,31,0,31,59,1,70,0,70,98
1797.186,17,448,39896,403,35,4470,288,25676,45,288,40018,288,14220
36.925,17,4,352,2,48,36916,48,152,2,72,36916,72,200
219.61,17,4,352,2,60,219609,60,176,2,60,219609,60,176
1.19,6,60,29362,34,1075,36,1380,24032,26,383,45,1380,5330
1777.09,17,73,3060,72,14,25029,14,3024,1,8,0,8,36
0.495,17,3,451,2,39,111,39,134,1,289,0,289,317
6.137,6,720,621874,442,1335,13,1368,602754,278,776,21,1473,19120
240.175,6,53,18237,28,807,8895,1408,15197,25,216,10007,580,3040
2.18,6,29,10365,17,367,136,833,1785,12,1012,190,1420,8580
4.479,6,40,7309,20,218,235,314,3423,20,440,222,1152,3886
1.404,6,12,3462,6,75,280,75,395,6,1373,280,1448,3067
5.946,17,6,519,5,31,1014,31,295,1,196,0,196,224
0.102,6,11,1703,6,314,20,500,948,5,487,25,487,755
1786.62,1,238,13328,238,28,7538,28,13328,0,0,0,0,0
1740.258,6,92,6668,60,31,29495,31,4062,32,31,56137,31,2606
0.013,17,2,263,1,36,0,36,64,1,171,0,171,199
137.838,6,41,25797,24,884,31,1360,6365,17,1561,8606,7457,19432
1378.364,6,98,10190,57,65,24610,722,4813,41,108,34454,2329,5377
1.639,6,51,19787,29,920,58,1360,14086,22,400,67,1360,5701
1.296,6,53,19490,29,892,46,1360,13709,24,400,48,1360,5781
0.258,6,11,913,6,182,51,182,490,5,77,14,134,423
3.096,6,3164,2921307,1692,219,1,230,94185,1472,1871,2,12672,2827122
54.36,17,4,352,2,60,54359,60,176,2,60,54358,60,176
1786.037,6,151,24832,90,483,20067,483,19170,61,83,29767,83,5662
0.099,17,2,144,1,36,0,36,64,1,52,0,52,80
1.519,17,24,12316,11,482,151,1350,5616,13,487,110,1350,6700
251.794,2,3,96,3,8,125897,8,96,0,0,0,0,0
0.083,6,10,767,5,186,15,186,454,5,45,17,45,313
289.57,1,4,224,4,28,96523,28,224,0,0,0,0,0
0.178,6,10,1671,6,552,35,948,1348,4,159,59,159,323
0.265,6,24,6046,12,181,24,537,1526,12,648,22,1448,4520
21.871,6,23,6180,14,117,1682,159,1337,9,873,2732,1675,4843
1.316,6,25,8056,12,164,103,267,1288,13,869,94,1440,6768
352.083,6,23,6701,5,106,16,106,322,18,376,20709,1917,6379
1.71,17,8,1718,4,37,568,37,260,4,336,568,348,1458
237.287,6,28,7352,12,158,21571,267,1277,16,603,15816,1400,6075
7.794,17,28,16320,14,820,599,1350,11881,14,289,560,1350,4439
2.683,17,3,1176,3,364,1341,364,1176,0,0,0,0,0
88.024,6,22,8810,11,333,81,692,1473,11,983,8788,1360,7337
0.086,6,6,300,0,0,0,0,0,6,0,0,0,300
0.522,6,23,7428,14,273,40,663,2104,9,1209,61,1946,5324
6.413,6,13,5585,4,106,2133,106,274,9,823,800,1452,5311
1683.584,1,52,2912,52,28,33011,28,2912,0,0,0,0,0
3.043,17,6,1437,3,40,1514,40,204,3,383,1515,407,1233
1.277,6,38,9848,21,440,63,1360,4392,17,476,69,2715,5456
131.871,17,4,352,2,60,131870,60,176,2,60,131870,60,176
1786.587,6,151,19402,90,302,20073,302,13740,61,83,29776,83,5662
5.015,17,4,288,2,36,5013,36,128,2,52,5013,52,160
255.957,17,6,528,3,60,127977,60,264,3,60,127978,60,264
0.211,6,23,5910,12,164,19,453,1442,11,555,20,1402,4468
0.355,17,2,152,1,48,0,48,76,1,48,0,48,76
232.104,1,15,1560,0,0,0,0,0,15,76,16578,76,1560
1681.968,17,14,1036,7,30,280322,30,406,7,62,280322,62,630
0.038,1,6,3456,6,548,7,548,3456,0,0,0,0,0
0.154,17,2,178,1,53,0,53,81,1,69,0,69,97
1764.756,2,13,416,13,8,147063,8,416,0,0,0,0,0
0.997,17,4,368,2,64,995,64,184,2,64,996,64,184
20.569,17,4,824,2,48,20554,48,152,2,308,20557,308,672
0.483,6,26,8991,13,252,40,647,1692,13,945,36,1438,7299
10.64,6,16,5255,9,275,1330,275,643,7,1440,936,1440,4612
0.254,17,2,290,1,40,0,40,68,1,194,0,194,222
169.979,6,324,267302,198,1367,862,1448,248182,126,589,1358,1448,19120
1730.588,6,71,5152,44,33,40246,33,3080,27,31,66553,31,2072
7.368,6,39,7285,21,218,368,314,3463,18,516,417,1179,3822
11.862,6,1862,1632087,1154,1363,10,1380,1599480,708,387,16,1923,32607
1.017,6,31,9996,16,222,57,540,2060,15,915,58,1360,7936
1785.394,6,102,8296,68,65,26647,65,4930,34,59,54100,59,3366
1762.649,6,103,7465,63,31,28429,31,4340,40,31,45195,31,3125
1756.057,1,54,4536,54,56,33133,56,4536,0,0,0,0,0
60.882,6,15,1666,9,180,7610,180,1016,6,110,12131,110,650
1681.329,17,14,1045,7,30,280218,30,406,7,63,280218,71,639
1707.712,1,8,448,8,28,243958,28,448,0,0,0,0,0
1.658,6,47,17856,26,859,66,1360,12240,21,433,72,1360,5616
290.087,6,27,1823,11,332,29007,332,912,16,83,19338,83,911
3.155,17,4,296,3,30,1576,30,174,1,94,0,94,122
6.826,6,1014,961611,636,1437,10,1448,937291,378,776,17,1448,24320
100.853,6,101,77043,65,1298,1575,1448,67009,36,741,2715,2359,10034
1741.405,17,30,31680,30,1028,60048,1028,31680,0,0,0,0,0
4.063,17,5,290,5,30,1015,30,290,0,0,0,0,0
0.353,17,8,2766,8,317,50,356,2766,0,0,0,0,0
1.577,6,12,1145,6,283,279,283,615,6,105,278,105,530
229.29,17,2,150,2,47,229290,47,150,0,0,0,0,0
1784.315,17,374,61122,374,135,4783,363,61122,0,0,0,0,0
0.53,17,3,543,2,39,380,39,134,1,381,0,381,409
217.661,6,31,11863,18,443,12803,1440,4490,13,836,18121,1440,7373
0.03,17,2,150,1,47,0,47,75,1,47,0,47,75
2.41,6,13,2311,8,188,344,245,700,5,1407,539,1407,1611
33.68,6,31,5104,15,180,2405,722,1860,16,301,2231,1440,3244
3.793,17,5,295,5,31,948,31,295,0,0,0,0,0
65.19,6,26,7130,6,154,13038,267,712,20,350,3417,1933,6418
0.054,6,6,312,0,0,0,0,0,6,0,0,0,312
1783.665,1,176,18656,176,78,10192,78,18656,0,0,0,0,0
117.24,6,46,21303,22,1031,943,1360,12260,24,619,5088,2241,9043
60.117,6,29,7257,13,155,5009,267,1306,16,441,4007,1420,5951
0.515,17,4,624,2,64,300,64,184,2,192,263,192,440
696.71,17,25,8856,25,326,29029,548,8856,0,0,0,0,0
207.947,17,8,2920,8,337,29706,548,2920,0,0,0,0,0
1681.339,1,15,840,15,28,120095,28,840,0,0,0,0,0
560.538,17,6,444,3,30,280222,30,174,3,62,280259,62,270
3.08,17,4,232,4,30,1026,30,232,0,0,0,0,0
1004.943,6,2250,1887022,1018,135,988,354,56686,1232,1470,816,2816,1830336
1791.559,17,144,11520,72,48,25232,48,5472,72,56,25232,56,6048
0.913,17,3,618,2,32,159,32,120,1,470,0,470,498
213.925,17,4,352,2,60,213924,60,176,2,60,213924,60,176
65.028,6,439,527464,183,204,357,253,11351,256,1987,254,11264,516113
0.103,17,2,904,2,424,103,548,904,0,0,0,0,0
0.376,6,13,1693,7,288,56,288,588,6,426,43,434,1105
7.114,6,14,1247,7,222,1184,222,728,7,231,1184,231,519
282.088,6,30,7432,13,158,23507,267,1317,17,543,17609,1400,6115
1788.499,6,360,22818,210,69,8557,69,12678,150,69,12002,69,10140
1014.837,17,200,15200,200,48,5099,48,15200,0,0,0,0,0
541.478,2,6,192,6,8,108295,8,192,0,0,0,0,0
1.915,17,6,998,3,33,953,33,183,3,243,952,249,815
0.487,6,23,8777,14,334,37,663,2097,9,1034,57,1471,6680
0.396,6,12,1653,6,288,77,288,548,6,426,44,434,1105
0.09,6,16,4917,9,290,11,517,1045,7,875,12,1402,3872
1.184,6,23,7952,12,164,92,267,1288,11,1216,101,2816,6664
597.994,2,4,128,4,8,199331,8,128,0,0,0,0,0
1790.177,17,180,11520,180,36,10000,36,11520,0,0,0,0,0
4.283,6,2,88,2,0,0,0,88,0,0,0,0,0
1610.768,1,8,848,8,78,230109,78,848,0,0,0,0,0
0.424,6,29,7088,17,244,26,656,2394,12,601,37,1420,4694
1771.82,6,80,5146,40,31,45430,36,2154,40,304,45430,443,2992
1.027,17,2,268,1,54,0,54,82,1,158,0,158,186
297.626,17,4,352,2,60,297625,60,176,2,60,297625,60,176
3.785,6,27,8205,12,330,340,517,1966,15,778,267,1418,6239
0.066,17,2,198,1,37,0,37,65,1,105,0,105,133
0.002,6,2,80,2,0,0,0,80,0,0,0,0,0
0.017,17,4,1116,2,32,12,32,120,2,470,12,470,996
240.961,17,4,304,2,48,240949,48,152,2,48,240949,48,152
125.36,6,14,3144,7,92,20893,92,452,7,464,20864,1440,2692
300.355,6,27,8061,15,173,21453,385,1483,12,849,21847,1438,6578
0.278,6,10,1514,5,503,69,503,771,5,475,69,475,743
1.379,6,47,18298,26,893,55,1360,12682,21,476,58,2715,5616
0.926,6,11,1727,7,100,154,100,384,4,589,219,1152,1343
81.17,6,43,8823,21,367,744,787,2034,22,368,3858,2720,6789
12.594,6,1894,1699102,1197,1366,10,1380,1663753,697,511,18,1923,35349
16.984,6,1906,1737653,1177,1419,14,1432,1700877,729,428,23,1871,36776
1787.101,6,115,13683,75,81,24150,504,5920,40,162,45820,1452,7763
0.018,6,16,6416,8,126,1,126,550,8,1088,2,1448,5866
1.174,17,3,265,2,39,999,39,134,1,103,0,103,131
1795.406,17,446,39548,402,35,4477,288,25644,44,288,40951,288,13904
1.297,6,48,19429,27,907,49,1460,13813,21,433,56,1460,5616
60.407,6,9,771,5,177,15101,177,445,4,110,20060,110,326
1551.47,6,23,3355,15,241,110819,241,2299,8,92,221610,92,1056
6.896,17,1304,848035,1029,771,6,1108,822282,275,65,24,598,25753
1739.926,1,14,784,14,28,133840,28,784,0,0,0,0,0
1796.744,1,102,5712,102,28,17789,28,5712,0,0,0,0,0
372.132,6,18,1242,14,180,28625,180,916,4,110,20070,110,326
103.752,17,10,800,5,48,25936,48,380,5,56,25936,56,420
1790.517,6,367,31558,212,103,8485,469,15751,155,135,11626,4837,15807
1786.166,6,113,9110,73,66,24807,66,5230,40,60,45796,60,3880
11.007,6,20,7050,11,275,1100,275,998,9,1420,779,1420,6052
1786.781,6,102,8364,68,66,26668,66,4964,34,60,54142,60,3400
1788.822,17,142,11360,71,48,25554,48,5396,71,56,25554,56,5964
573.422,6,52,5820,22,26,27305,26,1378,30,176,18684,427,4442
45.641,6,45,10296,22,541,550,910,3139,23,366,2068,3488,7157
240.307,6,55,12875,29,531,8582,1402,9486,26,184,9612,580,3389
0.195,17,2,290,1,40,0,40,68,1,194,0,194,222
481.329,2,6,192,6,8,96265,8,192,0,0,0,0,0
1.723,6,14,2351,8,188,246,245,700,6,703,290,1152,1651
0.76,6,26,5887,13,156,63,267,1462,13,650,58,1414,4425
102.476,6,22,8126,12,201,49,290,1115,10,942,11372,2720,7011
22.661,6,3058,2988149,2058,1377,10,1408,2931485,1000,931,22,2801,56664
579.695,1,10,560,10,28,64410,28,560,0,0,0,0,0
251.895,2,2,64,2,8,251895,8,64,0,0,0,0,0
5.307,6,40,7309,22,218,252,314,3503,18,513,296,1179,3806
1197.091,6,263,22175,145,82,7954,267,9591,118,160,10231,1420,12584
0.16,6,10,1379,5,145,40,145,349,5,826,31,826,1030
1729.233,6,62,4504,40,33,44339,33,2740,22,31,82333,31,1764
3.513,17,5,295,5,31,878,31,295,0,0,0,0,0
1787.538,6,419,25109,209,69,8593,69,12500,210,34,8552,48,12609
0.053,17,2,467,1,33,0,33,61,1,378,0,378,406
1.148,6,25,8056,12,164,88,267,1288,13,869,81,1402,6768
0.36,6,13,1693,7,288,60,288,588,6,284,36,434,1105
1771.966,6,89,6469,59,31,30551,31,3979,30,31,61089,31,2490
44.292,6,41,6567,18,154,2605,722,2027,23,256,2003,2026,4540
298.016,1,14,784,14,28,22924,28,784,0,0,0,0,0
159.678,6,28,7352,12,158,14516,267,1277,16,603,10642,1400,6075
4.019,6,40,7309,21,218,200,314,3463,19,513,209,1179,3846
1.379,6,48,19138,27,886,53,1360,13522,21,433,59,1360,5616
11.163,6,15,6747,8,275,1594,275,607,7,1171,628,1440,6140
10.966,6,19,4362,11,275,1096,275,998,8,1010,884,2840,3364
0.04,6,12,1948,7,329,6,500,1030,5,650,9,650,918
1.769,17,20,5180,20,231,93,388,5180,0,0,0,0,0
0.363,6,3,120,2,0,363,0,80,1,0,0,0,40
0.36,17,8,2766,8,317,51,356,2766,0,0,0,0,0
39.691,6,27,7177,13,155,3307,267,1306,14,530,3052,3417,5871
1777.09,6,187,16243,120,69,14933,69,8940,67,69,26922,69,7303
1773.151,6,180,15480,120,69,14900,69,8940,60,69,30051,69,6540
15.372,17,12,5667,6,575,3067,1350,3621,6,313,3067,1350,2046
1793.842,17,87,3648,86,14,21104,14,3612,1,8,0,8,36
240.439,6,55,24127,25,547,10018,1408,6231,30,960,8290,2755,17896
2.869,17,4,660,2,30,2857,30,116,2,244,2859,244,544
1782.106,6,299,26613,176,75,10183,267,12173,123,130,14607,1460,14440
0.256,17,2,136,1,32,0,32,60,1,48,0,48,76
0.89,6,11,1727,7,100,148,100,384,4,589,209,1152,1343
1779.311,6,104,8376,68,65,26556,65,4930,36,59,50834,59,3446
5.95,6,40,7325,21,218,297,314,3463,19,516,315,1179,3862
0.01,17,8,2750,8,315,1,354,2750,0,0,0,0,0
9.143,17,8,772,4,46,3045,46,296,4,91,3045,91,476
0.915,17,4,624,2,64,601,64,184,2,192,561,192,440
0.024,17,2,162,1,36,0,36,64,1,70,0,70,98
192.062,6,14,5799,4,98,64016,106,365,10,718,21338,1452,5434
1797.161,6,81,4302,41,26,44928,26,2184,40,26,46080,26,2118
1773.552,6,181,15589,120,69,14903,69,8940,61,69,29558,69,6649
0.151,17,2,166,1,39,0,39,67,1,71,0,71,99
153.705,1,4,224,4,28,51235,28,224,0,0,0,0,0
90.786,17,4,240,2,32,90785,32,120,2,32,90785,32,120
1799.185,6,367,25650,214,99,8446,469,15045,153,69,11835,69,10605
1797.937,6,358,22669,208,69,8685,69,12529,150,69,12066,69,10140
6.555,6,33,6145,17,206,409,314,2744,16,551,419,1179,3401
93.182,17,4,240,2,32,93181,32,120,2,32,93180,32,120
0.512,6,20,7229,13,334,42,663,2021,7,1209,80,1946,5208
1.268,2,2,64,2,8,1268,8,64,0,0,0,0,0
1800.0,6,221,17543,82,75,21851,337,8482,139,50,13043,143,9061
0.211,17,2,632,1,288,0,288,316,1,288,0,288,316
1.593,6,31,11054,16,434,106,1256,3278,15,1432,99,3942,7776
23.063,17,32,15278,14,481,1771,1350,7137,18,424,1354,1350,8141
1796.531,1,59,4956,59,56,30974,56,4956,0,0,0,0,0
1773.353,6,203,22290,130,75,13746,267,10057,73,134,24626,1917,12233
575.989,6,8,692,8,46,82284,62,692,0,0,0,0,0
24.995,6,3207,3031719,2043,1404,12,1448,2966491,1164,776,21,1448,65228
1.264,6,25,8056,12,164,100,267,1288,13,869,91,1408,6768
0.101,6,9,1340,5,145,25,145,349,4,827,25,827,991
1.103,17,18,5962,8,362,157,1350,3120,10,256,119,1350,2842
50.909,6,32,7553,13,156,538,267,1620,19,573,2820,1917,5933
280.345,6,29,7392,13,158,23362,267,1317,16,603,18682,1400,6075
1.376,6,49,19158,27,883,52,1360,13502,22,476,56,2720,5656
3.365,17,35,9013,17,238,208,1350,4536,18,220,195,1350,4477
234.177,6,18,1580,3,112,117088,112,240,15,77,16725,90,1340
0.229,17,2,136,1,32,0,32,60,1,48,0,48,76
1.083,17,26,6592,11,274,105,1350,3327,15,189,75,1350,3265
6.996,6,4,240,4,0,0,0,240,0,0,0,0,0
0.066,6,2,123,1,0,0,0,40,1,31,0,31,83
2.027,17,4,496,3,64,1000,64,276,1,192,0,192,220
4.534,6,39,7285,19,218,251,314,3383,20,516,224,1179,3902
1783.81,6,357,22629,208,69,8617,69,12460,149,69,12052,69,10169
0.006,6,3,120,1,0,0,0,40,2,0,2,0,80
19.312,17,52,33464,23,442,876,1350,10818,29,752,688,1350,22646
1782.065,1,164,9184,164,28,10932,28,9184,0,0,0,0,0
0.267,17,2,152,1,48,0,48,76,1,48,0,48,76
1797.478,1,345,28980,345,56,5225,56,28980,0,0,0,0,0
1740.477,6,90,6521,59,31,30008,31,3998,31,31,58013,31,2523
13.579,6,19,10974,6,106,2715,106,354,13,917,1130,1420,10620
240.204,6,209,193518,99,197,2451,581,6884,110,1845,2203,4206,186634
85.13,6,117,88526,73,1281,1182,1448,78118,44,676,1974,1448,10408
0.338,6,23,7394,13,335,28,668,2026,10,968,36,1475,5368
280.267,6,29,7392,13,158,23355,267,1317,16,603,18680,2036,6075
0.0,17,1,667,1,639,0,639,667,0,0,0,0,0
1788.038,17,138,11040,69,48,26294,48,5244,69,56,26294,56,5796
1793.991,1,58,4872,58,56,31473,56,4872,0,0,0,0,0
126.001,2,2,64,2,8,126001,8,64,0,0,0,0,0
1.3,6,41,8441,21,320,65,1162,2820,20,400,59,1360,5621
1794.241,17,87,3648,86,14,21108,14,3612,1,8,0,8,36
0.058,17,8,2750,8,315,8,354,2750,0,0,0,0,0
5.252,17,31,14791,15,484,372,1350,7692,16,415,347,1350,7099
1786.234,6,102,8296,68,65,26660,65,4930,34,59,54125,59,3366
61.349,6,35,15833,22,800,2921,1408,9159,13,855,5091,3847,6674
14.985,6,86,25813,43,552,356,1152,19952,43,459,349,1179,5861
59.132,17,4,1344,4,308,19710,308,1344,0,0,0,0,0
240.229,6,54,17953,29,801,8579,1408,15139,25,188,10009,580,2814
1772.659,6,180,15480,120,69,14896,69,8940,60,69,30037,69,6540
49.235,6,6205,5965760,4029,1401,12,1448,5847908,2176,776,22,1448,117852
1737.579,1,58,4872,58,56,30483,56,4872,0,0,0,0,0
14.455,6,24,4711,12,154,1291,721,1715,12,592,1295,1368,2996
1797.503,17,446,39548,402,35,4482,288,25644,44,288,40949,288,13904
0.039,17,2,241,1,44,0,44,72,1,141,0,141,169
0.017,6,3,327,2,103,14,138,287,1,0,0,0,40
51.382,6,47,9146,22,410,673,882,2238,25,327,2135,1360,6908
3.858,17,8,848,4,46,1285,46,296,4,110,1281,110,552
0.016,6,6,718,3,304,5,304,460,3,102,5,102,258
67.582,6,22,11685,12,367,64,783,1626,10,1607,7495,3966,10059
1773.192,6,180,15480,120,69,14900,69,8940,60,69,30050,69,6540
1747.697,1,67,5628,0,0,0,0,0,67,56,26480,56,5628
1799.833,6,357,22629,208,69,8694,69,12460,149,69,12160,69,10169
8.537,6,54,19988,30,858,294,1360,14183,24,400,361,1360,5805
1742.793,6,94,7151,62,38,28570,205,4424,32,33,56211,98,2727
3.393,6,2,88,2,0,0,0,88,0,0,0,0,0
0.492,6,12,1653,6,288,92,288,548,6,426,52,434,1105
1791.033,6,267,19663,132,178,13670,515,7614,135,38,13365,62,12049
32.38,6,44,17756,24,1116,384,1360,12154,20,399,1695,1360,5602
170.483,6,26,6482,9,220,6877,516,1245,17,325,10649,1452,5237
280.237,6,29,7392,13,158,23353,267,1317,16,603,18676,1400,6075
0.304,17,2,778,2,361,304,361,778,0,0,0,0,0
1799.498,17,142,11360,71,48,25706,48,5396,71,56,25706,56,5964
3.755,6,33,6129,17,206,234,314,2744,16,548,233,1179,3385
1787.656,6,107,8496,68,65,26681,65,4930,39,59,47040,59,3566
3.035,6,4,229,1,0,0,0,40,3,69,1509,69,189
1.311,6,37,9808,21,440,65,1360,4392,16,476,75,2715,5416
18.808,17,21,7347,10,378,2085,1350,4063,11,270,1877,1350,3284
5.475,6,41,7349,22,218,260,314,3503,19,513,289,1179,3846
1787.907,6,365,25639,214,98,8393,469,15183,151,69,11919,69,10456
1794.442,6,356,22520,208,69,8668,69,12460,148,69,12207,69,10060
1786.154,6,356,22520,208,69,8628,69,12460,148,69,12150,69,10060
30.648,6,41,15786,18,516,1802,517,3332,23,763,1372,1420,12454
246.488,6,37,6241,17,134,11562,516,1896,20,208,12960,1452,4345
1770.29,6,101,9344,66,65,27235,65,5577,35,59,52064,59,3767
7.3,6,1248,1119002,768,1379,9,1408,1089378,480,931,14,2801,29624
19.708,6,6,328,4,0,6569,0,216,2,0,19693,0,112
1780.451,1,8,448,8,28,254350,28,448,0,0,0,0,0
0.985,17,21,14626,12,978,85,1350,12080,9,254,112,1350,2546
1740.465,17,29,30566,29,1026,62159,1026,30566,0,0,0,0,0
1799.816,17,449,39644,405,35,4454,288,25740,44,288,40957,288,13904
177.475,17,4,352,2,60,177474,60,176,2,60,177474,60,176
0.41,17,19,7344,9,501,51,1350,4765,10,229,39,1350,2579
1.486,6,51,19842,29,924,53,1440,14141,22,400,62,1440,5701
5.556,6,44,8369,21,227,277,314,4022,23,489,240,1179,4347
0.821,17,15,8412,8,715,117,1350,5948,7,324,127,1350,2464
4.518,6,12,945,6,222,898,222,466,6,231,897,231,479
1.191,6,24,8004,12,164,92,267,1288,12,1014,92,2411,6716
145.468,17,4,352,2,60,145467,60,176,2,60,145467,60,176
1740.478,17,28,6580,28,207,64462,207,6580,0,0,0,0,0
1699.719,17,12,498,11,14,169971,14,462,1,8,0,8,36
180.527,2,2,64,2,8,180527,8,64,0,0,0,0,0
1740.558,17,30,20190,30,645,60019,645,20190,0,0,0,0,0
1777.061,1,133,7448,133,28,13462,28,7448,0,0,0,0,0
216.54,6,6,1255,4,327,72180,413,814,2,180,216355,269,441
0.118,17,2,136,1,32,0,32,60,1,48,0,48,76
0.425,17,16,5950,7,342,70,1350,2594,9,344,42,1350,3356
5.753,6,705,642382,457,1338,12,1368,624822,248,776,22,2736,17560
0.535,6,9,1002,5,213,133,213,417,4,421,173,421,585
1.708,6,13,2311,8,188,244,245,700,5,1407,360,1407,1611
51.074,6,25,7097,12,155,4643,267,1266,13,589,4255,3426,5831
12.178,6,1846,1658265,1168,1367,10,1380,1626019,678,421,17,1923,32246
1745.083,6,97,7307,63,38,28146,205,4476,34,33,52868,98,2831
1791.298,6,393,24897,220,69,8179,69,13837,173,69,10412,69,11060
0.061,6,2,149,1,0,0,0,40,1,69,0,69,109
8.269,6,17,5313,9,275,1033,275,643,8,1084,723,1414,4670
1795.565,17,448,39896,403,35,4466,288,25676,45,288,40016,288,14220
390.216,6,24,1575,15,177,27872,177,989,9,110,9869,110,586
240.932,6,36,6448,19,138,13384,517,1964,17,598,15057,1418,4484
1791.859,17,144,11520,72,48,25237,48,5472,72,56,25237,56,6048
0.105,6,9,1343,5,145,26,145,349,4,830,31,830,994
1710.191,1,8,848,8,78,244313,78,848,0,0,0,0,0
0.13,6,11,819,6,186,25,186,506,5,45,31,45,313
0.587,6,23,7397,13,334,48,663,2021,10,967,60,1471,5376
300.682,6,42,8891,18,308,17680,889,2023,24,327,13067,1360,6868
0.301,17,2,412,1,33,0,33,61,1,323,0,323,351
0.318,17,2,221,1,35,0,35,63,1,130,0,130,158
1784.24,6,180,15480,120,69,14993,69,8940,60,69,30239,69,6540
0.845,6,2,1253,1,0,0,0,40,1,1173,0,1173,1213
1.312,6,50,20088,27,948,50,1460,14392,23,433,51,1460,5696
6.144,17,4,304,2,48,6125,48,152,2,48,6121,48,152
3.196,2,2,64,2,8,3196,8,64,0,0,0,0,0
390.615,17,12,4032,12,308,35510,308,4032,0,0,0,0,0
681.39,6,53,8565,22,106,32444,517,2114,31,230,22711,1418,6451
280.252,6,28,7352,13,158,23354,267,1317,15,678,20016,2045,6035
0.912,17,4,560,2,64,611,64,184,2,160,548,160,376
5.509,17,24,10667,11,615,550,1350,7080,13,247,275,1350,3587
1744.193,6,95,7203,63,38,28132,205,4476,32,33,56252,98,2727
300.265,6,30,8749,16,409,20017,1050,2502,14,612,1931,1448,6247
1.988,6,124,104576,47,230,43,517,4055,77,1340,25,1440,100521
125.399,6,14,3144,7,92,20899,92,452,7,464,20867,1448,2692
1786.451,6,102,8364,68,66,26663,66,4964,34,60,54132,60,3400
1.379,6,24,8004,12,164,107,267,1288,12,1216,107,3859,6716
0.04,17,2,422,1,72,0,72,100,1,294,0,294,322
1741.351,17,30,31680,30,1028,60046,1028,31680,0,0,0,0,0
0.031,6,33,8043,17,131,1,131,1023,16,441,2,500,7020
2.002,6,19,3781,10,234,222,564,1452,9,463,227,1343,2329
1760.412,1,50,6078,50,93,35926,320,6078,0,0,0,0,0
0.321,1,10,840,10,56,35,56,840,0,0,0,0,0
0.02,17,2,142,1,35,0,35,63,1,51,0,51,79
1.259,6,118,87547,51,131,25,232,2569,67,1349,18,1420,84978
26.95,6,49,13146,23,182,1225,722,2570,26,680,1069,1380,10576
69.353,6,33,9101,13,327,640,1189,2495,20,483,3642,1926,6606
1.55,6,47,18161,26,882,62,1360,12545,21,476,66,2715,5616
1.121,6,31,6044,16,111,74,267,1539,15,780,71,1460,4505
601.629,2,6,192,6,8,120325,8,192,0,0,0,0,0
0.067,17,2,2380,2,1162,67,1162,2380,0,0,0,0,0
1647.274,1,20,1120,20,28,86698,28,1120,0,0,0,0,0
40.896,17,42,6056,21,48,2044,48,1596,21,184,2044,308,4460
1.472,6,47,19158,27,890,56,1360,13582,20,529,67,4075,5576
1782.356,17,83,3480,82,14,22004,14,3444,1,8,0,8,36
1.245,17,20,6034,8,280,177,1350,2471,12,268,71,1350,3563
0.524,6,50,20670,27,1026,20,1380,15508,23,421,21,1923,5162
1772.248,6,180,15480,120,69,14892,69,8940,60,69,30032,69,6540
1789.739,17,87,3648,86,14,21055,14,3612,1,8,0,8,36
1687.193,17,12,498,11,14,168719,14,462,1,8,0,8,36
1631.002,1,8,448,8,28,233000,28,448,0,0,0,0,0
74.374,6,127,105301,86,1275,874,1368,95041,41,738,1853,2519,10260
66.935,6,36,8455,18,410,512,882,1982,18,478,3928,2720,6473
1772.423,6,180,15480,120,69,14894,69,8940,60,69,30039,69,6540
1771.184,6,28,4129,18,241,104187,241,2901,10,92,196744,92,1228
0.94,17,21,14744,12,986,84,1350,12170,9,258,113,1350,2574
1.774,6,55,19163,29,863,63,1360,13290,26,400,61,1360,5873
240.89,6,46,6579,22,196,11469,585,3114,24,184,10471,580,3465
0.026,17,4,284,2,32,0,32,120,2,54,6,60,164
90.638,6,95,69693,61,1258,1510,1408,59798,34,811,2247,3847,9895
301.208,6,42,10146,22,517,14343,1360,4544,20,399,475,1360,5602
1782.403,17,83,3480,82,14,22004,14,3444,1,8,0,8,36
4.843,6,41,7365,22,218,230,314,3503,19,516,254,1179,3862
1.031,17,6,1674,3,32,513,32,180,3,470,513,470,1494
0.004,17,2,396,1,39,0,39,67,1,301,0,301,329
0.661,6,2,1175,1,0,0,0,40,1,1095,0,1095,1135
0.011,17,3,618,2,32,0,32,120,1,470,0,470,498
1793.961,17,140,11200,70,48,25999,48,5320,70,56,25999,56,5880
286.949,6,31,3137,17,324,17933,585,1549,14,282,22072,580,1588
0.02,6,11,3287,6,81,4,81,401,5,872,5,1448,2886
0.698,6,2,80,1,0,0,0,40,1,0,0,0,40
1787.129,17,87,3648,86,14,21025,14,3612,1,8,0,8,36
1799.152,6,356,22520,208,69,8691,69,12460,148,69,12239,69,10060
0.167,17,2,206,1,44,0,44,72,1,106,0,106,134
1791.403,6,356,22520,208,69,8654,69,12460,148,69,12186,69,10060
35.142,6,20,6471,10,680,77,1207,2570,10,564,3895,1440,3901
6.984,6,4,240,4,0,0,0,240,0,0,0,0,0
36.014,17,10,760,10,48,4001,48,760,0,0,0,0,0
366.017,6,21,1688,16,180,24401,180,1200,5,110,15109,110,488
0.481,17,4,350,2,34,473,34,124,2,85,472,91,226
24.924,6,18,788,8,0,3560,0,348,10,0,2458,0,440
1784.954,17,140,11200,70,48,25868,48,5320,70,56,25868,56,5880
3.106,17,8,656,4,30,1016,30,232,4,78,1019,94,424
0.669,6,10,1671,6,552,133,948,1348,4,159,222,159,323
0.764,6,16,6056,9,70,94,133,504,7,1756,125,2828,5552
1749.53,17,12,498,11,14,174953,14,462,1,8,0,8,36
16.585,17,2,778,2,361,16585,361,778,0,0,0,0,0
148.78,6,35,4806,17,160,9298,599,2334,18,166,8750,580,2472
0.233,6,523,537088,166,201,1,486,9445,357,1442,0,2876,527643
3.29,17,2,656,2,300,3290,300,656,0,0,0,0,0
0.335,6,28,9133,14,261,25,683,1780,14,1100,25,2816,7353
125.153,6,33,9061,14,158,9627,267,1357,19,578,6952,1400,7704
1781.424,17,142,11360,71,48,25448,48,5396,71,56,25448,56,5964
1775.734,17,73,3060,72,14,25010,14,3024,1,8,0,8,36
1.945,6,15,3491,5,288,442,288,520,10,511,195,853,2971
1641.234,1,8,448,8,28,234462,28,448,0,0,0,0,0
1798.082,6,356,22520,208,69,8686,69,12460,148,69,12231,69,10060
33.749,6,13,1362,8,182,4821,182,606,5,244,8433,476,756
12.292,1,16,1664,0,0,0,0,0,16,76,819,76,1664
9.577,6,45,40914,12,330,870,330,966,33,1414,297,1438,39948
158.479,6,22,10189,11,433,73,990,1771,11,1138,15834,2720,8418
0.119,17,2,574,1,32,0,32,60,1,486,0,486,514
0.082,17,2,204,1,34,0,34,62,1,114,0,114,142
67.049,6,46,8941,19,345,3724,720,1847,27,285,2563,1360,7094
6.52,6,18,6407,5,154,1630,267,672,13,578,488,1917,5735
60.811,6,48,12956,23,515,2764,1402,9965,25,149,2327,580,2991
1775.63,6,126,16036,69,68,26111,517,4766,57,331,31706,1408,11270
1.021,17,2,176,2,60,1021,60,176,0,0,0,0,0
1786.685,6,106,8456,68,65,26666,65,4930,38,59,48285,59,3526
9.962,6,15,2427,9,137,1245,267,913,6,423,1892,643,1514
37.883,6,38,8535,19,410,493,882,2022,19,441,2096,1440,6513
0.143,6,46,22043,27,1064,5,1420,17062,19,467,7,1883,4981
1.683,6,48,10434,25,440,70,1360,4588,23,378,67,2715,5846
250.575,6,55,21574,28,181,9280,641,2635,27,974,9637,4206,18939
146.753,6,31,14690,16,488,322,1360,3127,15,1216,10472,3928,11563
0.424,6,13,1693,7,288,64,288,588,6,426,46,434,1105
132.521,6,55,21627,29,537,766,1308,4575,26,887,5293,1360,17052
0.066,17,2,376,1,41,0,41,69,1,279,0,279,307
1630.564,1,32,1792,32,28,52598,28,1792,0,0,0,0,0
240.236,6,54,19750,29,813,8579,1418,16970,25,184,10009,580,2780
1798.47,6,360,24119,210,83,8605,965,13505,150,74,12070,405,10614
0.019,17,2,393,1,36,0,36,64,1,301,0,301,329
5.109,6,39,7269,20,218,268,314,3423,19,513,270,1179,3846
1739.702,1,15,870,15,30,124264,30,870,0,0,0,0,0
374.522,6,18,1239,14,177,28809,177,913,4,110,21120,110,326
57.935,6,33,8200,15,214,4138,721,1893,18,507,3393,2840,6307
657.145,6,96,9084,38,82,17757,339,3827,58,97,11526,1062,5257
7.692,6,46,8449,24,227,334,314,4142,22,489,353,1179,4307
1750.636,1,8,448,8,28,250090,28,448,0,0,0,0,0
0.07,17,4,588,2,48,58,48,152,2,190,57,308,436
103.735,17,6,456,6,48,20747,48,456,0,0,0,0,0
0.092,6,9,1340,5,145,23,145,349,4,827,27,827,991
319.864,6,16,1138,12,180,29078,180,812,4,110,20067,110,326
5.019,17,4,288,2,36,5001,36,128,2,52,5003,52,160
0.226,6,2,104,1,0,0,0,40,1,0,0,0,64
0.1,6,3,156,0,0,0,0,0,3,0,0,0,156
1769.313,6,125,7622,68,27,26407,27,4082,57,27,31594,27,3540
21.666,17,2,642,1,300,0,300,328,1,286,0,286,314
1684.487,2,23,736,23,8,76567,8,736,0,0,0,0,0
3.813,6,2,1175,1,0,0,0,40,1,1095,0,1095,1135
0.076,17,4,420,2,33,0,33,122,2,121,0,145,298
0.273,17,2,384,1,39,0,39,67,1,289,0,289,317
15.308,6,14,792,8,0,2186,0,440,6,0,1286,0,352
0.017,17,2,224,1,58,0,58,86,1,110,0,110,138
0.096,6,2,92,1,0,0,0,52,1,0,0,0,40
1.907,6,9,527,5,43,476,43,311,4,0,634,0,216
4.668,17,5,4754,5,922,1167,1451,4754,0,0,0,0,0
1794.091,1,73,6132,73,56,24917,56,6132,0,0,0,0,0
1777.85,1,76,4256,76,28,23704,28,4256,0,0,0,0,0
1.582,1,2,112,2,28,1582,28,112,0,0,0,0,0
1.407,17,24,11443,12,669,124,1350,8369,12,228,124,1350,3074
1795.251,17,142,11360,71,48,25646,48,5396,71,56,25646,56,5964
4.98,6,43,8329,22,227,237,314,4062,21,489,235,1179,4267
0.391,6,10,968,5,256,94,256,460,5,304,94,304,508
1786.619,6,102,8296,68,65,26665,65,4930,34,59,54136,59,3366
62.113,17,15,824,7,25,10352,29,375,8,28,8697,41,449
0.27,6,9,1340,5,145,67,145,349,4,827,74,827,991
280.227,6,27,7312,13,158,23352,267,1317,14,775,21551,4836,5995
131.514,6,5206,4489222,2523,1090,52,1392,143971,2683,1572,49,5584,4345251
12.263,6,23,4507,11,241,1226,722,1532,12,387,1043,1408,2975
33.059,17,39,5544,20,48,1736,48,1520,19,183,1833,308,4024
15.69,6,8,352,2,0,3367,0,88,6,0,3119,0,264
300.964,6,186,155371,99,213,3071,256,7516,87,1885,3499,4939,147855
110.879,17,6,360,3,32,55439,32,180,3,32,55439,32,180
1756.053,6,104,6218,60,27,29762,27,3525,44,27,40837,27,2693
1797.401,17,448,39896,403,35,4471,288,25676,45,288,40021,288,14220
4.704,17,2,656,2,300,4704,300,656,0,0,0,0,0
0.351,6,2,80,1,0,0,0,40,1,0,0,0,40
5.043,6,40,7309,20,218,265,314,3423,20,513,252,1179,3886
0.255,17,2,144,1,36,0,36,64,1,52,0,52,80
0.36,6,28,9019,14,234,27,575,1672,14,1099,27,2816,7347
1682.2,17,14,1036,7,30,280364,30,406,7,62,280364,62,630
1789.745,6,240,35580,150,302,12011,302,25920,90,83,20109,83,9660
0.268,17,2,167,1,39,0,39,67,1,72,0,72,100
280.306,6,30,7432,13,158,23358,267,1317,17,543,17518,1400,6115
378.097,2,4,128,4,8,126032,8,128,0,0,0,0,0
1719.332,1,8,448,8,28,245618,28,448,0,0,0,0,0
3.448,6,2,88,2,0,0,0,88,0,0,0,0,0
1783.419,17,83,3480,82,14,22017,14,3444,1,8,0,8,36
1789.956,6,358,22669,209,69,8605,69,12500,149,69,12094,69,10169
1.574,6,29,10373,17,368,98,837,1789,12,1012,134,1420,8584
0.414,6,53,22221,30,1051,14,1380,17014,23,387,17,1923,5207
1.295,6,25,8056,12,164,101,267,1288,13,869,92,1448,6768
1755.287,1,30,1680,30,28,60527,28,1680,0,0,0,0,0
65.579,17,2,672,2,308,65579,308,672,0,0,0,0,0
240.112,6,43,9102,21,209,12005,833,2563,22,538,11433,2339,6539
10.755,6,19,7010,11,275,1075,275,998,8,1893,857,2840,6012
1786.67,6,102,8296,68,65,26666,65,4930,34,59,54138,59,3366
1793.967,1,342,28728,342,56,5260,56,28728,0,0,0,0,0
17.853,17,6,528,3,48,8922,48,228,3,72,8922,72,300
1794.462,1,268,15008,268,28,6720,28,15008,0,0,0,0,0
0.123,17,2,2730,2,1337,123,1337,2730,0,0,0,0,0
18.061,6,18,1407,9,222,2256,222,808,9,231,2257,231,599
0.19,6,9,1147,5,145,47,145,349,4,634,56,634,798
1796.9,6,355,22480,207,69,8722,69,12420,148,69,12223,69,10060
41.936,6,1696,995696,889,168,47,168,35732,807,1152,52,2304,959964
1789.975,6,343,26588,166,291,10847,516,10799,177,38,10168,62,15789
1772.583,6,180,15480,120,69,14895,69,8940,60,69,30038,69,6540
1795.451,17,83,3480,82,14,22166,14,3444,1,8,0,8,36
10.969,6,37,15665,19,260,609,721,2589,18,1235,568,2840,13076
96.718,6,3,366,2,214,96718,214,314,1,0,0,0,52
0.004,17,2,306,1,36,0,36,64,1,214,0,214,242
23.419,6,35,5458,14,154,1801,722,1807,21,212,1116,1448,3651
77.73,6,11,8573,3,600,38865,684,1365,8,1355,4325,1408,7208
0.296,17,8,2750,8,315,42,354,2750,0,0,0,0,0
1091.36,17,216,16416,216,48,5076,48,16416,0,0,0,0,0
0.0,6,1,973,0,0,0,0,0,1,921,0,921,973
15.703,6,34,8466,16,247,1046,335,3119,18,660,907,1179,5347
2.33,6,13,2311,8,188,332,245,700,5,1407,513,1407,1611
1786.709,6,102,8160,68,63,26667,63,4862,34,57,54139,57,3298
113.901,6,29,6920,11,220,9662,516,1326,18,324,6675,1452,5594
0.99,6,13,1981,7,288,158,288,876,6,426,157,434,1105
67.694,17,4,240,2,32,67693,32,120,2,32,67692,32,120
2.545,6,18,3257,10,99,264,182,924,8,477,339,1343,2333
1739.715,17,299,58233,299,166,5837,358,58233,0,0,0,0,0
1.547,6,48,20141,28,894,57,1360,14565,20,476,71,2720,5576
2.094,17,2,778,2,361,2094,361,778,0,0,0,0,0
0.547,6,14,2039,8,182,78,182,534,6,417,72,419,1505
1.156,6,20,4960,10,137,128,267,1092,10,692,112,1467,3868
1746.127,6,108,8058,68,38,26061,205,4798,40,33,44761,98,3260
19.345,6,42,8595,22,488,921,656,2915,20,346,439,1871,5680
782.089,2,9,288,9,8,97761,8,288,0,0,0,0,0
4.002,17,8,668,4,39,1314,39,268,4,72,1319,72,400
301.752,6,53,27465,27,841,11605,1368,8985,26,951,2456,1571,18480
0.971,6,22,9898,13,1017,80,1360,8690,9,278,92,532,1208
1662.251,6,116,14314,68,78,24809,721,6482,48,327,9579,1440,7832
1798.593,17,142,11360,71,48,25694,48,5396,71,56,25694,56,5964
1791.72,17,140,11200,70,48,25966,48,5320,70,56,25966,56,5880
1795.111,17,80,3354,79,14,23014,14,3318,1,8,0,8,36
140.324,6,35,5505,18,148,8254,722,2120,17,277,8755,1448,3385
1777.968,1,29,3639,29,97,63498,320,3639,0,0,0,0,0
1789.471,17,87,3648,86,14,21052,14,3612,1,8,0,8,36
1.24,6,38,8254,19,321,68,1164,2718,19,433,59,1360,5536
757.29,17,58,4624,31,48,25243,48,2356,27,56,25231,56,2268
0.078,6,13,3514,7,75,13,75,447,6,1373,15,1448,3067
240.3,6,43,9187,21,519,12014,1402,5775,22,251,11442,618,3412
1.249,6,38,9848,21,440,62,1360,4392,17,476,66,2715,5456
1.669,6,65,56269,26,501,66,1396,3901,39,1676,41,6980,52368
616.044,6,91,15492,38,125,16649,615,4329,53,244,11844,4649,11163
1797.142,6,378,26835,218,103,8281,469,15881,160,69,11299,69,10954
0.321,17,2,162,1,36,0,36,64,1,70,0,70,98
1.187,6,31,12787,18,737,69,1408,6105,13,666,84,2688,6682
1.193,6,24,8004,12,164,92,267,1288,12,1014,92,2816,6716
2.713,6,2,88,2,0,0,0,88,0,0,0,0,0
1796.462,6,416,24920,208,69,8678,69,12460,208,34,8678,48,12460
22.421,6,25,4706,15,176,1601,517,2035,10,428,2490,499,2671
280.255,6,30,7432,13,158,23354,267,1317,17,543,17511,1400,6115
0.263,6,7,8980,1,0,0,0,40,6,1438,5,1438,8940
13.719,6,33,8992,15,158,979,267,1397,18,624,803,1400,7595
0.474,6,27,7296,13,155,39,267,1301,14,543,33,1400,5995
1787.456,6,102,8296,68,65,26678,65,4930,34,59,54155,59,3366
269.209,17,4,240,2,32,269208,32,120,2,32,269208,32,120
1772.22,6,113,6803,63,27,28583,27,3747,50,27,36166,27,3056
2.415,17,5,428,3,32,1179,32,180,2,96,56,96,248
24.366,6,17,2434,10,210,2707,210,984,7,545,4059,904,1450
101.734,6,23,8830,12,511,156,1194,2057,11,903,10155,1631,6773
1796.843,17,448,39896,403,35,4469,288,25676,45,288,40020,288,14220
0.166,6,25,7216,13,155,13,267,1301,12,775,14,4836,5915
0.013,17,4,680,2,33,1,33,122,2,251,0,323,558
1787.047,6,102,8296,68,65,26672,65,4930,34,59,54150,59,3366
1797.447,17,180,14040,180,50,10041,50,14040,0,0,0,0,0
1.349,6,10,861,5,222,335,222,426,5,231,335,231,435
112.709,6,9,7120,1,0,0,0,40,8,845,16097,959,7080
272.667,17,4,240,2,32,272666,32,120,2,32,272666,32,120
53.976,6,2004,1774807,1225,1363,44,1368,1723617,779,899,69,1473,51190
8.662,6,33,8137,17,344,541,685,1744,16,521,564,4080,6393
82.687,17,43,20382,18,526,4861,1350,9977,25,388,3388,1350,10405
1682.035,17,14,1036,7,30,280335,30,406,7,62,280337,62,630
1660.256,6,189,13970,99,75,16941,208,9533,90,31,15788,31,4437
1.291,17,6,2008,6,306,258,354,2008,0,0,0,0,0
2.358,17,2,329,1,45,0,45,73,1,228,0,228,256
0.144,17,2,290,1,40,0,40,68,1,194,0,194,222
1416.255,6,513,193072,246,734,5780,1440,153076,267,273,5321,1440,39996
11.254,6,91,29524,47,594,244,1152,23282,44,447,255,1179,6242
145.356,6,21,7979,11,525,89,1237,2048,10,919,16130,1591,5931
1796.079,1,234,24804,234,78,7708,78,24804,0,0,0,0,0
4.824,6,39,7269,20,218,253,314,3423,19,513,254,1179,3846
0.071,17,2,279,1,36,0,36,64,1,187,0,187,215
0.059,17,2,180,1,30,0,30,58,1,94,0,94,122
1796.419,6,241,35727,150,302,12056,302,25932,91,83,19960,83,9795
15.416,17,17,9592,8,539,2201,1350,4539,9,533,1923,1350,5053
0.071,6,10,1495,5,507,17,507,727,5,556,17,556,768
541.429,2,7,224,7,8,90238,8,224,0,0,0,0,0
1796.606,6,360,22818,209,69,8637,69,12569,151,69,11976,69,10249
1763.498,2,14,448,14,8,135653,8,448,0,0,0,0,0
1746.007,6,97,7307,63,38,28161,205,4476,34,33,52896,98,2831
1775.037,6,180,15480,120,69,14916,69,8940,60,69,30083,69,6540
1680.252,1,15,840,15,28,120018,28,840,0,0,0,0,0
1784.073,17,140,11200,70,48,25855,48,5320,70,56,25855,56,5880
0.326,17,8,2750,8,315,46,354,2750,0,0,0,0,0
1737.284,1,56,4704,56,56,31586,56,4704,0,0,0,0,0
1634.142,1,7,392,7,28,272357,28,392,0,0,0,0,0
0.074,17,2,128,1,28,0,28,56,1,44,0,44,72
1799.562,1,13,754,13,30,149963,30,754,0,0,0,0,0
16.56,17,25,13555,12,550,1502,1350,6938,13,481,1377,1350,6617
1795.036,17,449,39928,404,35,4454,288,25708,45,288,40021,288,14220
431.271,6,128,31109,63,706,6955,1418,25179,65,97,6737,580,5930
108.599,6,7,480,5,92,27149,92,360,2,0,18702,0,120
58.645,6,27,7177,13,155,4887,267,1306,14,530,4510,3417,5871
280.189,6,27,7312,13,158,23349,267,1317,14,775,21549,3445,5995
1740.99,6,104,7538,65,31,27202,31,4439,39,31,45815,31,3099
1750.552,17,12,498,11,14,175055,14,462,1,8,0,8,36
0.477,17,3,451,2,39,312,39,134,1,289,0,289,317
1758.161,6,100,7866,66,45,27048,205,4902,34,35,53266,98,2964
21.921,6,25,6757,12,181,1992,267,1212,13,717,1824,2036,5545
125.385,6,16,3249,8,92,17912,92,504,8,387,17885,1440,2745
29.914,17,9,684,9,48,3739,48,684,0,0,0,0,0
1795.166,17,448,39896,403,35,4465,288,25676,45,288,40016,288,14220
1121.046,17,29,9624,29,303,40037,308,9624,0,0,0,0,0
1769.493,6,99,9240,66,65,27222,65,5577,33,59,55293,59,3663
251.751,17,3,531,3,149,125875,355,531,0,0,0,0,0
1794.395,17,75,25200,75,308,24248,308,25200,0,0,0,0,0
68.814,6,41,8985,18,231,4047,314,3274,23,398,3115,1152,5711
0.182,17,2,212,1,46,0,46,74,1,110,0,110,138
60.41,6,10,2953,6,92,12082,92,412,4,2329,20065,2329,2541
1700.606,17,13,534,11,14,170041,14,462,2,8,1700431,8,72
0.07,17,2,198,1,39,0,39,67,1,103,0,103,131
32.228,17,4,240,2,32,32226,32,120,2,32,32227,32,120
1.104,6,25,8056,12,164,85,267,1288,13,869,78,1448,6768
0.81,17,23,6180,10,300,86,1350,3283,13,194,64,1350,2897
7.987,6,16,2556,10,210,871,210,1158,6,545,1596,904,1398
4.201,17,5,290,5,30,1050,30,290,0,0,0,0,0
1750.584,17,12,498,11,14,175058,14,462,1,8,0,8,36
303.596,17,10,3352,10,307,33732,308,3352,0,0,0,0,0
0.221,6,10,861,6,182,44,182,490,4,77,45,134,371
1538.4,6,176,12158,64,46,24419,46,5102,112,46,13858,46,7056
175.105,6,26,9389,13,487,14592,1440,2652,13,861,14532,1440,6737
0.884,17,3,215,2,33,880,33,122,1,65,0,65,93
0.334,6,9,1340,5,145,83,145,349,4,827,75,827,991
1752.895,6,147,9068,79,45,22473,208,5418,68,31,26159,31,3650
15.843,17,19,13425,11,986,1562,1350,11156,8,255,2252,1350,2269
10.765,6,20,4442,11,275,1076,275,998,9,768,753,1440,3444
64.633,17,4,240,2,32,64632,32,120,2,32,64632,32,120
864.69,1,8,448,8,28,123527,28,448,0,0,0,0,0
282.075,6,59,8683,27,158,10849,267,1877,32,502,9097,1400,6806
1637.641,1,8,448,8,28,233948,28,448,0,0,0,0,0
1.012,17,26,14658,13,836,84,1350,11240,13,234,65,1350,3418
0.253,6,33,8043,17,131,15,131,1023,16,441,16,500,7020
0.415,6,10,1992,5,288,97,288,508,5,424,60,434,1484
1750.659,6,107,8261,67,45,26525,205,4985,40,35,44878,98,3276
0.01,6,2,111,1,0,0,0,40,1,31,0,31,71
4.667,6,11,1275,7,304,777,304,968,4,83,1098,83,307
240.104,6,42,4907,22,181,11433,517,2255,20,178,12636,851,2652
0.008,17,2,384,1,32,0,32,60,1,296,0,296,324
0.014,17,2,358,1,30,0,30,58,1,272,0,272,300
0.228,6,10,1514,5,503,57,503,771,5,475,56,475,743
0.03,17,2,384,1,39,0,39,67,1,289,0,289,317
0.038,1,3,168,3,28,19,28,168,0,0,0,0,0
61.33,6,36,15966,22,807,2920,1408,9239,14,748,4698,2439,6727
35.233,17,20,1760,10,48,3913,48,760,10,72,3913,72,1000
63.519,6,36,9147,15,327,143,1189,2575,21,440,3175,1420,6572
245.173,6,57,9564,26,461,9806,1408,6030,31,147,8172,580,3534
4.002,6,11,467,6,0,800,0,248,5,7,742,7,219
5.639,17,5,320,5,36,1409,36,320,0,0,0,0,0
7.811,6,25,6937,7,138,1301,267,843,18,447,458,1460,6094
114.717,6,107,66930,53,927,99,1360,10560,54,1204,2161,1360,56370
1799.307,1,57,4788,57,56,32130,56,4788,0,0,0,0,0
100.642,6,47,10557,23,723,948,1360,4640,24,309,4367,2720,5917
0.0,17,2,2756,2,1350,0,1350,2756,0,0,0,0,0
1770.25,17,222,52260,222,207,8010,364,52260,0,0,0,0,0
778.654,17,36,1512,36,14,22247,14,1512,0,0,0,0,0
1781.305,1,58,4872,58,56,31250,56,4872,0,0,0,0,0
1783.219,17,141,11276,71,48,25473,48,5396,70,56,25843,56,5880
1793.809,17,144,11520,72,48,25264,48,5472,72,56,25264,56,6048
1789.969,6,368,23276,212,69,8483,69,12896,156,69,11548,69,10380
1.192,17,23,14477,13,881,96,1350,11818,10,237,128,1350,2659
0.252,17,2,2380,2,1162,252,1162,2380,0,0,0,0,0
1772.306,6,180,15480,120,69,14893,69,8940,60,69,30038,69,6540
214.3,17,4,244,2,33,214299,33,122,2,33,214299,33,122
0.11,6,9,1002,5,213,27,213,417,4,421,33,421,585
190.589,17,4,352,2,60,190588,60,176,2,60,190588,60,176
3.573,6,58,20894,29,977,127,1440,14904,29,370,117,1440,5990
0.397,6,54,23526,30,944,13,1380,16401,24,511,15,1923,7125
1792.189,1,284,15904,284,28,6332,28,15904,0,0,0,0,0
1.004,17,20,10015,9,587,125,1350,5537,11,379,91,1350,4478
15.3,17,17,11677,10,919,1696,1350,9478,7,286,2544,1350,2199
1729.197,6,63,4556,41,33,43229,33,2792,22,31,82334,31,1764
0.067,17,2,150,1,39,0,39,67,1,55,0,55,83
0.017,6,2,200,1,108,0,108,160,1,0,0,0,40
5.0,17,4,288,2,36,4999,36,128,2,52,5000,52,160
1440.974,6,299,21274,172,106,8426,469,12606,127,69,11436,69,8668
0.015,17,2,412,1,39,0,39,67,1,317,0,317,345
1783.702,17,142,11360,71,48,25480,48,5396,71,56,25480,56,5964
1786.459,6,102,8228,68,64,26663,64,4896,34,58,54132,58,3332
1361.554,17,20,6704,20,307,71660,308,6704,0,0,0,0,0
145.494,6,20,3509,6,92,87,92,412,14,215,11177,1448,3097
153.313,17,4,1344,4,308,51104,308,1344,0,0,0,0,0
1787.95,6,362,22898,210,69,8554,69,12678,152,69,11840,69,10220
0.013,6,2,104,1,0,0,0,64,1,0,0,0,40
0.366,17,2,136,1,32,0,32,60,1,48,0,48,76
1756.454,6,107,6374,60,27,29769,27,3525,47,27,38182,27,2849
0.053,17,2,212,1,46,0,46,74,1,110,0,110,138
280.505,17,6,1468,3,32,140250,37,181,3,401,140247,463,1287
1788.668,6,373,26028,216,98,8319,469,15263,157,69,11465,69,10765
0.01,17,2,411,1,33,0,33,61,1,322,0,322,350
283.923,17,4,352,2,60,283922,60,176,2,60,283922,60,176
1730.188,17,272,60724,272,195,6384,422,60724,0,0,0,0,0
1772.697,6,180,15480,120,69,14896,69,8940,60,69,30042,69,6540
1760.618,6,102,7970,66,45,27086,205,4902,36,35,50294,98,3068
1787.893,6,371,26224,212,100,8473,469,14896,159,69,11314,69,11328
0.01,6,3,226,2,106,0,106,186,1,0,0,0,40
300.849,6,44,13242,23,828,13674,1360,7600,21,399,479,1360,5642
421.159,2,5,160,5,8,105289,8,160,0,0,0,0,0
0.455,6,12,963,6,181,91,181,489,6,77,79,133,474
1799.731,17,740,44621,740,32,2435,37,44621,0,0,0,0,0
1226.108,6,76,10907,48,99,20766,498,4201,28,214,45408,1420,6706
17.587,17,50,25071,26,774,702,1350,20863,24,147,763,1350,4208
10.974,6,20,4442,11,275,1097,275,998,9,768,796,1440,3444
1772.5,6,181,15589,121,69,14770,69,9049,60,69,30035,69,6540
8.873,6,77,23681,39,560,233,1152,18393,38,470,229,1179,5288
290.937,17,2,150,2,47,290937,47,150,0,0,0,0,0
1692.009,1,8,448,8,28,241715,28,448,0,0,0,0,0
1789.171,17,83,3480,82,14,22088,14,3444,1,8,0,8,36
0.876,17,4,352,2,37,870,37,130,2,83,869,89,222
280.395,6,29,7392,13,158,23366,267,1317,16,603,18690,2076,6075
1787.319,6,102,8160,68,63,26676,63,4862,34,57,54157,57,3298
240.197,6,54,19724,29,853,8578,1418,16874,25,192,10007,580,2850
1.678,6,25,8759,15,284,119,585,1457,10,985,167,1420,7302
0.059,17,2,152,1,48,0,48,76,1,48,0,48,76
280.297,6,29,7392,12,158,25481,267,1277,17,543,17516,1400,6115
0.211,17,4,344,2,47,0,47,150,2,69,210,75,194
853.737,6,86,7373,57,69,15245,69,4212,29,69,30490,69,3161
2.365,6,17,4125,10,517,262,517,1053,7,1342,393,1408,3072
1755.447,6,225,21800,113,140,15673,208,16328,112,31,15810,31,5472
0.252,6,3,182,2,31,252,31,111,1,31,0,31,71
0.617,17,4,240,2,32,616,32,120,2,32,616,32,120
0.236,6,46,21314,26,1088,9,1420,16293,20,467,11,1883,5021
4.517,6,22,4426,12,213,410,597,1689,10,552,480,1767,2737
61.3,6,37,15936,22,800,2919,1448,9157,15,665,4360,1448,6779
11.581,6,1843,1596767,1112,1380,10,1414,1563306,731,467,15,1889,33461
1798.753,17,114,9120,57,48,32120,48,4332,57,56,32120,56,4788
1772.162,1,58,4872,58,56,31090,56,4872,0,0,0,0,0
1761.43,17,168,14050,156,30,11364,37,9090,12,385,154695,463,4960
481.289,2,4,128,4,8,160429,8,128,0,0,0,0,0
58.751,6,30,6425,15,282,1476,547,1451,15,397,4190,1420,4974
2.712,6,140,82323,73,1163,37,1440,73941,67,632,37,1440,8382
25.849,17,28,13383,14,688,1986,1350,10028,14,211,1985,1350,3355
81.645,6,18,744,7,0,8086,0,284,11,0,8163,0,460
64.309,6,22,7982,12,377,61,798,1681,10,981,7130,4080,6301
1.228,6,48,19197,27,888,47,1360,13581,21,476,52,2720,5616
20.261,6,21,5418,13,107,1688,159,1126,8,967,2887,1709,4292
300.641,6,71,53411,47,1241,6535,1368,47150,24,715,1675,2736,6261
1796.384,17,449,39928,404,35,4457,288,25708,45,288,40020,288,14220
0.21,6,21,4945,11,89,21,147,936,10,696,21,1408,4009
1791.528,6,419,25157,209,69,8613,69,12500,210,34,8571,69,12657
147.921,6,179,144706,112,1339,1332,1448,131723,67,632,2238,1448,12983
58.603,2,2,64,2,8,58603,8,64,0,0,0,0,0
1779.244,17,78,3270,77,14,23411,14,3234,1,8,0,8,36
104.503,6,30,7432,13,158,8708,267,1317,17,543,6526,1400,6115
366.23,6,99,20831,45,604,8323,1408,15143,54,124,6909,580,5688
1781.593,17,142,11360,71,48,25451,48,5396,71,56,25451,56,5964
260.095,1,3,1092,3,336,130047,336,1092,0,0,0,0,0
0.211,17,2,268,1,54,0,54,82,1,158,0,158,186
11.452,6,1829,1576154,1113,1363,10,1380,1543272,716,421,15,1923,32882
1786.297,6,106,8524,68,66,26661,66,4964,38,60,48275,60,3560
31.94,6,72,31892,44,409,742,718,8869,28,898,1182,2522,23023
1.09,17,6,360,3,32,544,32,180,3,32,544,32,180
1.382,6,41,9968,21,440,69,1360,4392,20,476,62,2720,5576
1772.582,1,232,12992,232,28,7673,28,12992,0,0,0,0,0
315.956,6,20,2429,7,242,52658,517,1111,13,323,26329,499,1318
22.054,17,37,10596,16,246,1468,1350,4398,21,267,1101,1350,6198
0.055,17,3,996,3,304,27,333,996,0,0,0,0,0
1781.649,6,119,7256,64,27,28280,27,3805,55,27,32989,27,3451
0.052,17,2,198,1,39,0,39,67,1,103,0,103,131
209.505,6,30,7432,13,158,17458,267,1317,17,543,13091,1400,6115
7.178,6,1805,1694050,1156,1389,6,1408,1655638,649,931,10,2816,38412
1.365,6,46,19459,27,915,52,1360,13923,19,476,64,2720,5536
5.001,6,38,15189,18,376,294,1202,2695,20,834,237,1360,12494
0.001,1,6,726,6,93,0,103,726,0,0,0,0,0
1.197,6,24,8016,12,164,93,267,1300,12,1014,93,2411,6716
727.483,6,46,12955,28,285,26943,1440,5171,18,526,42782,1440,7784
154.619,6,21,9351,11,418,66,944,1726,10,1202,17165,2590,7625
1799.211,17,449,39928,404,35,4464,288,25708,45,288,40012,288,14220
518.403,6,56,3030,28,0,19200,0,1456,28,29,19200,31,1574
0.436,6,7,295,4,0,145,0,164,3,7,109,7,131
0.011,17,2,365,1,40,0,40,68,1,269,0,269,297
3.059,6,51,41387,28,747,113,1360,7129,23,2221,132,5440,34258
1786.404,6,103,8404,68,66,26662,66,4964,35,60,52538,60,3440
1771.884,6,104,9648,68,65,26446,65,5758,36,59,50622,59,3890
0.009,17,2,235,1,36,0,36,64,1,143,0,143,171
120.08,6,166,129710,102,1340,1188,1448,116609,64,599,1901,1448,13101
1793.677,6,356,22520,208,69,8665,69,12460,148,69,12201,69,10060
4.928,17,5,4754,5,922,1232,1451,4754,0,0,0,0,0
0.031,17,2,136,1,32,0,32,60,1,48,0,48,76
3.855,6,14,2351,9,188,481,245,740,5,1407,894,1407,1611
1792.308,17,141,11268,72,48,25243,48,5472,69,56,25981,56,5796
1789.167,1,274,15344,274,28,6553,28,15344,0,0,0,0,0
32.767,6,10,580,3,0,16383,0,160,7,0,5423,0,420
171.018,17,4,240,2,32,171017,32,120,2,32,171017,32,120
300.632,6,37,8526,19,315,16701,882,2053,18,441,499,1460,6473
162.103,6,40,8616,15,124,11577,267,1731,25,293,6753,1452,6885
0.007,17,2,405,1,35,0,35,63,1,314,0,314,342
1799.586,17,447,39580,403,35,4476,288,25676,44,288,40950,288,13904
0.506,6,29,10225,14,231,38,563,1672,15,862,34,1448,8553
575.936,6,29,3623,18,171,33878,1440,2822,11,31,57573,31,801
1798.135,17,449,39928,404,35,4461,288,25708,45,288,40018,288,14220
280.537,6,30,7432,13,158,23378,267,1317,17,603,17525,2760,6115
0.061,17,2,144,1,36,0,36,64,1,52,0,52,80
65.47,17,4,352,2,60,65469,60,176,2,60,65469,60,176
1745.589,6,95,7203,63,38,28154,205,4476,32,33,56302,98,2727
280.037,6,32,7512,15,158,20002,267,1397,17,543,17499,1400,6115
371.385,6,25,1651,17,177,23211,177,1117,8,110,9212,110,534
155.894,6,30,7432,13,158,12991,267,1317,17,603,9740,2076,6115
0.344,6,24,6046,12,181,31,537,1526,12,648,29,1448,4520
0.069,17,2,152,1,48,0,48,76,1,48,0,48,76
89.613,17,4,352,2,60,89611,60,176,2,60,89612,60,176
4.0,17,8,792,4,39,1333,39,268,4,103,1328,103,524
1.95,17,2,334,1,32,0,32,60,1,246,0,246,274
1772.285,6,180,15480,120,69,14893,69,8940,60,69,30037,69,6540
0.016,17,3,286,2,46,3,46,148,1,110,0,110,138
0.292,6,2,80,1,0,0,0,40,1,0,0,0,40
623.092,6,43,3114,26,31,24923,31,1791,17,31,38939,31,1323
1788.529,17,469,59792,222,169,8092,1350,43851,247,36,7270,1350,15941
60.348,6,11,3005,6,92,12069,92,412,5,1164,15044,1408,2593
1.859,2,2,64,2,8,1859,8,64,0,0,0,0,0
223.93,17,4,240,2,32,223928,32,120,2,32,223929,32,120
1.062,17,4,314,2,31,1015,31,118,2,70,1030,70,196
8.578,17,6,528,3,48,4284,48,228,3,72,4283,72,300
73.007,17,8,2688,8,308,10429,308,2688,0,0,0,0,0
148.191,17,4,240,2,32,148190,32,120,2,32,148190,32,120
170.537,6,25,9908,12,549,55,1460,2709,13,952,14200,1460,7199
1791.048,6,356,22520,208,69,8652,69,12460,148,69,12183,69,10060
1740.521,17,28,6580,28,207,64463,207,6580,0,0,0,0,0
238.69,6,20,4962,12,536,21699,1244,2778,8,293,8607,1282,2184
0.069,6,25,37487,9,217,8,517,1345,16,2941,1,8412,36142
7.197,6,1259,1138477,764,1411,9,1448,1108073,495,776,14,1448,30404
1795.966,17,448,39896,403,35,4467,288,25676,45,288,40016,288,14220
1795.03,6,362,22898,210,69,8588,69,12678,152,69,11887,69,10220
0.413,17,2,152,1,48,0,48,76,1,48,0,48,76
4.398,17,3,3558,3,1158,2199,1449,3558,0,0,0,0,0
0.239,6,21,5000,10,137,26,267,1092,11,692,23,1467,3908
175.639,6,244,202041,158,1340,1118,1448,183767,86,599,2062,2359,18274
1.72,6,14,2181,8,324,245,585,1061,6,396,295,580,1120
1799.992,6,211,16454,78,71,22986,330,7860,133,48,13636,78,8594
0.015,17,2,382,1,36,0,36,64,1,290,0,290,318
1643.234,1,8,448,8,28,234747,28,448,0,0,0,0,0
1792.667,6,356,22520,208,69,8660,69,12460,148,69,12194,69,10060
1740.485,17,30,20190,30,645,60016,645,20190,0,0,0,0,0
75.784,6,34,7733,13,155,6315,267,1306,21,348,3788,1420,6427
1797.716,17,180,14040,180,50,10043,50,14040,0,0,0,0,0
51.528,17,44,6704,22,48,2453,48,1672,22,200,2453,308,5032
1.361,6,51,20939,28,939,50,1460,15243,23,476,53,2615,5696
1779.383,17,140,11200,70,48,25788,48,5320,70,56,25788,56,5880
10.804,6,1733,1494204,1048,1372,10,1420,1462571,685,467,15,1883,31633
0.875,6,10,1687,7,100,145,100,384,3,1179,310,1179,1303
240.378,6,46,8551,24,449,10450,1418,5752,22,205,11446,580,2799
0.226,6,23,6673,10,181,18,267,1128,13,627,18,1400,5545
1747.04,6,99,7144,64,31,27730,31,4289,35,31,51377,31,2855
1782.081,6,117,13596,77,81,23448,500,6029,40,156,45692,1420,7567
106.708,1,2,120,2,32,106708,32,120,0,0,0,0,0
100.845,6,81,10423,37,152,2801,630,4716,44,151,2343,580,5707
1788.64,17,83,3480,82,14,22081,14,3444,1,8,0,8,36
0.148,6,10,1863,5,105,37,105,325,5,1326,36,1326,1538
1795.816,17,448,39896,403,35,4467,288,25676,45,288,40018,288,14220
9.176,17,8,664,4,47,3056,47,300,4,63,3056,63,364
1798.663,17,141,11276,71,48,25695,48,5396,70,56,26067,56,5880
1237.111,6,247,15607,143,69,8711,69,8618,104,69,12010,69,6989
0.028,17,4,284,2,32,0,32,120,2,54,12,60,164
416.636,2,3,96,3,8,208318,8,96,0,0,0,0,0
488.218,6,64,8680,33,304,15256,304,5704,31,83,16265,83,2976
1799.479,6,404,39127,234,175,7723,789,22157,170,124,10645,725,16970
1792.384,6,173,19881,92,115,19696,722,10013,81,157,22398,1440,9868
8.307,17,12,1764,6,48,1657,48,456,6,190,1658,308,1308
0.25,6,10,1370,5,125,62,125,393,5,356,62,380,977
300.575,6,11,912,6,226,60079,226,546,5,110,75099,110,366
58.662,6,13,1079,12,43,5332,43,1019,1,0,0,0,60
275.572,6,29,5275,14,189,8511,516,1512,15,263,19676,1452,3763
225.9,17,4,304,2,48,225899,64,152,2,48,225899,64,152
1.26,6,26,8108,13,164,90,267,1340,13,869,90,1408,6768
1749.554,17,12,498,11,14,174955,14,462,1,8,0,8,36
1785.534,6,105,8682,71,66,25507,66,5282,34,60,54104,60,3400
1749.052,6,97,7338,62,38,28672,205,4424,35,33,51429,98,2914
58.056,17,12,1764,6,48,11609,48,456,6,190,11609,308,1308
0.057,17,2,588,1,39,0,39,67,1,493,0,493,521
3.114,6,52,27951,31,962,103,1360,11988,21,1259,148,2720,15963
2.24,1,2,270,2,107,2240,121,270,0,0,0,0,0
0.235,6,23,6012,12,181,21,537,1526,11,781,22,2224,4486
2.859,6,36,12928,19,266,155,540,2180,17,1116,167,1591,10748
12.805,6,1768,1654846,1165,1369,11,1380,1624648,603,383,21,1380,30198
182.95,6,10,560,5,0,45695,0,300,5,0,45695,0,260
2.594,17,4,610,3,39,540,39,201,1,381,0,381,409
0.87,6,20,6829,8,163,123,267,819,12,788,78,1420,6010
1610.557,1,24,1344,24,28,70024,28,1344,0,0,0,0,0
0.918,6,10,1687,7,100,153,100,384,3,1179,326,1179,1303
1769.986,6,99,9240,66,65,27230,65,5577,33,59,55309,59,3663
152.468,17,4,352,2,60,152467,60,176,2,60,152467,60,176
300.63,6,41,11692,21,272,15031,742,1961,20,594,447,1460,9731
1793.409,6,356,22520,208,69,8663,69,12460,148,69,12199,69,10060
2.331,6,13,2512,5,299,578,299,579,8,301,330,492,1933
84.257,17,4,1344,4,308,28085,308,1344,0,0,0,0,0
0.369,17,2,904,2,424,369,548,904,0,0,0,0,0
4.211,17,5,295,5,31,1052,31,295,0,0,0,0,0
8.25,6,78,24677,39,561,217,1152,18976,39,413,210,1152,5701
0.315,6,20,4960,10,137,35,267,1092,10,692,34,1467,3868
8.49,6,33,12651,15,481,606,721,2531,18,722,394,1440,10120
10.741,6,20,4442,11,275,1074,275,998,9,768,740,1440,3444
1746.236,6,122,9039,75,37,23597,205,5255,47,32,37955,98,3784
1744.536,6,95,7203,63,38,28137,205,4476,32,33,56266,98,2727
2.205,17,4,360,2,30,2146,30,116,2,94,2159,94,244
1.195,6,59,18058,29,706,42,1360,8949,30,438,40,1360,9109
1.274,6,50,19308,27,892,49,1460,13612,23,433,50,1460,5696
7.362,17,3,228,3,48,3681,48,228,0,0,0,0,0
0.165,17,2,2756,2,1350,165,1350,2756,0,0,0,0,0
1796.744,17,440,39640,395,36,4560,288,25420,45,288,40019,288,14220
5.512,6,15,10510,6,275,1102,275,519,9,1375,634,4260,9991
0.595,6,20,7196,13,325,49,626,1984,7,1210,93,1946,5212
1799.229,6,382,26995,219,103,8253,469,15990,163,69,11104,69,11005
40.135,17,21,1596,21,48,2006,48,1596,0,0,0,0,0
1705.17,1,14,1141,14,53,131166,78,1141,0,0,0,0,0
284.628,1,4,326,4,53,94876,78,326,0,0,0,0,0
1785.094,6,358,22669,209,69,8582,69,12569,149,69,12061,69,10100
1.812,6,9,527,5,43,453,43,311,4,0,602,0,216
1740.405,17,30,31680,30,1028,60013,1028,31680,0,0,0,0,0
1770.948,6,99,9240,66,65,27245,65,5577,33,59,55339,59,3663
5.656,6,57,27019,25,1036,235,1440,16598,32,608,176,1440,10421
0.126,17,3,404,2,64,89,64,184,1,192,0,192,220
4.645,6,38,7229,20,218,244,314,3423,18,513,257,1179,3806
0.009,17,4,927,2,33,0,33,122,2,374,1,404,805
281.565,6,31,7476,14,158,21658,267,1357,17,678,17594,2760,6119
6.743,2,2,64,2,8,6743,8,64,0,0,0,0,0
4.347,6,38,7229,19,218,241,314,3383,19,440,226,1152,3846
41.688,17,44,6468,22,48,1982,48,1672,22,190,1979,308,4796
16.893,6,377,491747,144,331,118,332,8158,233,2058,72,8448,483589
0.941,6,5,637,3,241,470,241,373,2,92,477,92,264
600.201,6,49,8351,27,117,18725,516,2494,22,261,28576,2642,5857
9.076,2,2,64,2,8,9076,8,64,0,0,0,0,0
1795.572,6,416,28921,231,93,7806,469,16898,185,69,9755,69,12023
291.101,1,3,168,3,28,145550,28,168,0,0,0,0,0
0.8,17,8,2750,8,315,114,354,2750,0,0,0,0,0
260.81,17,4,352,2,60,260809,60,176,2,60,260809,60,176
1773.225,6,183,15669,121,69,14776,69,9049,62,69,29066,69,6620
0.164,6,40,16679,23,985,7,1420,11778,17,467,9,1883,4901
60.047,6,8,432,5,0,15011,0,268,3,0,30007,0,164
1787.483,6,215,16949,137,69,13143,69,9689,78,69,23213,69,7260
110.673,6,33,16580,15,426,58,956,1923,18,994,6501,1440,14657
308.939,6,23,7661,7,272,398,517,1101,16,455,20590,1452,6560
0.993,17,2,925,1,548,0,548,576,1,321,0,321,349
300.614,6,343,465355,200,162,1510,230,11374,143,3189,2116,19628,453981
170.906,6,16,3969,8,407,24415,722,1226,8,464,24384,1408,2743
1794.689,1,206,11536,206,28,8754,28,11536,0,0,0,0,0
365.73,6,18,1242,14,180,28133,180,916,4,110,20055,110,326
0.048,6,7,423,4,43,3,43,259,3,0,22,0,164
1770.947,6,103,9514,66,66,27245,66,5610,37,60,49190,60,3904
0.149,6,11,742,6,71,29,71,391,5,83,27,83,351
15.402,17,10,880,5,48,3845,48,380,5,72,3843,72,500
0.249,6,3,120,2,0,249,0,80,1,0,0,0,40
1781.008,17,130,29287,130,197,13806,422,29287,0,0,0,0,0
0.163,6,44,17929,24,992,7,1420,12908,20,420,8,1420,5021
300.559,6,38,8471,20,291,15818,786,1997,18,441,495,1360,6474
0.01,17,2,457,1,40,0,40,68,1,361,0,361,389
1746.968,6,143,9855,77,68,22986,208,5975,66,31,26870,31,3880
0.054,17,4,352,2,60,11,60,176,2,60,30,60,176
1799.401,1,57,4788,0,0,0,0,0,57,56,32132,56,4788
0.017,17,2,423,1,39,0,39,67,1,328,0,328,356
61.653,6,31,8843,14,158,4742,267,1357,17,680,3850,1400,7486
7.242,6,5,216,2,0,7242,0,84,3,0,1513,0,132
1773.685,1,152,8512,152,28,11746,28,8512,0,0,0,0,0
6.038,6,1251,1129531,775,1379,7,1408,1100115,476,931,12,2801,29416
3.334,17,5,290,5,30,833,30,290,0,0,0,0,0
1786.83,6,102,8296,68,65,26669,65,4930,34,59,54142,59,3366
5.381,6,37,7189,19,218,298,314,3383,18,513,299,1179,3806
0.048,17,2,152,1,48,0,48,76,1,48,0,48,76
449.145,6,63,8059,29,115,16035,722,3131,34,132,13605,1408,4928
0.012,6,5,6040,1,0,0,0,40,4,1448,3,1448,6000
0.045,17,2,160,1,48,0,48,76,1,56,0,56,84
1772.0,6,180,15480,120,69,14890,69,8940,60,69,30031,69,6540
18.897,1,6,636,6,78,3779,78,636,0,0,0,0,0
41.463,17,3,228,3,48,20731,48,228,0,0,0,0,0
0.042,6,2,132,2,26,42,26,132,0,0,0,0,0
14.942,6,2236,2048429,1417,1367,10,1408,2001177,819,931,18,2816,47252
756.293,2,4,128,4,8,252097,8,128,0,0,0,0,0
192.697,17,82,3280,40,12,4901,12,1600,42,12,4699,12,1680
1093.66,6,781,787693,310,160,3539,833,23556,471,1740,2326,7010,764137
1775.206,6,108,8462,69,42,26105,205,4976,39,39,46705,149,3486
1789.56,1,58,4872,58,56,31395,56,4872,0,0,0,0,0
3.002,17,6,1486,3,30,1496,30,174,3,409,1476,468,1312
0.188,17,2,180,1,30,0,30,58,1,94,0,94,122
0.042,6,3,187,1,0,0,0,52,2,31,0,31,135
280.195,6,32,7512,15,158,20013,267,1397,17,543,17509,1400,6115
1787.094,6,108,8664,69,66,26280,66,5004,39,60,47026,60,3660
1773.039,6,180,15480,120,69,14899,69,8940,60,69,30050,69,6540
0.011,17,2,140,1,42,0,42,70,1,42,0,42,70
1740.562,1,15,840,15,28,124325,28,840,0,0,0,0,0
1.334,6,10,1687,7,100,222,100,384,3,1179,536,1179,1303
1785.319,1,342,28728,342,56,5235,56,28728,0,0,0,0,0
21.278,1,10,280,10,0,0,0,280,0,0,0,0,0
287.526,6,338,276042,216,1315,1337,1408,254635,122,557,2261,1408,21407
4.369,6,37,7189,19,218,242,314,3383,18,513,241,1179,3806
2.099,6,30,5942,16,104,139,267,1477,14,650,151,1420,4465
1771.639,6,120,15473,75,170,23941,889,10193,45,77,40262,192,5280
1030.714,6,149,20029,81,128,11551,469,8776,68,144,15383,1452,11253
31.174,6,45,20069,24,1221,384,1460,14427,21,399,1549,1460,5642
0.622,6,22,5040,11,137,62,267,1132,11,692,52,1467,3908
43.114,6,5658,5378059,3631,1401,11,1448,5267979,2027,776,21,1448,110080
6.13,17,6,498,3,47,3063,47,225,3,63,3062,63,273
11.799,6,1924,1642239,1159,1363,10,1380,1607397,765,421,15,2760,34842
1744.016,6,107,8342,69,42,25647,205,4980,38,38,47124,149,3362
61.619,6,602,275716,312,820,198,1152,258611,290,392,212,1152,17105
301.769,6,60,26949,34,1082,9139,1440,20878,26,358,12063,1440,6071
1744.946,6,97,7307,63,38,28144,205,4476,34,33,52865,98,2831
300.996,6,63,27234,33,1017,9406,1448,15015,30,532,505,1406,12219
287.295,6,12,1526,7,226,47855,226,1050,5,110,71782,110,476
115.834,17,4,352,2,60,115833,60,176,2,60,115833,60,176
0.465,17,2,154,1,33,0,33,61,1,65,0,65,93
0.944,6,24,7886,14,319,72,602,2024,10,889,104,1471,5862
1787.422,6,106,8320,68,63,26677,63,4862,38,57,48306,57,3458
1734.451,1,8,448,8,28,247778,28,448,0,0,0,0,0
0.534,17,2,152,1,48,0,48,76,1,48,0,48,76
0.586,17,4,624,2,64,362,64,184,2,192,365,192,440
0.014,17,2,503,1,40,0,40,68,1,407,0,407,435
0.57,6,3,120,2,0,2,0,80,1,0,0,0,40
0.499,17,3,451,2,39,424,39,134,1,289,0,289,317
1793.265,17,180,11520,180,36,10018,36,11520,0,0,0,0,0
1763.848,2,14,448,14,8,135680,8,448,0,0,0,0,0
39.744,2,4,128,4,8,13248,8,128,0,0,0,0,0
1740.305,6,87,6322,58,31,30531,31,3915,29,31,62152,31,2407
382.471,6,18,1242,14,180,29420,180,916,4,110,20073,110,326
21.44,6,5,611,3,91,10720,91,211,2,160,11875,160,400
1787.104,6,356,22520,208,69,8633,69,12460,148,69,12157,69,10060
867.294,6,147,26192,93,316,9427,316,19368,54,83,16340,83,6824
16.089,6,2746,2585203,1778,1375,8,1408,2530203,968,931,16,2801,55000
280.036,6,27,7312,11,158,28003,267,1237,16,603,18666,2036,6075
12.57,6,33,8426,15,247,897,335,3079,18,660,724,1179,5347
902.384,2,8,256,8,8,128912,8,256,0,0,0,0,0
15.115,17,12,5221,6,490,3017,1350,3111,6,323,3016,1350,2110
302.81,17,4,1375,1,300,0,300,328,3,321,150907,321,1047
0.0,17,1,99,1,71,0,71,99,0,0,0,0,0
238.062,17,4,240,2,32,238061,32,120,2,32,238061,32,120
1795.971,6,356,22520,208,69,8676,69,12460,148,69,12217,69,10060
3.003,17,2,1430,2,687,3003,687,1430,0,0,0,0,0
317.029,6,71,18735,36,339,9057,1460,9616,35,350,9320,3089,9119
1.451,6,10,1687,7,100,241,100,384,3,1179,593,1179,1303
1795.562,1,58,4872,58,56,31501,56,4872,0,0,0,0,0
368.327,6,18,1242,14,180,28332,180,916,4,110,20063,110,326
367.004,6,21,1422,15,180,26214,180,992,6,110,12231,110,430
0.019,17,2,136,1,32,0,32,60,1,48,0,48,76
114.817,6,23,6160,8,267,315,501,1125,15,369,8194,1420,5035
0.01,17,2,144,1,36,0,36,64,1,52,0,52,80
1792.947,17,140,11200,70,48,25984,48,5320,70,56,25984,56,5880
153.11,17,4,352,2,60,153109,60,176,2,60,153109,60,176
1516.025,6,212,25653,69,109,22294,1305,6888,143,115,10675,3289,18765
0.094,6,9,1339,5,145,23,145,349,4,826,22,826,990
105.949,6,89,56962,51,1199,2118,1368,48249,38,841,1678,2519,8713
840.784,17,8,592,4,30,280256,30,232,4,62,280257,62,360
58.07,17,6,528,3,48,29030,48,228,3,72,29030,72,300
1700.95,1,8,448,8,28,242992,28,448,0,0,0,0,0
300.819,6,49,13214,26,783,12032,1360,7399,23,325,409,1360,5815
282.089,6,29,7392,13,158,23507,267,1317,16,603,18799,1400,6075
1756.255,6,254,26297,128,146,13828,239,20234,126,31,13974,31,6063
299.923,1,4,224,4,28,99974,28,224,0,0,0,0,0
1794.627,6,361,22858,210,69,8586,69,12678,151,69,11963,69,10180
1784.837,6,369,23385,213,69,8419,69,13005,156,69,11514,69,10380
1745.542,6,90,6540,60,31,29585,31,4050,30,31,60180,31,2490
1348.889,1,34,1904,34,28,40875,28,1904,0,0,0,0,0
26.96,6,2,104,2,0,0,0,104,0,0,0,0,0
0.006,17,2,426,1,37,0,37,65,1,333,0,333,361
280.407,6,30,7432,13,158,23367,267,1317,17,603,17522,2760,6115
1572.876,1,7,392,7,28,262146,28,392,0,0,0,0,0
1741.943,1,14,812,14,30,133995,30,812,0,0,0,0,0
0.868,17,2,157,1,31,0,31,59,1,70,0,70,98
0.03,17,2,198,1,39,0,39,67,1,103,0,103,131
280.573,6,30,7432,13,158,23381,267,1317,17,603,17530,2760,6115
1720.731,17,13,534,11,14,172055,14,462,2,8,1720537,8,72
0.932,6,27,5740,13,125,77,267,1275,14,650,65,1420,4465
1752.995,6,184,11305,92,47,19263,208,6695,92,31,19260,31,4610
1775.352,17,73,3060,72,14,25004,14,3024,1,8,0,8,36
1.28,6,12,5628,3,106,640,106,234,9,718,158,1420,5394
0.469,6,13,1693,7,288,77,288,588,6,426,57,434,1105
0.159,17,2,144,1,36,0,36,64,1,52,0,52,80
4.014,17,5,1160,5,204,1003,204,1160,0,0,0,0,0
236.078,17,4,352,2,60,236077,60,176,2,60,236077,60,176
1797.786,6,353,22262,206,69,8769,69,12311,147,69,12313,69,9951
1.302,6,3,199,1,0,0,0,52,2,31,1302,31,147
1771.285,1,52,4368,52,56,34731,56,4368,0,0,0,0,0
3.966,6,16,4153,9,49,495,92,575,7,1070,630,1448,3578
1799.818,6,165,24249,96,255,18944,1303,16340,69,105,26466,361,7909
300.626,6,36,8486,19,315,16701,882,2053,17,478,528,2128,6433
2.348,17,2,136,1,32,0,32,60,1,48,0,48,76
4.019,6,2,88,2,0,0,0,88,0,0,0,0,0
1798.048,6,366,24672,213,88,8481,469,14067,153,69,11828,69,10605
6.157,1,2,112,2,28,6157,28,112,0,0,0,0,0
1684.413,17,18,6397,18,327,99083,1284,6397,0,0,0,0,0
45.172,17,18,1368,18,48,2657,48,1368,0,0,0,0,0
1.044,6,25,6735,14,362,79,1148,2375,11,783,103,1420,4360
10.943,6,960,788988,535,1382,20,1448,757528,425,776,25,1448,31460
2.235,6,14,2351,8,188,319,245,700,6,703,398,1152,1651
1.843,17,4,808,3,64,913,64,276,1,504,0,504,532
0.006,17,2,354,1,46,0,46,74,1,252,0,252,280
1776.321,17,73,3060,72,14,25018,14,3024,1,8,0,8,36
2.714,6,78,61741,42,210,66,255,3243,36,1665,76,7240,58498
1781.336,17,142,11360,71,48,25447,48,5396,71,56,25447,56,5964
17.32,6,25,8116,10,133,1924,267,941,15,656,1224,2077,7175
1793.264,17,140,11200,70,48,25989,48,5320,70,56,25989,56,5880
61.427,6,11,1583,11,127,6142,127,1583,0,0,0,0,0
84.218,6,29,13323,16,469,101,1360,3019,13,1221,7007,3928,10304
10.84,6,20,4442,11,275,1084,275,998,9,768,758,1440,3444
1773.01,6,180,15480,120,69,14899,69,8940,60,69,30042,69,6540
1798.003,6,356,22520,208,69,8686,69,12460,148,69,12231,69,10060
1774.422,6,180,15480,120,69,14911,69,8940,60,69,30074,69,6540
300.626,6,42,8701,21,276,15031,728,2014,21,364,422,1460,6687
1737.064,1,65,5460,65,56,27141,56,5460,0,0,0,0,0
71.207,6,48,8490,20,123,3747,267,1921,28,388,2636,1452,6569
0.612,6,18,7096,10,180,68,180,612,8,1230,29,1716,6484
1.305,6,49,20448,27,977,50,1460,14792,22,433,53,1460,5656
1771.759,6,101,9344,66,65,27257,65,5577,35,59,52107,59,3767
1.266,6,41,9980,21,440,63,1360,4404,20,476,57,2720,5576
5.654,6,40,7309,21,218,282,314,3463,19,440,299,1152,3846
0.024,6,10,1327,5,299,4,299,567,5,246,5,459,760
310.193,6,56,12913,28,647,11488,1460,6380,28,284,580,1460,6533
93.312,17,4,589,4,119,31104,336,589,0,0,0,0,0
2.066,17,2,144,1,36,0,36,64,1,52,0,52,80
1790.24,6,356,22520,208,69,8648,69,12460,148,69,12178,69,10060
1798.916,6,365,25032,213,94,8485,469,14536,152,69,11910,69,10496
91.127,6,37,11077,13,181,7593,417,1107,24,473,1647,1460,9970
1799.997,6,511,205613,251,809,7080,1440,175228,260,208,6949,1440,30385
240.261,6,42,8874,21,523,12012,1408,5810,21,218,12012,618,3064
270.585,6,30,7432,14,158,20814,267,1357,16,678,18035,3456,6075
1779.613,17,142,11360,71,48,25422,48,5396,71,56,25422,56,5964
0.366,6,21,7217,13,318,30,599,1957,8,967,50,1471,5260
247.56,6,40,8732,16,110,16504,267,1978,24,321,9177,1933,6754
1790.871,1,342,28728,342,56,5251,56,28728,0,0,0,0,0
6.205,6,1747,1624603,1107,1390,5,1408,1586659,640,931,9,2801,37944
325.715,6,8,537,8,31,46530,31,537,0,0,0,0,0
0.053,17,4,368,2,32,2,32,120,2,96,0,96,248
0.087,6,10,767,5,186,18,186,454,5,45,17,45,313
1793.326,6,366,23196,212,69,8499,69,12896,154,69,11720,69,10300
6.176,17,4,304,3,48,3048,48,228,1,48,0,48,76
1786.705,6,104,8376,68,65,26667,65,4930,36,59,51045,59,3446
1.022,17,3,265,2,39,1000,39,134,1,103,0,103,131
31.578,6,7,336,1,0,0,0,48,6,0,6313,0,288
244.701,6,374,404524,133,736,1853,1402,25550,241,1728,1019,7010,378974
1795.261,17,75,3141,73,13,24934,14,3061,2,12,1694920,16,80
1749.144,6,100,7506,64,38,27764,205,4559,36,33,49965,98,2947
1.94,6,3,144,2,0,1940,0,92,1,0,0,0,52
1665.709,1,7,392,7,28,277618,28,392,0,0,0,0,0
1784.542,6,354,22440,207,69,8662,69,12420,147,69,12222,69,10020
5.306,17,22,7437,11,399,526,1350,4697,11,221,526,1350,2740
0.046,17,2,338,1,33,0,33,61,1,249,0,249,277
0.01,6,2,218,1,138,0,138,178,1,0,0,0,40
0.093,17,2,152,1,48,0,48,76,1,48,0,48,76
1796.63,1,141,7896,141,28,12833,28,7896,0,0,0,0,0
233.658,6,31,6806,13,189,9851,516,1470,18,307,13739,1452,5336
1772.56,6,180,15480,120,69,14895,69,8940,60,69,30042,69,6540
161.959,6,36,8132,13,141,2567,267,1375,23,323,7361,3417,6757
17.763,6,393,299155,233,1323,75,1360,287221,160,290,110,1360,11934
8.739,6,1793,1561678,1021,1439,8,1448,1512322,772,776,11,1448,49356
0.386,6,13,1693,7,288,58,288,588,6,426,43,434,1105
1237.162,6,75,6121,39,27,32555,27,2298,36,150,35346,427,3823
0.273,6,27,9065,13,252,22,646,1694,14,947,20,1402,7371
180.528,17,2,122,2,33,180528,33,122,0,0,0,0,0
1751.909,1,79,6636,0,0,0,0,0,79,56,22460,56,6636
1747.264,1,74,6216,74,56,23935,56,6216,0,0,0,0,0
392.998,6,23,1499,14,177,30230,177,913,9,110,10729,110,586
10.767,6,19,4266,11,275,1076,275,998,8,978,853,1420,3268
11.829,6,1877,1635698,1137,1384,10,1420,1601877,740,467,15,1883,33821
0.27,17,2,136,1,32,0,32,60,1,48,0,48,76
1799.345,17,142,11360,71,48,25704,48,5396,71,56,25704,56,5964
0.022,17,2,405,1,34,0,34,62,1,315,0,315,343
1787.252,6,162,21231,93,304,19426,304,14868,69,83,26283,83,6363
11.49,17,4,304,4,48,3830,48,304,0,0,0,0,0
1651.202,1,7,392,7,28,275200,28,392,0,0,0,0,0
0.007,6,2,92,1,0,0,0,40,1,0,0,0,52
9.805,6,87,26565,43,563,233,1152,20307,44,449,222,1179,6258
128.888,17,12,960,6,48,25774,48,456,6,56,25774,56,504
182.186,6,22,9126,12,304,79,597,1425,10,1214,20221,2720,7701
61.421,6,26,4899,12,517,5583,517,1181,14,1459,4724,1500,3718
13.8,17,6,6233,6,1010,2760,1451,6233,0,0,0,0,0
0.139,17,2,2384,2,1164,139,1164,2384,0,0,0,0,0
76.097,17,4,352,2,60,76095,60,176,2,60,76096,60,176
114.31,6,2335,1702969,1181,1365,96,1380,1642191,1154,468,99,3303,60778
13.678,6,16,1327,8,222,1951,222,768,8,231,1951,231,559
381.048,6,21,1422,15,180,27217,180,992,6,110,12239,110,430
14.062,6,27,7177,13,155,1171,267,1306,14,530,1081,3417,5871
19.703,1,24,2496,0,0,0,0,0,24,76,856,76,2496
117.431,17,4,240,2,32,117430,32,120,2,32,117430,32,120
63.359,6,13,716,7,0,10559,0,380,6,0,12556,0,336
294.491,6,6,364,4,31,98163,31,222,2,31,294458,31,142
0.042,17,2,176,1,48,0,48,76,1,72,0,72,100
1799.848,17,450,39960,405,35,4455,288,25740,45,288,40017,288,14220
10.003,6,91,28863,47,576,217,1152,22621,44,447,226,1179,6242
374.756,6,18,1242,14,180,28827,180,916,4,110,20073,110,326
280.227,6,29,7392,13,158,23352,267,1317,16,603,18681,1400,6075
0.875,6,11,1727,7,100,145,100,384,4,589,207,1152,1343
1763.878,1,8,448,8,28,251982,28,448,0,0,0,0,0
1790.418,1,102,10812,102,78,17726,78,10812,0,0,0,0,0
1743.558,6,111,8605,71,45,24907,205,5193,40,34,44695,98,3412
280.435,6,30,7432,14,158,21571,267,1357,16,678,18690,3456,6075
7.831,17,12,1764,6,48,1563,48,456,6,190,1563,308,1308
8.174,6,70,20766,36,559,233,1152,15979,34,427,240,1152,4787
386.343,6,18,1242,14,180,29718,180,916,4,110,20094,110,326
1.36,6,48,19615,27,920,52,1360,13999,21,433,58,1360,5616
0.234,6,29,8832,14,158,18,267,1357,15,687,15,2036,7475
0.43,17,25,17182,14,838,30,1350,12135,11,430,39,1350,5047
39.152,6,46,9825,25,278,1631,944,3068,21,492,704,4848,6757
125.319,6,42,25923,19,840,41,1460,5847,23,1196,5690,1460,20076
1.418,6,49,19650,27,920,54,1360,13994,22,476,57,2715,5656
1798.504,1,61,5124,61,56,29975,56,5124,0,0,0,0,0
6.427,6,3,168,1,0,0,0,52,2,0,6427,0,116
107.071,17,4,462,2,34,107031,34,124,2,141,107057,141,338
1742.461,6,97,7307,63,38,28104,205,4476,34,33,52794,98,2831
9.829,6,31,8912,14,158,756,267,1357,17,763,609,2760,7555
3.889,6,12,648,8,0,555,0,440,4,0,982,0,208
7.017,6,20,8384,7,106,1169,106,394,13,678,584,1420,7990
39.667,6,45,9729,23,259,544,464,1790,22,542,1882,2720,7939
1.746,17,20,5190,20,231,91,389,5190,0,0,0,0,0
63.378,6,7,424,4,112,21126,112,280,3,0,1516,0,144
1798.205,17,450,39960,405,35,4451,288,25740,45,288,40022,288,14220
1751.913,1,59,4956,59,56,30205,56,4956,0,0,0,0,0
201.996,6,32,8952,14,158,15538,267,1357,18,624,11879,1400,7595
1795.299,17,449,39928,404,35,4454,288,25708,45,288,40022,288,14220
190.722,17,4,352,2,60,190720,60,176,2,60,190721,60,176
1.587,6,51,20903,29,933,56,1360,15202,22,437,67,2715,5701
1.25,6,49,20372,28,906,46,1360,14756,21,476,53,2715,5616
115.025,6,128,97738,79,1296,1474,1448,87088,49,735,2391,2359,10650
1782.487,6,356,22589,208,69,8611,69,12460,148,69,12125,69,10129
0.266,6,27,7296,13,155,22,267,1301,14,603,19,2036,5995
1794.703,17,142,11360,71,48,25638,48,5396,71,56,25638,56,5964
5.033,17,6,1392,6,204,1006,204,1392,0,0,0,0,0
0.375,6,12,3702,6,170,71,170,490,6,964,61,1448,3212
21.163,17,34,11325,16,282,1408,1350,4974,18,324,1243,1350,6351
150.689,6,23,9936,11,397,72,884,1665,12,972,13686,1460,8271
273.717,17,4,240,2,32,273716,32,120,2,32,273716,32,120
11.501,17,8,704,4,48,3830,48,304,4,72,3830,72,400
8.805,6,44,7469,23,218,400,314,3543,21,440,426,1152,3926
4.393,6,38,7245,19,218,244,314,3383,19,516,229,1179,3862
280.459,6,28,7352,12,158,25496,267,1277,16,678,18695,2760,6075
0.208,6,9,1242,5,145,52,145,349,4,729,50,729,893
0.412,17,2,178,1,29,0,29,57,1,93,0,93,121
0.188,6,4,493,2,241,188,241,321,2,92,3,92,172
8.155,1,9,756,9,56,1019,56,756,0,0,0,0,0
0.029,6,2,364,1,0,0,0,40,1,272,0,272,324
280.53,6,29,7392,13,158,23377,267,1317,16,603,18699,2036,6075
22.898,17,4,352,2,60,22897,60,176,2,60,22897,60,176
30.998,17,6,670,6,83,6199,84,670,0,0,0,0,0
1788.5,17,142,11360,71,48,25549,48,5396,71,56,25549,56,5964
138.588,17,4,352,2,60,138586,60,176,2,60,138587,60,176
0.012,6,4,191,1,0,0,0,40,3,31,5,31,151
92.885,6,78,47160,42,844,367,1460,7653,36,1311,2644,2920,39507
1323.521,2,13,416,13,8,110293,8,416,0,0,0,0,0
1779.681,1,60,5040,60,56,30164,56,5040,0,0,0,0,0
27.404,6,20,3130,12,183,2491,517,1561,8,381,3907,499,1569
1679.542,17,12,498,11,14,167954,14,462,1,8,0,8,36
300.222,6,30,11781,17,592,18763,1408,4458,13,1106,20020,2816,7323
240.393,6,43,8992,22,524,11446,1418,5868,21,253,12019,617,3124
15.231,17,38,17965,19,484,844,1350,9738,19,405,844,1350,8227
0.745,6,10,924,5,283,124,283,551,5,105,124,105,373
1787.182,6,102,8296,68,65,26674,65,4930,34,59,54154,59,3366
2.035,1,3,252,3,56,1017,56,252,0,0,0,0,0
1770.895,6,103,9652,67,66,26831,66,5728,36,60,50594,60,3924
240.224,6,57,19981,30,821,8283,1408,17193,27,152,9239,580,2788
280.441,6,27,7312,12,158,25494,267,1277,15,775,20028,3465,6035
167.123,17,17,1292,17,48,10445,48,1292,0,0,0,0,0
34.188,17,20,1760,10,48,3797,48,760,10,72,3797,72,1000
172.069,6,22,9920,11,433,74,990,1771,11,1099,17192,1440,8149
18.895,6,18,14696,3,156,95,156,296,15,1253,1336,1360,14400
40.777,17,3,228,3,48,20388,48,228,0,0,0,0,0
82.596,6,34,7802,13,155,6883,267,1306,21,353,4129,1420,6496
0.284,6,25,8840,13,237,23,589,1634,12,1095,25,2804,7206
42.414,17,4,352,2,60,42413,60,176,2,60,42412,60,176
37.604,17,44,6468,22,48,1790,48,1672,22,190,1790,308,4796
376.401,6,10,636,8,106,53771,106,540,2,0,1018,0,96
1758.885,6,144,8709,78,41,22842,208,5170,66,31,27054,31,3539
0.565,6,23,7397,13,334,47,663,2021,10,1209,58,1946,5376
0.378,1,3,168,3,28,189,28,168,0,0,0,0,0
1671.02,1,48,2688,48,28,35553,28,2688,0,0,0,0,0
12.16,6,1936,1680391,1170,1380,10,1420,1645530,766,467,15,1883,34861
0.432,6,12,1653,6,288,86,288,548,6,426,47,434,1105
240.28,6,43,8914,21,519,12013,1402,5775,22,220,11441,618,3139
1.293,6,25,8056,12,164,100,267,1288,13,869,90,1448,6768
1781.295,6,190,11492,97,44,18555,208,6780,93,31,19359,31,4712
1798.212,17,449,39928,404,35,4462,288,25708,45,288,40017,288,14220
1792.902,6,369,23454,213,69,8457,69,12936,156,69,11565,69,10518
1781.414,17,142,11360,71,48,25448,48,5396,71,56,25448,56,5964
4.185,6,39,7269,20,218,220,314,3423,19,513,219,1179,3846
1772.377,6,180,15480,120,69,14893,69,8940,60,69,30031,69,6540
1788.822,17,83,3480,82,14,22084,14,3444,1,8,0,8,36
0.17,17,2,184,1,32,0,32,60,1,96,0,96,124
145.11,6,159,124567,101,1284,1451,1408,110633,58,727,2542,2816,13934
1788.836,17,87,3648,86,14,21045,14,3612,1,8,0,8,36
4.011,17,5,588,4,64,1329,64,368,1,192,0,192,220
1760.825,1,59,4956,0,0,0,0,0,59,56,30359,56,4956
0.371,6,26,9013,13,257,30,669,1714,13,945,29,1438,7299
3.024,17,4,304,2,48,3012,48,152,2,48,3012,48,152
78.498,6,18,6340,4,106,26166,106,274,14,458,6037,1997,6066
1740.071,6,87,6322,58,31,30527,31,3915,29,31,62144,31,2407
1747.62,1,56,4704,56,56,31774,56,4704,0,0,0,0,0
0.009,17,2,251,1,31,0,31,59,1,164,0,164,192
6.82,17,29,13803,14,484,524,1350,7172,15,414,412,1350,6631
0.06,6,10,1380,5,145,15,145,349,5,827,11,827,1031
1762.864,1,182,10192,182,28,9739,28,10192,0,0,0,0,0
146.352,17,571,636570,559,1109,261,1252,636090,12,12,2952,12,480
0.134,17,2,152,1,48,0,48,76,1,48,0,48,76
0.162,17,4,560,2,64,145,64,184,2,160,143,160,376
2.572,6,24,7471,14,108,197,147,999,10,866,237,1608,6472
11.338,6,44,7524,22,218,539,314,3507,22,390,512,1152,4017
1769.722,6,99,9306,66,66,27226,66,5610,33,60,55300,60,3696
1775.516,1,58,4872,0,0,0,0,0,58,56,31149,56,4872
7.968,6,9,392,4,0,2656,0,172,5,0,1130,0,220
1794.66,6,356,22520,208,69,8669,69,12460,148,69,12205,69,10060
280.294,6,28,7352,12,158,25481,267,1277,16,603,18684,1400,6075
1781.617,1,75,6300,0,0,0,0,0,75,56,24075,56,6300
1.37,17,4,352,2,60,1368,60,176,2,60,1368,60,176
1744.647,2,26,832,26,8,69785,8,832,0,0,0,0,0
178.335,6,2,120,2,0,0,0,120,0,0,0,0,0
1779.71,17,73,3060,72,14,25066,14,3024,1,8,0,8,36
0.117,17,2,268,1,54,0,54,82,1,158,0,158,186
158.371,2,4,192,4,24,52790,24,192,0,0,0,0,0
0.37,6,3,160,2,0,370,0,100,1,0,0,0,60
2.076,17,4,580,2,40,2043,40,136,2,194,2045,194,444
1.021,17,13,6872,7,613,170,1350,4492,6,368,185,1350,2380
200.205,6,27,6494,11,220,5529,516,1326,16,348,13340,1452,5168
1777.622,1,188,10528,188,28,9506,28,10528,0,0,0,0,0
1772.498,6,182,15560,120,69,14894,69,8940,62,69,29051,69,6620
0.02,17,2,272,1,60,0,60,88,1,156,0,156,184
1797.137,1,345,28980,345,56,5224,56,28980,0,0,0,0,0
69.446,6,26,7068,12,155,6313,267,1266,14,523,5326,1460,5802
252.246,1,8,448,8,28,36035,28,448,0,0,0,0,0
252.548,2,3,96,3,8,126274,8,96,0,0,0,0,0
1796.73,17,449,39928,404,35,4458,288,25708,45,288,40020,288,14220
1.334,6,50,19731,27,923,51,1460,14035,23,433,51,1460,5696
7.595,17,18,6286,9,431,949,1350,4132,9,211,728,1350,2154
0.568,6,241,223567,81,269,7,517,4363,160,1355,3,2840,219204
1792.943,6,370,23425,213,69,8457,69,13005,157,69,11491,69,10420
0.907,6,24,6631,13,346,74,1070,2257,11,786,89,1420,4374
28.361,6,30,7432,13,158,2363,267,1317,17,543,1766,1400,6115
293.742,1,4,224,4,28,97914,28,224,0,0,0,0,0
21.679,6,45,33025,29,231,774,517,2915,16,2439,1439,8448,30110
91.998,6,53,41618,33,1386,2874,1448,39140,20,359,3196,1319,2478
369.663,6,23,1538,16,180,24644,180,1056,7,110,10380,110,482
285.149,6,59,8683,28,158,10561,267,1917,31,552,9502,2036,6766
0.85,6,13,1096,7,256,140,256,544,6,304,168,304,552
1748.002,1,57,4788,57,56,31214,56,4788,0,0,0,0,0
0.517,17,4,768,2,39,508,39,134,2,289,14,289,634
1.342,17,2,216,1,49,0,49,77,1,111,0,111,139
48.516,6,42,8752,21,367,533,787,2034,21,419,2419,4848,6718
0.27,6,12,965,6,182,54,182,490,6,77,8,134,475
1.748,6,25,8757,15,284,124,584,1456,10,985,174,1414,7301
0.039,17,2,2754,2,1349,39,1349,2754,0,0,0,0,0
403.426,1,14,784,14,28,31032,28,784,0,0,0,0,0
0.49,17,3,451,2,39,114,39,134,1,289,0,289,317
0.412,6,12,1653,6,288,79,288,548,6,426,45,434,1105
1771.999,6,180,15480,120,69,14890,69,8940,60,69,30031,69,6540
370.274,17,12,4032,12,308,33661,308,4032,0,0,0,0,0
15.394,17,18,9110,9,740,1919,1350,6918,9,215,1919,1350,2192
280.611,6,31,7813,14,158,21585,267,1357,17,577,17537,1400,6456
1.307,6,49,20999,28,948,48,1360,15383,21,433,56,1360,5616
1773.528,6,180,15480,120,69,14903,69,8940,60,69,30052,69,6540
1.054,6,2,120,2,0,0,0,120,0,0,0,0,0
0.56,6,27,9188,13,225,46,733,1821,14,945,39,1368,7367
18.151,17,20,12632,12,840,1647,1350,10417,8,248,2588,1350,2215
0.533,6,10,967,5,256,131,256,460,5,303,131,303,507
0.012,6,3,120,2,0,12,0,80,1,0,0,0,40
48.52,17,4,352,2,60,48519,60,176,2,60,48519,60,176
0.985,17,17,10561,9,881,122,1350,8181,8,269,135,1350,2380
30.979,6,128,83661,66,1108,476,1438,21204,62,1260,389,1534,62457
1.044,6,30,12625,16,529,69,1360,3318,14,873,64,1360,9307
0.306,17,2,192,1,60,0,60,88,1,76,0,76,104
38.55,17,3,228,3,48,19275,48,228,0,0,0,0,0
1789.981,6,374,23654,214,69,8403,69,13114,160,69,11257,69,10540
11.973,6,89,27322,45,566,272,1152,21080,44,447,272,1179,6242
1725.736,17,170,14420,157,30,11062,37,9155,13,377,138676,463,5265
1795.04,17,449,39928,404,35,4454,288,25708,45,288,40026,288,14220
20.448,6,681,591093,414,1352,49,1368,570841,267,776,76,2736,20252
0.002,17,2,1152,1,548,0,548,576,1,548,0,548,576
0.187,1,2,112,2,28,187,28,112,0,0,0,0,0
0.011,6,32,7991,17,131,0,131,1023,15,475,0,1000,6968
57.741,6,35,8320,17,378,544,786,1846,18,478,3387,2128,6474
0.395,6,14,1733,7,288,62,288,588,7,284,37,434,1145
300.543,6,18,1227,5,177,75093,177,445,13,110,25031,110,782
4.185,6,24,4530,13,213,348,597,1741,11,441,400,1440,2789
1591.821,1,8,448,8,28,227403,28,448,0,0,0,0,0
20.154,6,23,5795,13,107,1679,159,1138,10,825,2236,2816,4657
885.964,6,53,4346,34,65,26847,65,2465,19,59,45115,59,1881
0.397,1,2,112,2,28,397,28,112,0,0,0,0,0
1787.167,17,126,10080,63,48,28825,48,4788,63,56,28825,56,5292
1790.378,6,417,24981,208,69,8649,69,12460,209,34,8607,48,12521
1795.307,1,256,27136,256,78,7040,78,27136,0,0,0,0,0
146.992,6,21,8230,11,511,85,1194,2041,10,962,16312,2720,6189
1.053,17,6,936,3,64,519,64,276,3,192,497,192,660
295.529,17,4,352,2,60,295527,60,176,2,60,295528,60,176
5.198,6,15,2572,8,178,742,193,780,7,473,848,891,1792
0.667,6,2,92,2,0,0,0,92,0,0,0,0,0
0.131,17,4,588,2,48,117,48,152,2,190,117,308,436
1772.001,6,243,16826,94,46,19051,46,6956,149,46,11972,46,9870
1271.461,6,129,11227,81,70,15893,138,6138,48,68,27052,69,5089
0.214,6,10,1840,5,901,53,901,1169,5,403,53,403,671
294.817,6,34,7028,16,262,19651,517,1628,18,744,17339,1418,5400
0.299,17,2,157,1,31,0,31,59,1,70,0,70,98
1025.627,6,141,17050,79,80,13148,267,6223,62,148,16813,1420,10827
1772.301,6,180,15480,120,69,14893,69,8940,60,69,30038,69,6540
3.867,17,2,656,2,300,3867,300,656,0,0,0,0,0
83.461,6,33,7762,13,155,6955,267,1306,20,376,4339,3417,6456
1683.812,17,16,1152,9,30,210474,30,522,7,62,280626,62,630
331.003,6,47,3371,18,63,17706,293,1550,29,47,11821,78,1821
361.075,6,86,12849,42,289,8806,1111,6307,44,192,8396,1192,6542
2.832,17,4,292,2,37,2799,37,130,2,53,2800,53,162
342.301,6,34,7420,15,202,3972,502,1818,19,302,19012,1420,5602
1081.12,17,212,16112,212,48,5123,48,16112,0,0,0,0,0
0.064,17,3,286,2,46,2,46,148,1,110,0,110,138
0.691,17,16,6202,7,425,115,1350,3173,9,308,60,1350,3029
1124.77,17,220,16720,220,48,5135,48,16720,0,0,0,0,0
280.27,6,28,7352,12,158,25479,267,1277,16,603,18682,1400,6075
1.219,6,38,8413,19,277,67,761,1900,19,441,57,1360,6513
13.47,6,13,5135,6,275,2694,275,523,7,1440,2043,1440,4612
5.832,6,41,7349,21,218,291,314,3463,20,513,291,1179,3886
0.025,17,2,482,1,63,0,63,91,1,363,0,363,391
0.011,17,2,279,1,36,0,36,64,1,187,0,187,215
2.051,17,6,594,3,39,1000,39,201,3,103,0,103,393
997.939,6,475,43286,234,61,4283,1448,19606,241,91,4156,1448,23680
31.443,17,8,1648,4,48,10473,48,304,4,308,10473,308,1344
394.061,6,18,1242,14,180,30312,180,916,4,110,20090,110,326
1796.848,6,359,22709,209,69,8638,69,12569,150,69,12057,69,10140
0.305,6,5,248,3,0,152,0,144,2,0,134,0,104
1.229,6,48,18224,26,882,49,1360,12568,22,433,50,1360,5656
5.065,17,3,3228,3,1048,2532,1072,3228,0,0,0,0,0
24.794,6,114,67708,63,246,399,1199,6296,51,1305,495,2816,61412
300.648,6,38,8386,20,270,15823,734,1913,18,441,500,1460,6473
1.277,6,24,8004,12,164,98,267,1288,12,1014,98,2896,6716
0.015,6,12,3462,6,75,3,75,395,6,1373,2,1448,3067
0.257,17,3,451,2,39,82,39,134,1,289,0,289,317
1798.274,6,347,22436,195,69,9269,69,11940,152,69,11909,69,10496
98.766,6,39,12116,20,633,5198,1360,4647,19,558,5477,1360,7469
15.094,17,10,880,5,48,3770,48,380,5,72,3770,72,500
10.95,6,20,4442,11,275,1095,275,998,9,768,768,1440,3444
2.593,17,2,341,1,64,0,64,92,1,221,0,221,249
6.923,6,1173,988513,701,1362,9,1380,965295,472,421,14,1923,23218
0.316,6,26,8880,13,227,26,547,1604,13,941,25,1408,7276
13.504,6,32,8867,16,399,900,721,2643,16,928,777,2840,6224
1773.018,6,180,15480,120,69,14899,69,8940,60,69,30048,69,6540
0.231,6,9,1002,5,213,57,213,417,4,421,54,421,585
457.431,17,36,2880,18,48,26907,48,1368,18,56,26907,56,1512
0.642,17,2,144,1,36,0,36,64,1,52,0,52,80
8.798,6,40,7618,20,224,463,314,3716,20,516,449,1179,3902
240.202,6,56,20685,30,851,8282,1418,17747,26,197,9607,580,2938
247.852,6,25,6458,9,272,209,516,1180,16,356,16517,1452,5278
4.417,6,37,7189,19,218,245,314,3383,18,513,244,1179,3806
0.327,6,21,7281,13,334,27,663,2021,8,1209,45,1906,5260
0.051,17,2,210,1,53,0,53,81,1,101,0,101,129
0.338,17,8,2742,8,314,48,353,2742,0,0,0,0,0
370.867,6,25,1654,17,180,23179,180,1120,8,110,9245,110,534
1.1,6,31,12793,16,511,73,1460,3239,15,812,65,1460,9554
1779.474,17,142,11360,71,48,25420,48,5396,71,56,25420,56,5964
8.123,6,67,20470,35,552,238,1152,15763,32,489,253,1179,4707
0.073,17,2,245,1,32,0,32,60,1,157,0,157,185
1796.373,17,87,3648,86,14,21133,14,3612,1,8,0,8,36
0.005,17,8,2462,8,279,0,318,2462,0,0,0,0,0
1789.932,17,177,13806,177,50,10170,50,13806,0,0,0,0,0
4.38,6,31,6133,18,138,257,517,1920,13,878,358,1368,4213
180.879,17,16,1216,16,48,12058,48,1216,0,0,0,0,0
0.367,17,2,180,1,30,0,30,58,1,94,0,94,122
54.548,6,7341,7090142,4926,1362,11,1408,6959898,2415,776,22,1408,130244
1799.951,17,411,236496,1,308,0,308,336,410,548,4400,548,236160
1777.194,1,58,4872,58,56,31178,56,4872,0,0,0,0,0
0.256,17,3,451,2,39,79,39,134,1,289,0,289,317
0.013,17,2,402,1,34,0,34,62,1,312,0,312,340
1774.641,6,274,33049,112,133,15986,1360,15704,162,133,11021,4080,17345
1773.499,1,118,6608,118,28,15158,28,6608,0,0,0,0,0
299.701,1,4,224,4,28,99900,28,224,0,0,0,0,0
66.186,6,33,7647,11,151,34,267,1206,22,347,3151,1420,6441
1789.999,6,219,26021,108,75,16320,721,9542,111,261,16270,1440,16479
2.953,6,48,29448,30,956,101,1360,11770,18,1694,165,4727,17678
1121.618,6,207,14034,89,46,12715,46,5944,118,46,9586,46,8090
0.248,17,2,178,1,29,0,29,57,1,93,0,93,121
3.211,6,5,232,2,0,3211,0,88,3,0,1515,0,144
29.92,17,2692,2693365,766,43,39,1350,54557,1926,1342,15,1350,2638808
50.194,6,25,7097,12,155,4563,267,1266,13,589,4181,3426,5831
1764.934,2,14,448,14,8,135764,8,448,0,0,0,0,0
0.106,17,2,588,1,39,0,39,67,1,493,0,493,521
0.004,17,2,154,1,33,0,33,61,1,65,0,65,93
1799.427,1,15,840,15,28,128530,28,840,0,0,0,0,0
1748.555,6,178,18380,93,80,19006,721,8459,85,176,20811,2840,9921
31.345,6,224,150448,113,1400,80,1460,140449,111,260,281,1460,9999
283.184,6,35,11418,14,158,21783,267,1357,21,658,14157,1400,10061
0.343,6,26,9017,13,261,28,683,1728,13,943,27,1438,7289
1741.142,6,90,6521,59,31,30019,31,3998,31,31,58036,31,2523
106.795,6,75,50859,47,1182,2321,1408,42668,28,961,2281,3847,8191
17.451,6,3079,2907461,2003,1374,8,1408,2846845,1076,931,16,2801,60616
1785.426,6,104,8564,68,66,26648,66,4964,36,60,51009,60,3600
24.585,6,3624,3489633,2461,1343,9,1368,3424481,1163,776,20,1473,65152
3.51,17,4,240,4,32,1170,32,240,0,0,0,0,0
1786.837,6,103,8404,68,66,26669,66,4964,35,60,52551,60,3440
10.112,6,14,4557,5,92,2528,92,348,9,1244,1219,1408,4209
7.136,6,599,542166,382,1353,18,1368,526206,217,776,32,1473,15960
0.084,17,2,152,1,48,0,48,76,1,48,0,48,76
10.977,6,18,4266,10,275,1219,275,958,8,992,879,1440,3308
280.37,6,29,7392,13,158,23364,267,1317,16,603,18686,2800,6075
280.538,6,29,7392,13,158,23378,267,1317,16,678,18696,3456,6075
1772.166,6,180,15480,120,69,14892,69,8940,60,69,30036,69,6540
1781.762,6,361,22858,210,69,8525,69,12678,151,69,11878,69,10180
0.124,17,2,204,1,34,0,34,62,1,114,0,114,142
1740.472,17,29,6815,29,207,62159,207,6815,0,0,0,0,0
0.301,17,2,780,2,362,301,362,780,0,0,0,0,0
2.573,6,13,2311,8,188,367,245,700,5,1407,575,1407,1611
1.587,6,26,8868,13,227,132,547,1592,13,941,131,1438,7276
10.64,6,10,580,4,0,3546,0,220,6,0,1430,0,360
269.809,17,1246,1206984,1189,985,227,1252,1204660,57,12,4783,56,2324
1783.207,1,144,15264,144,78,12469,78,15264,0,0,0,0,0
1680.562,17,12,498,11,14,168056,14,462,1,8,0,8,36
1718.411,17,302,52482,302,145,5709,385,52482,0,0,0,0,0
0.089,17,2,376,1,39,0,39,67,1,281,0,281,309
252.144,2,2,64,2,8,252144,8,64,0,0,0,0,0
105.423,6,44,10136,14,328,2115,1189,2541,30,304,3634,1420,7595
14.771,6,7,380,4,0,4923,0,216,3,0,7380,0,164
96.348,6,46,8957,22,360,749,766,2089,24,368,4181,2720,6868
1788.175,1,280,15680,280,28,6409,28,15680,0,0,0,0,0
1743.25,6,95,7203,63,38,28116,205,4476,32,33,56223,98,2727
0.296,17,2,170,1,37,0,37,65,1,77,0,77,105
1742.678,6,87,6322,58,31,30573,31,3915,29,31,62238,31,2407
9.323,6,1349,1240140,815,1440,11,1448,1206084,534,776,16,1448,34056
1772.758,6,180,15480,120,69,14897,69,8940,60,69,30038,69,6540
849.141,6,126,18671,51,292,16982,1360,14022,75,48,11473,143,4649
0.951,6,21,6709,11,830,95,1360,5457,10,207,83,418,1252
1771.156,6,101,9278,66,64,27248,64,5544,35,58,52088,58,3734
1.164,6,10,1687,7,100,194,100,384,3,1179,453,1179,1303
1793.019,6,357,22629,209,69,8620,69,12569,148,69,12195,69,10060
0.009,17,2,322,1,36,0,36,64,1,230,0,230,258
1.366,6,37,8214,19,321,75,1164,2718,18,476,70,2715,5496
1783.103,17,83,3480,82,14,22013,14,3444,1,8,0,8,36
1798.531,17,448,39612,404,35,4462,288,25708,44,288,40950,288,13904
281.832,6,30,7432,13,158,23486,267,1317,17,543,17592,1400,6115
300.526,6,15,1979,8,141,42907,141,493,7,398,50058,419,1486
1796.761,1,280,15680,280,28,6440,28,15680,0,0,0,0,0
2.882,17,4,1370,2,308,1886,308,672,2,321,1890,321,698
74.159,17,4,352,2,60,74158,60,176,2,60,74158,60,176
171.625,17,7,1092,7,128,28604,128,1092,0,0,0,0,0
15.841,17,14,7616,8,669,2253,1350,5580,6,311,3154,1350,2036
1770.983,6,137,8441,73,27,24596,27,4447,64,27,28110,27,3994
0.11,17,2,574,1,32,0,32,60,1,486,0,486,514
0.007,6,2,80,1,0,0,0,40,1,0,0,0,40
1785.164,17,87,3648,86,14,21001,14,3612,1,8,0,8,36
1799.725,6,323,22380,133,46,13575,46,9030,190,46,9522,46,13350
238.651,2,3,96,3,8,119325,8,96,0,0,0,0,0
1.217,6,10,1903,5,657,304,657,925,5,710,304,710,978
0.032,6,11,1566,6,503,6,503,823,5,475,8,475,743
2.264,6,14,2351,8,188,323,245,700,6,703,401,1152,1651
1784.672,6,366,25541,212,99,8458,469,14965,154,69,11664,69,10576
0.032,6,10,1755,5,657,7,657,925,5,562,7,562,830
32.03,6,9,540,2,0,1346,0,120,7,0,5336,0,420
0.524,6,51,19886,29,965,18,1380,14719,22,387,22,2760,5167
24.063,6,14,2708,6,837,4808,1452,1918,8,231,3435,231,790
1.517,6,32,6320,15,141,108,267,1735,17,650,83,1380,4585
1788.63,6,123,14710,79,84,22931,502,6390,44,156,41593,1452,8320
0.04,17,2,558,1,41,0,41,69,1,461,0,461,489
368.393,6,13,888,9,112,46047,112,704,4,0,122793,0,184
1773.0,6,180,15480,120,69,14899,69,8940,60,69,30047,69,6540
1.282,6,24,5819,13,184,106,385,1446,11,785,127,1420,4373
0.512,17,3,451,2,39,97,39,134,1,289,0,289,317
37.063,17,22,1936,11,48,3705,48,836,11,72,3705,72,1100
0.04,17,2,278,1,49,0,49,77,1,173,0,173,201
38.816,2,4,160,4,16,12938,16,160,0,0,0,0,0
1794.161,6,383,29049,222,124,8118,469,17848,161,69,11211,69,11201
280.492,6,30,7432,13,158,23374,267,1317,17,603,17525,2760,6115
1782.942,1,61,5124,0,0,0,0,0,61,56,29715,56,5124
0.053,17,4,284,2,32,2,32,120,2,54,42,60,164
1771.523,1,58,4872,58,56,31079,56,4872,0,0,0,0,0
8.385,6,1762,1628723,1115,1383,7,1408,1590415,647,931,12,2801,38308
1665.498,1,7,742,7,78,277583,78,742,0,0,0,0,0
1.128,17,2,136,1,32,0,32,60,1,48,0,48,76
1.26,6,9,1647,6,100,252,100,344,3,1179,497,1179,1303
31.633,6,7,308,1,0,0,0,44,6,0,6290,0,264
1793.783,17,180,11520,180,36,10021,36,11520,0,0,0,0,0
280.282,6,27,7312,12,158,25480,267,1277,15,678,20015,2800,6035
0.403,6,5,1564,3,413,201,413,946,2,269,194,269,618
288.316,1,4,224,4,28,96105,28,224,0,0,0,0,0
351.636,17,8,2934,8,338,50233,548,2934,0,0,0,0,0
11.606,6,1836,1596212,1114,1377,10,1420,1563111,722,467,16,1883,33101
28.267,6,30,8872,14,158,2174,267,1357,16,858,1879,3456,7515
0.058,17,2,178,1,29,0,29,57,1,93,0,93,121
181.042,17,4,794,2,36,181037,39,128,2,305,181035,332,666
560.407,17,6,1647,3,30,280201,30,174,3,463,280201,463,1473
179.433,6,20,8672,11,314,63,634,1415,9,1377,22414,3928,7257
1798.046,17,448,39896,403,35,4472,288,25676,45,288,40020,288,14220
1738.745,6,87,6322,58,31,30504,31,3915,29,31,62097,31,2407
10.153,17,4,352,2,60,10151,60,176,2,60,10152,60,176
2.671,17,20,14858,8,634,381,1350,5299,12,768,232,1350,9559
0.019,17,2,417,1,34,0,34,62,1,327,0,327,355
0.317,6,3,206,2,31,0,31,166,1,0,0,0,40
10.765,6,19,4350,10,275,1196,275,958,9,755,743,1414,3392
1774.747,6,265,36662,109,178,16431,1360,20280,156,135,11449,3298,16382
0.079,6,14,5282,8,1089,11,1376,3692,6,635,15,1251,1590
14.603,6,21,6825,12,275,1327,275,1038,9,1353,1199,1440,5787
1754.484,6,184,11305,92,47,19280,208,6695,92,31,19277,31,4610
1757.717,6,132,16769,72,64,24755,517,4972,60,361,29791,1418,11797
7.599,6,1503,1242043,815,1429,9,1448,1197079,688,776,10,1448,44964
0.862,6,10,1687,7,100,143,100,384,3,1179,309,1179,1303
1797.856,6,358,22669,209,69,8643,69,12500,149,69,12147,69,10169
0.005,6,2,569,1,0,0,0,40,1,489,0,489,529
0.04,17,2,144,1,36,0,36,64,1,52,0,52,80
74.813,6,23,940,11,0,5296,0,444,12,0,6800,0,496
240.2,6,57,18293,31,804,8006,1418,15313,26,180,9607,580,2980
300.562,6,18,1227,6,177,60077,177,497,12,110,27307,110,730
3.168,6,4,240,1,0,0,0,60,3,0,1515,0,180
0.047,17,2,367,1,33,0,33,61,1,278,0,278,306
298.794,17,6,360,3,32,149396,32,180,3,32,149396,32,180
371.346,6,25,1651,17,177,23209,177,1117,8,110,9226,110,534
0.405,17,12,11272,5,822,101,1350,4254,7,974,39,1350,7018
882.668,1,14,1484,14,78,67897,78,1484,0,0,0,0,0
3.276,17,4,1556,4,361,1092,361,1556,0,0,0,0,0
1781.773,6,356,22520,208,69,8607,69,12460,148,69,12120,69,10060
19.618,17,4,1350,4,309,6539,322,1350,0,0,0,0,0
240.197,6,54,19020,29,824,8578,1408,16353,25,169,10008,580,2667
5.149,6,38,7229,20,218,271,314,3423,18,513,287,1179,3806
2.285,6,13,2311,8,188,326,245,700,5,1407,502,1407,1611
1793.979,1,342,28728,342,56,5260,56,28728,0,0,0,0,0
60.697,17,4,240,2,32,60696,32,120,2,32,60696,32,120
2.368,6,101,62795,58,1296,41,1432,52960,43,540,47,1871,9835
1786.676,6,106,8524,68,66,26666,66,4964,38,60,48286,60,3560
0.126,17,2,136,1,32,0,32,60,1,48,0,48,76
0.073,17,2,681,2,312,73,332,681,0,0,0,0,0
114.055,6,43,8924,20,401,790,889,2096,23,368,5177,3488,6828
10.982,6,20,4402,11,275,1098,275,998,9,758,776,1420,3404
109.449,6,22,9178,12,304,70,597,1425,10,1223,12142,3081,7753
1.894,17,2,124,2,34,1894,34,124,0,0,0,0,0
0.0,17,2,136,1,32,0,32,60,1,48,0,48,76
1773.31,6,180,15480,120,69,14901,69,8940,60,69,30049,69,6540
1794.246,17,179,11456,179,36,10080,36,11456,0,0,0,0,0
1743.349,6,96,7286,63,38,28118,205,4476,33,33,54471,98,2810
8.985,6,17,5391,9,275,1123,275,643,8,1104,1124,1440,4748
1794.109,1,58,4872,58,56,31475,56,4872,0,0,0,0,0
5.027,17,4,288,2,36,5007,36,128,2,52,5010,52,160
0.008,6,10,1514,5,503,2,503,771,5,475,2,475,743
1756.184,6,105,6270,60,27,29765,27,3525,45,27,39912,27,2745
46.598,6,29,7257,13,155,3883,267,1306,16,441,3106,1420,5951
12.715,6,20,1360,11,92,1271,92,760,9,92,1034,92,600
1796.572,6,418,25048,209,69,8637,69,12500,209,34,8637,48,12548
0.167,6,43,18410,24,1037,7,1420,13429,19,467,8,1883,4981
65.942,6,21,7836,7,154,10990,267,752,14,724,5069,1420,7084
1791.83,17,765,46134,765,32,2345,37,46134,0,0,0,0,0
0.175,17,2,152,1,48,0,48,76,1,48,0,48,76
1681.315,17,14,3843,7,30,280217,30,406,7,463,280217,463,3437
86.595,6,155,69843,79,778,312,1152,59975,76,487,1151,1179,9868
280.289,6,30,7432,13,158,23357,267,1317,17,543,17512,1400,6115
1.005,6,16,4559,8,92,143,92,524,8,900,143,1448,4035
2.489,6,22,6028,10,281,276,544,1248,12,716,182,1420,4780
1794.378,17,144,11520,72,48,25272,48,5472,72,56,25272,56,6048
1681.464,2,25,800,25,8,70061,8,800,0,0,0,0,0
3.575,2,2,64,2,8,3575,8,64,0,0,0,0,0
368.394,6,18,1242,14,180,28338,180,916,4,110,20065,110,326
280.401,6,29,7392,12,158,25491,267,1277,17,678,17522,2085,6115
1664.239,1,8,448,8,28,237748,28,448,0,0,0,0,0
285.714,6,30,3141,15,324,20406,585,1461,15,226,20406,580,1680
0.957,6,10,1687,7,100,159,100,384,3,1179,345,1179,1303
1793.302,17,29,9512,29,300,64046,300,9512,0,0,0,0,0
1682.656,17,16,1265,8,30,240375,37,471,8,71,240374,136,794
1781.952,6,354,22440,207,69,8650,69,12420,147,69,12205,69,10020
842.269,2,5,160,5,8,210567,8,160,0,0,0,0,0
872.217,1,30,1680,30,28,30076,28,1680,0,0,0,0,0
1795.137,17,80,3354,79,14,23014,14,3318,1,8,0,8,36
259.576,6,54,9645,23,105,11798,267,2189,31,248,8652,1452,7456
1786.6,6,102,8296,68,65,26665,65,4930,34,59,54137,59,3366
1777.207,17,72,3018,71,14,25388,14,2982,1,8,0,8,36
1789.887,6,382,26664,219,97,8210,469,15590,163,69,11048,69,11074
24.969,17,4,320,2,48,24960,48,152,2,56,24960,56,168
0.039,17,2,167,1,39,0,39,67,1,72,0,72,100
1788.751,6,377,27085,206,98,8725,469,14932,171,69,10521,69,12153
9.925,6,6,1255,4,327,3308,413,814,2,180,9746,269,441
1.35,6,49,19136,27,883,51,1440,13480,22,433,55,1440,5656
81.592,6,44,6747,22,169,3885,722,2839,22,197,3876,1440,3908
303.616,6,185,123366,108,1189,2837,1408,66385,77,1431,636,6858,56981
4.451,6,39,7269,19,218,247,314,3383,20,513,221,1179,3886
2.481,17,37,18460,21,604,122,1350,13278,16,295,163,1350,5182
2.326,6,46,13527,24,453,101,1360,4726,22,564,102,1360,8801
10.99,6,20,4350,11,275,1099,275,998,9,992,749,1440,3352
0.075,17,2,152,2,48,75,48,152,0,0,0,0,0
503.869,2,3,96,3,8,251934,8,96,0,0,0,0,0
0.359,6,52,22849,29,1029,12,1380,17687,23,421,14,1923,5162
0.139,6,10,1514,5,503,34,503,771,5,475,34,475,743
16.805,2,2,64,2,8,16805,8,64,0,0,0,0,0
1795.62,6,245,47290,152,483,11891,483,37379,93,83,19517,83,9911
1720.64,17,13,534,11,14,172045,14,462,2,8,1720455,8,72
300.623,6,36,8391,20,291,15822,786,1997,16,522,566,3488,6394
1715.25,1,8,448,8,28,245035,28,448,0,0,0,0,0
1782.197,17,83,3480,82,14,22002,14,3444,1,8,0,8,36
0.157,17,2,144,1,36,0,36,64,1,52,0,52,80
0.426,6,12,1653,6,288,82,288,548,6,426,50,434,1105
75.121,6,21,860,10,0,6123,0,404,11,0,7511,0,456
56.608,6,29,7257,13,155,4717,267,1306,16,441,3772,1460,5951
6.504,6,29,6175,15,338,464,1314,2294,14,368,498,1460,3881
32.073,6,71,52786,44,1295,745,1408,46369,27,715,1228,1491,6417
1769.565,1,58,4872,58,56,31045,56,4872,0,0,0,0,0
0.277,17,2,167,1,39,0,39,67,1,72,0,72,100
1680.39,1,15,870,15,30,120027,30,870,0,0,0,0,0
1793.594,17,142,11360,71,48,25622,48,5396,71,56,25622,56,5964
217.937,17,11,3696,11,308,21793,308,3696,0,0,0,0,0
280.507,6,30,7432,13,158,23375,267,1317,17,603,17523,2760,6115
4.021,17,8,616,4,33,1333,33,244,4,65,1334,65,372
6.88,6,38,7245,20,218,362,314,3423,18,516,389,1179,3822
280.446,6,30,7432,13,158,23370,267,1317,17,603,17523,2076,6115
80.39,6,9702,9324222,6297,1401,12,1448,9142414,3405,776,23,1448,181808
1787.905,6,356,22589,207,69,8679,69,12420,149,69,12080,69,10169
1784.175,6,356,22520,208,69,8619,69,12460,148,69,12134,69,10060
16.181,17,30,23406,15,824,1150,1350,12793,15,679,1147,1350,10613
1772.268,6,180,15480,120,69,14893,69,8940,60,69,30032,69,6540
1772.043,6,180,15480,120,69,14891,69,8940,60,69,30034,69,6540
1763.374,2,14,448,14,8,135644,8,448,0,0,0,0,0
0.006,6,14,5639,8,134,0,134,474,6,2456,1,4380,5165
1447.9,1,34,1904,34,28,43875,28,1904,0,0,0,0,0
1738.847,1,14,784,14,28,133757,28,784,0,0,0,0,0
1797.472,6,367,25650,214,99,8438,469,15045,153,69,11824,69,10605
0.047,17,2,157,1,31,0,31,59,1,70,0,70,98
1101.449,6,218,13757,127,69,8741,69,7633,91,69,12238,69,6124
54.939,6,531,246610,276,823,199,1152,230905,255,423,215,1179,15705
891.594,6,131,19660,69,101,13111,721,7239,62,342,14612,1414,12421
0.261,17,3,451,2,39,105,39,134,1,289,0,289,317
1791.287,17,179,13962,179,50,10063,50,13962,0,0,0,0,0
1795.45,17,1682,127640,924,40,1945,41,63442,758,56,2371,57,64198
280.852,6,31,7563,13,158,23404,267,1317,18,502,16519,1400,6246
0.038,17,2,182,1,39,0,39,67,1,87,0,87,115
1796.423,17,448,39896,403,35,4468,288,25676,45,288,40014,288,14220
1.512,6,35,11649,18,461,88,1332,3532,17,1060,83,3942,8117
1776.528,17,142,11360,71,48,25378,48,5396,71,56,25378,56,5964
8.56,6,6,260,2,0,8560,0,84,4,0,2422,0,176
1341.007,6,67,11487,42,99,32707,721,4872,25,431,5396,1414,6615
0.137,17,4,588,2,48,133,48,152,2,190,130,308,436
0.553,6,14,1745,7,288,63,288,600,7,426,62,434,1145
4.127,17,3,276,3,64,2063,64,276,0,0,0,0,0
180.412,2,3,96,3,8,90206,8,96,0,0,0,0,0
621.751,1,12,672,12,28,56522,28,672,0,0,0,0,0
21.865,17,4,824,2,48,21856,48,152,2,308,21855,308,672
3.079,6,38,22680,21,776,153,1360,6319,17,1566,182,5294,16361
2.138,6,20,3833,11,234,213,564,1504,9,463,245,1343,2329
21.636,17,33,5674,16,163,1440,1350,3066,17,125,1349,1350,2608
1799.259,6,2372,2176071,859,148,2097,913,53753,1513,1421,1189,4254,2122318
0.529,6,27,8984,13,243,44,611,1656,14,941,38,1368,7328
3.828,17,2,152,2,48,3828,48,152,0,0,0,0,0
1.333,6,52,18934,28,922,49,1460,13153,24,400,50,1460,5781
95.081,1,2,252,2,98,95081,105,252,0,0,0,0,0
7.307,6,5,216,2,0,7307,0,84,3,0,1521,0,132
16.307,17,28,8630,14,389,1251,1350,5850,14,170,1251,1350,2780
0.31,6,25,8965,13,261,25,683,1728,12,1100,27,2816,7237
0.417,17,4,1436,4,331,139,354,1436,0,0,0,0,0
1.384,6,236,181939,137,1334,10,1420,173688,99,475,14,1883,8251
82.658,17,9,684,9,48,10332,48,684,0,0,0,0,0
337.256,6,58,38571,38,1151,9115,1448,30776,20,1124,3231,5255,7795
0.127,6,2,754,1,674,0,674,714,1,0,0,0,40
5.017,17,3,343,2,36,5005,36,128,1,187,0,187,215
20.113,6,112,48980,64,676,319,1360,36428,48,482,424,1360,12552
1794.6,6,436,26503,220,69,8194,69,13147,216,38,8346,69,13356
123.743,6,2033,1738181,973,681,127,1396,59221,1060,1545,116,8376,1678960
1.713,6,14,2351,8,188,244,245,700,6,703,290,1152,1651
0.928,6,50,13773,24,549,40,1429,4824,26,493,36,3446,8949
0.07,17,2,245,1,32,0,32,60,1,157,0,157,185
1775.611,1,8,448,8,28,253658,28,448,0,0,0,0,0
0.809,6,22,5835,13,282,67,546,1370,9,683,91,1420,4465
421.285,2,5,160,5,8,105321,8,160,0,0,0,0,0
0.176,17,2,144,1,36,0,36,64,1,52,0,52,80
0.055,17,2,912,1,308,0,308,336,1,548,0,548,576
24.566,6,41,10228,20,619,471,1360,3334,21,431,1220,2142,6894
77.106,17,6,528,3,48,38548,48,228,3,72,38548,72,300
1.305,17,2,154,1,33,0,33,61,1,65,0,65,93
2.793,6,11,975,6,304,558,304,624,5,83,691,83,351
1794.995,6,240,24852,97,68,18696,757,9214,143,137,12639,2720,15638
0.078,17,2,322,1,33,0,33,61,1,233,0,233,261
1783.813,6,361,24196,211,88,8494,469,13918,150,69,11971,69,10278
219.898,17,5,5854,5,1142,54974,1444,5854,0,0,0,0,0
280.532,6,29,7392,13,158,23377,267,1317,16,603,18700,2036,6075
4.94,6,42,7405,22,218,235,314,3503,20,442,246,1152,3902
1.361,6,47,18956,26,943,54,1460,13340,21,433,58,1460,5616
1772.977,6,180,15480,120,69,14898,69,8940,60,69,30048,69,6540
300.228,6,26,8087,15,401,21444,1050,2406,11,850,3031,2899,5681
0.023,17,8,1670,8,180,3,219,1670,0,0,0,0,0
1798.456,17,144,11520,72,48,25330,48,5472,72,56,25330,56,6048
0.126,6,9,1002,5,213,31,213,417,4,421,34,421,585
1786.664,6,356,22520,208,69,8631,69,12460,148,69,12152,69,10060
1793.667,6,422,25373,211,69,8541,69,12580,211,35,8540,69,12793
0.136,6,15,5090,9,149,17,205,774,6,999,26,1408,4316
241.174,6,51,9831,22,263,11484,675,3296,29,386,8612,1418,6535
0.582,6,27,8996,13,243,48,611,1656,14,941,40,1368,7340
77.56,6,121,100618,83,1267,945,1368,90514,38,738,2089,2519,10104
350.778,6,88,30446,44,586,8157,1402,11087,44,741,8157,1402,19359
0.818,6,6,300,3,0,303,0,144,3,0,226,0,156
2.584,6,30,6004,16,111,172,267,1539,14,780,188,1460,4465
1665.737,1,7,742,7,78,277622,78,742,0,0,0,0,0
378.733,2,3,96,3,8,189366,8,96,0,0,0,0,0
81.956,6,72,47178,45,1175,1862,1448,37611,27,679,3143,1448,9567
100.398,6,47,9998,22,450,491,766,2761,25,327,4178,1360,7237
1799.527,17,140,11200,70,48,26079,48,5320,70,56,26079,56,5880
1788.529,6,410,25073,224,69,8020,69,13445,186,42,9667,69,11628
0.043,17,8,2446,8,277,6,316,2446,0,0,0,0,0
1.33,6,54,20597,30,903,45,1360,14816,24,437,50,2720,5781
11.578,6,1841,1601759,1111,1386,10,1414,1568302,730,467,15,1889,33457
0.379,1,2,112,2,28,379,28,112,0,0,0,0,0
1008.271,6,85,9536,48,82,19420,722,4421,37,113,28002,2026,5115
1789.347,17,142,11360,71,48,25562,48,5396,71,56,25562,56,5964
1762.718,6,116,8432,72,31,24827,31,4944,44,31,40993,31,3488
240.213,6,52,18217,27,825,9238,1418,15438,25,183,10008,580,2779
23.429,6,8,432,4,0,7808,0,228,4,0,7808,0,204
1.645,17,56,40138,22,341,78,1350,8134,34,913,40,1350,32004
1745.696,6,151,9613,81,51,21821,208,5914,70,31,25295,31,3699
240.283,6,54,19288,28,830,8899,1418,16414,26,189,9610,580,2874
0.603,6,10,924,5,283,103,283,551,5,105,103,105,373
16.306,17,13,6578,7,613,2711,1350,4489,6,320,3253,1350,2089
613.508,17,175,18749,77,141,8072,1350,13073,98,29,6318,60,5676
1740.503,17,29,6815,29,207,62160,207,6815,0,0,0,0,0
0.136,17,4,588,2,48,126,48,152,2,190,123,308,436
553.324,17,84,6384,84,48,6666,48,6384,0,0,0,0,0
1791.765,1,276,15456,276,28,6515,28,15456,0,0,0,0,0
13.678,6,9,1651,5,100,3419,100,304,4,1179,4474,1179,1347
177.305,6,31,15376,14,634,63,1460,3129,17,1050,11072,1460,12247
0.117,17,2,152,1,48,0,48,76,1,48,0,48,76
1792.178,17,180,11520,180,36,10012,36,11520,0,0,0,0,0
99.58,6,45,8794,22,371,719,766,2121,23,478,4520,2720,6673
14.201,6,43,8911,21,218,710,314,3463,22,570,664,1179,5448
54.173,17,4,240,2,32,54172,32,120,2,32,54172,32,120
1.746,6,11,1727,7,100,291,100,384,4,1179,496,1179,1343
1787.335,6,104,8308,68,64,26676,64,4896,36,58,51064,58,3412
0.18,17,2,152,1,48,0,48,76,1,48,0,48,76
133.427,6,23,8359,11,525,92,1237,2048,12,831,12112,1360,6311
0.293,6,21,5000,11,137,29,267,1132,10,692,30,1467,3868
124.751,6,124,90800,77,1249,1641,1408,80235,47,811,2249,3847,10565
1.973,6,33,13542,18,522,116,1360,3398,15,866,129,1360,10144
301.066,6,37,11676,21,617,15053,1368,4802,16,548,585,2206,6874
2.015,17,4,314,2,31,1974,31,118,2,70,1970,70,196
44.338,17,4,240,2,32,44338,32,120,2,32,44338,32,120
0.052,17,2,185,1,45,0,45,73,1,84,0,84,112
1787.001,6,104,8376,68,65,26671,65,4930,36,59,51053,59,3446
1795.208,6,363,25352,211,100,8548,469,14856,152,69,11888,69,10496
41.042,6,28,8792,13,158,3420,267,1317,15,858,2928,2045,7475
41.368,1,45,4680,0,0,0,0,0,45,76,940,76,4680
95.276,6,40,10152,12,274,8661,1189,2684,28,288,2940,1420,7468
0.181,6,41,15740,23,896,8,1420,10799,18,420,9,1420,4941
280.451,6,30,7432,13,158,23370,267,1317,17,603,17525,2076,6115
0.098,6,11,913,6,182,19,182,490,5,77,12,134,423
1787.135,6,102,8228,68,64,26673,64,4896,34,58,54152,58,3332
76.606,17,4,240,2,32,76605,32,120,2,32,76605,32,120
0.664,6,10,924,5,283,122,283,551,5,105,121,105,373
1.942,17,3,174,3,30,971,30,174,0,0,0,0,0
0.503,6,27,8984,13,234,41,575,1620,14,828,34,1448,7364
0.024,17,4,680,2,33,0,33,122,2,251,1,323,558
0.026,17,2,624,1,64,0,64,92,1,504,0,504,532
1.035,6,10,1687,7,100,172,100,384,3,1179,377,1179,1303
1677.274,1,121,12826,121,78,13977,78,12826,0,0,0,0,0
276.125,1,2,261,2,102,276125,105,261,0,0,0,0,0
1786.576,6,102,8364,68,66,26665,66,4964,34,60,54135,60,3400
1791.157,1,224,12544,224,28,8032,28,12544,0,0,0,0,0
1741.486,1,15,840,15,28,124391,28,840,0,0,0,0,0
254.52,6,16,5713,5,106,63629,106,314,11,706,25451,1420,5399
0.07,17,4,420,2,33,57,33,122,2,121,59,145,298
1780.265,1,342,28728,342,56,5220,56,28728,0,0,0,0,0
0.127,17,2,586,1,46,0,46,74,1,484,0,484,512
1786.883,6,104,8376,68,65,26669,65,4930,36,59,51050,59,3446
1235.155,6,125,10727,83,69,15062,69,6218,42,69,30124,69,4509
671.431,17,6,246,5,14,167857,14,210,1,8,0,8,36
146.963,6,23,9247,12,557,92,1360,2183,11,1102,14682,2356,7064
42.502,1,12,1248,0,0,0,0,0,12,76,3863,76,1248
1788.639,17,87,3648,86,14,21042,14,3612,1,8,0,8,36
1788.369,6,357,22629,208,69,8639,69,12460,149,69,12083,69,10169
0.493,6,58,23915,32,925,15,1380,15285,26,582,17,3303,8630
0.736,6,29,12985,15,835,52,1360,5646,14,845,43,1725,7339
0.933,6,23,6429,13,314,77,909,2095,10,982,102,1731,4334
10.136,6,13,2640,7,187,1689,293,1035,6,453,518,1179,1605
165.035,6,23,940,9,0,6055,0,364,14,0,12694,0,576
1795.942,17,448,39896,403,35,4467,288,25676,45,288,40017,288,14220
1772.163,6,180,15480,120,69,14892,69,8940,60,69,30036,69,6540
537.94,6,110,44392,49,856,11206,1408,29981,61,449,8965,1408,14411
1773.425,6,180,15480,120,69,14902,69,8940,60,69,30055,69,6540
6.704,6,18,2877,9,137,838,267,913,9,400,807,1179,1964
21.457,6,1953,1753067,1228,1372,17,1380,1716725,725,421,29,1923,36342
71.262,6,40,25058,23,884,28,1360,6281,17,1808,4445,4416,18777
1793.576,6,355,22480,207,69,8706,69,12420,148,69,12201,69,10060
2.936,6,10,420,6,0,587,0,248,4,0,910,0,172
2.188,17,3,1232,3,382,1094,548,1232,0,0,0,0,0
0.02,6,2,84,1,0,0,0,44,1,0,0,0,40
0.289,6,27,9042,13,247,24,624,1672,14,947,21,1438,7370
1.171,6,26,8529,14,283,75,625,2009,12,1205,88,3151,6520
1786.631,6,104,8444,68,66,26666,66,4964,36,60,51044,60,3480
1793.773,1,290,30740,290,78,6206,78,30740,0,0,0,0,0
85.814,6,18,3660,4,92,1487,92,308,14,370,6587,1408,3352
4.127,17,3,222,3,46,2063,46,222,0,0,0,0,0
1796.947,17,448,39896,403,35,4470,288,25676,45,288,40018,288,14220
32.75,6,26,8513,11,499,3254,1193,1983,15,1479,2325,2279,6530
880.614,1,32,1792,32,28,28406,28,1792,0,0,0,0,0
225.136,6,31,8912,14,158,17318,267,1357,17,763,14065,2076,7555
0.004,17,3,1543,3,486,2,514,1543,0,0,0,0,0
1799.652,1,66,5544,66,56,27686,56,5544,0,0,0,0,0
4.128,17,3,233,2,39,4000,39,134,1,71,0,71,99
280.282,17,4,1098,2,30,280204,30,116,2,463,280271,463,982
1.774,6,27,8797,16,277,118,564,1476,11,859,156,1380,7321
3.461,17,5,340,5,40,865,40,340,0,0,0,0,0
542.61,17,4,304,4,48,180870,48,304,0,0,0,0,0
367.213,6,696,754974,171,171,659,827,11988,525,1411,700,4254,742986
9.691,6,32,16847,21,333,484,978,2264,11,2018,951,6132,14583
604.161,17,699,112816,89,33,4330,288,5464,610,147,991,308,107352
86.889,1,6,336,6,28,17377,28,336,0,0,0,0,0
75.245,6,21,860,10,0,5389,0,404,11,0,7523,0,456
1771.781,6,99,9306,66,66,27258,66,5610,33,60,55363,60,3696
0.15,6,46,20920,26,1059,6,1420,15899,20,467,7,1883,5021
1774.302,6,207,17595,130,69,13754,69,9685,77,69,23343,69,7910
44.756,17,22,13489,12,666,4068,1350,8334,10,487,1711,1350,5155
0.051,17,4,368,2,32,51,32,120,2,96,9,96,248
1791.191,6,364,23047,211,69,8529,69,12787,153,69,11783,69,10260
505.448,6,7501,6750200,3849,396,131,420,220974,3652,1739,138,14080,6529226
0.279,6,9,1148,5,145,69,145,349,4,635,79,635,799
1764.099,2,14,448,14,8,135699,8,448,0,0,0,0,0
1787.252,6,102,8296,68,65,26675,65,4930,34,59,54155,59,3366
0.947,6,10,1687,7,100,157,100,384,3,1179,343,1179,1303
36.142,6,22,3234,13,183,3011,517,1613,9,381,4516,499,1621
281.249,6,30,7432,13,158,23437,267,1317,17,543,17560,1400,6115
0.314,17,2,218,1,34,0,34,62,1,128,0,128,156
1.244,6,50,20665,28,923,46,1360,15009,22,476,51,2715,5656
7.961,6,459,373959,275,1293,28,1368,359727,184,776,42,1473,14232
1.84,6,54,19887,29,893,65,1460,13728,25,395,69,1460,6159
1799.315,17,142,11360,71,48,25704,48,5396,71,56,25704,56,5964
0.069,17,2,290,1,40,0,40,68,1,194,0,194,222
0.557,17,3,451,2,39,480,39,134,1,289,0,289,317
1664.844,17,440,51494,214,151,7816,1350,38406,226,29,7399,60,13088
379.06,6,21,1419,15,177,27075,177,989,6,110,12267,110,430
0.111,17,2,184,1,32,0,32,60,1,96,0,96,124
0.055,17,4,420,2,33,1,33,122,2,121,0,145,298
204.912,6,16,2200,5,124,759,267,577,11,1179,20465,1179,1623
1774.594,6,100,7702,66,40,27301,205,4730,34,35,53766,108,2972
1.327,6,25,8068,12,164,102,267,1300,13,869,94,1408,6768
235.24,17,4,352,2,60,235239,60,176,2,60,235239,60,176
1791.446,6,355,22480,207,69,8696,69,12420,148,69,12186,69,10060
1759.607,6,100,7866,66,45,27070,205,4902,34,35,53311,98,2964
5.119,6,39,7269,20,218,269,314,3423,19,513,269,1179,3846
1755.591,6,170,22086,97,304,18287,304,15412,73,83,24375,83,6674
4.177,6,33,6145,17,206,261,314,2744,16,551,261,1179,3401
12.986,6,14,2242,8,210,1849,210,844,6,545,2594,904,1398
1740.475,17,28,29551,28,1027,64462,1028,29551,0,0,0,0,0
0.047,6,11,1566,6,503,9,503,823,5,475,11,475,743
12.41,17,2,148,2,46,12410,46,148,0,0,0,0,0
10.79,6,86,26765,42,570,263,1152,20523,44,447,244,1179,6242
3.796,17,2,152,1,48,0,48,76,1,48,0,48,76
1787.907,6,359,22709,209,69,8595,69,12569,150,69,11999,69,10140
0.861,6,3,182,2,0,861,0,80,1,62,0,62,102
1772.629,6,180,15480,120,69,14896,69,8940,60,69,30036,69,6540
0.021,17,2,263,1,36,0,36,64,1,171,0,171,199
0.783,6,10,1687,7,100,130,100,384,3,1179,264,1179,1303
1769.054,6,99,9240,66,65,27216,65,5577,33,59,55278,59,3663
303.004,6,37,15895,23,796,13772,1368,9169,14,748,4724,2519,6726
0.107,6,13,1997,7,329,17,500,1030,6,323,21,500,967
1797.413,1,258,14448,258,28,6993,28,14448,0,0,0,0,0
0.502,17,3,451,2,39,263,39,134,1,289,0,289,317
0.403,6,12,3462,6,75,80,75,395,6,1373,80,1448,3067
1264.518,1,12,1392,12,88,114956,88,1392,0,0,0,0,0
1793.622,6,356,22589,207,69,8706,69,12420,149,69,12119,69,10169
1.847,6,15,3636,7,150,307,174,584,8,681,246,1420,3052
0.015,6,14,4020,7,88,2,88,388,7,1113,2,1460,3632
10.778,6,18,5610,10,275,1197,275,958,8,1440,817,1440,4652
1781.763,6,365,24963,213,94,8404,469,14467,152,69,11799,69,10496
0.914,6,11,1727,7,100,152,100,384,4,589,216,1152,1343
0.01,17,2,304,1,37,0,37,65,1,211,0,211,239
369.623,6,25,1651,17,177,23101,177,1117,8,110,9202,110,534
1799.89,17,449,39928,404,35,4466,288,25708,45,288,40019,288,14220
0.045,6,2,116,1,0,0,0,64,1,0,0,0,52
1783.807,6,356,22520,208,69,8617,69,12460,148,69,12134,69,10060
0.073,17,2,362,1,46,0,46,74,1,260,0,260,288
1786.792,6,102,8296,68,65,26668,65,4930,34,59,54141,59,3366
1778.014,17,73,3060,72,14,25042,14,3024,1,8,0,8,36
13.256,6,16,935,8,43,1893,43,479,8,0,1891,0,456
1784.097,6,280,28793,141,147,12742,208,22210,139,31,12926,31,6583
300.819,6,41,9809,23,546,13673,1360,4242,18,402,508,2667,5567
11.245,6,27,11355,13,275,937,275,1078,14,1078,839,1414,10277
0.144,17,2,2754,2,1349,144,1349,2754,0,0,0,0,0
283.424,17,4,240,2,32,283423,32,120,2,32,283423,32,120
1795.261,1,262,14672,262,28,6878,28,14672,0,0,0,0,0
1772.447,6,180,15480,120,69,14894,69,8940,60,69,30037,69,6540
406.101,17,7,525,7,47,67683,47,525,0,0,0,0,0
1.381,17,3,1170,3,362,690,362,1170,0,0,0,0,0
13.85,6,88,26046,45,536,314,1152,19503,43,438,323,1179,6543
2.507,6,5,288,2,0,2327,0,112,3,0,1162,0,176
10.689,6,84,26030,44,534,248,1152,19948,40,407,266,1152,6082
126.227,6,20,4600,5,152,1492,267,662,15,302,8997,1152,3938
0.617,6,14,2598,7,288,77,288,600,7,568,76,853,1998
1620.321,2,18,576,18,8,95313,8,576,0,0,0,0,0
21.629,17,26,5799,13,238,1799,1350,3466,13,151,1799,1350,2333
280.46,6,31,7472,13,158,23371,267,1317,18,603,16494,2760,6155
1788.423,6,99,6444,63,47,28845,208,4074,36,31,51085,31,2370
1798.779,1,16,896,16,28,119918,28,896,0,0,0,0,0
0.462,17,2,152,1,48,0,48,76,1,48,0,48,76
300.884,6,48,13411,25,814,12536,1360,7596,23,325,427,1360,5815
1779.777,17,142,11360,71,48,25425,48,5396,71,56,25425,56,5964
0.286,1,2,112,2,28,286,28,112,0,0,0,0,0
12.053,17,10,690,5,33,3009,33,305,5,49,3010,49,385
161.503,6,35,15746,18,894,91,1360,6143,17,891,10082,3639,9603
1796.106,1,341,28644,341,56,5282,56,28644,0,0,0,0,0
1681.476,17,18,4639,9,31,210182,37,536,9,427,210181,463,4103
0.395,17,8,2758,8,316,56,355,2758,0,0,0,0,0
240.673,6,57,21039,31,863,8020,1418,18019,26,198,9623,580,3020
80.996,6,20,10080,11,433,57,990,1771,9,1322,10108,2720,8309
1746.914,6,95,7203,63,38,28176,205,4476,32,33,56337,98,2727
7.969,6,14,3735,8,275,1138,275,603,6,1440,1224,1440,3132
0.117,17,2,154,1,33,0,33,61,1,65,0,65,93
1744.634,2,30,960,30,8,60159,8,960,0,0,0,0,0
2.031,17,3,1170,3,362,1015,362,1170,0,0,0,0,0
1782.969,17,132,10560,66,48,27430,48,5016,66,56,27430,56,5544
0.003,6,2,1460,0,0,0,0,0,2,1368,3,1368,1460
377.481,6,25,1651,17,177,23592,177,1117,8,110,9280,110,534
1794.101,6,402,36002,175,68,10310,659,13188,227,87,7937,1938,22814
1.721,17,6,552,3,32,687,32,180,3,96,0,96,372
1707.609,1,8,848,8,78,243944,78,848,0,0,0,0,0
61.132,17,4,304,4,48,20377,48,304,0,0,0,0,0
101.896,17,6,360,3,32,50947,32,180,3,32,50947,32,180
0.52,17,3,543,2,39,410,39,134,1,381,0,381,409
317.035,6,82,20000,42,337,7732,1360,10189,40,327,8125,1929,9811
0.163,1,2,112,2,28,163,28,112,0,0,0,0,0
1791.809,1,214,11984,214,28,8412,28,11984,0,0,0,0,0
0.565,1,2,112,2,28,565,28,112,0,0,0,0,0
116.566,6,25,9873,12,465,59,1360,2374,13,995,9703,1360,7499
0.243,17,2,152,1,48,0,48,76,1,48,0,48,76
2.332,17,12,6024,6,585,466,1350,3678,6,363,299,1350,2346
1794.372,17,282,59577,282,183,6385,422,59577,0,0,0,0,0
118.536,6,42,25887,19,840,44,1460,5847,23,1194,5381,1460,20040
871.445,6,54,3224,31,26,29048,26,1820,23,26,39606,26,1404
24.456,6,45,8915,22,367,653,787,2086,23,368,1105,3488,6829
1786.693,6,362,24774,211,94,8508,469,14387,151,69,11911,69,10387
1777.244,17,142,11360,71,48,25388,48,5396,71,56,25388,56,5964
1763.27,17,150,24194,150,133,11834,373,24194,0,0,0,0,0
0.095,6,9,1346,5,145,23,145,349,4,833,26,833,997
1758.268,6,128,12661,74,63,22606,721,6150,54,78,33171,1448,6511
342.647,6,29,6553,12,216,4980,502,1350,17,322,21410,1420,5203
0.537,17,14,7651,7,716,89,1350,5212,7,320,80,1350,2439
0.021,17,2,252,1,52,0,52,80,1,144,0,144,172
1791.025,1,342,28728,342,56,5252,56,28728,0,0,0,0,0
24.683,6,7,804,0,0,0,0,0,7,87,4113,91,804
0.077,6,10,1673,6,553,15,949,1350,4,159,25,159,323
271.525,17,7,1631,7,205,45254,205,1631,0,0,0,0,0
378.108,2,4,128,4,8,126036,8,128,0,0,0,0,0
1794.111,17,144,11520,72,48,25269,48,5472,72,56,25269,56,6048
1797.066,6,356,22520,208,69,8681,69,12460,148,69,12224,69,10060
0.045,17,6,912,3,60,10,60,264,3,188,10,188,648
1719.457,17,12,498,11,14,171945,14,462,1,8,0,8,36
15.478,6,14,1025,7,222,2578,222,506,7,231,2577,231,519
0.347,17,2,152,1,48,0,48,76,1,48,0,48,76
1679.511,17,12,498,11,14,167951,14,462,1,8,0,8,36
0.14,6,33,7907,17,271,8,517,1785,16,455,8,1432,6122
1789.491,17,142,11360,71,48,25564,48,5396,71,56,25564,56,5964
1770.953,6,113,10124,69,64,26043,64,5840,44,58,41182,58,4284
9.462,17,4,1344,4,308,3154,308,1344,0,0,0,0,0
198.146,17,4,558,2,36,198141,36,128,2,187,198142,187,430
279.836,6,33,9061,14,158,21525,267,1357,19,578,15545,1400,7704
1773.218,6,182,15698,120,69,14900,69,8940,62,69,29066,69,6758
1.272,6,48,18791,27,861,48,1360,13175,21,433,53,1360,5616
1783.811,6,363,22938,210,69,8534,69,12678,153,69,11735,69,10260
1.298,6,47,18161,26,882,51,1360,12545,21,476,56,2715,5616
240.246,6,53,17766,28,789,8897,1418,14884,25,196,10009,580,2882
2.82,6,5,293,0,0,0,0,0,5,31,705,31,293
2.006,17,2,184,2,64,2006,64,184,0,0,0,0,0
387.889,6,19,1306,14,180,29837,180,928,5,110,15207,110,378
0.243,6,10,1544,5,505,60,505,773,5,503,60,503,771
0.218,17,2,152,1,48,0,48,76,1,48,0,48,76
1.173,6,58,18034,28,707,43,1360,8925,30,438,40,1360,9109
923.338,17,74,5920,37,48,25648,48,2812,37,56,25647,56,3108
0.721,6,13,1182,7,146,118,146,430,6,254,142,506,752
11.692,6,3,127,1,0,0,0,40,2,7,0,7,87
1.919,6,6,1257,4,327,639,414,815,2,181,1744,270,442
299.452,6,6,364,4,31,99817,31,222,2,31,299439,31,142
26.606,17,32,4704,16,48,1773,48,1216,16,190,1772,308,3488
1781.762,6,369,26199,214,105,8365,469,15514,155,69,11569,69,10685
9.556,6,11,640,5,0,2389,0,280,6,0,1412,0,360
1.285,6,43,11458,22,547,61,1360,5842,21,433,55,1360,5616
9.063,6,1976,1831107,1256,1380,7,1408,1789003,720,931,12,2816,42104
1767.688,1,58,4872,0,0,0,0,0,58,56,31012,56,4872
1.299,17,20,5180,20,231,68,388,5180,0,0,0,0,0
82.359,6,22,8245,11,510,98,1193,2016,11,962,8219,1791,6229
54.018,6,44,8976,21,401,727,889,2148,23,368,2449,3488,6828
1787.508,6,104,8308,68,64,26679,64,4896,36,58,51067,58,3412
0.9,17,4,352,2,60,899,60,176,2,60,898,60,176
247.845,17,17,5726,17,308,15490,322,5726,0,0,0,0,0
0.302,17,8,2774,8,318,43,357,2774,0,0,0,0,0
1792.26,6,356,22520,208,69,8658,69,12460,148,69,12192,69,10060
0.626,6,30,7990,16,345,41,720,1707,14,571,37,3488,6283
4.934,2,2,64,2,8,4934,8,64,0,0,0,0,0
1798.555,6,157,17215,81,56,22481,517,5706,76,257,23980,1418,11509
378.467,6,21,1398,14,180,29112,180,916,7,110,10375,110,482
7.865,6,66,20126,32,562,253,1152,15339,34,489,228,1179,4787
1.208,6,10,1687,7,100,201,100,384,3,1179,468,1179,1303
0.165,6,47,20246,26,1007,6,1420,15185,21,420,7,1420,5061
0.017,17,2,368,1,37,0,37,65,1,275,0,275,303
330.284,6,30,2869,16,332,22018,332,1856,14,83,25367,83,1013
1793.147,6,356,22520,208,69,8662,69,12460,148,69,12198,69,10060
1775.336,17,73,3060,72,14,25004,14,3024,1,8,0,8,36
1786.13,6,593,105344,377,304,4750,304,78032,216,83,8307,83,27312
1.663,17,4,240,2,32,1662,32,120,2,32,1662,32,120
1788.188,6,367,23236,212,69,8474,69,12896,155,69,11611,69,10340
5.374,6,40,7309,20,218,282,314,3423,20,513,267,1179,3886
721.932,2,6,192,6,8,144386,8,192,0,0,0,0,0
4.174,17,5,290,5,30,1043,30,290,0,0,0,0,0
1764.247,2,15,480,15,8,126017,8,480,0,0,0,0,0
4.009,17,8,792,4,39,1333,39,268,4,103,1333,103,524
4.421,17,4,240,2,32,4420,32,120,2,32,4420,32,120
1792.507,17,142,11360,71,48,25606,48,5396,71,56,25606,56,5964
1135.668,17,57,2391,56,13,20648,14,2347,1,16,0,16,44
0.406,6,13,1693,7,288,63,288,588,6,426,43,434,1105
0.445,6,22,4442,11,165,44,456,1394,11,493,42,888,3048
1785.509,6,104,8376,68,65,26649,65,4930,36,59,51012,59,3446
0.139,17,2,602,1,46,0,46,74,1,500,0,500,528
0.435,17,6,2069,6,316,87,354,2069,0,0,0,0,0
1772.479,6,180,15480,120,69,14894,69,8940,60,69,30036,69,6540
15.151,17,5,380,5,48,3787,48,380,0,0,0,0,0
1787.862,6,102,8296,68,65,26684,65,4930,34,59,54175,59,3366
4.201,6,40,7309,20,218,221,314,3423,20,440,207,1152,3886
112.972,17,4,1344,4,308,37657,308,1344,0,0,0,0,0
1799.884,2,15,480,15,8,128563,8,480,0,0,0,0,0
1.025,6,3,180,1,0,0,0,60,2,0,1013,0,120
1789.706,17,140,11200,70,48,25937,48,5320,70,56,25937,56,5880
0.86,6,51,13853,24,551,37,1429,4864,27,464,32,1986,8989
161.284,17,3,1008,3,308,80642,308,1008,0,0,0,0,0
280.514,17,4,296,2,30,280440,30,116,2,62,280466,62,180
1798.921,6,356,22520,208,69,8690,69,12460,148,69,12234,69,10060
1772.264,6,180,15480,120,69,14892,69,8940,60,69,30035,69,6540
0.191,1,5,420,5,56,47,56,420,0,0,0,0,0
2.886,6,3,120,1,0,0,0,40,2,0,2886,0,80
96.397,6,76,53099,48,1211,2051,1368,44907,28,747,2289,1368,8192
0.248,17,3,451,2,39,157,39,134,1,289,0,289,317
1739.41,1,56,4704,0,0,0,0,0,56,56,31625,56,4704
0.074,17,2,283,1,31,0,31,59,1,196,0,196,224
17.75,1,4,424,4,78,5916,78,424,0,0,0,0,0
5.916,17,3,1008,3,308,2958,308,1008,0,0,0,0,0
61.936,6,15,1657,9,177,7742,177,1007,6,110,12344,110,650
0.384,6,10,1992,5,288,89,288,508,5,424,53,434,1484
1788.649,6,356,22520,208,69,8640,69,12460,148,69,12167,69,10060
5.536,6,855,779675,553,1363,10,1432,763738,302,477,18,1432,15937
1745.938,6,95,7203,63,38,28160,205,4476,32,33,56306,98,2727
7.402,6,9,588,3,106,3695,106,234,6,90,1478,90,354
0.033,17,2,413,1,100,0,100,128,1,257,0,257,285
1786.294,6,102,8364,68,66,26661,66,4964,34,60,54127,60,3400
0.413,6,28,7482,17,306,25,1089,2828,11,701,40,1728,4654
19.598,6,7,380,4,0,6532,0,216,3,0,9793,0,164
5.903,6,5,220,5,0,0,0,220,0,0,0,0,0
1787.907,6,375,23832,216,69,8315,69,13332,159,69,11315,69,10500
0.167,6,46,21328,26,1089,6,1420,16307,20,467,8,1883,5021
0.159,17,2,152,1,48,0,48,76,1,48,0,48,76
0.006,17,2,358,1,30,0,30,58,1,272,0,272,300
1796.957,6,367,25650,214,99,8436,469,15045,153,69,11818,69,10605
0.262,6,19,4920,10,137,29,267,1092,9,866,31,2867,3828
3.106,6,7428,8407451,2885,152,1,292,154299,4543,1766,0,9814,8253152
1.613,6,49,18831,27,861,62,1360,13175,22,433,66,1360,5656
13.811,6,31,7613,12,155,1255,267,1266,19,371,766,1997,6347
0.015,17,2,251,1,36,0,36,64,1,159,0,159,187
240.25,6,58,20848,29,812,8579,1418,17762,29,196,8579,580,3086
2.762,6,35,18755,19,777,153,1360,6246,16,1693,175,3934,12509
20.613,17,48,14154,23,405,935,1350,9974,25,139,857,1350,4180
82.561,6,70,47513,44,1196,1920,1408,39426,26,747,2465,1408,8087
297.594,6,71,10199,32,170,9599,585,3792,39,229,7831,849,6407
5.212,17,4,288,2,36,5012,36,128,2,52,5197,52,160
11.77,6,1893,1612597,1140,1362,10,1380,1576267,753,475,15,1923,36330
1740.317,6,87,6322,58,31,30531,31,3915,29,31,62153,31,2407
0.914,6,10,1687,7,100,152,100,384,3,1179,327,1179,1303
358.443,17,54,15084,54,251,6763,422,15084,0,0,0,0,0
0.058,17,2,152,2,48,58,48,152,0,0,0,0,0
1773.018,6,183,15738,121,69,14775,69,8980,62,69,29060,69,6758
280.217,6,27,7312,12,158,25474,267,1277,15,678,20012,2045,6035
219.51,6,65,12008,26,235,8780,469,4585,39,292,5003,1460,7423
1.398,6,50,18902,27,863,53,1360,13206,23,433,54,1360,5696
10.958,6,18,5610,10,275,1217,275,958,8,1440,852,1440,4652
317.033,6,72,18824,38,325,8568,1460,9699,34,352,9602,3089,9125
11.776,6,1865,1628003,1152,1363,10,1380,1593273,713,515,16,1923,34730
10.762,6,18,4226,10,275,1195,275,958,8,978,856,1420,3268
756.585,1,147,12348,147,56,5182,56,12348,0,0,0,0,0
44.725,6,45,8836,21,345,796,720,1967,24,327,1938,1460,6869
207.553,17,4,352,2,60,207551,60,176,2,60,207552,60,176
1.312,6,51,19324,27,891,50,1460,13588,24,433,49,1460,5736
209.22,17,4,240,2,32,209219,32,120,2,32,209219,32,120
1121.152,17,10,2745,5,30,280270,30,290,5,463,280286,463,2455
106.691,17,4,352,2,60,106690,60,176,2,60,106690,60,176
0.34,17,2,677,1,300,0,300,328,1,321,0,321,349
98.055,6,37,8050,15,149,2373,267,1652,22,367,4668,1420,6398
1.719,6,14,2351,8,188,245,245,700,6,703,290,1152,1651
0.305,6,22,7342,12,335,27,668,1974,10,1210,33,2816,5368
23.135,6,33,8097,16,188,1542,721,1964,17,681,1434,2828,6133
1756.024,6,95,7203,63,38,28322,205,4476,32,33,56637,98,2727
0.772,6,23,5529,12,140,70,267,1184,11,780,70,1460,4345
4.266,6,38,7245,20,218,224,314,3423,18,516,235,1179,3822
1.569,6,46,18763,27,865,60,1360,13227,19,433,77,1360,5536
1681.533,17,14,1036,7,30,280250,30,406,7,62,280249,62,630
111.324,6,23,10989,12,380,73,832,1665,11,1267,11118,3928,9324
30.789,6,38,9586,18,289,1811,721,3329,20,681,1566,1420,6257
17.635,17,4,1344,4,308,5878,308,1344,0,0,0,0,0
3.104,6,6,364,0,0,0,0,0,6,31,620,31,364
1.875,6,42,16490,24,750,81,1418,14021,18,217,109,580,2469
0.243,17,2,632,1,288,0,288,316,1,288,0,288,316
0.933,17,4,272,2,40,902,40,136,2,40,911,40,136
31.03,17,6,604,6,72,6206,84,604,0,0,0,0,0
219.803,1,8,448,8,28,31400,28,448,0,0,0,0,0
1798.984,6,358,22738,208,69,8690,69,12460,150,69,12073,69,10278
0.193,17,4,240,2,32,192,32,120,2,32,188,32,120
1785.92,17,87,3648,86,14,21010,14,3612,1,8,0,8,36
1729.17,6,61,4464,41,33,43229,33,2804,20,31,90999,31,1660
0.091,6,12,3704,6,171,17,171,491,6,964,12,1448,3213
0.009,17,2,318,1,39,0,39,67,1,223,0,223,251
1744.63,2,20,640,20,8,91822,8,640,0,0,0,0,0
1749.771,1,79,6636,0,0,0,0,0,79,56,22432,56,6636
1787.909,6,357,22767,205,69,8764,69,12409,152,69,11840,69,10358
1771.081,6,116,10698,73,65,24598,65,6184,43,59,42166,59,4514
504.308,2,3,96,3,8,252154,8,96,0,0,0,0,0
1.232,6,16,1472,9,256,132,256,880,7,304,161,304,592
0.271,17,2,588,1,39,0,39,67,1,493,0,493,521
1772.796,6,182,15698,120,69,14897,69,8940,62,69,29060,69,6758
9.016,1,10,840,10,56,1001,56,840,0,0,0,0,0
1787.909,6,365,25777,209,100,8595,469,14776,156,69,11534,69,11001
0.464,17,8,2750,8,315,66,354,2750,0,0,0,0,0
1768.464,1,58,4872,0,0,0,0,0,58,56,31025,56,4872
1734.667,1,36,2016,36,28,49561,28,2016,0,0,0,0,0
1788.866,1,58,4872,58,56,31383,56,4872,0,0,0,0,0
1741.201,6,96,6962,62,31,28544,31,4209,34,31,52763,31,2753
11.159,6,15,4536,6,83,2193,92,499,9,592,1371,2026,4037
379.043,6,24,1587,16,177,25269,177,1053,8,110,8934,110,534
1.882,17,27,10091,13,338,153,1350,4760,14,352,141,1350,5331
280.26,6,29,7392,13,158,23355,267,1317,16,603,18679,2800,6075
128.066,6,23,6677,7,138,21344,267,843,16,518,8532,1420,5834
1793.562,1,58,4872,58,56,31466,56,4872,0,0,0,0,0
248.739,17,4,240,2,32,248738,32,120,2,32,248738,32,120
125.115,6,22,2487,10,304,13901,304,1428,12,83,11334,83,1059
280.558,6,29,7392,13,158,23379,267,1317,16,678,18694,3456,6075
629.99,2,5,160,5,8,157497,8,160,0,0,0,0,0
30.163,17,32,19308,17,725,1880,1350,12816,15,404,2150,1350,6492
494.139,6,68,5092,27,70,19000,295,2483,41,48,12349,78,2609
1740.931,1,16,896,16,28,116062,28,896,0,0,0,0,0
2.978,6,2,88,2,0,0,0,88,0,0,0,0,0
34.307,6,18,4964,13,174,2858,174,698,5,1354,117,1420,4266
93.062,2,3,96,3,8,46531,8,96,0,0,0,0,0
1775.324,1,58,4872,0,0,0,0,0,58,56,31146,56,4872
1704.081,1,8,448,8,28,243440,28,448,0,0,0,0,0
1776.507,17,16,3624,16,198,118433,687,3624,0,0,0,0,0
0.617,17,4,580,2,40,569,40,136,2,194,565,194,444
280.279,6,29,7392,13,158,23356,267,1317,16,603,18677,2036,6075
1774.11,6,180,15480,120,69,14908,69,8940,60,69,30062,69,6540
281.772,6,31,7472,14,158,21674,267,1357,17,603,17610,2036,6115
1772.502,6,204,22330,130,75,13740,267,10057,74,132,24277,1460,12273
1743.758,6,95,7203,63,38,28125,205,4476,32,33,56243,98,2727
1679.721,17,13,534,11,14,167953,14,462,2,8,1679536,8,72
1784.845,17,142,11360,71,48,25497,48,5396,71,56,25497,56,5964
0.691,6,14,1745,7,288,82,288,600,7,426,84,434,1145
0.795,6,9,1340,5,145,198,145,349,4,827,175,827,991
256.205,6,74,13236,31,264,8182,1189,4956,43,273,6099,1917,8280
0.473,6,23,7397,13,334,39,663,2021,10,967,49,1471,5376
280.24,6,28,7352,13,158,23353,267,1317,15,678,20015,2800,6035
1.833,6,51,20385,29,962,65,1460,14684,22,400,74,1460,5701
1787.437,6,102,8296,68,65,26678,65,4930,34,59,54161,59,3366
33.351,6,20,5856,11,267,3335,502,1246,9,707,4157,1420,4610
0.289,17,2,212,1,46,0,46,74,1,110,0,110,138
1770.411,6,197,31920,111,256,16094,826,20415,86,121,20827,234,11505
1.254,6,25,8056,12,164,97,267,1288,13,869,89,1448,6768
125.887,2,2,64,2,8,125887,8,64,0,0,0,0,0
180.845,17,4,240,2,32,180843,32,120,2,32,180843,32,120
1796.875,17,448,39896,403,35,4469,288,25676,45,288,40018,288,14220
1781.207,6,357,22698,207,69,8646,69,12489,150,69,11954,69,10209
25.654,6,3615,3393784,2285,1405,11,1448,3319960,1330,776,19,1448,73824
1741.019,6,92,6668,60,31,29508,31,4062,32,31,56160,31,2606
1796.853,6,274,48914,182,302,9927,302,36652,92,83,19745,83,12262
1786.662,6,102,8364,68,66,26666,66,4964,34,60,54138,60,3400
1786.461,6,118,13696,77,81,23506,501,6030,41,154,44659,1420,7666
116.369,6,31,6689,15,166,8312,501,1600,16,444,7749,1420,5089
1.42,6,52,21477,29,911,50,1360,15781,23,433,56,1360,5696
1741.961,1,15,840,15,28,124425,28,840,0,0,0,0,0
0.166,1,2,163,2,53,166,78,163,0,0,0,0,0
61.327,6,22,9393,11,354,66,752,1535,11,1058,6119,1440,7858
1155.339,1,10,560,10,28,128371,28,560,0,0,0,0,0
0.125,17,10,5430,5,618,31,1350,3234,5,411,23,1350,2196
1777.593,17,142,11360,71,48,25393,48,5396,71,56,25393,56,5964
5.011,17,4,526,2,36,5006,36,128,2,171,5005,171,398
302.165,6,51,17446,28,861,11191,1360,11495,23,358,454,1360,5951
163.889,6,10,435,3,0,81944,0,124,7,7,26995,7,311
1790.741,1,339,28476,339,56,5298,56,28476,0,0,0,0,0
148.904,17,6,1236,3,48,74448,48,228,3,308,74448,308,1008
0.202,6,24,7660,12,176,18,334,1339,12,1137,17,1648,6321
0.014,17,2,182,1,39,0,39,67,1,87,0,87,115
127.625,6,24,11684,8,154,18232,267,792,16,853,8506,3377,10892
23.281,1,4,224,4,28,7760,28,224,0,0,0,0,0
107.399,6,24,6248,9,272,107,516,1180,15,372,7664,1452,5068
1792.655,6,279,34380,116,141,15587,1360,16972,163,134,11065,3302,17408
1798.365,1,267,14952,267,28,6760,28,14952,0,0,0,0,0
0.243,17,2,152,1,48,0,48,76,1,48,0,48,76
1.665,6,13,2311,8,188,237,245,700,5,1407,353,1407,1611
192.052,17,4,352,2,60,192051,60,176,2,60,192051,60,176
6.956,6,1117,963723,672,1388,10,1420,941702,445,420,15,1420,22021
1740.973,6,134,8393,75,46,23526,208,5134,59,31,30012,31,3259
404.097,6,31,3415,17,185,25256,1314,2723,14,33,25508,34,692
312.546,17,37,12640,37,313,8681,548,12640,0,0,0,0,0
280.538,6,30,7432,13,158,23378,267,1317,17,678,17524,2760,6115
0.224,6,22,5009,12,89,20,147,1000,10,696,23,1418,4009
1.383,6,38,8254,19,321,76,1164,2718,19,433,67,1440,5536
0.057,6,9,1348,5,145,14,145,349,4,835,15,835,999
59.212,6,28,7217,13,155,4934,267,1306,15,482,4228,1997,5911
1740.755,17,29,6815,29,207,62169,207,6815,0,0,0,0,0
0.161,6,42,17190,24,937,7,1420,12249,18,420,8,1420,4941
683.281,6,61,11758,29,112,19357,516,2630,32,290,22038,1452,9128
1747.445,6,99,7411,63,38,28184,205,4476,36,33,49915,98,2935
0.013,6,11,1805,6,126,2,126,446,5,545,1,990,1359
1.586,6,49,19180,27,886,61,1360,13524,22,433,66,1360,5656
1657.649,1,7,392,7,28,276274,28,392,0,0,0,0,0
197.064,17,4,1344,4,308,65688,308,1344,0,0,0,0,0
1749.602,17,12,498,11,14,174960,14,462,1,8,0,8,36
1.438,6,48,19025,26,945,57,1460,13369,22,433,59,1460,5656
17.315,6,16,2358,9,210,2164,210,908,7,545,2885,904,1450
364.492,6,25,1651,17,177,22780,177,1117,8,110,9160,110,534
280.031,6,28,7352,13,158,23335,267,1317,15,678,19999,3436,6035
1799.271,6,138,9000,77,53,23674,208,5630,61,31,29983,31,3370
1750.801,6,202,19059,104,73,16998,721,8739,98,172,18046,1414,10320
0.051,6,2,123,1,0,0,0,40,1,31,0,31,83
0.778,6,10,1687,7,100,129,100,384,3,1179,262,1179,1303
2.052,17,23,13861,10,526,228,1350,5543,13,611,159,1350,8318
201.463,6,112,82991,70,1278,2919,1448,72693,42,675,1809,1448,10298
0.375,6,10,968,5,256,92,256,460,5,304,92,304,508
187.392,17,7,2292,7,299,31232,312,2292,0,0,0,0,0
1.412,6,171,204589,89,258,16,517,7517,82,2471,16,14080,197072
3.243,6,73,45136,39,913,85,1360,12549,34,1248,93,1360,32587
0.28,6,9,1269,5,585,70,585,841,4,212,88,212,428
1120.909,17,12,3143,6,31,224167,37,355,6,436,224181,463,2788
1740.266,6,87,6322,58,31,30530,31,3915,29,31,62151,31,2407
50.88,6,27,7177,13,155,4240,267,1306,14,530,3913,3417,5871
60.53,6,7,320,3,0,30265,0,128,4,0,2393,0,192
0.676,6,8,440,5,0,169,0,268,3,0,290,0,172
0.032,17,2,472,1,60,0,60,88,1,356,0,356,384
4.242,17,5,295,5,31,1060,31,295,0,0,0,0,0
1787.507,6,102,8364,68,66,26679,66,4964,34,60,54163,60,3400
871.937,17,70,5600,35,48,25644,48,2660,35,56,25644,56,2940
1788.011,17,142,11360,71,48,25542,48,5396,71,56,25542,56,5964
1.377,6,47,19326,27,902,52,1460,13750,20,476,62,2615,5576
308.849,17,20,18499,20,896,16255,1451,18499,0,0,0,0,0
107.321,6,22,8784,11,325,63,634,1447,11,983,10719,1360,7337
1799.457,1,31,3786,31,94,59981,173,3786,0,0,0,0,0
280.392,6,30,7432,13,158,23366,267,1317,17,543,17521,1400,6115
280.456,6,29,7392,14,158,21573,267,1357,15,678,20026,3436,6035
378.64,2,4,128,4,8,126213,8,128,0,0,0,0,0
0.582,6,26,9041,13,261,48,683,1752,13,943,48,1408,7289
10.952,6,20,4442,11,275,1095,275,998,9,768,766,1440,3444
1795.785,17,142,11360,71,48,25653,48,5396,71,56,25653,56,5964
599.76,6,12,697,7,31,99960,31,373,5,31,149850,31,324
1744.341,17,49,16464,49,308,36340,308,16464,0,0,0,0,0
15.275,6,35,8401,19,401,848,889,2008,16,521,569,3488,6393
1768.814,1,58,4872,0,0,0,0,0,58,56,31031,56,4872
1716.093,1,36,3816,36,78,49031,78,3816,0,0,0,0,0
0.532,6,27,9154,14,220,40,711,1839,13,1103,39,2736,7315
0.006,17,2,216,1,45,0,45,73,1,115,0,115,143
20.34,6,18,3655,10,269,2260,517,1616,8,538,2904,969,2039
1792.68,17,89,3729,87,13,20842,14,3649,2,12,1792300,16,80
1739.457,6,87,6322,58,31,30516,31,3915,29,31,62122,31,2407
1781.763,6,361,22858,210,69,8525,69,12678,151,69,11878,69,10180
1692.415,1,7,392,7,28,282069,28,392,0,0,0,0,0
1795.47,6,471,63304,262,267,6879,981,33715,209,175,8631,453,29589
0.487,17,2,384,1,39,0,39,67,1,289,0,289,317
1768.877,6,101,9344,66,65,27213,65,5577,35,59,52021,59,3767
1798.857,17,91,6916,91,48,19987,48,6916,0,0,0,0,0
202.061,17,4,1018,2,34,202047,39,124,2,419,202037,432,894
1700.614,17,12,498,11,14,170061,14,462,1,8,0,8,36
127.393,6,18,3639,4,92,265,92,308,14,216,9786,1408,3331
0.036,6,10,1512,5,503,8,503,771,5,473,9,473,741
3.839,17,4,352,2,48,3826,48,152,2,72,3826,72,200
1.664,6,54,20440,30,894,57,1360,14659,24,400,62,1360,5781
5.602,6,854,749603,535,1357,10,1432,732516,319,427,17,1432,17087
1744.499,6,95,7203,63,38,28137,205,4476,32,33,56264,98,2727
0.487,6,6,324,4,0,162,0,216,2,0,294,0,108
52.133,17,4,352,2,60,52132,60,176,2,60,52132,60,176
227.447,6,31,8637,20,206,11970,1258,3116,11,705,2650,1448,5521
1795.863,17,447,39864,402,35,4478,288,25644,45,288,40017,288,14220
117.774,6,28,6904,13,217,9814,517,1576,15,504,2234,1418,5328
1799.585,1,58,4872,58,56,31571,56,4872,0,0,0,0,0
2.14,1,2,668,2,306,2140,306,668,0,0,0,0,0
1743.778,6,100,7556,65,38,27246,205,4580,35,33,51275,98,2976
0.103,6,9,1002,5,213,25,213,417,4,421,27,421,585
61.657,6,58,39683,38,1150,1666,1408,31893,20,963,3233,3847,7790
1746.113,6,142,8806,78,45,22676,208,5347,64,31,27712,31,3459
8.294,6,14,6155,3,186,4140,267,501,11,650,827,1452,5654
757.709,17,16,1427,8,32,108240,37,485,8,89,108241,136,942
322.853,6,92,14937,39,166,7315,1189,4561,53,274,6208,1420,10376
7.177,1,2,748,2,346,7177,346,748,0,0,0,0,0
1774.959,6,180,15480,120,69,14915,69,8940,60,69,30079,69,6540
0.702,6,13,1121,7,186,111,186,744,6,45,139,45,377
396.492,6,18,1696,14,509,30499,509,1089,4,435,68265,435,607
0.076,6,12,3705,6,171,11,171,491,6,964,12,1448,3214
28.626,6,1381,1266586,836,1433,33,1448,1232034,545,776,52,1448,34552
1648.135,1,7,392,7,28,274689,28,392,0,0,0,0,0
274.485,6,161,51916,76,599,3659,1360,37303,85,280,3266,1360,14613
1794.054,17,29,9512,29,300,64073,300,9512,0,0,0,0,0
0.183,6,26,7256,13,155,15,267,1301,13,678,13,2800,5955
0.483,6,14,1917,6,304,96,304,1232,8,83,65,83,685
0.081,6,9,1002,5,213,20,213,417,4,421,22,421,585
1772.331,6,180,15480,120,69,14893,69,8940,60,69,30034,69,6540
1.159,6,27,8591,14,283,74,625,2009,13,1008,79,2720,6582
24.354,6,32,5083,17,165,1522,456,1770,15,498,1675,888,3313
300.997,6,38,8538,20,308,15841,885,2064,18,441,506,1360,6474
1799.82,6,355,22480,207,69,8736,69,12420,148,69,12240,69,10060
250.04,6,53,7228,23,138,7125,722,2725,30,139,8616,1408,4503
0.103,6,9,1338,5,145,25,145,349,4,825,27,825,989
161.424,17,4,352,2,60,161423,60,176,2,60,161423,60,176
2.628,6,13,2311,7,188,438,245,660,6,1407,475,1407,1651
2.107,17,26,16848,14,787,162,1350,11415,12,424,164,1350,5433
11.706,6,1970,1826933,1228,1408,9,1448,1783673,742,776,15,1448,43260
240.838,6,48,8624,22,173,11468,561,2226,26,359,9633,1408,6398
0.051,17,2,188,1,58,0,58,86,1,74,0,74,102
80.45,6,159,111095,85,1209,92,1460,22790,74,1376,1100,2920,88305
1786.269,6,102,8296,68,65,26660,65,4930,34,59,54126,59,3366
1685.961,1,7,392,7,28,280993,28,392,0,0,0,0,0
1746.004,6,95,7203,63,38,28161,205,4476,32,33,56312,98,2727
0.063,6,9,1344,5,145,15,145,349,4,831,16,831,995
1740.417,6,87,6322,58,31,30533,31,3915,29,31,62157,31,2407
1754.228,6,185,11345,93,47,19067,208,6735,92,31,19274,31,4610
0.446,1,10,840,10,56,49,56,840,0,0,0,0,0
0.505,17,3,451,2,39,351,39,134,1,289,0,289,317
1.453,17,4,734,2,44,1440,44,144,2,267,1442,275,590
240.279,6,284,390040,112,196,2164,703,7416,172,2320,1405,7010,382624
281.475,6,28,7352,12,158,25588,267,1277,16,603,18751,1400,6075
240.321,6,48,8698,25,449,10013,1408,5816,23,186,10923,580,2882
2.013,17,6,460,3,40,998,41,206,3,56,996,57,254
1679.84,1,15,840,15,28,119988,28,840,0,0,0,0,0
1773.537,6,181,15589,120,69,14903,69,8940,61,69,29556,69,6649
101.795,6,135,101491,84,1269,1226,1368,90712,51,676,1877,1368,10779
11.19,6,20,6495,5,154,2797,267,672,15,520,784,1460,5823
140.228,17,18,1380,9,40,17526,41,618,9,56,17526,57,762
11.42,6,1782,1573878,1113,1364,10,1380,1540965,669,558,17,1923,32913
0.155,6,46,21588,27,1033,5,1420,16607,19,467,8,1883,4981
0.35,6,27,8957,13,241,29,606,1651,14,938,26,1408,7306
1786.756,6,102,8364,68,66,26668,66,4964,34,60,54140,60,3400
408.21,17,13,1307,13,72,34017,355,1307,0,0,0,0,0
0.278,6,26,6084,12,164,25,453,1442,14,558,20,1402,4642
317.182,6,71,19385,36,347,9062,1360,9820,35,388,9324,4649,9565
280.347,6,30,7432,13,158,23362,267,1317,17,543,17519,1400,6115
300.437,6,40,12492,21,593,15021,1408,4734,19,614,13563,1578,7758
0.839,17,3,372,2,64,615,64,184,1,160,0,160,188
1476.976,6,170,22487,113,112,13187,469,11929,57,156,21281,3423,10558
300.827,6,37,8501,21,308,15041,888,2107,16,522,576,3488,6394
391.437,6,98,11811,51,96,7828,267,3792,47,255,8508,1460,8019
1799.968,1,242,13552,242,28,7468,28,13552,0,0,0,0,0
0.104,17,2,212,1,46,0,46,74,1,110,0,110,138
1799.67,1,57,4788,57,56,32136,56,4788,0,0,0,0,0
1791.008,6,262,49960,160,483,11264,483,39288,102,83,17732,83,10672
1797.407,17,449,39928,404,35,4460,288,25708,45,288,40021,288,14220
1784.157,17,141,11276,71,48,25487,48,5396,70,56,25856,56,5880
300.232,6,107,90470,40,134,7698,192,2624,67,1360,3637,1438,87846
1796.839,17,448,39612,404,35,4458,288,25708,44,288,40949,288,13904
0.343,6,10,968,5,256,84,256,460,5,304,84,304,508
1.14,6,29,10429,16,599,65,1360,3682,13,776,80,2134,6747
0.037,17,4,588,2,48,33,48,152,2,190,31,308,436
0.043,6,10,1512,5,503,10,503,771,5,473,10,473,741
195.361,6,1341,693161,764,842,256,1152,662141,577,396,338,1179,31020
1783.637,17,83,3480,82,14,22020,14,3444,1,8,0,8,36
300.617,6,37,8527,19,315,16700,882,2053,18,441,499,1440,6474
0.521,6,29,7521,17,306,32,1088,2827,12,601,45,1452,4694
0.111,17,2,334,1,32,0,32,60,1,246,0,246,274
299.543,6,6,364,4,31,99847,31,222,2,31,299521,31,142
10.865,6,20,4442,11,275,1086,275,998,9,768,761,1440,3444
30.766,6,6,360,0,0,0,0,0,6,0,0,0,360
887.969,1,26,1456,26,28,35518,28,1456,0,0,0,0,0
1797.432,17,447,39580,403,35,4471,288,25676,44,288,40950,288,13904
0.905,6,23,6205,13,269,75,685,1871,10,982,99,1731,4334
11.108,6,86,24965,43,542,264,1152,19088,43,461,258,1179,5877
3.828,17,5,840,4,64,1266,64,368,1,444,0,444,472
2.17,6,45,36797,23,751,98,1408,5710,22,2302,102,7040,31087
1794.585,17,144,11520,72,48,25275,48,5472,72,56,25275,56,6048
0.007,6,2,84,1,0,0,0,44,1,0,0,0,40
1740.734,6,215,25237,111,125,15824,721,13105,104,159,16897,2828,12132
1679.551,17,12,498,11,14,167955,14,462,1,8,0,8,36
0.809,17,21,9619,10,427,86,1350,4551,11,432,77,1350,5068
1787.061,17,87,3648,86,14,21024,14,3612,1,8,0,8,36
212.04,6,25,6318,9,272,109,516,1180,16,345,14129,1452,5138
1.194,6,41,9968,21,440,59,1360,4392,20,476,54,2720,5576
1771.287,6,101,9410,66,66,27250,66,5610,35,60,52093,60,3800
171.947,6,29,8080,10,217,6432,505,1274,19,377,9548,1420,6806
0.009,17,2,167,1,39,0,39,67,1,72,0,72,100
1.198,6,25,8056,12,164,93,267,1288,13,869,85,1440,6768
1795.559,6,367,23236,212,69,8509,69,12896,155,69,11656,69,10340
12.757,17,4,352,2,48,12735,48,152,2,72,12734,72,200
0.009,1,4,432,0,0,0,0,0,4,80,3,80,432
0.6,6,15,1785,8,288,65,288,640,7,426,70,434,1145
141.707,6,30,6752,10,217,6589,502,1272,20,275,7453,1420,5480
1.445,6,50,17770,28,838,53,1360,12069,22,437,59,2715,5701
5.174,6,3,152,2,0,5174,0,100,1,0,0,0,52
11.906,6,1878,1645090,1140,1389,10,1420,1611349,738,467,16,1883,33741
100.137,17,24,8754,24,336,4353,359,8754,0,0,0,0,0
0.274,17,2,396,1,39,0,39,67,1,301,0,301,329
0.344,6,23,7271,11,257,33,748,1611,12,838,30,1418,5660
0.014,17,4,538,3,36,1,36,192,1,318,0,318,346
0.886,6,33,13301,19,890,49,1440,7039,14,632,54,1440,6262
19.899,6,13,4992,6,150,3979,174,544,7,832,298,1420,4448
0.793,2,2,64,2,8,793,8,64,0,0,0,0,0
15.361,6,17,2425,9,211,1919,211,922,8,545,2194,904,1503
0.323,17,8,2774,8,318,46,357,2774,0,0,0,0,0
3.343,17,5,295,5,31,835,31,295,0,0,0,0,0
377.962,2,3,96,3,8,188981,8,96,0,0,0,0,0
28.881,6,20,4477,8,341,4125,722,1437,12,342,2597,1408,3040
198.732,17,4,1344,4,308,66244,308,1344,0,0,0,0,0
0.628,6,38,11413,22,566,29,1188,7366,16,356,36,758,4047
560.378,17,6,1647,3,30,280187,30,174,3,463,280186,463,1473
13.1,6,13,2133,8,324,1871,585,1073,5,396,3205,580,1060
3.312,6,50,21353,28,969,122,1460,15697,22,433,135,1460,5656
0.044,17,4,336,2,34,3,34,124,2,78,38,84,212
1.539,6,41,8429,21,320,76,1162,2808,20,400,70,1460,5621
1781.783,1,323,27132,323,56,5533,56,27132,0,0,0,0,0
1680.446,1,14,812,14,30,129265,30,812,0,0,0,0,0
1422.833,17,250,69119,250,248,5714,422,69119,0,0,0,0,0
1771.373,6,101,9344,66,65,27251,65,5577,35,59,52096,59,3767
501.299,17,43,45121,43,1021,11935,1451,45121,0,0,0,0,0
0.502,6,26,9017,13,261,41,683,1728,13,943,40,1438,7289
1772.068,6,182,15629,121,69,14767,69,8980,61,69,29530,69,6649
0.089,17,2,245,1,32,0,32,60,1,157,0,157,185
1.457,6,50,19336,27,894,56,1460,13640,23,433,56,1460,5696
1786.813,17,87,3648,86,14,21021,14,3612,1,8,0,8,36
1789.147,17,142,11360,71,48,25559,48,5396,71,56,25559,56,5964
241.426,6,49,7942,22,332,11496,1056,3524,27,273,9285,696,4418
1772.27,6,239,17840,120,69,14893,69,8940,119,34,15019,69,8900
2.845,17,3,468,3,128,1422,128,468,0,0,0,0,0
771.012,6,95,14373,52,123,15117,965,5286,43,198,18357,1420,9087
287.551,6,34,8027,16,262,19167,517,1640,18,778,16911,1418,6387
236.675,6,129,100566,84,1260,2851,1368,90098,45,738,1647,2519,10468
60.025,17,12,912,12,48,5456,48,912,0,0,0,0,0
280.376,6,28,7352,12,158,25488,267,1277,16,603,18682,1400,6075
5.007,17,4,558,2,36,4998,36,128,2,187,4993,187,430
28.969,6,17,1814,13,222,2414,222,1638,4,0,1133,0,176
3.012,17,4,292,2,37,3004,37,130,2,53,3003,53,162
0.979,17,3,1170,3,362,489,362,1170,0,0,0,0,0
0.115,17,7,2368,7,310,19,354,2368,0,0,0,0,0
71.665,6,10,1416,10,127,7962,127,1416,0,0,0,0,0
7.464,6,1062,950595,641,1404,11,1448,924039,421,776,17,1448,26556
0.121,17,2,184,1,32,0,32,60,1,96,0,96,124
13.302,17,4,824,2,48,13293,48,152,2,308,13290,308,672
0.455,17,8,2750,8,315,65,354,2750,0,0,0,0,0
1246.667,6,31,3655,22,98,59365,138,2743,9,69,15920,69,912
364.357,6,25,1651,17,177,22772,177,1117,8,110,9156,110,534
0.338,6,18,3068,9,282,42,531,1606,9,493,24,828,1462
1789.977,17,763,46018,763,32,2349,37,46018,0,0,0,0,0
0.707,6,3,120,1,0,0,0,40,2,0,707,0,80
61.095,6,28,7217,13,155,5091,267,1306,15,482,4363,1997,5911
202.072,17,4,352,2,60,202070,60,176,2,60,202071,60,176
1790.81,17,140,11200,70,48,25953,48,5320,70,56,25953,56,5880
1783.526,6,356,22520,208,69,8616,69,12460,148,69,12130,69,10060
0.172,6,26,7256,13,155,14,267,1301,13,678,13,2800,5955
264.469,6,132,100869,86,1271,3111,1408,89699,46,674,2614,3847,11170
1796.498,17,31,7285,31,207,59883,207,7285,0,0,0,0,0
1787.497,17,87,3648,86,14,21029,14,3612,1,8,0,8,36
0.571,6,9,1337,5,145,142,145,349,4,824,88,824,988
1788.783,17,87,3648,86,14,21044,14,3612,1,8,0,8,36
69.085,6,27,7177,13,155,5757,267,1306,14,530,5313,3417,5871
0.661,17,4,820,2,36,656,36,128,2,318,656,318,692
0.856,6,11,1727,7,100,142,100,384,4,589,202,1152,1343
519.336,6,56,3728,21,77,25966,138,1461,35,39,15274,48,2267
11.836,6,19,4306,10,275,1315,275,958,9,992,1356,1440,3348
1617.45,1,7,392,7,28,269575,28,392,0,0,0,0,0
1741.634,1,70,5880,70,56,25241,56,5880,0,0,0,0,0
0.372,17,2,672,2,308,372,308,672,0,0,0,0,0
379.266,6,25,1651,17,177,23704,177,1117,8,110,9292,110,534
149.095,6,36,7338,17,142,9318,516,1825,19,339,8278,1452,5513
1739.822,6,87,6322,58,31,30523,31,3915,29,31,62135,31,2407
1.358,6,41,13487,23,703,61,1360,7991,18,476,69,2715,5496
280.476,6,28,7352,13,158,23373,267,1317,15,775,20027,3465,6035
0.068,6,5,303,2,0,3,0,116,3,31,33,31,187
0.026,17,2,197,1,35,0,35,63,1,106,0,106,134
0.02,17,2,136,1,32,0,32,60,1,48,0,48,76
599.62,17,26,8736,26,308,23984,308,8736,0,0,0,0,0
1775.529,17,140,11200,70,48,25732,48,5320,70,56,25732,56,5880
0.494,6,9,1343,5,145,123,145,349,4,830,154,830,994
0.111,6,10,2046,6,739,22,1322,1723,4,159,36,159,323
7.489,17,12,1764,6,48,1495,48,456,6,190,1495,308,1308
1680.958,1,15,840,15,28,120068,28,840,0,0,0,0,0
137.075,6,32,8952,14,158,10544,267,1357,18,624,8060,1400,7595
1.69,6,14,2351,8,188,241,245,700,6,703,285,1152,1651
1680.685,17,12,498,11,14,168068,14,462,1,8,0,8,36
2.993,1,3,318,3,78,1496,78,318,0,0,0,0,0
0.023,6,2,135,2,31,23,31,135,0,0,0,0,0
20.867,17,1019,1147938,172,52,121,1350,13812,847,1310,24,1350,1134126
99.803,6,19,3771,6,167,10457,242,654,13,1164,8301,1408,3117
622.964,17,22,2033,11,33,62293,37,673,11,95,62268,136,1360
17.04,6,12,5544,4,112,5680,112,280,8,822,2357,1420,5264
1729.247,6,62,4504,40,33,44339,33,2740,22,31,82334,31,1764
69.093,6,26,7137,12,155,6281,267,1266,14,530,5314,2006,5871
0.108,6,9,1340,5,145,27,145,349,4,827,12,827,991
0.832,6,34,8135,19,247,46,643,1781,15,574,49,4848,6354
0.161,6,9,1340,5,145,40,145,349,4,827,48,827,991
1772.078,6,99,9306,66,66,27262,66,5610,33,60,55374,60,3696
1795.338,17,140,11200,70,48,26019,48,5320,70,56,26019,56,5880
0.405,6,12,1653,6,288,79,288,548,6,426,43,434,1105
16.559,6,15,5936,5,98,4137,112,502,10,837,1838,1420,5434
1791.342,1,58,4872,58,56,31427,56,4872,0,0,0,0,0
0.12,6,10,1569,5,627,30,627,895,5,406,30,406,674
132.579,17,2,150,2,47,132579,47,150,0,0,0,0,0
38.353,6,16,2301,9,326,4794,589,1129,7,396,6152,580,1172
1776.648,6,85,4951,43,31,42299,36,2298,42,234,42207,443,2653
0.017,17,2,144,1,36,0,36,64,1,52,0,52,80
6.463,6,1869,1834792,1254,1389,5,1408,1798148,615,776,10,1408,36644
1096.722,1,14,784,14,28,84363,28,784,0,0,0,0,0
0.077,17,2,152,1,48,0,48,76,1,48,0,48,76
0.654,6,14,1745,7,288,76,288,600,7,426,79,434,1145
0.063,17,2,2128,2,1036,63,1036,2128,0,0,0,0,0
199.184,6,30,7432,13,158,16598,267,1317,17,543,12445,1400,6115
0.431,6,26,9026,13,263,35,691,1736,13,943,34,1448,7290
367.239,6,25,1651,17,177,22952,177,1117,8,110,9209,110,534
1776.775,17,50,16800,50,308,36260,308,16800,0,0,0,0,0
281.072,6,28,7421,12,158,25552,267,1277,16,550,18736,1400,6144
28.962,6,15,5679,4,112,9651,112,280,11,706,2895,1420,5399
1794.575,17,80,3354,79,14,23007,14,3318,1,8,0,8,36
0.991,6,19,5880,11,285,99,556,1300,8,851,125,2642,4580
0.111,17,4,352,2,37,104,37,130,2,83,104,89,222
43.478,17,24,2112,12,48,3945,48,912,12,72,3950,72,1200
232.612,6,30,7432,13,158,19384,267,1317,17,543,14532,1400,6115
184.148,17,6,3543,6,562,36829,696,3543,0,0,0,0,0
1.681,17,4,947,2,33,1671,37,123,2,384,1669,463,824
380.593,6,84,14595,39,312,10014,1368,7343,45,222,8649,1368,7252
3.998,17,6,788,4,32,1052,32,240,2,246,0,246,548
9.385,6,1864,1743452,1198,1378,7,1408,1704156,666,931,13,2801,39296
1796.276,17,80,3354,79,14,23029,14,3318,1,8,0,8,36
1772.107,6,180,15480,120,69,14891,69,8940,60,69,30032,69,6540
1.66,6,14,2351,8,188,237,245,700,6,703,281,1152,1651
1796.847,6,452,26562,240,69,7518,69,13878,212,34,8515,64,12684
0.551,17,2,136,1,32,0,32,60,1,48,0,48,76
0.036,17,2,672,2,308,36,308,672,0,0,0,0,0
0.365,17,2,233,1,50,0,50,78,1,127,0,127,155
1786.956,6,103,8326,68,64,26670,64,4896,35,58,52555,58,3430
973.213,6,139,10201,57,64,17376,295,4862,82,47,12014,78,5339
1788.692,6,361,22858,210,69,8558,69,12678,151,69,11924,69,10180
0.116,1,2,163,2,53,116,78,163,0,0,0,0,0
12.704,6,24,6993,13,275,1058,275,1078,11,910,769,1440,5915
1785.858,6,366,24534,212,87,8463,469,14096,154,69,11672,69,10438
6.335,6,18,6940,6,275,1267,275,794,12,629,472,1414,6146
66.459,6,25,10330,12,579,59,1360,2831,13,995,5527,1360,7499
2.739,6,2,88,2,0,0,0,88,0,0,0,0,0
1.385,6,49,18814,27,860,53,1360,13158,22,433,57,1360,5656
165.723,6,72,51940,48,1184,3526,1368,43959,24,840,2685,2519,7981
242.301,17,3,231,3,49,121150,49,231,0,0,0,0,0
124.827,6,785,691478,459,718,272,1396,30594,326,2031,384,8376,660884
0.889,17,3,222,3,46,444,46,222,0,0,0,0,0
2.288,6,13,2311,8,188,326,245,700,5,1407,500,1407,1611
1722.407,1,56,3136,56,28,31316,28,3136,0,0,0,0,0
1276.303,6,298,28803,155,133,8006,1189,13556,143,139,8987,1420,15247
1777.205,17,79,3312,78,14,23080,14,3276,1,8,0,8,36
1134.362,2,6,192,6,8,226872,8,192,0,0,0,0,0
338.446,6,89,30947,42,594,8254,1418,11113,47,695,7357,1418,19834
68.91,6,25,8763,9,138,8613,267,923,16,719,4570,2840,7840
324.184,6,182,141856,117,1317,2794,1448,126034,65,565,2742,1448,15822
19.768,6,27,4710,14,275,1520,275,1130,13,758,1256,1420,3580
0.245,6,2,88,1,0,0,0,44,1,0,0,0,44
30.064,17,36,5292,18,48,1767,48,1368,18,190,1767,308,3924
0.015,17,2,471,1,45,0,45,73,1,370,0,370,398
60.59,6,27,7177,13,155,5049,267,1306,14,530,4660,3417,5871
0.543,6,54,22874,31,1021,18,1380,17635,23,426,22,3303,5239
1769.64,6,99,9174,66,64,27225,64,5544,33,58,55297,58,3630
0.163,6,28,7336,14,155,12,267,1341,14,603,12,2036,5995
1746.228,6,96,7255,62,38,28626,205,4424,34,33,52907,98,2831
0.298,17,2,184,1,32,0,32,60,1,96,0,96,124
0.842,6,13,2546,6,288,146,288,548,7,568,110,853,1998
1741.352,17,29,30624,29,1028,62191,1028,30624,0,0,0,0,0
61.287,6,37,15935,22,800,2918,1448,9157,15,665,4359,1448,6778
1784.617,1,102,10812,102,78,17669,78,10812,0,0,0,0,0
0.075,17,2,304,1,60,0,60,88,1,188,0,188,216
1.253,6,50,20121,28,887,46,1360,14465,22,476,51,2715,5656
269.644,1,3,168,3,28,134822,28,168,0,0,0,0,0
1795.489,1,58,4872,0,0,0,0,0,58,56,31499,56,4872
0.412,17,8,2758,8,316,58,355,2758,0,0,0,0,0
0.347,2,2,64,2,8,347,8,64,0,0,0,0,0
8.824,6,24,10864,12,275,802,275,763,12,1201,710,1414,10101
0.213,6,47,21258,27,1081,8,1420,16237,20,467,10,2840,5021
125.411,6,17,3345,8,92,17915,92,504,9,338,15650,1402,2841
1794.964,17,87,3648,86,14,21117,14,3612,1,8,0,8,36
1.501,6,47,19080,26,953,60,1460,13464,21,476,65,2615,5616
0.241,6,32,7991,17,131,15,131,1023,15,475,17,578,6968
1776.458,6,180,15480,120,69,14928,69,8940,60,69,30101,69,6540
7.093,6,1741,1633812,1115,1388,6,1408,1596596,626,931,11,2816,37216
4.311,17,4,824,2,48,4297,48,152,2,308,4293,308,672
0.265,17,8,2758,8,316,37,355,2758,0,0,0,0,0
1786.454,6,169,25540,99,263,18229,1294,16856,70,117,25888,362,8684
15.789,17,13,6609,7,612,2626,1350,4485,6,326,3151,1350,2124
0.994,6,11,1727,7,100,165,100,384,4,589,246,1152,1343
1785.859,6,356,22520,208,69,8627,69,12460,148,69,12148,69,10060
1797.344,17,449,39928,404,35,4459,288,25708,45,288,40018,288,14220
5.019,17,4,558,2,36,5005,36,128,2,187,5009,187,430
2.975,6,4,196,2,0,2974,0,92,2,0,8,0,104
175.89,2,3,96,3,8,87945,8,96,0,0,0,0,0
1795.33,1,264,14784,264,28,6826,28,14784,0,0,0,0,0
0.001,17,7,1493,7,185,0,219,1493,0,0,0,0,0
1763.515,17,261,65360,261,222,6782,422,65360,0,0,0,0,0
1680.395,1,15,840,15,28,120028,28,840,0,0,0,0,0
1.107,6,22,7900,12,164,86,267,1288,10,1521,105,5227,6612
1786.914,6,358,22738,208,69,8632,69,12460,150,69,11992,69,10278
145.4,17,4,1344,4,308,48466,308,1344,0,0,0,0,0
1.371,6,47,18701,26,924,54,1460,13085,21,433,58,1460,5616
0.521,17,2,144,1,36,0,36,64,1,52,0,52,80
1795.294,17,449,39928,404,35,4454,288,25708,45,288,40018,288,14220
66.746,6,7917,7564793,5112,1400,13,1448,7414427,2805,899,23,1448,150366
1782.111,17,83,3480,82,14,22001,14,3444,1,8,0,8,36
1795.265,17,80,3354,79,14,23016,14,3318,1,8,0,8,36
1776.914,6,98,7421,65,38,27764,205,4611,33,33,55515,98,2810
1795.82,17,446,38980,404,35,4456,288,25708,42,288,42946,288,13272
1798.45,1,38,4497,38,90,48606,320,4497,0,0,0,0,0
1785.86,6,370,25770,214,99,8384,469,15114,156,69,11521,69,10656
18.221,6,2351,2178582,1510,1363,11,1368,2127158,841,776,21,2736,51424
1790.591,6,430,49308,237,204,7587,1380,25058,193,157,9325,837,24250
1.335,17,2,778,2,361,1335,361,778,0,0,0,0,0
317.028,6,79,19895,39,317,8342,1360,10176,40,324,8124,1360,9719
2.423,6,17,2073,9,304,302,304,1388,8,83,344,83,685
200.011,1,2,232,2,88,200011,88,232,0,0,0,0,0
11.251,6,29,8871,15,209,803,500,1481,14,974,848,2279,7390
1785.86,6,367,25719,214,99,8384,469,15114,153,69,11749,69,10605
1795.834,17,449,39928,404,35,4456,288,25708,45,288,40018,288,14220
0.067,6,11,1535,6,507,13,507,767,5,556,16,556,768
1798.938,1,300,25200,300,56,6016,56,25200,0,0,0,0,0
0.432,1,2,112,2,28,432,28,112,0,0,0,0,0
1789.928,17,346,58163,346,140,5188,391,58163,0,0,0,0,0
93.894,6,19,788,8,0,3598,0,328,11,0,9387,0,460
0.159,17,2,290,1,40,0,40,68,1,194,0,194,222
55.235,17,40,10360,40,231,1416,388,10360,0,0,0,0,0
41.04,6,28,7217,13,155,3420,267,1306,15,482,2930,1420,5911
1799.948,17,4214,202272,2107,20,854,20,101136,2107,20,854,20,101136
1742.086,6,158,9778,83,47,21244,208,5879,75,31,23538,31,3899
1.049,6,28,8503,15,225,61,561,1985,13,997,71,1791,6518
0.721,6,4,220,2,0,721,0,100,2,0,301,0,120
1.964,6,2,176,1,0,0,0,40,1,96,0,96,136
1748.286,6,187,11425,94,47,18798,208,6806,93,31,18997,31,4619
24.701,1,4,224,4,28,8233,28,224,0,0,0,0,0
1786.852,6,104,8308,68,64,26669,64,4896,36,58,51050,58,3412
1772.619,6,180,15480,120,69,14895,69,8940,60,69,30039,69,6540
3.871,17,12,6492,6,615,774,1350,3860,6,410,305,1350,2632
1619.345,1,8,848,8,78,231335,78,848,0,0,0,0,0
171.421,6,22,10186,11,304,79,597,1385,11,1192,17124,1460,8801
1740.602,17,28,6580,28,207,64466,207,6580,0,0,0,0,0
291.431,6,51,11053,25,116,12141,517,2267,26,617,11655,1418,8786
69.185,6,25,9939,12,410,57,922,1778,13,847,5753,1360,8161
280.217,6,27,7312,12,158,25474,267,1277,15,678,20010,2045,6035
72.302,6,31,7083,14,178,5558,517,1654,17,504,4516,1408,5429
1.875,17,4,280,2,34,1874,34,124,2,50,1872,50,156
1799.562,6,370,24832,215,87,8409,469,14285,155,69,11683,69,10547
1785.916,6,102,8228,68,64,26655,64,4896,34,58,54116,58,3332
1773.377,6,180,15480,120,69,14902,69,8940,60,69,30048,69,6540
2.523,6,9,1647,6,100,504,100,344,3,1179,1118,1179,1303
225.32,17,10,880,5,48,56326,48,380,5,72,56327,72,500
280.18,6,26,7272,12,158,25470,267,1277,14,775,21549,2800,5995
0.004,17,2,235,1,36,0,36,64,1,143,0,143,171
0.006,17,2,468,1,40,0,40,68,1,372,0,372,400
4.824,6,342,273155,195,971,24,1360,20472,147,1801,31,5643,252683
12.209,6,1916,1658257,1166,1367,10,1380,1622907,750,421,16,1923,35350
0.097,6,10,767,5,186,21,186,454,5,45,19,45,313
1784.837,6,107,8561,69,65,26247,65,5035,38,59,48236,59,3526
1.06,17,4,360,2,30,1014,30,116,2,94,1008,94,244
299.542,6,6,364,4,31,99847,31,222,2,31,299521,31,142
1790.038,6,356,22520,208,69,8647,69,12460,148,69,12176,69,10060
1796.882,17,449,39928,404,35,4458,288,25708,45,288,40020,288,14220
5.184,6,39,7269,20,218,272,314,3423,19,513,274,1179,3846
1784.588,6,102,8364,68,66,26635,66,4964,34,60,54075,60,3400
243.753,6,79,23990,41,701,6093,1418,13404,38,452,6587,1819,10586
1790.884,6,357,22698,208,69,8651,69,12529,149,69,12099,69,10169
1788.138,17,264,62823,264,209,6799,422,62823,0,0,0,0,0
1792.613,6,247,36448,153,302,11793,302,26402,94,83,19274,83,10046
6.797,6,42,7389,22,218,323,314,3503,20,513,343,1179,3886
4.182,17,36,24125,19,752,230,1350,14837,17,518,259,1350,9288
1741.43,6,87,6322,58,31,30551,31,3915,29,31,62193,31,2407
0.021,17,2,118,1,31,0,31,59,1,31,0,31,59
372.136,6,25,1651,17,177,23258,177,1117,8,110,9218,110,534
1752.545,6,97,8880,45,36,39828,36,2628,52,445,34362,445,6252
1751.072,17,12,498,11,14,175107,14,462,1,8,0,8,36
175.437,17,2,72,1,8,0,8,36,1,8,0,8,36
0.016,17,4,284,2,32,0,32,120,2,54,6,60,164
205.749,6,35,5244,20,304,10828,304,3772,15,83,14678,83,1472
7.613,6,16,3273,8,49,1087,92,523,8,1165,1026,1448,2750
1739.332,1,183,10248,183,28,9556,28,10248,0,0,0,0,0
1679.453,1,15,840,15,28,119960,28,840,0,0,0,0,0
1787.911,6,376,26148,217,98,8277,469,15372,159,69,11315,69,10776
1143.067,2,10,320,10,8,127007,8,320,0,0,0,0,0
1797.221,17,448,39896,403,35,4470,288,25676,45,288,40024,288,14220
1.427,6,53,19658,29,905,50,1460,13877,24,400,54,1460,5781
8.736,6,1744,1606590,1098,1385,7,1408,1568334,646,931,13,2801,38256
2.026,17,3,468,3,128,1013,128,468,0,0,0,0,0
240.33,6,45,9209,21,519,12016,1402,5777,24,241,10448,618,3432
173.717,6,20808,20110383,14017,1357,12,1408,19752587,6791,776,25,1408,357796
0.539,6,27,9008,13,243,44,611,1668,14,941,38,1368,7340
0.034,17,2,472,1,60,0,60,88,1,356,0,356,384
371.234,6,78,5462,34,56,11234,294,2673,44,46,8633,78,2789
997.443,17,196,14896,196,48,5115,48,14896,0,0,0,0,0
1770.381,6,101,9410,66,66,27236,66,5610,35,60,52067,60,3800
0.05,17,2,265,1,45,0,45,73,1,164,0,164,192
280.534,6,30,7432,14,158,21579,267,1357,16,678,18697,3456,6075
1773.457,6,180,15480,120,69,14903,69,8940,60,69,30051,69,6540
7.023,17,2,178,1,29,0,29,57,1,93,0,93,121
8.727,6,45,8409,21,227,436,314,4022,24,489,368,1179,4387
0.379,6,21,7203,13,318,31,600,1958,8,964,52,1471,5245
0.729,6,155,103490,82,1309,9,1420,96279,73,427,9,1420,7211
300.144,6,24,8495,14,404,23088,1241,2352,10,802,7300,1448,6143
1772.623,6,180,15480,120,69,14895,69,8940,60,69,30036,69,6540
70.4,6,29,7395,13,155,5866,267,1306,16,453,4692,3417,6089
1.156,6,22,7900,11,164,98,267,1236,11,1216,98,3819,6664
65.249,17,4,558,2,36,65244,36,128,2,187,65245,187,430
4.827,17,2,656,2,300,4827,300,656,0,0,0,0,0
1797.899,6,189,18020,100,68,18158,721,8095,89,171,20428,1414,9925
0.835,6,11,1727,7,100,139,100,384,4,589,193,1152,1343
0.668,6,127,99211,81,1302,8,1420,93150,46,526,14,3303,6061
1.007,17,2,124,2,34,1007,34,124,0,0,0,0,0
1.615,6,75,52053,43,1280,38,1440,44484,32,842,46,1440,7569
0.865,1,2,112,2,28,865,28,112,0,0,0,0,0
0.454,6,12,1653,6,288,84,288,548,6,426,51,434,1105
1740.464,17,29,30566,29,1026,62159,1026,30566,0,0,0,0,0
1.002,6,10,1687,7,100,167,100,384,3,1179,370,1179,1303
0.29,6,27,9071,13,247,24,624,1672,14,832,21,1448,7399
1794.989,1,23,3199,23,111,81590,351,3199,0,0,0,0,0
46.639,6,38,9540,14,296,388,1189,2641,24,395,2027,1420,6899
1778.938,17,72,3018,71,14,25413,14,2982,1,8,0,8,36
5.34,6,6,1257,4,327,1780,414,815,2,181,5118,270,442
300.135,6,45,19123,25,1035,12498,1360,13459,20,373,15787,2667,5664
93.783,6,46,10336,22,541,511,910,3139,24,366,4071,3488,7197
4.761,6,39,7269,19,218,264,314,3383,20,513,235,1179,3886
1799.111,6,367,25650,214,99,8446,469,15045,153,69,11836,69,10605
268.44,6,32,9021,14,158,20649,267,1357,18,630,15783,1781,7664
17.588,17,17,9004,9,736,2152,1350,6884,8,237,2507,1350,2120
67.261,6,38,9296,16,327,363,1189,2615,22,413,3202,1420,6681
36.985,17,5,1688,5,309,9246,316,1688,0,0,0,0,0
240.158,6,54,18114,29,807,8576,1408,15242,25,195,10006,580,2872
1794.293,1,57,4788,57,56,32040,56,4788,0,0,0,0,0
11.777,6,1847,1625353,1125,1390,10,1420,1592240,722,467,16,1883,33113
1771.449,6,99,9306,66,66,27253,66,5610,33,60,55355,60,3696
7.819,6,15,1362,8,275,1117,275,878,7,96,988,96,484
18.202,6,6,328,4,0,6067,0,216,2,0,18187,0,112
0.157,17,2,390,1,46,0,46,74,1,288,0,288,316
364.229,6,609,539983,413,1327,884,1368,508496,196,519,1782,2736,31487
1785.397,6,97,7369,64,38,28339,205,4559,33,33,55784,98,2810
10.456,6,13,11898,4,275,3485,275,439,9,1585,1235,2840,11459
1799.231,17,758,45749,758,32,2376,37,45749,0,0,0,0,0
1798.378,17,448,39896,403,35,4473,288,25676,45,288,40019,288,14220
374.632,6,18,1242,14,180,28817,180,916,4,110,20059,110,326
1.575,6,12,1036,6,283,279,283,603,6,105,280,105,433
8.415,6,1841,1714810,1176,1381,7,1408,1675566,665,931,12,2801,39244
0.019,17,4,284,2,32,15,32,120,2,54,12,60,164
302.661,6,60,26673,34,1067,9171,1360,20602,26,358,419,1360,6071
1787.904,6,366,24534,213,88,8433,469,14067,153,69,11762,69,10467
61.34,6,37,15900,22,794,2920,1408,9122,15,665,4361,1408,6778
61.667,6,32,7584,15,140,4404,267,1593,17,482,3850,1933,5991
1786.731,6,359,24079,209,83,8590,965,13465,150,74,11991,405,10614
1798.415,17,448,39896,403,35,4473,288,25676,45,288,40022,288,14220
1771.626,6,101,9344,66,65,27255,65,5577,35,59,52104,59,3767
282.723,6,33,8575,13,158,23560,267,1317,20,496,14877,1400,7258
1694.737,17,16,1265,8,30,242100,37,471,8,71,242100,136,794
1715.886,17,387,62024,387,132,4445,391,62024,0,0,0,0,0
1744.57,6,98,7421,64,38,27691,205,4528,34,33,52852,98,2893
1794.238,17,86,3612,86,14,21108,14,3612,0,0,0,0,0
300.985,6,73,53758,46,1249,6688,1368,47378,27,828,1617,1571,6380
0.281,17,2,167,1,39,0,39,67,1,72,0,72,100
1789.535,17,134,10720,67,48,27114,48,5092,67,56,27114,56,5628
0.033,17,2,234,1,33,0,33,61,1,145,0,145,173
0.323,6,12,3704,6,171,64,171,491,6,964,55,1448,3213
89.13,6,24,10657,14,741,47,1360,3557,10,1337,9887,4428,7100
1.167,6,25,8056,12,164,91,267,1288,13,1014,83,2411,6768
22.553,6,28,11324,10,214,2487,214,880,18,968,1318,1440,10444
1700.603,17,13,534,11,14,170042,14,462,2,8,1700427,8,72
20.151,6,20,5366,12,107,1831,159,1074,8,967,2874,1659,4292
0.783,17,4,560,2,64,768,64,184,2,160,760,160,376
300.693,6,37,8431,20,291,15825,786,1997,17,478,529,2128,6434
228.31,6,5604,4889678,3360,1366,67,1368,4755176,2244,749,101,1368,134502
300.686,6,38,8269,20,241,15825,618,1797,18,441,502,1440,6472
1791.41,17,386,64223,386,138,4653,386,64223,0,0,0,0,0
396.525,17,6,456,3,48,198257,48,228,3,48,198257,48,228
16.57,17,16,8992,9,741,2061,1350,6923,7,267,2748,1350,2069
1120.913,17,12,3099,6,31,224180,37,355,6,429,224180,463,2744
0.069,6,11,913,6,182,13,182,490,5,77,3,134,423
43.802,17,4,352,2,60,43801,60,176,2,60,43801,60,176
1681.508,17,16,1265,8,30,240213,37,471,8,71,240213,136,794
4.116,17,4,244,4,33,1372,33,244,0,0,0,0,0
0.188,17,2,414,1,32,0,32,60,1,326,0,326,354
760.017,1,32,1792,32,28,24516,28,1792,0,0,0,0,0
448.541,1,4,416,4,76,149513,76,416,0,0,0,0,0
82.304,6,33,7963,9,155,568,267,1146,24,307,3578,1420,6817
140.853,6,117,91430,78,1245,1829,1408,81280,39,811,1906,3847,10150
11.583,6,1776,1590628,1124,1363,10,1380,1560306,652,421,17,1923,30322
3.557,6,31,8912,14,158,273,267,1357,17,763,217,2236,7555
1799.468,1,58,4872,58,56,31569,56,4872,0,0,0,0,0
28.982,6,37,9998,19,736,495,1360,4476,18,435,1694,2667,5522
280.47,6,31,7472,13,158,23372,267,1317,18,603,16495,2760,6155
3.01,6,14,3459,8,81,430,81,513,6,872,602,1448,2946
0.38,6,12,1304,6,256,74,256,756,6,304,74,304,548
1770.346,6,101,9278,66,64,27236,64,5544,35,58,52065,58,3734
1772.154,6,180,15480,120,69,14892,69,8940,60,69,30030,69,6540
1799.716,17,87,3648,86,14,21173,14,3612,1,8,0,8,36
1763.879,2,14,448,14,8,135683,8,448,0,0,0,0,0
125.49,6,14,3266,6,183,621,267,611,8,777,17890,1152,2655
1790.001,1,280,15680,280,28,6415,28,15680,0,0,0,0,0
0.38,6,6,324,4,0,126,0,216,2,0,206,0,108
4.573,6,44,8369,22,227,217,314,4062,22,427,206,1152,4307
858.378,17,165,12540,165,48,5234,48,12540,0,0,0,0,0
401.602,6,27,7267,6,156,67186,267,718,21,356,20079,1460,6549
1.582,6,23,4777,13,208,131,523,1714,10,507,156,1448,3063
1.444,6,52,18399,26,885,57,1440,12583,26,433,50,1440,5816
19.532,17,2097,614980,1324,389,14,1108,552420,773,52,25,599,62560
0.293,6,9,1346,5,145,73,145,349,4,833,33,833,997
0.683,6,12,3704,6,171,124,171,491,6,964,130,1448,3213
1680.474,1,15,840,15,28,120033,28,840,0,0,0,0,0
280.023,6,28,7352,13,158,23335,267,1317,15,678,20000,3436,6035
1747.108,6,113,8190,70,31,25320,31,4797,43,31,41597,31,3393
31.4,6,17,5837,10,139,3488,159,1098,7,873,5224,1659,4739
11.007,17,8,704,4,48,3666,48,304,4,72,3665,72,400
240.829,6,36,4890,17,267,15034,781,2495,19,199,13371,580,2395
1.279,6,48,18809,27,862,49,1360,13193,21,476,55,2715,5616
21.95,6,3102,2885179,1948,1400,11,1448,2820507,1154,776,18,1448,64672
0.026,17,3,676,2,60,1,60,176,1,472,0,472,500
373.906,6,26,1703,17,177,23369,177,1117,9,110,8956,110,586
0.073,6,9,1339,5,145,18,145,349,4,826,16,826,990
21.713,6,3513,3211949,2107,1436,10,1448,3126573,1406,776,15,1448,85376
1789.882,6,365,23087,211,69,8523,69,12787,154,69,11695,69,10300
56.473,6,23,1664,17,43,3529,43,1304,6,0,6202,0,360
137.768,6,15,3237,3,92,636,92,256,12,261,12506,1448,2981
8.256,6,1633,1528314,1049,1380,7,1408,1493282,584,931,13,2816,35032
2.609,6,13,2311,7,188,434,245,660,6,1407,466,1407,1651
1745.099,6,96,7255,62,38,28608,205,4424,34,33,52875,98,2831
0.002,17,2,770,2,357,2,357,770,0,0,0,0,0
5.21,17,8,1176,4,48,1729,48,304,4,190,1730,308,872
10.947,6,18,3378,10,210,1216,210,972,8,664,1563,904,2406
1764.256,2,14,448,14,8,135712,8,448,0,0,0,0,0
0.008,6,2,218,1,138,0,138,178,1,0,0,0,40
64.768,6,12,927,4,177,119,177,393,8,110,9227,110,534
1798.462,17,447,39580,403,35,4473,288,25676,44,288,40952,288,13904
2.483,6,6,260,3,0,1241,0,128,3,0,978,0,132
32.598,17,3,228,3,48,16299,48,228,0,0,0,0,0
0.434,6,12,1653,6,288,83,288,548,6,426,46,434,1105
6.766,6,28,7424,11,155,676,267,1226,17,423,422,2006,6198
0.051,17,4,288,2,33,1,33,122,2,55,10,61,166
300.657,6,37,8526,19,315,16703,882,2053,18,441,496,1360,6473
254.118,17,6,528,3,48,127055,48,228,3,72,127054,72,300
3.146,17,6,420,3,32,1571,32,180,3,52,1570,60,240
280.463,6,28,7352,13,158,23371,267,1317,15,775,20026,4836,6035
195.766,6,28081,23478497,13175,1264,14,1348,737121,14906,1474,13,5584,22741376
35.23,17,20,1760,10,48,3913,48,760,10,72,3913,72,1000
58.382,6,25,7097,12,155,5307,267,1266,13,589,4864,3426,5831
3.355,17,4,368,4,64,1118,64,368,0,0,0,0,0
1772.028,6,181,15589,120,69,14890,69,8940,61,69,29531,69,6649
1750.596,17,25,1044,24,14,76112,14,1008,1,8,0,8,36
1744.998,6,97,7307,63,38,28145,205,4476,34,33,52871,98,2831
6.039,17,3,418,2,32,6028,32,120,1,270,0,270,298
0.584,6,18,7140,9,120,72,120,644,9,1003,72,1448,6496
1742.967,6,95,7203,63,38,28112,205,4476,32,33,56215,98,2727
1795.709,6,356,22520,208,69,8674,69,12460,148,69,12215,69,10060
0.41,17,4,352,2,60,410,60,176,2,60,409,60,176
186.528,17,4,1344,4,308,62176,308,1344,0,0,0,0,0
1.602,6,62,18932,30,707,55,1360,9061,32,428,51,1360,9871
0.158,17,2,154,1,41,0,41,69,1,57,0,57,85
50.963,17,4,240,2,32,50962,32,120,2,32,50962,32,120
0.426,17,18,9451,9,419,53,1350,4026,9,574,49,1350,5425
1781.576,17,73,3060,72,14,25092,14,3024,1,8,0,8,36
280.322,6,30,7432,13,158,23360,267,1317,17,543,17516,1400,6115
0.085,17,4,304,2,37,46,37,130,2,59,40,65,174
324.792,6,26,3399,9,221,40598,517,1374,17,381,20299,499,2025
280.282,6,28,7352,12,158,25480,267,1277,16,603,18684,1400,6075
1744.656,2,26,832,26,8,69786,8,832,0,0,0,0,0
204.406,17,4,377,2,33,204382,37,123,2,99,204383,136,254
1792.339,6,344,23420,194,69,9286,69,12245,150,69,12029,69,11175
312.509,6,8,474,2,106,312500,106,194,6,0,62500,0,280
0.665,6,20,9985,10,125,73,125,653,10,1257,73,1448,9332
1772.435,6,180,15480,120,69,14894,69,8940,60,69,30036,69,6540
3.462,17,5,562,4,32,1053,32,240,1,294,0,294,322
1.143,6,25,8056,12,164,89,267,1288,13,1014,81,2411,6768
300.834,6,44,14393,24,866,13079,1360,8791,20,399,454,1360,5602
252.443,2,3,96,3,8,126221,8,96,0,0,0,0,0
0.348,17,2,196,1,62,0,62,90,1,78,0,78,106
19.868,17,4,824,2,48,19858,48,152,2,308,19856,308,672
1.012,6,24,6420,13,299,84,842,2023,11,790,99,1452,4397
1792.894,17,180,11520,180,36,10016,36,11520,0,0,0,0,0
1772.336,6,180,15480,120,69,14893,69,8940,60,69,30035,69,6540
1690.262,17,35,11752,35,307,49713,308,11752,0,0,0,0,0
1785.239,1,98,5488,98,28,18404,28,5488,0,0,0,0,0
1787.914,6,365,23087,211,69,8513,69,12787,154,69,11685,69,10300
1792.605,1,116,6496,116,28,15587,28,6496,0,0,0,0,0
0.601,6,7,295,4,0,200,0,164,3,7,206,7,131
220.092,17,8,2688,8,308,31441,308,2688,0,0,0,0,0
65.509,6,34,7956,11,155,146,267,1226,23,305,2977,1460,6730
1772.296,6,180,15480,120,69,14893,69,8940,60,69,30032,69,6540
1794.684,17,202,42218,202,181,8928,379,42218,0,0,0,0,0
2.944,17,6,1409,3,40,1467,40,204,3,373,1465,379,1205
240.654,2,4,128,4,8,80218,8,128,0,0,0,0,0
82.081,6,7,10500,7,1448,13680,1448,10500,0,0,0,0,0
0.3,17,2,154,1,33,0,33,61,1,65,0,65,93
38.069,17,44,6468,22,48,1812,48,1672,22,190,1812,308,4796
4.089,17,10,2322,5,30,1016,30,290,5,378,1019,468,2032
300.937,6,23,9197,14,236,23136,597,1536,9,1457,37596,3081,7661
240.595,2,2,64,2,8,240595,8,64,0,0,0,0,0
61.771,6,63,45311,42,1176,1506,1408,37485,21,960,3076,3847,7826
14.761,1,6,636,6,78,2952,78,636,0,0,0,0,0
1744.718,2,27,864,27,8,67104,8,864,0,0,0,0,0
0.423,6,111,87029,59,131,7,232,2889,52,1745,8,5411,84140
409.979,6,61,11665,30,183,14137,1189,4141,31,313,4349,1917,7524
9.715,2,4,128,4,8,3238,8,128,0,0,0,0,0
1624.115,1,7,392,7,28,270685,28,392,0,0,0,0,0
281.61,6,27,7312,13,158,23467,267,1317,14,775,21643,3445,5995
0.374,6,24,6064,12,181,34,537,1526,12,651,31,1448,4538
1771.234,1,173,9688,173,28,10297,28,9688,0,0,0,0,0
1.136,17,4,368,2,32,818,32,120,2,96,861,96,248
205.96,6,29,7392,13,158,17163,267,1317,16,603,13729,2036,6075
0.109,6,39,24765,18,274,6,517,1791,21,1286,3,1408,22974
0.177,17,2,152,1,48,0,48,76,1,48,0,48,76
1787.37,6,102,8228,68,64,26677,64,4896,34,58,54158,58,3332
1786.994,6,106,8580,69,65,26279,65,5035,37,59,49634,59,3545
0.01,17,2,251,1,36,0,36,64,1,159,0,159,187
18.624,17,30,6460,10,257,2065,1350,2856,20,152,978,1350,3604
280.805,6,31,7813,14,158,21600,267,1357,17,577,17549,2036,6456
0.095,6,20,9166,10,121,10,121,649,10,1141,10,1448,8517
126.073,17,4,558,2,36,126068,36,128,2,187,126068,187,430
1786.679,17,87,3648,86,14,21019,14,3612,1,8,0,8,36
1789.64,17,141,11276,71,48,25566,48,5396,70,56,25936,56,5880
0.081,6,3,132,2,0,27,0,92,1,0,0,0,40
39.216,17,22,1936,11,48,3919,48,836,11,72,3916,72,1100
359.691,6,51,7826,25,142,11338,516,2145,26,231,14384,1452,5681
0.435,6,11,1008,6,256,81,256,500,5,304,101,304,508
1021.531,6,222,17326,117,125,8806,469,10185,105,68,9668,69,7141
1798.299,6,367,25650,214,99,8442,469,15045,153,69,11829,69,10605
2.082,6,29,10388,17,373,130,851,1803,12,1012,181,1420,8585
6.309,1,4,224,4,28,2103,28,224,0,0,0,0,0
1798.265,6,2428,2473643,857,147,2100,900,55114,1571,1561,1145,7010,2418529
1638.262,2,13,416,13,8,136521,8,416,0,0,0,0,0
8.374,6,1948,1820401,1244,1385,6,1408,1779129,704,931,11,2801,41272
0.163,6,28,7336,14,155,12,267,1341,14,603,11,2036,5995
2.445,17,2,672,2,308,2445,308,672,0,0,0,0,0
358.578,17,26,2080,13,48,29880,48,988,13,56,29880,56,1092
906.757,6,108,14324,62,83,12319,267,4991,46,182,20150,4837,9333
240.294,6,46,9044,24,524,10447,1418,5974,22,213,11442,618,3070
1661.938,1,7,392,7,28,276989,28,392,0,0,0,0,0
178.104,6,11,14718,11,1298,17810,1298,14718,0,0,0,0,0
177.39,6,73,48060,45,1172,4031,1448,39874,28,746,2282,1448,8186
280.291,6,30,7432,13,158,23357,267,1317,17,603,17515,2036,6115
8.282,6,14,6414,7,0,2,0,340,7,827,1050,958,6074
1775.7,17,140,11200,70,48,25734,48,5320,70,56,25734,56,5880
351.662,6,38,12709,12,137,31968,267,1590,26,503,14066,1460,11119
5.894,6,5,339,3,131,2821,131,255,2,0,5640,0,84
1786.081,6,104,8376,68,65,26657,65,4930,36,59,51028,59,3446
1780.942,17,142,11360,71,48,25441,48,5396,71,56,25441,56,5964
12.804,6,24,6993,13,275,1067,275,1078,11,910,805,1440,5915
1771.196,6,99,9306,66,66,27249,66,5610,33,60,55346,60,3696
1653.019,1,8,448,8,28,236145,28,448,0,0,0,0,0
0.613,6,8,335,4,0,204,0,164,4,7,68,7,171
83.873,6,38,18850,20,592,327,1360,6162,18,919,4924,3928,12688
280.426,6,28,7352,13,158,23368,267,1317,15,678,20027,3456,6035
1775.633,1,56,4704,56,56,32284,56,4704,0,0,0,0,0
1727.288,1,8,448,8,28,246755,28,448,0,0,0,0,0
104.837,6,7040,7161454,2384,649,43,650,150651,4656,1455,22,2896,7010803
280.164,6,29,7392,14,158,21551,267,1357,15,678,20011,3436,6035
6.198,6,2,111,2,31,6198,31,111,0,0,0,0,0
1775.072,6,180,15480,120,69,14916,69,8940,60,69,30079,69,6540
34.755,1,40,4160,0,0,0,0,0,40,76,891,76,4160
1274.908,6,99,10860,60,81,21608,722,5465,39,112,33544,1408,5395
11.359,6,1817,1571009,1100,1374,10,1420,1538108,717,526,15,3303,32901
2.169,6,25,6680,13,343,180,1061,2243,12,790,192,1460,4437
0.034,17,2,904,1,300,0,300,328,1,548,0,548,576
277.487,17,2,150,2,47,277487,47,150,0,0,0,0,0
14.504,17,30,18005,13,670,1208,1350,9080,17,497,904,1350,8925
194.59,6,16,5988,6,94,38918,106,627,10,706,529,1452,5361
1785.86,6,367,24574,212,87,8463,469,14096,155,69,11596,69,10478
2.581,6,11,975,6,304,516,304,624,5,83,638,83,351
518.665,6,1421,1333619,511,219,1016,955,29867,910,1400,570,1418,1303752
0.037,17,5,1640,5,300,9,300,1640,0,0,0,0,0
0.826,17,4,820,2,36,821,36,128,2,318,821,318,692
16.981,17,16,6698,8,539,2421,1350,4539,8,241,2421,1350,2159
264.138,17,2,908,2,426,264138,687,908,0,0,0,0,0
259.63,17,4,352,2,60,259628,60,176,2,60,259629,60,176
3.003,6,2,88,2,0,0,0,88,0,0,0,0,0
533.387,1,22,1232,22,28,25399,28,1232,0,0,0,0,0
1795.776,17,142,11360,71,48,25653,48,5396,71,56,25653,56,5964
4.443,6,13,3468,4,92,1481,92,296,9,385,323,1448,3172
31.094,6,40,8640,20,399,463,882,2042,20,413,1629,1460,6598
5.018,17,4,288,2,36,5002,36,128,2,52,4993,52,160
280.237,6,29,7392,13,158,23353,267,1317,16,603,18681,2036,6075
2.916,17,4,518,3,39,877,39,201,1,289,0,289,317
1.232,6,50,18786,27,855,47,1360,13090,23,433,48,1360,5696
1796.639,6,357,22629,208,69,8679,69,12460,149,69,12139,69,10169
50.887,6,28,7217,13,155,4240,267,1306,15,482,3634,2840,5911
1778.663,17,140,11200,70,48,25777,48,5320,70,56,25777,56,5880
2.136,6,16,3676,8,150,305,174,624,8,681,284,1420,3052
1772.994,6,180,15480,120,69,14899,69,8940,60,69,30043,69,6540
2.035,6,39,13222,21,222,91,540,2264,18,929,90,1591,10958
1748.015,6,95,7203,63,38,28193,205,4476,32,33,56373,98,2727
10.971,6,20,4390,11,275,1097,275,998,9,755,781,1414,3392
11.317,6,26,9913,13,275,943,275,1078,13,1037,766,1420,8835
0.478,6,10,968,5,256,114,256,460,5,304,114,304,508
11.361,6,1790,1569065,1086,1391,10,1420,1536684,704,526,16,3303,32381
31.778,6,8,436,2,0,31778,0,100,6,0,5918,0,336
0.457,6,23,6001,12,108,41,147,919,11,927,43,1608,5082
102.204,6,42,25125,19,884,35,1360,6109,23,1130,4639,1696,19016
77.07,6,122,49131,66,719,1185,1360,36508,56,471,1396,1360,12623
1786.361,6,129,18522,80,246,22612,1272,13076,49,87,37214,241,5446
1797.788,6,386,27224,220,102,8209,469,16099,166,69,10895,69,11125
4.018,6,14,2355,7,188,669,245,660,7,703,626,1152,1695
0.258,17,3,422,2,32,65,32,120,1,274,0,274,302
240.489,6,55,18175,29,762,8588,1418,15243,26,196,9619,580,2932
0.155,6,2,303,1,211,0,211,263,1,0,0,0,40
1781.003,17,140,11200,70,48,25811,48,5320,70,56,25811,56,5880
1799.491,17,449,39416,404,34,4465,288,25444,45,282,40020,288,13972
1.282,6,42,11418,21,616,64,1460,5802,21,433,55,1460,5616
840.759,17,8,2168,4,30,280227,30,232,4,456,280249,463,1936
12.142,6,1920,1677016,1164,1385,10,1420,1642543,756,467,16,1883,34473
15.232,17,10,880,5,48,3805,48,380,5,72,3805,72,500
1775.581,1,214,22684,214,78,8336,78,22684,0,0,0,0,0
1783.863,6,104,8376,68,65,26624,65,4930,36,59,50964,59,3446
4.279,6,38,7229,19,218,237,314,3383,19,440,223,1152,3846
0.819,6,11,1727,7,100,136,100,384,4,589,184,1152,1343
661.755,2,7,224,7,8,110292,8,224,0,0,0,0,0
120.592,17,4,352,2,60,120591,60,176,2,60,120591,60,176
1748.487,6,94,7151,62,38,28663,205,4424,32,33,56389,98,2727
1772.339,6,180,15480,120,69,14893,69,8940,60,69,30037,69,6540
790.603,1,36,3816,36,78,22588,78,3816,0,0,0,0,0
0.036,17,2,454,1,37,0,37,65,1,361,0,361,389
2.661,6,2,80,1,0,0,0,40,1,0,0,0,40
1770.536,6,101,9410,66,66,27239,66,5610,35,60,52071,60,3800
1.649,6,25,8711,15,276,117,561,1433,10,982,164,1420,7278
10.991,6,95,30361,48,596,233,1152,23983,47,449,233,1179,6378
1786.453,6,106,8524,68,66,26663,66,4964,38,60,48280,60,3560
7.223,6,979,861668,582,1401,12,1448,836360,397,776,17,1448,25308
289.919,6,33,7009,15,274,20705,517,1612,18,744,17051,1418,5397
78.471,6,25,10829,12,380,71,832,1665,13,959,6528,1440,9164
0.024,17,2,180,1,30,0,30,58,1,94,0,94,122
1.143,6,26,9564,13,164,81,267,1388,13,1070,81,2816,8176
7.582,6,22,3291,13,180,631,595,1764,9,347,918,580,1527
1.397,6,49,25462,26,884,55,1360,6425,23,1065,54,1360,19037
0.356,6,7,371,4,0,118,0,204,3,7,94,7,167
1096.627,17,216,16416,216,48,5100,48,16416,0,0,0,0,0
0.331,6,23,7364,11,270,32,797,1660,12,845,29,1418,5704
4.252,6,13,2311,8,188,607,245,700,5,1407,994,1407,1611
1792.204,6,360,22818,210,69,8575,69,12678,150,69,12027,69,10140
1776.306,17,73,3060,72,14,25018,14,3024,1,8,0,8,36
1772.46,6,180,15480,120,69,14894,69,8940,60,69,30036,69,6540
8.489,6,622,553139,390,1350,21,1368,536131,232,776,35,2736,17008
1774.767,6,181,15589,120,69,14914,69,8940,61,69,29574,69,6649
4.455,6,35,6209,19,206,247,314,2824,16,456,279,1152,3385
82.259,17,8,704,4,48,27417,48,304,4,72,27416,72,400
20.2,6,17,2316,10,189,2244,517,1298,7,323,3364,499,1018
0.411,6,10,968,5,256,99,256,460,5,304,98,304,508
232.057,6,31,7813,13,158,19338,267,1317,18,524,13648,1400,6496
1.007,17,2,677,1,300,0,300,328,1,321,0,321,349
10.313,6,1656,1436055,1016,1362,10,1380,1406213,640,421,16,1923,29842
0.028,6,11,1566,6,503,5,503,823,5,475,7,475,743
7.863,6,38,7229,20,218,413,314,3423,18,513,429,1179,3806
1758.444,17,246,45334,246,156,7177,353,45334,0,0,0,0,0
1.234,6,9,382,4,0,411,0,164,5,7,206,7,218
1.273,6,48,19610,27,920,48,1460,13994,21,433,54,1460,5616
377.829,2,3,96,3,8,188914,8,96,0,0,0,0,0
0.088,17,2,174,1,45,0,45,73,1,73,0,73,101
240.304,6,43,8956,21,524,12014,1418,5818,22,220,11442,639,3138
0.557,6,6,319,3,0,278,0,152,3,7,160,7,167
1780.023,6,119,13883,76,81,23733,518,5974,43,158,42379,1420,7909
6.016,17,4,724,2,41,6004,41,138,2,265,6006,265,586
28.153,1,32,3328,0,0,0,0,0,32,76,908,76,3328
1.423,6,50,21499,28,979,52,1460,15843,22,433,59,1460,5656
7.542,6,26,7143,13,156,628,267,1312,13,589,627,4837,5831
1795.868,1,56,4704,56,56,32652,56,4704,0,0,0,0,0
1784.425,6,183,15738,121,69,14870,69,9049,62,69,29246,69,6689
0.001,17,2,2754,2,1349,1,1349,2754,0,0,0,0,0
0.997,6,28,8558,15,229,59,583,2019,13,1001,68,1791,6539
1.068,6,30,12050,16,518,71,1360,3278,14,820,67,1379,8772
0.965,17,5,980,3,32,480,32,180,2,372,10,470,800
1.125,6,4,240,2,0,991,0,120,2,0,990,0,120
79.411,17,4,352,2,60,79410,60,176,2,60,79410,60,176
1.425,17,16,8760,7,471,237,1350,3494,9,557,174,1350,5266
1797.576,17,393,49548,184,172,9822,1350,36814,209,32,8641,61,12734
0.432,6,48,19708,26,1039,17,1380,14586,22,421,19,1923,5122
1786.479,6,111,8970,72,66,25161,66,5190,39,60,47010,60,3780
280.188,6,28,7352,13,158,23349,267,1317,15,678,20011,3436,6035
1792.322,6,362,22898,210,69,8575,69,12678,152,69,11869,69,10220
0.095,6,8,962,4,213,31,213,377,4,421,21,421,585
44.382,6,34,9089,14,294,50,1189,2626,20,514,2335,1420,6463
0.026,17,4,624,2,64,3,64,184,2,192,10,192,440
4.015,17,4,244,4,33,1338,33,244,0,0,0,0,0
4.429,6,3,144,2,0,4429,0,92,1,0,0,0,52
0.075,17,2,2748,2,1346,75,1346,2748,0,0,0,0,0
1682.62,17,14,3843,7,30,280434,30,406,7,463,280434,463,3437
0.288,17,2,180,1,30,0,30,58,1,94,0,94,122
301.03,6,56,19500,31,1018,10034,1460,13556,25,328,420,2567,5944
1789.948,6,358,22600,208,69,8647,69,12460,150,69,12013,69,10140
1789.972,17,83,3480,82,14,22098,14,3444,1,8,0,8,36
280.42,6,30,7432,13,158,23368,267,1317,17,543,17515,1400,6115
158.06,6,30,7432,13,158,13171,267,1317,17,543,9876,1400,6115
367.301,6,25,1651,17,177,22956,177,1117,8,110,9199,110,534
1799.688,6,128,12586,75,63,24320,721,6203,53,82,34604,1448,6383
0.447,6,9,1002,5,213,111,213,417,4,421,146,421,585
0.064,17,8,2454,8,278,9,317,2454,0,0,0,0,0
0.025,17,2,672,2,308,25,308,672,0,0,0,0,0
8.274,1,5,140,5,0,0,0,140,0,0,0,0,0
229.91,17,36,2736,36,48,6568,48,2736,0,0,0,0,0
1782.404,17,246,50797,246,178,7275,422,50797,0,0,0,0,0
337.206,17,8,2688,8,308,48172,308,2688,0,0,0,0,0
1793.678,1,90,5040,90,28,20153,28,5040,0,0,0,0,0
302.758,6,85,13482,36,170,8649,1189,4174,49,236,6307,1917,9308
32.892,17,18,1584,9,48,4109,48,684,9,72,4110,72,900
134.775,6,24,10136,12,541,79,1360,2677,12,1161,12235,2574,7459
1773.116,6,180,15480,120,69,14900,69,8940,60,69,30052,69,6540
1764.066,2,13,416,13,8,147005,8,416,0,0,0,0,0
240.638,6,282,379297,141,461,1718,1402,11032,141,2819,1718,9814,368265
407.121,6,91,30590,48,593,8662,1408,11432,43,768,9693,2816,19158
0.621,6,11,976,5,283,103,283,551,6,105,84,105,425
2.07,17,2,144,1,36,0,36,64,1,52,0,52,80
110.682,17,4,240,2,32,110681,32,120,2,32,110681,32,120
1786.889,6,106,8456,68,65,26669,65,4930,38,59,48291,59,3526
190.171,17,4,352,2,60,190169,60,176,2,60,190170,60,176
29.74,6,19,9560,6,112,5948,112,360,13,788,2462,1420,9200
1793.961,6,349,22585,203,69,8880,69,12536,146,69,12370,69,10049
1794.882,6,356,22520,208,69,8670,69,12460,148,69,12209,69,10060
1738.977,1,56,4704,56,56,31617,56,4704,0,0,0,0,0
521.164,6,61,8010,29,105,16443,501,2745,32,165,16808,1420,5265
1787.358,6,102,8296,68,65,26676,65,4930,34,59,54157,59,3366
11.69,6,17,4322,8,275,1670,275,878,9,768,1338,1440,3444
1.411,6,40,8389,21,320,70,1162,2808,19,437,68,2715,5581
0.902,6,51,13853,24,551,39,1429,4864,27,464,33,1986,8989
1777.175,17,199,45984,199,203,8975,342,45984,0,0,0,0,0
299.534,6,6,364,4,31,99844,31,222,2,31,299516,31,142
721.911,2,7,224,7,8,120318,8,224,0,0,0,0,0
7.998,6,16,2654,10,275,888,275,958,6,1440,1212,1440,1696
10.118,6,1493,1386185,980,1364,10,1420,1361374,513,475,19,1883,24811
3.318,6,29,6175,15,338,237,1314,2294,14,368,253,1380,3881
509.717,6,36,2711,22,65,24272,65,1530,14,56,39202,59,1181
2.255,17,2,144,1,36,0,36,64,1,52,0,52,80
0.195,6,12,3462,6,75,39,75,395,6,1373,38,1448,3067
144.814,6,21,10120,11,433,80,990,1771,10,1322,16072,2720,8349
6.967,6,8,602,0,0,0,0,0,8,31,995,31,602
1787.526,6,104,8376,68,65,26679,65,4930,36,59,51069,59,3446
1.122,6,11,1540,6,279,218,279,878,5,191,234,272,662
67.919,6,43,10146,17,328,1567,1189,2669,26,356,2716,1420,7477
1778.962,6,106,8620,68,64,26551,64,4896,38,58,48077,58,3724
1793.271,6,358,22669,209,69,8621,69,12569,149,69,12114,69,10100
1796.601,1,156,8736,156,28,11590,28,8736,0,0,0,0,0
0.017,17,2,350,1,33,0,33,61,1,261,0,261,289
61.789,2,2,64,2,8,61789,8,64,0,0,0,0,0
96.303,6,36,7951,13,155,8025,267,1306,23,317,4377,1420,6645
13.228,6,89,26501,46,542,293,1152,20299,43,447,309,1179,6202
0.019,17,2,433,1,34,0,34,62,1,343,0,343,371
1.721,6,47,19223,26,951,68,1460,13511,21,405,77,1460,5712
12.128,6,19,4402,10,275,1347,275,958,9,768,775,1440,3444
300.71,6,39,8449,22,249,14319,619,1970,17,482,531,3488,6479
1785.054,6,110,9164,68,66,26642,66,4964,42,60,43535,60,4200
184.943,6,32,8952,15,158,13210,267,1397,17,687,11558,1781,7555
481.337,2,4,128,4,8,160445,8,128,0,0,0,0,0
27.446,17,8,472,3,27,12752,29,165,5,33,6569,42,307
12.973,6,9,3531,3,275,6486,275,399,6,1440,2037,1440,3132
1750.721,17,12,498,11,14,175072,14,462,1,8,0,8,36
11.04,6,14,1247,7,222,1838,222,728,7,231,1838,231,519
86.474,17,4,352,2,60,86473,60,176,2,60,86472,60,176
7.715,6,1408,1338501,920,1382,8,1408,1308449,488,776,15,1408,30052
16.887,17,6,528,3,48,8438,48,228,3,72,8438,72,300
9.513,17,2,152,2,48,9513,48,152,0,0,0,0,0
34.604,17,8,1176,4,48,11533,48,304,4,190,11532,308,872
64.19,6,21,6508,6,156,12838,267,718,15,518,4564,1440,5790
240.203,6,35,4759,17,181,15012,517,1983,18,229,14129,851,2776
0.148,6,7,423,4,43,37,43,259,3,0,21,0,164
0.813,6,20,5952,11,282,81,548,1292,9,716,91,1420,4660
1795.371,17,1037,337158,512,568,3513,1350,305541,525,32,3426,340,31617
8.059,6,538,463770,338,1306,23,1368,448706,200,931,39,2736,15064
95.627,6,25,9783,12,653,75,1460,3126,13,875,7954,1460,6657
138.237,6,56,9721,18,130,3849,267,1644,38,211,3735,1420,8077
2.978,17,4,932,4,205,992,205,932,0,0,0,0,0
1.138,6,57,14171,28,551,42,1429,5024,29,419,39,1986,9147
0.677,6,30,7560,17,306,42,1087,2826,13,601,55,1420,4734
1739.632,6,87,6322,58,31,30519,31,3915,29,31,62129,31,2407
1786.758,6,102,8364,68,66,26668,66,4964,34,60,54141,60,3400
1749.804,6,239,27261,119,134,14827,721,15918,120,152,14702,1420,11343
0.445,17,8,2750,8,315,63,354,2750,0,0,0,0,0
1794.747,6,100,6484,64,47,28488,208,4114,36,31,51265,31,2370
2.354,6,27,8825,16,281,156,577,1489,11,984,215,1452,7336
0.06,6,2,80,1,0,0,0,40,1,0,0,0,40
1743.131,6,97,7307,63,38,28115,205,4476,34,33,52811,98,2831
1772.029,6,180,15480,120,69,14891,69,8940,60,69,30032,69,6540
240.207,6,55,18279,30,758,8282,1418,15225,25,218,10008,580,3054
53.632,17,4,352,2,60,53631,60,176,2,60,53631,60,176
0.042,17,2,586,1,46,0,46,74,1,484,0,484,512
3.233,17,3,228,2,48,2904,48,152,1,48,0,48,76
1797.933,1,164,9184,164,28,11030,28,9184,0,0,0,0,0
1787.532,17,85,3561,83,13,21796,14,3481,2,12,1787349,16,80
2.349,6,4,220,2,0,2349,0,100,2,0,1002,0,120
177.556,17,9,684,9,48,22194,48,684,0,0,0,0,0
1770.251,6,101,9410,66,66,27234,66,5610,35,60,52063,60,3800
20.02,17,13,6707,6,491,3997,1350,3115,7,485,3331,1350,3592
12.082,6,82,25637,41,550,302,1152,18704,41,528,295,1179,6933
0.198,6,28,7336,14,155,15,267,1341,14,543,14,1400,5995
0.252,17,2,184,1,32,0,32,60,1,96,0,96,124
711.216,6,56,8849,29,112,19373,516,2630,27,213,27351,1452,6219
8.357,6,1666,1459510,999,1379,8,1408,1420162,667,931,12,2801,39348
28.002,6,2084,1959159,1284,1443,21,1448,1909687,800,776,34,1448,49472
367.32,6,27,1767,18,177,21607,177,1181,9,110,9254,110,586
2.499,17,24,15565,10,587,275,1350,6154,14,644,189,1350,9411
1769.572,1,58,4872,58,56,31045,56,4872,0,0,0,0,0
1749.058,6,113,8190,70,31,25348,31,4797,43,31,41644,31,3393
1795.142,17,446,38980,404,35,4454,288,25708,42,288,42948,288,13272
280.531,6,28,7352,13,158,23377,267,1317,15,775,20035,3445,6035
18.398,6,56,11589,28,178,681,877,4312,28,387,680,1440,7277
1785.931,6,106,8524,68,66,26655,66,4964,38,60,48261,60,3560
2.942,17,24,9706,11,492,294,1350,5726,13,278,164,1350,3980
1782.972,6,104,8444,68,66,26611,66,4964,36,60,50939,60,3480
7.916,6,535,454764,334,1298,23,1368,439504,201,931,38,2736,15260
1795.378,1,59,4956,59,56,30954,56,4956,0,0,0,0,0
11.624,6,1830,1603355,1110,1389,10,1420,1570334,720,467,16,1883,33021
1.407,6,36,8174,19,321,78,1164,2718,17,529,75,4075,5456
1792.887,1,58,4872,58,56,31454,56,4872,0,0,0,0,0
255.491,6,9,528,2,112,255480,112,200,7,0,42579,0,328
421.72,2,4,128,4,8,140573,8,128,0,0,0,0,0
240.209,6,59,18651,31,777,8006,1402,15608,28,197,8896,580,3043
6.236,6,1601,1465540,1000,1387,6,1408,1429624,601,776,10,1408,35916
12.176,6,89,25665,45,518,276,1152,19423,44,447,276,1179,6242
1770.754,6,99,9240,66,65,27242,65,5577,33,59,55333,59,3663
1794.253,17,289,59942,289,179,6230,373,59942,0,0,0,0,0
1777.453,17,128,10240,64,48,28213,48,4864,64,56,28213,56,5376
0.062,17,2,198,1,63,0,63,91,1,79,0,79,107
0.49,17,4,624,2,64,362,64,184,2,192,391,192,440
300.065,6,38,9801,19,576,16660,1460,4239,19,399,16660,1460,5562
5.468,17,10,1946,5,36,1366,36,320,5,297,1365,318,1626
0.714,17,2,176,2,60,714,60,176,0,0,0,0,0
1.306,6,47,17297,25,884,54,1440,11641,22,433,54,1440,5656
12.568,6,1441,1117043,745,1398,16,1448,1071079,696,776,17,1448,45964
280.308,6,28,7352,12,158,25482,267,1277,16,603,18681,1400,6075
1.278,6,47,19441,27,910,49,1360,13865,20,433,58,1360,5576
37.94,6,5257,4905989,3401,1363,11,1408,4804813,1856,931,20,2816,101176
1783.731,6,356,22520,208,69,8617,69,12460,148,69,12132,69,10060
0.956,6,24,9520,13,351,79,1045,1956,11,1016,78,1460,7564
1786.627,17,140,11200,70,48,25893,48,5320,70,56,25893,56,5880
372.9,6,86,17998,43,270,7226,1221,7679,43,238,8878,1420,10319
1151.464,1,10,1410,10,113,127940,207,1410,0,0,0,0,0
1.212,6,24,8004,12,164,93,267,1288,12,1014,93,2411,6716
16.806,6,18,5532,9,275,2100,275,918,9,1414,1494,1414,4614
247.284,6,16,1517,6,187,49456,187,495,10,247,27098,462,1022
1771.674,6,106,9752,68,65,26442,65,5758,38,59,47880,59,3994
0.133,17,2,672,2,308,133,308,672,0,0,0,0,0
1791.64,6,269,33512,108,142,16743,1360,16184,161,135,11196,4662,17328
1740.691,17,29,30624,29,1028,62167,1028,30624,0,0,0,0,0
85.307,6,827,388771,436,825,196,1152,367610,391,424,218,1179,21161
25.685,6,95,81236,37,143,713,253,2494,58,1376,450,1448,78742
1.285,6,46,17631,26,843,51,1360,12055,20,433,58,1360,5576
6.189,6,1532,1402903,956,1387,6,1408,1368287,576,931,10,2801,34616
301.029,6,49,26036,26,795,12041,1440,8517,23,1019,1406,1892,17519
8.291,6,21,7128,12,373,753,602,1753,9,979,1033,1440,5375
0.285,1,2,112,2,28,285,28,112,0,0,0,0,0
0.247,1,2,112,2,28,247,28,112,0,0,0,0,0
1624.362,2,16,512,16,8,108290,8,512,0,0,0,0,0
1.597,6,46,18124,26,882,63,1360,12548,20,476,73,2715,5576
1756.614,6,4279,4588695,1548,148,1135,879,92659,2731,1639,643,8412,4496036
1790.58,6,356,22520,208,69,8650,69,12460,148,69,12179,69,10060
0.162,6,5,1647,4,699,13,1368,1607,1,0,0,0,40
1160.067,6,134,25652,58,281,20352,1460,12845,76,187,12263,1629,12807
18.323,17,37,7546,17,188,1143,1350,3685,20,165,962,1350,3861
7.302,6,5,216,2,0,7302,0,84,3,0,1523,0,132
4.077,6,11,467,6,0,815,0,248,5,7,760,7,219
14.157,6,39,9719,19,401,786,721,3178,20,520,718,1440,6541
1.349,6,46,18124,26,882,53,1360,12548,20,476,61,2715,5576
360.966,2,5,160,5,8,90241,8,160,0,0,0,0,0
808.67,6,138,15680,72,88,11389,267,5733,66,182,12439,1420,9947
1.107,6,23,11755,12,405,100,907,1739,11,1195,96,2856,10016
240.686,2,5,160,5,8,60171,8,160,0,0,0,0,0
0.328,6,2,92,1,0,0,0,52,1,0,0,0,40
33.749,6,32,5147,15,154,2410,722,1859,17,300,2096,1408,3288
1771.94,6,99,9240,66,65,27260,65,5577,33,59,55370,59,3663
315.328,6,23,5479,9,133,39415,159,887,14,967,24255,1669,4592
1783.682,17,46,15440,46,307,39637,308,15440,0,0,0,0,0
0.106,6,10,1851,5,658,26,658,926,5,657,26,657,925
1.263,6,48,18933,27,870,48,1360,13317,21,433,54,1360,5616
31.124,17,18,1584,9,48,3888,48,684,9,72,3888,72,900
0.0,17,1,186,1,158,0,158,186,0,0,0,0,0
1640.768,1,26,1456,26,28,65630,28,1456,0,0,0,0,0
3.735,6,14,2589,8,187,498,293,1075,6,635,697,1179,1514
0.043,17,2,214,1,47,0,47,75,1,111,0,111,139
280.299,6,27,7312,12,158,25481,267,1277,15,678,20020,2045,6035
1752.716,1,56,4704,56,56,31867,56,4704,0,0,0,0,0
0.239,6,46,21678,27,1039,9,1420,16697,19,467,12,1883,4981
0.227,6,9,1344,5,145,56,145,349,4,831,38,831,995
0.144,6,40,14331,22,849,6,1420,9390,18,467,8,1883,4941
1.225,17,2,178,1,29,0,29,57,1,93,0,93,121
104.628,17,4,1328,4,304,34876,308,1328,0,0,0,0,0
0.049,17,4,284,2,32,33,32,120,2,54,34,60,164
1.087,6,28,8263,15,225,65,561,1985,13,957,75,1631,6278
280.352,6,28,7352,13,158,23362,267,1317,15,678,20022,2800,6035
3.225,17,4,518,3,39,841,39,201,1,289,0,289,317
1.348,6,51,21490,29,915,48,1360,15834,22,476,56,2715,5656
1680.673,17,13,534,11,14,168048,14,462,2,8,1680492,8,72
0.307,6,20,4960,10,137,34,267,1092,10,692,32,1467,3868
0.012,17,2,1197,1,40,0,40,68,1,1101,0,1101,1129
1799.171,6,355,22480,207,69,8733,69,12420,148,69,12239,69,10060
413.96,6,97,31597,47,582,8999,1402,11194,50,635,8448,1402,20403
3.637,17,4,1568,4,364,1212,364,1568,0,0,0,0,0
1792.176,1,342,28728,342,56,5255,56,28728,0,0,0,0,0
0.885,6,26,7235,14,660,68,1408,5359,12,248,78,580,1876
1190.364,17,9,372,8,14,170052,14,336,1,8,0,8,36
0.41,6,52,22583,29,1014,14,1380,17421,23,383,16,1380,5162
8.6,6,28,9240,15,423,614,721,1879,13,1365,686,1414,7361
16.882,6,2681,2481014,1664,1410,10,1448,2423454,1017,776,16,1448,57560
3.932,17,5,290,5,30,983,30,290,0,0,0,0,0
0.557,6,22,5040,11,137,55,267,1132,11,577,49,1400,3908
1.552,6,38,9848,21,440,77,1360,4392,17,476,83,2715,5456
175.57,17,2,72,1,8,0,8,36,1,8,0,8,36
89.461,17,4,1344,4,308,29820,308,1344,0,0,0,0,0
0.53,6,15,2449,8,324,75,585,1073,7,334,83,580,1376
1.252,6,5,260,2,0,1080,0,104,3,0,584,0,156
11.536,6,19,7910,10,275,1281,275,683,9,1371,1327,1440,7227
1701.211,17,15,3774,15,223,121515,1030,3774,0,0,0,0,0
0.546,17,2,255,1,43,0,43,71,1,156,0,156,184
374.984,6,25,1651,17,177,23436,177,1117,8,110,9249,110,534
9.67,6,2152,2031635,1390,1384,6,1408,1987347,762,931,12,2801,44288
10.707,6,67,15977,35,551,314,1429,5404,32,403,52,3446,10573
0.014,17,2,487,1,40,0,40,68,1,391,0,391,419
299.945,17,4,558,2,36,299939,36,128,2,187,299940,187,430
1738.591,1,56,4704,56,56,31610,56,4704,0,0,0,0,0
1788.392,17,87,3648,86,14,21039,14,3612,1,8,0,8,36
777.152,2,7,224,7,8,129525,8,224,0,0,0,0,0
9.768,6,35,9037,18,639,574,1432,3320,17,456,578,1473,5717
11.372,6,26,11958,13,275,947,275,1078,13,1293,830,1414,10880
296.55,17,11,3768,11,314,29655,548,3768,0,0,0,0,0
4.222,6,22,4426,13,213,351,597,1741,9,552,506,1767,2685
1787.922,6,365,25432,213,100,8433,469,14936,152,69,11840,69,10496
280.046,6,29,7392,13,158,23337,267,1317,16,678,18665,2760,6075
1772.05,1,58,4872,0,0,0,0,0,58,56,31088,56,4872
263.775,6,29,8832,14,158,20290,267,1357,15,981,18828,4836,7475
300.943,6,42,12391,23,733,13679,1360,6829,19,399,482,1360,5562
0.02,6,14,4020,8,88,2,88,428,6,1113,3,1460,3592
22.492,1,20,1680,20,56,1183,56,1680,0,0,0,0,0
293.312,17,4,352,2,60,293311,60,176,2,60,293311,60,176
0.98,6,10,1687,7,100,163,100,384,3,1179,357,1179,1303
0.505,17,3,451,2,39,56,39,134,1,289,0,289,317
1.181,6,47,18740,27,860,45,1360,13164,20,476,53,2715,5576
1769.791,6,99,9306,66,66,27227,66,5610,33,60,55302,60,3696
8.989,17,4,240,2,32,8988,32,120,2,32,8988,32,120
15.635,17,18,5640,9,334,1950,1350,3265,9,235,1950,1350,2375
0.071,6,12,3462,6,75,14,75,395,6,1373,14,1448,3067
0.01,17,2,355,1,33,0,33,61,1,266,0,266,294
0.558,6,20,7229,13,334,46,663,2021,7,1209,85,1946,5208
1791.849,6,356,22520,208,69,8656,69,12460,148,69,12189,69,10060
0.015,6,4,160,2,0,0,0,80,2,0,1,0,80
89.436,6,3,760,3,302,44718,302,760,0,0,0,0,0
215.159,1,4,224,4,28,71719,28,224,0,0,0,0,0
72.211,6,193,129265,113,1140,644,1408,58424,80,1626,913,7417,70841
1792.681,6,366,25541,213,100,8456,469,14936,153,69,11790,69,10605
33.52,6,15,700,8,0,1800,0,396,7,0,5558,0,304
1772.004,6,203,22359,130,75,13736,267,10057,73,135,24610,3417,12302
160.276,17,6,528,3,60,80137,60,264,3,60,80137,60,264
7.057,6,65,21019,34,575,213,1152,16336,31,491,226,1179,4683
0.009,6,3,1084,2,940,1,940,1044,1,0,0,0,40
1787.923,6,396,27900,224,101,8017,469,16535,172,69,10455,69,11365
280.768,6,32,7603,14,158,21597,267,1357,18,502,16511,1400,6246
1315.971,2,9,288,9,8,164496,8,288,0,0,0,0,0
0.14,17,2,198,1,39,0,39,67,1,103,0,103,131
1745.144,6,95,7203,63,38,28147,205,4476,32,33,56286,98,2727
0.022,17,4,608,2,60,1,60,176,2,188,5,188,432
1793.168,17,87,3648,86,14,21096,14,3612,1,8,0,8,36
7.427,6,39,7562,19,224,412,314,3676,20,513,376,1179,3886
126.828,6,23,8054,12,378,60,801,1684,11,845,12668,4080,6370
0.268,17,3,451,2,39,249,39,134,1,289,0,289,317
1772.427,6,180,15480,120,69,14894,69,8940,60,69,30037,69,6540
1794.965,17,448,39896,403,35,4465,288,25676,45,288,40017,288,14220
1779.02,17,138,11040,69,48,26161,48,5244,69,56,26161,56,5796
39.774,17,4,352,2,60,39773,60,176,2,60,39773,60,176
1794.949,17,87,3648,86,14,21117,14,3612,1,8,0,8,36
9.748,6,81,24749,41,560,243,1152,19008,40,459,242,1179,5741
1680.049,1,15,840,15,28,120003,28,840,0,0,0,0,0
0.01,17,2,491,1,37,0,37,65,1,398,0,398,426
26.811,6,1399,1255689,881,1345,30,1368,1220639,518,792,51,1473,35050
1794.791,6,356,22520,208,69,8670,69,12460,148,69,12209,69,10060
240.291,6,43,8925,21,523,12014,1418,5815,22,217,11441,619,3110
1792.189,6,354,22509,205,69,8706,69,12340,149,69,12109,69,10169
0.128,6,11,1703,6,314,25,500,948,5,487,31,487,755
124.335,6,30,13781,15,859,100,1440,5791,15,922,8868,1440,7990
0.05,17,2,144,1,36,0,36,64,1,52,0,52,80
1.961,17,22,5709,22,231,93,389,5709,0,0,0,0,0
23.35,17,4,304,4,48,7783,48,304,0,0,0,0,0
1619.807,1,8,448,8,28,231401,28,448,0,0,0,0,0
0.01,17,2,283,1,31,0,31,59,1,196,0,196,224
0.981,6,3,280,1,0,0,0,40,2,160,784,160,240
4.977,17,4,288,2,36,4960,36,128,2,52,4906,52,160
211.151,6,28,3358,14,323,16242,582,1406,14,304,16230,580,1952
1789.863,6,358,22669,209,69,8605,69,12500,149,69,12093,69,10169
3.925,17,6,420,3,32,1961,32,180,3,52,1960,60,240
280.037,6,26,7272,12,158,25457,267,1277,14,775,21538,2800,5995
1787.467,17,136,10880,68,48,26678,48,5168,68,56,26678,56,5712
1775.115,6,152,9684,81,51,22188,208,5914,71,31,25355,31,3770
0.762,6,11,1727,7,100,127,100,384,4,589,171,1152,1343
816.402,17,22,2000,22,62,38876,355,2000,0,0,0,0,0
1787.042,6,102,8296,68,65,26672,65,4930,34,59,54149,59,3366
1.253,6,24,8004,12,164,96,267,1288,12,1014,96,2423,6716
127.16,6,25,10089,12,531,68,1360,2637,13,988,10584,1360,7452
0.037,6,12,963,6,181,7,181,489,6,77,6,133,474
290.568,1,4,224,4,28,96856,28,224,0,0,0,0,0
1786.14,6,154,19574,92,302,19627,302,13852,62,83,29280,83,5722
1772.16,6,182,15629,121,69,14768,69,8980,61,69,29531,69,6649
1798.328,6,373,26097,216,98,8364,469,15332,157,69,11527,69,10765
1795.603,17,448,39896,403,35,4466,288,25676,45,288,40021,288,14220
1798.405,1,345,28980,345,56,5227,56,28980,0,0,0,0,0
1531.449,6,117,7226,63,45,24697,208,4198,54,31,28891,31,3028
1787.392,17,140,11200,70,48,25904,48,5320,70,56,25904,56,5880
1797.507,6,356,22520,208,69,8683,69,12460,148,69,12227,69,10060
0.057,6,3,136,2,0,57,0,88,1,0,0,0,48
1799.522,17,450,39960,405,35,4454,288,25740,45,288,40020,288,14220
1.619,6,36,12217,20,517,85,1460,3456,16,675,87,1460,8761
1783.816,6,356,22520,208,69,8617,69,12460,148,69,12134,69,10060
0.751,6,40,19749,21,698,37,1408,4744,19,1000,41,1408,15005
0.799,6,2,1175,1,0,0,0,40,1,1095,0,1095,1135
1274.752,17,16,4090,8,31,182105,37,478,8,423,182105,463,3612
299.52,6,7,404,4,31,99840,31,222,3,31,149756,31,182
27.609,17,4,320,2,48,27599,48,152,2,56,27598,56,168
5.061,6,13,2311,8,188,723,245,700,5,1407,1195,1407,1611
1798.022,6,356,22520,208,69,8686,69,12460,148,69,12230,69,10060
0.141,17,2,166,1,39,0,39,67,1,71,0,71,99
1795.912,17,448,39896,403,35,4467,288,25676,45,288,40016,288,14220
1.492,6,38,8258,19,321,82,1168,2722,19,433,72,1460,5536
1747.045,6,95,7203,63,38,28178,205,4476,32,33,56346,98,2727
1778.604,1,59,4956,59,56,30665,56,4956,0,0,0,0,0
1774.298,6,184,15847,121,69,14785,69,8980,63,69,28610,69,6867
1769.875,6,99,9174,66,64,27228,64,5544,33,58,55304,58,3630
292.015,1,4,224,4,28,97338,28,224,0,0,0,0,0
1800.0,6,228,19506,85,74,21428,301,8618,143,69,12676,1062,10888
32.068,6,14,2245,8,211,4577,211,846,6,545,6410,904,1399
0.433,17,2,602,1,46,0,46,74,1,500,0,500,528
1772.425,17,349,56390,349,133,5093,376,56390,0,0,0,0,0
0.373,6,21,5000,10,137,41,267,1092,11,692,34,1467,3908
1681.438,17,16,1265,8,30,240202,37,471,8,71,240201,136,794
1.879,17,2,396,1,58,0,58,86,1,282,0,282,310
0.727,6,17,5164,9,150,90,174,664,8,835,91,1452,4500
1799.885,6,369,25799,215,99,8410,469,15085,154,69,11763,69,10714
0.417,6,13,1693,7,288,69,288,588,6,284,41,434,1105
99.292,6,30,2358,14,86,7562,86,936,16,44,6547,63,1422
0.299,6,22,7354,13,335,24,668,2038,9,968,36,1906,5316
0.221,1,2,112,2,28,221,28,112,0,0,0,0,0
1746.951,17,315,68757,315,190,5563,361,68757,0,0,0,0,0
37.577,17,6,528,3,48,18784,48,228,3,72,18783,72,300
0.448,6,56,23079,32,968,14,1380,15909,24,515,17,1923,7170
0.118,17,2,180,1,30,0,30,58,1,94,0,94,122
61.844,6,69,49957,45,1200,1405,1408,41975,24,960,2678,3847,7982
10.456,6,26,4904,13,182,871,267,1620,13,458,809,1152,3284
65.876,6,44,9958,19,256,3659,1189,3080,25,418,2742,1997,6878
98.35,6,11,719,11,31,9835,31,719,0,0,0,0,0
1787.905,6,370,26239,215,105,8354,469,15554,155,69,11609,69,10685
280.377,6,29,7392,13,158,23364,267,1317,16,678,18689,4140,6075
285.005,17,4,352,2,60,285004,60,176,2,60,285004,60,176
1744.665,2,28,896,28,8,64617,8,896,0,0,0,0,0
1794.893,6,356,22520,208,69,8670,69,12460,148,69,12209,69,10060
81.396,6,20,820,9,0,6169,0,364,11,0,8138,0,456
1799.514,17,379,129659,379,314,4760,422,129659,0,0,0,0,0
3.569,17,5,840,4,64,1180,64,368,1,444,0,444,472
4.024,17,8,616,4,33,1334,33,244,4,65,1336,65,372
1786.197,17,87,3648,86,14,21014,14,3612,1,8,0,8,36
74.897,6,17,700,8,0,4405,0,324,9,0,9360,0,376
0.141,6,33,8043,17,131,8,131,1023,16,441,9,500,7020
178.563,17,4,352,2,60,178562,60,176,2,60,178562,60,176
231.855,17,6,528,3,48,115924,48,228,3,72,115924,72,300
617.283,1,6,360,6,32,123456,32,360,0,0,0,0,0
2.45,17,2,456,1,60,0,60,88,1,340,0,340,368
3.438,17,6,424,5,40,855,40,340,1,56,0,56,84
1775.562,6,180,15480,120,69,14920,69,8940,60,69,30085,69,6540
11.86,17,16,2352,8,48,1692,48,608,8,190,1692,308,1744
41.485,17,16,1216,16,48,2765,48,1216,0,0,0,0,0
1.226,6,50,19226,27,886,47,1360,13530,23,433,48,1360,5696
260.617,6,14,8680,6,424,52123,721,1517,8,1708,8748,2840,7163
3.822,6,23,6518,11,281,374,517,1423,12,744,339,1368,5095
132.209,17,4,352,2,60,132207,60,176,2,60,132207,60,176
1.238,6,47,18886,27,871,47,1360,13310,20,529,56,4075,5576
1.599,6,31,6084,15,123,114,267,1468,16,567,98,1420,4616
0.015,17,2,588,1,60,0,60,88,1,472,0,472,500
1797.159,17,423,35688,384,32,4692,288,23364,39,288,46342,288,12324
41.522,6,28,7217,13,155,3460,267,1306,15,482,2965,1997,5911
17.82,6,7,1571,4,100,5940,100,264,3,1179,1488,1179,1307
0.46,6,13,1693,6,288,85,288,548,7,426,43,434,1145
0.168,17,2,136,1,32,0,32,60,1,48,0,48,76
252.008,2,3,96,3,8,126004,8,96,0,0,0,0,0
240.201,6,57,20049,31,819,8006,1418,17182,26,188,9607,580,2867
66.876,17,24,2112,12,48,6079,48,912,12,72,6078,72,1200
1798.11,1,118,6608,118,28,15368,28,6608,0,0,0,0,0
0.316,6,26,8990,13,247,26,624,1672,13,947,25,1438,7318
0.991,6,11,1727,7,100,165,100,384,4,589,244,1152,1343
2.896,6,2,88,2,0,0,0,88,0,0,0,0,0
1789.672,1,342,28728,342,56,5248,56,28728,0,0,0,0,0
62.517,6,3154,2778473,2031,1290,30,1368,2715401,1123,776,55,1473,63072
0.279,6,15,3099,8,139,39,139,595,7,533,42,904,2504
1.296,17,25,14683,11,607,129,1350,6985,14,521,90,1350,7698
347.986,6,118,86887,74,1252,4766,1408,76479,44,811,2448,3847,10408
1800.0,17,181,26969,181,121,10000,121,26969,0,0,0,0,0
0.747,6,23,5529,13,140,62,267,1224,10,780,75,1460,4305
1746.555,6,95,7203,63,38,28170,205,4476,32,33,56332,98,2727
2.362,17,6,1202,3,36,1168,36,192,3,308,1174,318,1010
0.39,6,12,1653,6,288,71,288,548,6,426,42,434,1105
1791.198,6,313,46900,134,216,13466,1360,26392,179,141,10062,1360,20508
104.073,6,63,41565,40,1168,2668,1408,33627,23,841,2791,2439,7938
1798.631,1,58,4872,58,56,31554,56,4872,0,0,0,0,0
1.883,6,29,8832,14,158,144,267,1357,15,858,132,3436,7475
379.787,6,21,1422,15,180,27127,180,992,6,110,12251,110,430
0.045,6,10,690,6,71,9,71,391,4,83,10,83,299
315.003,6,27,5686,9,133,39374,159,887,18,773,18529,1408,4799
1796.503,17,448,39896,403,35,4468,288,25676,45,288,40016,288,14220
3.265,6,4,176,1,0,0,0,44,3,0,1509,0,132
111.592,1,16,1664,0,0,0,0,0,16,76,7439,76,1664
1773.498,6,180,15480,120,69,14903,69,8940,60,69,30054,69,6540
1773.629,6,180,15480,120,69,14904,69,8940,60,69,30055,69,6540
22.826,6,3647,3441500,2314,1407,9,1448,3367508,1333,776,17,1448,73992
1.389,6,10,924,5,283,223,283,551,5,105,237,105,373
5.687,6,741,641402,449,1351,12,1368,619250,292,776,18,1473,22152
1041.02,17,726,51003,653,40,1596,41,44831,73,56,569,57,6172
1.995,17,5,1272,3,40,997,41,206,2,505,1063,505,1066
1745.633,6,95,7203,63,38,28155,205,4476,32,33,56304,98,2727
0.184,17,2,152,2,48,184,48,152,0,0,0,0,0
3.423,6,125,88193,53,131,65,232,2649,72,1355,47,1420,85544
1746.099,6,110,7991,69,31,25677,31,4714,41,31,43652,31,3277
0.303,6,25,6098,12,181,27,537,1526,13,648,24,1408,4572
0.208,6,10,1669,6,551,41,947,1346,4,159,69,159,323
0.151,6,3,120,1,0,0,0,40,2,0,150,0,80
589.891,17,81,6097,47,40,12823,41,3222,34,56,17874,57,2875
300.63,6,49,10037,24,202,13070,464,1885,25,396,633,1460,8152
9.129,6,668,616362,445,1320,20,1368,600102,223,931,40,2736,16260
3.604,6,34,6169,18,206,212,314,2784,16,456,223,1152,3385
0.434,17,8,2750,8,315,62,354,2750,0,0,0,0,0
1.287,6,37,8214,19,321,71,1164,2718,18,476,65,2715,5496
180.913,17,2,386,2,165,180913,165,386,0,0,0,0,0
269.117,17,9,3008,9,306,33639,308,3008,0,0,0,0,0
0.024,17,2,362,1,46,0,46,74,1,260,0,260,288
1744.044,6,95,7203,63,38,28129,205,4476,32,33,56247,98,2727
61.85,6,73,50569,45,1213,1405,1448,42384,28,746,2282,1448,8185
6.129,6,2,149,0,0,0,0,0,2,69,6129,69,149
1786.917,6,102,8296,68,65,26670,65,4930,34,59,54145,59,3366
13.727,6,30,7297,14,155,1055,267,1346,16,441,914,1420,5951
11.566,6,25,8473,13,275,963,275,1078,12,986,749,1440,7395
1786.331,6,102,8228,68,64,26661,64,4896,34,58,54128,58,3332
499.041,1,12,672,12,28,45367,28,672,0,0,0,0,0
279.974,6,28,7352,13,158,23331,267,1317,15,678,19995,3436,6035
0.102,6,13,4387,7,92,17,92,464,6,1201,20,2121,3923
10.176,6,9,527,5,43,2544,43,311,4,0,3391,0,216
119.229,17,6,609,3,43,59608,43,213,3,104,59608,104,396
8.499,6,19,2565,13,211,708,211,1166,6,545,1698,904,1399
0.003,6,10,14888,1,0,0,0,40,9,1597,0,2876,14848
1795.459,17,447,39580,403,35,4466,288,25676,44,288,40949,288,13904
1784.852,6,104,8376,68,65,26639,65,4930,36,59,50993,59,3446
1680.581,17,12,498,11,14,168058,14,462,1,8,0,8,36
27.124,6,14,3148,5,92,6781,92,348,9,464,3366,1408,2800
1008.227,2,6,192,6,8,201645,8,192,0,0,0,0,0
12.455,6,1910,1707263,1201,1368,10,1380,1669346,709,683,17,3303,37917
300.709,6,37,8526,20,315,15826,882,2093,17,478,534,2720,6433
113.378,17,4,352,2,60,113377,60,176,2,60,113377,60,176
1784.895,6,102,8296,68,65,26640,65,4930,34,59,54085,59,3366
1780.212,6,79,4160,40,26,45645,26,2106,39,26,46846,26,2054
0.06,6,10,1568,5,121,14,121,389,5,911,14,911,1179
3.03,17,4,240,4,32,1010,32,240,0,0,0,0,0
1.343,6,48,19463,27,909,51,1460,13847,21,433,58,1460,5616
12.743,6,22,5962,11,275,1274,275,998,11,902,1202,1440,4964
0.01,17,2,244,1,46,0,46,74,1,142,0,142,170
1797.274,6,80,4160,40,0,46079,0,2080,40,0,46080,0,2080
1783.81,6,378,23952,215,69,8335,69,13223,163,69,11011,69,10729
1.594,6,9,872,4,283,473,283,499,5,105,354,105,373
7.842,6,30,8872,14,158,603,267,1357,16,763,514,2760,7515
0.195,17,2,136,1,32,0,32,60,1,48,0,48,76
124.683,6,33,7757,12,155,29,267,1266,21,352,6233,1997,6491
42.596,17,3,228,3,48,21298,48,228,0,0,0,0,0
131.297,6,24,10282,12,433,84,990,1823,12,995,11922,1390,8459
112.768,17,4,1344,4,308,37589,308,1344,0,0,0,0,0
1746.703,6,95,7203,63,38,28172,205,4476,32,33,56333,98,2727
0.018,17,2,283,1,31,0,31,59,1,196,0,196,224
1699.003,1,8,448,8,28,242714,28,448,0,0,0,0,0
31.836,6,7,308,1,0,0,0,44,6,0,6303,0,264
1.385,17,19,9163,8,468,197,1350,3972,11,443,103,1350,5191
0.391,17,4,304,2,37,384,37,130,2,59,384,65,174
0.241,17,6,2008,6,306,48,354,2008,0,0,0,0,0
1224.578,1,33,1848,33,28,38268,28,1848,0,0,0,0,0
314.802,6,23,2585,7,242,52466,517,1111,16,323,20986,499,1474
33.598,6,32,5157,15,154,2399,722,1870,17,299,2088,1408,3287
0.908,6,24,6408,13,297,75,830,2011,11,988,89,1731,4397
45.249,6,3,4500,3,1460,22624,1460,4500,0,0,0,0,0
1783.856,17,142,11360,71,48,25482,48,5396,71,56,25482,56,5964
83.008,6,34,7802,12,155,30,267,1266,22,332,3952,1420,6536
3.514,6,13,2311,8,188,502,245,700,5,1407,812,1407,1611
0.109,17,2,588,1,39,0,39,67,1,493,0,493,521
0.523,6,58,24122,33,968,16,1380,16912,25,475,20,1923,7210
0.124,17,2,182,1,39,0,39,67,1,87,0,87,115
1.593,6,55,19743,27,909,61,1460,13847,28,433,51,1460,5896
1798.367,17,449,39928,404,35,4462,288,25708,45,288,40019,288,14220
0.051,17,2,128,1,36,0,36,64,1,36,0,36,64
13.101,17,4,352,2,60,13100,60,176,2,60,13099,60,176
0.481,17,3,451,2,39,128,39,134,1,289,0,289,317
79.526,6,15,2237,9,324,9940,585,1125,6,396,15896,580,1112
69.492,6,19,776,9,0,6041,0,364,10,0,7719,0,412
0.013,17,4,284,2,32,9,32,120,2,54,6,60,164
419.785,2,4,128,4,8,139928,8,128,0,0,0,0,0
280.217,6,29,7392,13,158,23351,267,1317,16,543,18680,1400,6075
38.604,6,26,8159,14,465,2965,1306,2598,12,705,3503,1571,5561
125.226,2,2,64,2,8,125226,8,64,0,0,0,0,0
0.054,17,4,680,2,33,0,33,122,2,251,1,323,558
12.687,6,16,2275,9,253,1585,597,1469,7,147,1232,346,806
1786.592,6,104,8444,68,66,26665,66,4964,36,60,51041,60,3480
1767.348,17,170,14432,157,30,11329,37,9155,13,377,142111,463,5277
2.993,17,8,792,4,39,997,39,268,4,103,993,103,524
1787.458,6,158,20179,93,302,19428,302,14206,65,83,27928,83,5973
27.721,6,1990,1632453,1139,1372,24,1380,1591243,851,421,32,1923,41210
2.069,17,15,8470,8,706,295,1350,5873,7,343,335,1350,2597
1794.743,17,144,11520,72,48,25277,48,5472,72,56,25277,56,6048
0.063,6,10,584,5,44,15,44,312,5,0,15,0,272
1793.586,6,356,22520,208,69,8664,69,12460,148,69,12201,69,10060
3.885,17,3,186,3,34,1942,34,186,0,0,0,0,0
0.434,6,6,324,4,0,144,0,216,2,0,253,0,108
1789.151,17,142,11360,71,48,25559,48,5396,71,56,25559,56,5964
1.824,17,4,580,2,40,1792,40,136,2,194,1673,194,444
0.667,6,22,5040,11,137,66,267,1132,11,692,61,1467,3908
1798.149,17,312,69422,312,194,5781,422,69422,0,0,0,0,0
12.7,6,2,87,1,0,0,0,40,1,7,0,7,47
61.294,6,36,15979,22,810,2918,1440,9253,14,665,4695,1440,6726
0.502,6,21,7203,13,318,41,600,1958,8,964,68,1471,5245
1742.238,6,138,8761,77,49,22924,208,5422,61,31,29030,31,3339
1780.777,17,82,3438,81,14,22259,14,3402,1,8,0,8,36
1797.945,17,449,39928,404,35,4461,288,25708,45,288,40014,288,14220
0.351,6,26,8890,13,232,29,569,1614,13,1098,28,2804,7276
1769.361,1,58,4872,58,56,31041,56,4872,0,0,0,0,0
1773.529,6,180,15480,120,69,14903,69,8940,60,69,30051,69,6540
0.265,6,21,5000,11,137,26,267,1132,10,692,27,1467,3868
0.857,6,53,14390,26,549,34,1429,4916,27,441,32,1460,9474
373.792,1,8,448,8,28,53398,28,448,0,0,0,0,0
46.929,6,970,819560,418,350,112,426,27028,552,1416,84,2816,792532
521.146,1,36,3816,36,78,14889,78,3816,0,0,0,0,0
38.508,17,4,240,2,32,38507,32,120,2,32,38507,32,120
0.11,6,13,1749,7,253,18,500,878,6,275,22,500,871
0.163,6,7,423,4,43,41,43,259,3,0,29,0,164
0.166,17,4,344,2,47,159,47,150,2,69,159,75,194
1788.746,17,87,3648,86,14,21044,14,3612,1,8,0,8,36
1786.532,6,102,8364,68,66,26664,66,4964,34,60,54134,60,3400
3.225,6,2,88,2,0,0,0,88,0,0,0,0,0
1783.538,17,83,3480,82,14,22018,14,3444,1,8,0,8,36
297.037,1,4,326,4,53,99012,78,326,0,0,0,0,0
280.517,6,29,7392,13,158,23376,267,1317,16,678,18694,3456,6075
30.866,17,6,2016,6,308,6173,308,2016,0,0,0,0,0
1.994,17,2,672,2,308,1994,308,672,0,0,0,0,0
1741.877,6,87,6322,58,31,30559,31,3915,29,31,62209,31,2407
1680.629,1,15,870,15,30,120044,30,870,0,0,0,0,0
841.625,17,8,592,4,30,280536,30,232,4,62,280505,62,360
917.987,2,11,352,11,8,91798,8,352,0,0,0,0,0
751.037,1,65,6760,0,0,0,0,0,65,76,11734,76,6760
0.224,17,2,198,1,39,0,39,67,1,103,0,103,131
1799.993,6,746,50558,372,31,4851,31,25296,374,31,4825,71,25262
112.494,6,15,5673,4,106,37486,106,274,11,706,11245,1460,5399
300.403,6,134,116391,50,173,6130,230,3648,84,1354,3619,1933,112743
1577.755,6,24,3624,16,241,105183,241,2568,8,92,225362,92,1056
1744.588,2,28,896,28,8,64614,8,896,0,0,0,0,0
5.025,17,4,288,2,36,5005,36,128,2,52,5004,52,160
0.028,17,8,1094,5,36,4,36,320,3,230,9,230,774
4.255,6,2,104,1,0,0,0,64,1,0,0,0,40
374.092,6,25,1651,17,177,23380,177,1117,8,110,9262,110,534
51.269,17,4,352,2,60,51268,60,176,2,60,51268,60,176
0.569,6,20,7238,12,335,51,668,1974,8,1210,80,1906,5264
338.824,6,88,13124,40,182,8687,1189,4532,48,246,7208,1420,8592
104.735,17,4,352,2,60,104734,60,176,2,60,104734,60,176
280.456,6,29,7392,14,158,21573,267,1357,15,678,20025,3456,6035
1.256,6,47,18164,26,882,50,1360,12548,21,433,53,1360,5616
0.335,6,25,8840,13,227,27,547,1616,12,1098,29,2816,7224
9.657,6,1722,1679614,1107,1441,8,1448,1642958,615,776,15,1448,36656
1787.976,6,360,25370,211,99,8514,469,14994,149,69,12080,69,10376
44.357,17,4,1313,4,300,14785,301,1313,0,0,0,0,0
132.214,6,65,42893,41,1169,3305,1448,34892,24,749,2673,1448,8001
282.315,6,30,7432,13,158,23526,267,1317,17,603,17639,1380,6115
15.24,6,30,7230,15,237,1088,335,2744,15,647,1069,1179,4486
1798.022,6,356,22520,208,69,8686,69,12460,148,69,12231,69,10060
5.001,17,4,530,2,36,4997,36,128,2,173,4995,187,402
1799.797,17,448,39896,403,35,4477,288,25676,45,288,40018,288,14220
296.168,2,9,288,9,8,37021,8,288,0,0,0,0,0
252.04,2,2,64,2,8,252040,8,64,0,0,0,0,0
1.868,6,39,8383,20,351,97,1432,2560,19,459,102,1432,5823
1798.747,1,218,12208,218,28,8289,28,12208,0,0,0,0,0
1787.409,6,102,8228,68,64,26677,64,4896,34,58,54160,58,3332
1.336,6,43,11515,24,547,58,1360,5934,19,437,64,2715,5581
91.566,6,34,13388,14,566,7043,1360,3449,20,651,4808,1360,9939
0.171,6,45,21053,26,1072,6,1420,16072,19,526,9,3303,4981
0.012,17,2,330,1,30,0,30,58,1,244,0,244,272
1684.507,2,21,672,21,8,84225,8,672,0,0,0,0,0
1.494,6,44,11591,24,547,64,1360,5970,20,437,68,2715,5621
1754.388,6,95,7203,63,38,28296,205,4476,32,33,56583,98,2727
0.3,6,8,530,5,43,73,43,354,3,0,149,0,176
1796.901,17,448,39896,403,35,4469,288,25676,45,288,40020,288,14220
1796.112,1,266,28196,266,78,6777,78,28196,0,0,0,0,0
15.321,6,23,4896,9,308,1915,722,1696,14,305,1162,1408,3200
9.991,17,4,288,2,44,9980,44,144,2,44,9979,44,144
10.925,6,20,4442,11,275,1092,275,998,9,768,768,1440,3444
1781.273,6,126,12418,78,62,23133,721,6420,48,87,37891,1448,5998
30.794,6,1103,1008524,708,1352,43,1368,983296,395,776,77,1473,25228
0.214,17,2,152,1,48,0,48,76,1,48,0,48,76
240.224,6,55,17620,28,730,8896,1418,14604,27,200,9239,580,3016
588.998,6,17,959,9,31,73624,31,546,8,31,84141,31,413
12.653,6,1995,1730074,1221,1362,10,1380,1694836,774,425,16,1923,35238
