flow_duration,protocol,TotPackets,TotBytes,tot_fwd_pkts,totlen_fwd_pkts,fwd_iat_mean,fwd_pkt_len_max,fwd_pkt_len_mean,tot_bwd_pkts,totlen_bwd_pkts,bwd_iat_mean,bwd_pkt_len_max,bwd_pkt_len_mean
1741.276,17,29,6699,29,203,62188,203,6699,0,0,0,0,0
1.827,17,43,35653,18,411,107,1350,7907,25,1081,59,1350,27746
2.221,6,14,2351,8,188,317,245,700,6,703,392,1152,1651
0.981,6,28,8460,15,222,58,540,1964,13,994,67,1791,6496
125.424,6,34,7872,12,156,29,267,1272,22,336,5972,1997,6600
0.53,17,3,543,2,39,238,39,134,1,381,0,381,409
2.339,6,5,274,1,0,0,0,40,4,1,489,1,234
1797.02,17,438,147168,438,308,4112,308,147168,0,0,0,0,0
0.394,6,12,1653,6,288,72,288,548,6,426,43,434,1105
1.013,6,25,8044,13,164,84,267,1328,12,869,75,1448,6716
0.331,17,8,2766,8,317,47,356,2766,0,0,0,0,0
0.134,17,8,2454,8,278,19,317,2454,0,0,0,0,0
953.014,1,5,280,5,28,238253,28,280,0,0,0,0,0
0.847,6,9,527,5,43,211,43,311,4,0,278,0,216
0.064,6,10,767,5,186,15,186,454,5,45,14,45,313
57.625,17,4,352,2,48,57616,48,152,2,72,57614,72,200
0.34,17,2,152,1,48,0,48,76,1,48,0,48,76
280.032,6,26,7272,12,158,25457,267,1277,14,775,21538,3445,5995
1789.896,1,280,29680,280,78,6415,78,29680,0,0,0,0,0
1.602,6,51,20229,28,892,59,1360,14533,23,433,63,1360,5696
57.724,1,16,1664,0,0,0,0,0,16,76,3848,76,1664
1786.548,6,104,8376,68,65,26664,65,4930,36,59,51041,59,3446
73.131,6,87,12859,46,304,1625,304,8880,41,83,1822,83,3979
1787.728,6,356,22520,208,69,8636,69,12460,148,69,12159,69,10060
1772.745,6,180,15480,120,69,14897,69,8940,60,69,30044,69,6540
0.337,17,2,192,1,60,0,60,88,1,76,0,76,104
0.106,17,4,368,2,32,106,32,120,2,96,62,96,248
1792.896,6,295,28729,177,103,10186,469,14351,118,134,15323,4837,14378
0.41,6,50,21420,29,946,14,1380,16338,21,468,18,3303,5082
1795.128,17,80,3354,79,14,23014,14,3318,1,8,0,8,36
126.299,17,4,336,2,42,126251,47,140,2,70,126230,77,196
1.377,6,47,19398,27,907,52,1360,13822,20,476,62,2715,5576
280.44,6,28,7352,12,158,25494,267,1277,16,603,18689,1400,6075
1771.974,6,180,15480,120,69,14890,69,8940,60,69,30032,69,6540
8.016,17,12,1764,6,48,1601,48,456,6,190,1600,308,1308
1781.762,6,363,25283,211,100,8484,469,14787,152,69,11799,69,10496
1745.914,6,94,7151,62,38,28621,205,4424,32,33,56311,98,2727
1786.72,6,102,8296,68,65,26667,65,4930,34,59,54140,59,3366
1740.451,17,30,6930,30,203,60015,203,6930,0,0,0,0,0
1785.22,17,87,3648,86,14,21002,14,3612,1,8,0,8,36
0.304,6,26,9046,13,261,25,683,1728,13,1105,24,4224,7318
1797.621,6,277,26600,116,66,15627,659,10322,161,121,11234,1460,16278
0.56,6,51,22060,29,981,20,1380,16926,22,421,24,1923,5134
1770.443,6,101,9410,66,66,27237,66,5610,35,60,52068,60,3800
280.469,6,30,7432,14,158,21574,267,1357,16,678,18695,3456,6075
1786.667,1,58,4872,0,0,0,0,0,58,56,31345,56,4872
87.418,6,41,8813,19,401,604,888,2055,22,366,4156,2128,6758
169.363,17,4,352,2,60,169361,60,176,2,60,169362,60,176
0.348,6,27,9076,13,252,29,647,1692,14,831,26,1448,7384
240.222,6,53,17839,28,793,8897,1418,14947,25,198,10008,580,2892
23.598,17,2,672,2,308,23598,308,672,0,0,0,0,0
167.555,6,27,6550,10,220,6158,516,1285,17,327,10466,1452,5265
1.28,6,41,10591,21,517,64,1440,5015,20,433,58,1440,5576
0.044,6,15,4072,8,88,6,88,440,7,1670,7,1880,3632
0.002,6,5,6879,5,1323,0,1448,6879,0,0,0,0,0
0.414,17,8,2750,8,315,59,354,2750,0,0,0,0,0
0.11,6,12,1587,6,507,21,507,779,6,556,22,556,808
1799.182,6,379,26406,218,97,8291,469,15481,161,69,11242,69,10925
1786.481,6,104,8444,68,66,26663,66,4964,36,60,51039,60,3480
39.524,6,30,7297,14,155,3040,267,1346,16,441,2634,1420,5951
300.153,6,56,21983,31,978,9999,1360,15952,25,358,12499,1360,6031
60.382,6,13,3818,7,407,10063,722,1174,6,1164,12038,1408,2644
996.68,17,12,3143,6,31,199333,37,355,6,436,199334,463,2788
1787.887,17,83,3480,82,14,22072,14,3444,1,8,0,8,36
1777.769,17,140,11200,70,48,25764,48,5320,70,56,25764,56,5880
0.068,1,2,163,2,53,68,78,163,0,0,0,0,0
1789.95,6,381,24141,217,69,8286,69,13441,164,69,10981,69,10700
145.705,6,25,11665,13,495,121,1360,2546,12,1437,13233,3944,9119
280.23,6,26,7272,13,158,23352,267,1317,13,905,23347,4845,5955
63.109,6,7,420,7,0,0,0,420,0,0,0,0,0
0.329,17,12,4389,12,337,29,360,4389,0,0,0,0,0
1772.998,6,181,15589,120,69,14899,69,8940,61,69,29547,69,6649
288.539,6,25,6289,9,273,93,519,1183,16,343,19231,1420,5106
113.191,6,9,506,4,106,37496,106,274,5,0,28296,0,232
0.138,6,12,3488,6,101,27,101,421,6,1373,27,1448,3067
10.83,6,20,4442,11,275,1083,275,998,9,768,756,1440,3444
5.854,6,56,19603,28,829,216,1440,13599,28,433,208,1440,6004
0.549,17,4,936,2,39,536,39,134,2,373,19,381,802
126.068,6,55,9200,23,127,3089,267,2333,32,371,4062,1917,6867
0.113,1,2,112,2,28,113,28,112,0,0,0,0,0
78.713,17,8,640,4,48,26233,48,304,4,56,26232,56,336
20.133,6,21,5418,13,107,1677,159,1126,8,967,2874,1675,4292
291.422,17,4,240,2,32,291421,32,120,2,32,291421,32,120
1684.575,2,14,448,14,8,129582,8,448,0,0,0,0,0
1799.987,17,449,39928,404,35,4466,288,25708,45,288,40021,288,14220
1757.756,6,253,25262,126,98,14062,721,13630,127,155,13948,1440,11632
1789.221,17,142,11360,71,48,25560,48,5396,71,56,25560,56,5964
1676.329,1,8,848,8,78,239475,78,848,0,0,0,0,0
3.217,6,2,88,2,0,0,0,88,0,0,0,0,0
1758.04,17,83,3480,82,14,21704,14,3444,1,8,0,8,36
0.36,6,23,7394,13,335,29,668,2026,10,1210,39,1906,5368
4.957,6,37,7189,19,218,275,314,3383,18,513,275,1179,3806
0.032,6,10,1865,6,649,6,1141,1542,4,159,9,159,323
280.696,6,30,7432,13,158,23391,267,1317,17,543,17538,1400,6115
0.968,6,29,8500,15,222,59,540,1964,14,852,61,1360,6536
59.817,6,83,45997,40,161,1533,167,3414,43,1008,1422,1445,42583
3.797,1,2,72,2,8,3797,8,72,0,0,0,0,0
1.295,6,46,19265,27,901,49,1360,13729,19,476,62,2720,5536
0.231,17,2,2728,2,1336,231,1336,2728,0,0,0,0,0
34.392,17,4,240,2,32,34391,32,120,2,32,34391,32,120
12.017,17,20,1760,10,37,1334,37,650,10,83,1334,89,1110
1797.7,6,127,8051,73,47,24968,208,4961,54,31,33913,31,3090
8.565,17,4,352,2,60,8564,60,176,2,60,8563,60,176
0.235,6,43,17242,24,940,10,1420,12261,19,467,12,1883,4981
0.021,17,2,904,2,424,21,548,904,0,0,0,0,0
0.179,6,9,1340,5,145,44,145,349,4,827,40,827,991
1789.316,17,87,3648,86,14,21050,14,3612,1,8,0,8,36
0.024,17,2,596,1,64,0,64,92,1,476,0,476,504
1799.043,17,758,45742,758,32,2376,37,45742,0,0,0,0,0
1741.264,17,30,31680,30,1028,60043,1028,31680,0,0,0,0,0
1742.621,1,70,3920,70,28,25255,28,3920,0,0,0,0,0
0.285,6,3,160,2,0,285,0,100,1,0,0,0,60
1790.634,6,381,23520,208,69,8650,69,12460,173,48,10410,69,11060
1780.637,1,75,6300,75,56,24062,56,6300,0,0,0,0,0
0.01,17,4,350,2,34,1,34,124,2,85,0,91,226
0.472,17,2,201,1,50,0,50,78,1,95,0,95,123
1776.731,6,189,16254,122,69,14683,69,9089,67,69,26914,69,7165
49.142,6,1619,1404923,972,1361,50,1368,1363259,647,776,75,1473,41664
2.099,6,19,3781,10,234,233,564,1452,9,463,239,1343,2329
0.005,6,4,4540,1,0,0,0,40,3,1448,1,1448,4500
504.064,2,4,128,4,8,168021,8,128,0,0,0,0,0
1.779,6,48,20772,28,933,65,1360,15196,20,476,82,2715,5576
0.506,17,2,144,1,36,0,36,64,1,52,0,52,80
0.006,17,2,2166,2,1055,6,1055,2166,0,0,0,0,0
37.188,6,4679,4481144,3111,1363,11,1408,4394920,1568,776,23,1408,86224
242.494,6,31,3958,15,411,17321,585,2046,16,265,16163,580,1912
1786.62,6,104,8435,69,65,26273,65,4970,35,59,52544,59,3465
0.086,1,2,112,2,28,86,28,112,0,0,0,0,0
0.818,17,4,368,2,64,817,64,184,2,64,817,64,184
280.318,6,30,7432,13,158,23359,267,1317,17,543,17515,1400,6115
0.157,6,11,1170,6,135,30,135,379,5,587,38,587,791
0.022,17,2,461,1,34,0,34,62,1,371,0,371,399
920.873,6,67,9811,43,94,21925,504,3616,24,237,40034,1452,6195
243.8,6,56,13219,26,155,9752,517,2835,30,489,8406,1402,10384
1748.194,6,95,7203,63,38,28196,205,4476,32,33,56380,98,2727
1.227,6,3,189,1,0,0,0,40,2,69,877,69,149
291.153,6,33,8234,14,158,22396,267,1357,19,509,16151,1400,6877
37.668,6,36,6840,18,306,2214,517,3767,18,297,2149,499,3073
300.784,6,34,18624,19,595,16703,1360,4413,15,1359,21475,3527,14211
1799.004,6,358,22738,208,69,8690,69,12460,150,69,12073,69,10278
28.953,6,2275,2095457,1375,1439,20,1448,2041345,900,776,31,1448,54112
1642.55,1,54,4536,54,56,30991,56,4536,0,0,0,0,0
60.06,17,84,21777,84,231,723,389,21777,0,0,0,0,0
34.781,17,4,240,2,32,34780,32,120,2,32,34780,32,120
0.131,17,2,1920,2,932,131,932,1920,0,0,0,0,0
280.189,6,26,7272,12,158,25471,267,1277,14,775,21550,2800,5995
1798.383,17,144,11520,72,48,25329,48,5472,72,56,25329,56,6048
54.964,6,22,1567,11,222,5494,222,888,11,231,5494,231,679
1.744,6,52,21639,28,983,64,1440,15903,24,433,67,1440,5736
3.786,6,16,3449,9,49,473,92,563,7,503,109,1448,2886
12.338,6,21,6003,10,272,1179,516,1220,11,542,1225,1452,4783
1137.915,17,366,25133,366,40,3117,41,25133,0,0,0,0,0
1775.444,17,140,11200,70,48,25730,48,5320,70,56,25730,56,5880
1790.006,1,58,4872,58,56,31403,56,4872,0,0,0,0,0
1711.807,6,91,7742,58,72,25633,293,4433,33,64,53491,247,3309
49.009,6,138,111520,89,1263,556,1368,100684,49,740,1016,2519,10836
227.056,6,30,6735,13,189,9082,516,1470,17,327,14185,1452,5265
143.36,6,93,61400,47,878,89,1460,20371,46,1152,3182,2284,41029
1780.079,6,331,22560,143,46,12534,46,9428,188,46,9518,46,13132
11.573,6,25,8473,13,275,964,275,1078,12,986,753,1440,7395
1681.633,17,16,1265,8,30,240228,37,471,8,71,240227,136,794
52.353,6,20,9698,8,263,7479,722,1467,12,1086,4729,1448,8231
300.949,6,39,10154,19,611,16709,1360,4459,20,348,15830,2667,5695
6.019,6,7,400,3,0,3009,0,160,4,0,1340,0,240
23.087,6,13,6416,4,150,3590,174,464,9,930,2874,1420,5952
1680.612,1,15,870,15,30,120043,30,870,0,0,0,0,0
1741.054,6,87,6322,58,31,30544,31,3915,29,31,62178,31,2407
1795.105,17,80,3354,79,14,23014,14,3318,1,8,0,8,36
104.503,6,48,13984,27,892,4012,1360,8297,21,439,5216,4027,5687
1786.848,6,159,30539,95,404,19009,1302,22823,64,107,28361,241,7716
1.57,17,4,580,2,40,1539,40,136,2,194,1530,194,444
1771.25,6,105,9828,68,66,26436,66,5792,37,60,49198,60,4036
12.246,17,3,228,3,48,6123,48,228,0,0,0,0,0
0.425,6,27,7296,13,155,35,267,1301,14,603,31,1400,5995
1626.003,1,7,392,7,28,271000,28,392,0,0,0,0,0
231.036,17,8,5050,8,603,33005,840,5050,0,0,0,0,0
1798.783,17,142,11360,71,48,25696,48,5396,71,56,25696,56,5964
0.192,17,2,152,1,48,0,48,76,1,48,0,48,76
0.053,17,2,152,2,48,53,48,152,0,0,0,0,0
756.57,2,6,192,6,8,151314,8,192,0,0,0,0,0
11.681,6,1827,1608855,1137,1362,10,1380,1577001,690,421,16,1923,31854
20.505,17,44,14289,23,442,930,1350,10810,21,137,1023,1350,3479
0.406,6,50,22755,29,969,14,1380,17682,21,467,18,1923,5073
1771.074,6,101,9410,66,66,27247,66,5610,35,60,52087,60,3800
1793.163,6,244,35804,152,302,11875,302,26032,92,83,19704,83,9772
1656.239,1,8,448,8,28,236605,28,448,0,0,0,0,0
1771.508,6,99,9234,66,64,27253,65,5574,33,58,55356,59,3660
13.884,6,31,7613,12,155,1262,267,1266,19,371,770,1997,6347
0.016,6,11,3410,6,75,3,75,395,5,2747,4,2747,3015
159.15,17,4,824,2,48,159141,48,152,2,308,159140,308,672
21.216,17,865,556193,860,618,23,1472,555993,5,12,5001,12,200
1743.752,6,94,7151,62,38,28586,205,4424,32,33,56233,98,2727
1770.217,6,103,9514,66,66,27234,66,5610,37,60,49170,60,3904
64.112,17,18,1584,9,48,8012,48,684,9,72,8012,72,900
280.28,6,23,7014,10,181,31142,267,1128,13,670,23352,1400,5886
0.405,6,10,1992,5,288,94,288,508,5,424,55,434,1484
1.621,6,12,1304,6,256,322,256,756,6,304,322,304,548
280.305,6,29,7392,13,158,23358,267,1317,16,603,18685,2036,6075
5.348,6,41,7349,21,218,267,314,3463,20,440,268,1152,3886
0.343,6,21,5000,10,137,38,267,1092,11,577,33,1400,3908
8.713,6,15,2306,9,210,1088,210,908,6,545,1742,904,1398
15.72,17,18,12927,11,956,1565,1350,10832,7,271,2608,1350,2095
0.966,6,11,1727,7,100,161,100,384,4,589,228,1152,1343
0.737,6,20,7238,13,335,61,668,2026,7,1210,117,1946,5212
1788.293,17,83,3480,82,14,22077,14,3444,1,8,0,8,36
180.204,6,22,9371,11,396,62,880,1706,11,1030,18007,1360,7665
1777.546,17,140,11200,70,48,25761,48,5320,70,56,25761,56,5880
1781.44,1,58,4872,0,0,0,0,0,58,56,31253,56,4872
0.612,6,116,87048,51,131,12,232,2569,65,1364,9,1557,84479
59.012,17,2,912,1,308,0,308,336,1,548,0,548,576
1743.062,6,95,7203,63,38,28113,205,4476,32,33,56220,98,2727
1785.859,6,367,25650,213,100,8423,469,14936,154,69,11672,69,10714
5.151,17,4,304,4,48,1717,48,304,0,0,0,0,0
44.827,6,31,8878,13,327,123,1189,2495,18,514,2636,1997,6383
1787.927,1,158,16748,158,78,11388,78,16748,0,0,0,0,0
0.057,17,2,262,1,39,0,39,67,1,167,0,167,195
367.432,6,55,6948,26,109,14690,721,2672,29,146,13115,1448,4276
1738.804,6,99,7192,63,31,28045,31,4292,36,31,49679,31,2900
102.081,6,34,11351,17,769,150,1360,4639,17,547,6370,1360,6712
0.309,6,24,6071,11,181,30,537,1474,13,652,24,1448,4597
83.139,6,47,10557,23,723,1250,1360,4640,24,309,3606,2720,5917
17.442,6,36,5061,20,165,904,267,1645,16,458,1145,1152,3416
0.373,17,3,451,2,39,49,39,134,1,289,0,289,317
1798.862,17,449,39928,404,35,4463,288,25708,45,288,40015,288,14220
541.48,2,6,192,6,8,108296,8,192,0,0,0,0,0
1792.001,6,360,24156,210,88,8574,469,13878,150,69,12026,69,10278
1797.161,6,367,25650,214,99,8437,469,15045,153,69,11822,69,10605
7.648,6,31,11163,17,372,478,873,2574,14,890,577,1516,8589
221.702,1,3,168,3,28,110851,28,168,0,0,0,0,0
300.262,6,38,29085,22,190,14298,444,1925,16,2632,16017,7845,27160
13.913,6,81,24525,40,552,356,1152,18744,41,459,341,1179,5781
102.288,6,24,11061,13,612,75,1360,3613,11,1166,10212,2720,7448
10.555,6,2092,1802518,1180,1432,8,1448,1742042,912,776,11,1448,60476
0.188,6,25,7216,13,155,15,267,1301,12,775,14,4836,5915
1772.78,6,180,15480,120,69,14897,69,8940,60,69,30043,69,6540
1741.467,17,30,6930,30,203,60050,203,6930,0,0,0,0,0
0.53,17,2,152,1,48,0,48,76,1,48,0,48,76
371.553,6,25,1651,17,177,23222,177,1117,8,110,9243,110,534
1.06,6,24,6636,13,350,87,1089,2276,11,783,105,1420,4360
20.672,6,23,5545,12,107,1879,159,1086,11,773,2063,1368,4459
1746.492,1,209,11704,209,28,8396,28,11704,0,0,0,0,0
1749.662,17,12,498,11,14,174966,14,462,1,8,0,8,36
76.866,6,27,8011,11,261,84,467,1365,16,446,5112,1448,6646
2.053,17,2,784,2,364,2053,364,784,0,0,0,0,0
0.018,17,2,383,1,39,0,39,67,1,288,0,288,316
1.198,17,12,6498,6,615,239,1350,3860,6,411,161,1350,2638
0.064,17,2,178,1,29,0,29,57,1,93,0,93,121
65.963,6,39,17304,21,1015,3298,1448,9270,18,590,3870,1448,8034
8.86,17,4,1344,4,308,2953,308,1344,0,0,0,0,0
32.455,6,9,392,8,0,4636,0,348,1,0,0,0,44
1775.411,6,244,30337,124,100,14434,721,13635,120,297,14916,2828,16702
0.871,6,14,4308,7,85,145,85,457,7,869,145,1448,3851
1798.685,17,178,13884,178,50,10162,50,13884,0,0,0,0,0
0.156,6,2,149,1,0,0,0,40,1,69,0,69,109
1741.179,6,87,6322,58,31,30547,31,3915,29,31,62183,31,2407
1.317,6,50,19033,27,873,50,1360,13337,23,433,51,1360,5696
1.289,6,25,8056,12,164,101,267,1288,13,869,93,1408,6768
177.464,6,73,52726,48,1205,3775,1368,44690,25,841,2573,2736,8036
248.414,6,35,12145,17,704,15525,1408,4450,18,676,14612,2816,7695
12.549,6,1822,1614900,1134,1370,11,1380,1582206,688,421,18,1923,32694
0.287,6,28,9123,13,247,23,624,1672,15,832,20,1408,7451
1.581,6,47,18662,27,855,60,1360,13086,20,433,71,1360,5576
0.202,17,2,144,1,36,0,36,64,1,52,0,52,80
1782.158,6,357,22629,208,69,8609,69,12460,149,69,12039,69,10169
1782.773,17,83,3480,82,14,22009,14,3444,1,8,0,8,36
0.187,17,2,180,1,30,0,30,58,1,94,0,94,122
280.32,6,29,7392,13,158,23360,267,1317,16,603,18683,2036,6075
1771.958,6,101,9344,66,65,27260,65,5577,35,59,52113,59,3767
240.195,6,54,17482,29,732,8578,1408,14692,25,185,10007,580,2790
267.114,6,18,5839,10,784,29679,1360,3538,8,247,38123,272,2301
16.038,6,2703,2523970,1737,1374,9,1408,2469074,966,931,16,2816,54896
1797.721,17,439,38472,396,34,4551,288,24884,43,288,41925,288,13588
1764.39,1,138,7728,138,28,12878,28,7728,0,0,0,0,0
181.834,6,18,1978,11,177,18162,177,1288,7,110,30270,110,690
0.29,17,6,2123,6,325,58,355,2123,0,0,0,0,0
1785.981,6,104,8308,68,64,26656,64,4896,36,58,51025,58,3412
1795.761,6,270,32318,109,128,16626,1360,15171,161,133,11222,1942,17147
0.133,6,20,4906,11,89,13,147,948,9,870,15,1659,3958
1786.139,6,354,22440,207,69,8670,69,12420,147,69,12233,69,10020
0.257,6,22,4467,11,165,25,456,1394,11,498,24,888,3073
17.945,17,17,8081,9,587,2243,1350,5535,8,290,2532,1350,2546
10.922,6,19,3442,12,210,992,210,1088,7,664,1820,904,2354
1653.399,17,60,2520,60,14,28023,14,2520,0,0,0,0,0
11.598,6,25,8453,13,275,966,275,1078,12,983,763,1420,7375
1788.671,17,87,3648,86,14,21043,14,3612,1,8,0,8,36
1772.015,6,180,15480,120,69,14890,69,8940,60,69,30030,69,6540
0.216,17,12,6417,6,615,43,1350,3860,6,398,30,1350,2557
1048.009,6,82,8954,48,71,22298,721,4157,34,112,28884,1448,4797
1787.968,6,356,22520,208,69,8637,69,12460,148,69,12162,69,10060
337.836,6,85,30446,43,586,8043,1402,11042,42,819,8239,2804,19404
1787.268,17,85,3564,84,14,21533,14,3528,1,8,0,8,36
29.326,6,14,2626,7,152,4887,267,742,7,400,4845,1179,1884
1783.491,17,83,3480,82,14,22018,14,3444,1,8,0,8,36
8.895,6,79,24781,41,563,222,1152,19120,38,459,233,1179,5661
280.261,6,29,7392,13,158,23355,267,1317,16,603,18682,2036,6075
0.051,6,7,759,3,69,8,69,189,4,205,16,341,570
1785.546,17,140,11200,70,48,25877,48,5320,70,56,25877,56,5880
1.169,17,4,248,3,30,584,30,174,1,46,0,46,74
1741.093,6,88,6374,58,31,30545,31,3915,30,31,60036,31,2459
85.137,6,39,9405,17,290,1933,1189,2724,22,445,4053,1460,6681
9.746,6,83,24845,42,560,237,1152,19048,41,461,236,1179,5797
0.1,17,2,705,2,324,100,355,705,0,0,0,0,0
1773.729,6,180,15480,120,69,14905,69,8940,60,69,30056,69,6540
373.445,6,18,1242,14,180,28726,180,916,4,110,20072,110,326
300.086,6,13,963,7,176,50013,176,572,6,83,60016,83,391
14.445,6,14,2245,8,211,2063,211,846,6,545,2886,904,1399
21.87,6,9,527,5,43,5467,43,311,4,0,7289,0,216
0.478,6,12,1653,6,288,92,288,548,6,426,56,434,1105
0.004,17,2,599,1,48,0,48,76,1,495,0,495,523
1776.486,6,102,8296,68,65,26514,65,4930,34,59,53830,59,3366
1787.949,6,104,8308,68,64,26685,64,4896,36,58,51082,58,3412
1681.287,17,14,1036,7,30,280210,30,406,7,62,280211,62,630
1.711,17,3,468,3,128,855,128,468,0,0,0,0,0
5.037,17,2,2200,2,1072,5037,1072,2200,0,0,0,0,0
7.45,6,1463,1290987,848,1433,8,1448,1249463,615,776,11,1448,41524
1682.731,17,16,1265,8,30,240382,37,471,8,71,240382,136,794
176.272,2,2,64,2,8,176272,8,64,0,0,0,0,0
1.351,6,49,19799,27,930,51,1460,14143,22,433,55,1460,5656
214.038,1,6,336,6,28,42807,28,336,0,0,0,0,0
1.25,6,47,18488,27,842,48,1360,12912,20,433,56,1360,5576
1770.1,1,76,6384,0,0,0,0,0,76,56,23601,56,6384
5.017,17,4,288,2,36,4999,36,128,2,52,5004,52,160
0.578,17,4,768,2,39,568,39,134,2,289,58,289,634
721.915,2,7,224,7,8,120319,8,224,0,0,0,0,0
1.347,6,51,19866,29,925,48,1440,14165,22,400,55,1440,5701
1790.964,6,362,22898,210,69,8569,69,12678,152,69,11860,69,10220
10.96,6,20,4350,11,275,1096,275,998,9,992,772,1440,3352
31.861,6,52,40323,20,130,1676,313,1431,32,1329,1026,1418,38892
1745.134,6,97,7307,63,38,28147,205,4476,34,33,52870,98,2831
0.729,6,155,105675,84,1303,8,1420,98532,71,427,10,1420,7143
1620.029,1,7,392,7,28,270004,28,392,0,0,0,0,0
1781.216,17,142,11360,71,48,25445,48,5396,71,56,25445,56,5964
1.854,6,2,142,1,0,0,0,40,1,62,0,62,102
1767.275,6,226,39176,140,304,12714,304,28628,86,83,20791,83,10548
0.371,6,13,1693,7,288,61,288,588,6,284,39,434,1105
3.544,6,35,8816,18,398,208,1216,2382,17,478,213,2720,6434
1792.883,1,228,12768,228,28,7898,28,12768,0,0,0,0,0
5.667,6,44,8369,22,227,269,314,4062,22,489,258,1179,4307
1771.256,6,99,9240,66,65,27250,65,5577,33,59,55348,59,3663
6.402,6,15,6416,6,126,1280,126,446,9,1373,800,1448,5970
352.115,6,21,6659,3,112,45,112,240,18,355,20711,1460,6419
1774.708,6,180,15480,120,69,14913,69,8940,60,69,30072,69,6540
1744.657,6,94,7151,62,38,28600,205,4424,32,33,56269,98,2727
0.573,6,10,1669,6,551,114,947,1346,4,159,191,159,323
1351.236,6,171,19173,66,175,20788,1041,11421,105,62,12992,143,7752
3.059,17,3,228,2,48,2982,48,152,1,48,0,48,76
1772.756,6,180,15480,120,69,14897,69,8940,60,69,30044,69,6540
277.333,6,30,7432,13,158,23111,267,1317,17,543,17330,1400,6115
1.441,6,49,19611,27,917,55,1460,13955,22,476,59,2615,5656
240.375,6,45,8520,24,449,10450,1418,5752,21,208,12018,580,2768
1799.393,17,766,46192,766,32,2352,37,46192,0,0,0,0,0
0.016,17,2,189,1,30,0,30,58,1,103,0,103,131
14.944,6,14,2243,8,210,2123,210,844,6,545,2988,905,1399
0.043,6,2,129,1,0,0,0,40,1,37,0,37,89
225.997,6,62,15600,34,168,6848,721,4911,28,637,2628,1414,10689
0.507,17,3,451,2,39,287,39,134,1,289,0,289,317
1771.988,6,180,15480,120,69,14890,69,8940,60,69,30031,69,6540
1681.445,1,24,1344,24,28,73106,28,1344,0,0,0,0,0
0.017,17,2,299,1,59,0,59,87,1,184,0,184,212
36.51,6,47,9124,22,410,748,917,2216,25,327,1515,1460,6908
359.791,6,24,2134,18,180,21164,180,1484,6,110,12124,110,650
2.804,17,24,8180,10,362,311,1350,3903,14,277,125,1350,4277
1.411,6,38,8254,19,321,78,1164,2718,19,433,68,1440,5536
171.764,6,25,10749,13,754,54,1360,3569,12,1114,15602,2720,7180
0.1,6,10,2031,6,732,19,1304,1708,4,159,32,159,323
8.301,1,5,140,5,0,0,0,140,0,0,0,0,0
356.514,6,24,3827,18,242,20971,242,1186,6,580,36007,1408,2641
1022.735,2,9,288,9,8,127841,8,288,0,0,0,0,0
1090.762,17,216,16416,216,48,5073,48,16416,0,0,0,0,0
15.977,6,2295,1965227,1302,1416,12,1448,1901959,993,776,15,1448,63268
1.582,6,38,8360,19,338,87,1270,2824,19,433,76,1460,5536
1794.511,6,356,22520,208,69,8669,69,12460,148,69,12205,69,10060
0.764,17,2,144,1,36,0,36,64,1,52,0,52,80
15.622,6,2648,2481136,1712,1371,9,1408,2427800,936,931,16,2801,53336
1750.983,17,12,498,11,14,175098,14,462,1,8,0,8,36
300.634,6,44,8926,22,291,14315,786,2137,22,346,628,2128,6789
0.091,17,4,2876,2,689,91,1350,1434,2,693,55,1350,1442
57.913,6,45,13010,19,1026,3217,1460,6951,26,263,2084,1460,6059
1769.905,6,104,9648,68,65,26416,65,5758,36,59,50564,59,3890
1787.297,6,102,8296,68,65,26676,65,4930,34,59,54157,59,3366
1796.878,17,448,39896,403,35,4469,288,25676,45,288,40018,288,14220
3.418,6,27,8827,16,282,227,578,1490,11,984,323,1452,7337
0.468,6,111,72856,61,1282,7,1420,66565,50,427,9,1420,6291
0.0,6,3,3040,1,0,0,0,40,2,1448,0,1448,3000
1.358,6,23,7952,12,164,105,267,1288,11,1216,116,3859,6664
1.698,6,18,3257,10,99,167,182,924,8,477,215,1343,2333
1705.808,17,144,12642,132,30,13021,37,7698,12,384,155072,463,4944
1799.362,17,449,39928,404,35,4464,288,25708,45,288,40022,288,14220
0.523,6,24,6041,13,108,43,147,959,11,773,50,1608,5082
0.962,6,10,1687,7,100,160,100,384,3,1179,350,1179,1303
0.489,17,3,451,2,39,467,39,134,1,289,0,289,317
0.023,6,12,3462,7,75,3,75,447,5,1373,4,1448,3015
5.007,17,4,558,2,36,5001,36,128,2,187,4996,187,430
251.925,2,2,64,2,8,251925,8,64,0,0,0,0,0
1773.226,6,180,15480,120,69,14901,69,8940,60,69,30051,69,6540
1784.353,6,106,8574,68,65,26632,65,4930,38,59,48222,59,3644
113.276,6,25,9086,12,661,78,1360,3180,13,767,9425,1360,5906
4.86,6,40,7309,20,218,255,314,3423,20,440,241,1152,3886
0.173,17,10,7511,6,879,34,1350,5443,4,489,33,1350,2068
11.802,6,1775,1621646,1145,1363,10,1420,1592107,630,475,18,1883,29539
1720.665,17,13,534,11,14,172047,14,462,2,8,1720471,8,72
2.389,6,26,8636,13,164,183,267,1352,13,942,183,3819,7284
15.932,17,12,5322,6,490,3170,1350,3110,6,340,3170,1350,2212
5.692,6,39,7285,20,218,299,314,3423,19,516,302,1179,3862
5.708,6,504,456891,328,1331,16,1368,443075,176,931,31,2841,13816
9.903,6,1540,1356120,960,1362,10,1380,1328678,580,421,17,1923,27442
123.485,17,10,13760,10,1348,13720,1348,13760,0,0,0,0,0
0.767,6,25,6082,13,108,63,147,959,12,773,64,1608,5123
0.137,17,4,352,2,37,7,37,130,2,83,132,89,222
0.097,6,3,156,0,0,0,0,0,3,0,0,0,156
3.344,17,16,2040,16,99,222,351,2040,0,0,0,0,0
1741.665,6,87,6322,58,31,30555,31,3915,29,31,62201,31,2407
1786.401,17,87,3648,86,14,21016,14,3612,1,8,0,8,36
63.13,6,14,5631,4,112,21037,112,280,10,706,7012,1460,5351
0.011,17,2,162,1,34,0,34,62,1,72,0,72,100
4.058,17,8,1176,4,48,1349,48,304,4,190,1349,308,872
1773.877,6,204,22330,130,75,13750,267,10057,74,132,24293,1460,12273
28.379,6,20,4464,9,341,3547,722,1489,11,342,2815,1448,2975
73.301,6,32,8150,8,175,500,267,1379,24,305,3182,1460,6771
1786.081,17,142,11360,71,48,25515,48,5396,71,56,25515,56,5964
17.05,6,11,5594,4,112,5683,112,280,7,1005,2828,3417,5314
1794.632,17,266,55586,266,180,6772,379,55586,0,0,0,0,0
107.266,17,6,528,3,60,53632,60,264,3,60,53632,60,264
1771.866,6,180,15480,120,69,14889,69,8940,60,69,30030,69,6540
60.022,17,12,912,12,48,5456,48,912,0,0,0,0,0
1740.753,17,30,7050,30,207,60025,207,7050,0,0,0,0,0
1783.5,17,73,3060,72,14,25119,14,3024,1,8,0,8,36
1682.616,1,15,870,15,30,120186,30,870,0,0,0,0,0
1754.442,6,175,13027,93,80,19070,208,8848,82,31,21657,31,4179
1.372,6,49,18884,27,865,52,1360,13228,22,433,56,1360,5656
0.541,6,12,1653,6,288,103,288,548,6,426,65,434,1105
1744.654,2,19,608,19,8,96925,8,608,0,0,0,0,0
17.366,6,1462,1344926,884,1437,19,1448,1306350,578,776,29,1448,38576
1.479,6,239,183623,107,287,13,906,7812,132,1330,11,1418,175811
5.025,17,4,288,2,36,5003,36,128,2,52,5007,52,160
1744.746,2,29,928,29,8,62312,8,928,0,0,0,0,0
1.643,6,49,19314,27,896,63,1360,13658,22,433,67,1360,5656
0.126,6,9,1339,5,145,31,145,349,4,826,34,826,990
0.001,6,3,120,2,0,1,0,80,1,0,0,0,40
245.016,6,478,963946,76,168,3266,577,5692,402,2434,610,11216,958254
71.097,17,4,352,2,60,71096,60,176,2,60,71095,60,176
80.056,6,29,13436,15,488,355,1360,3075,14,1223,6148,2568,10361
299.548,6,6,364,4,31,99849,31,222,2,31,299534,31,142
33.536,6,30,5041,15,154,2395,722,1858,15,399,2382,2026,3183
1690.778,17,14,1036,7,30,281790,30,406,7,62,281788,62,630
0.0,6,3,1617,1,0,0,0,40,2,1473,0,1473,1577
11.578,6,22,6817,12,275,1052,275,1038,10,1073,728,1440,5779
0.933,6,52,13885,24,553,40,1429,4856,28,438,33,1460,9029
280.565,6,30,7432,13,158,23380,267,1317,17,603,17529,2076,6115
280.449,6,29,7392,13,158,23370,267,1317,16,603,18694,2760,6075
65.148,17,8,704,4,48,21712,48,304,4,72,21712,72,400
11.582,6,23,8086,13,282,965,721,2216,10,1822,1090,2880,5870
11.734,6,42,21296,22,702,558,1360,5187,20,1019,610,1696,16109
64.996,1,4,224,4,28,21665,28,224,0,0,0,0,0
165.685,17,4,240,2,32,165683,32,120,2,32,165684,32,120
0.314,17,2,193,1,43,0,43,71,1,94,0,94,122
0.079,17,2,650,1,308,0,308,336,1,286,0,286,314
4.716,6,38,7229,20,218,248,314,3423,18,513,262,1179,3806
0.515,17,3,451,2,39,365,39,134,1,289,0,289,317
71.427,17,4,352,2,60,71426,60,176,2,60,71426,60,176
1798.226,6,410,30005,229,114,7886,469,18211,181,69,9988,69,11794
0.507,6,26,8991,13,252,42,647,1692,13,945,38,1408,7299
54.286,6,28,7217,13,155,4523,267,1306,15,482,3877,1997,5911
1682.77,17,14,1036,7,30,280455,30,406,7,62,280453,62,630
300.42,6,73,55033,47,162,6530,230,3406,26,2284,12016,7965,51627
1743.209,1,15,840,15,28,124514,28,840,0,0,0,0,0
6.638,6,23,4478,12,213,603,597,1689,11,441,646,1448,2789
1.399,6,51,23808,30,997,48,1360,18192,21,476,60,2715,5616
1799.566,17,449,39928,404,35,4465,288,25708,45,288,40021,288,14220
301.07,6,41,10642,23,606,13685,1380,4664,18,476,539,1521,5978
782.12,2,8,256,8,8,111731,8,256,0,0,0,0,0
0.764,6,4,298,1,0,0,0,40,3,69,361,69,258
1783.812,6,367,25581,214,100,8374,469,14976,153,69,11735,69,10605
3.299,17,4,1556,4,361,1099,361,1556,0,0,0,0,0
114.473,6,26,13903,14,836,67,1460,5612,12,1114,10390,1460,8291
1742.467,6,160,11013,85,65,20743,208,7114,75,31,23543,31,3899
240.577,6,47,8603,24,449,10459,1418,5752,23,205,10934,580,2851
1786.451,6,102,8334,68,65,26663,66,4949,34,59,54132,60,3385
1768.927,1,76,6384,76,56,23585,56,6384,0,0,0,0,0
1788.737,6,357,22629,208,69,8641,69,12460,149,69,12085,69,10169
1679.565,17,12,498,11,14,167956,14,462,1,8,0,8,36
0.008,17,2,223,1,36,0,36,64,1,131,0,131,159
17.023,6,20,6376,8,154,2431,267,792,12,637,1513,1917,5584
0.264,17,2,152,1,48,0,48,76,1,48,0,48,76
1792.96,17,142,11360,71,48,25613,48,5396,71,56,25613,56,5964
300.873,6,49,10486,25,433,12536,910,3258,24,329,582,2720,7228
1783.835,6,356,22520,208,69,8617,69,12460,148,69,12134,69,10060
7.922,17,6,528,3,48,3954,48,228,3,72,3954,72,300
108.697,1,4,224,4,28,36232,28,224,0,0,0,0,0
1788.065,6,201,38629,115,360,15684,1273,24786,86,179,21035,1452,13843
11.325,6,27,11433,13,275,943,275,1078,14,1087,836,1440,10355
11.624,17,4,304,4,48,3874,48,304,0,0,0,0,0
11.838,6,23,9480,13,275,986,275,1078,10,1598,1046,2840,8402
223.84,6,124,96450,80,1279,2833,1408,86043,44,811,2645,3847,10407
61.667,1,24,2496,0,0,0,0,0,24,76,2681,76,2496
173.187,6,29,7392,13,158,14432,267,1317,16,603,11542,2036,6075
1795.962,17,448,39896,403,35,4467,288,25676,45,288,40019,288,14220
0.027,6,20,9985,10,125,3,125,653,10,1257,3,1448,9332
823.595,17,315,58997,178,178,4652,1209,36802,137,134,293,1252,22195
2.629,6,2,1175,1,0,0,0,40,1,1095,0,1095,1135
280.25,6,27,7312,13,158,23354,267,1317,14,775,21555,4836,5995
60.892,17,3,228,3,48,30446,48,228,0,0,0,0,0
60.402,6,9,774,5,180,15100,180,448,4,110,20062,110,326
1.784,17,25,6207,10,257,198,1350,2853,15,195,115,1350,3354
366.363,6,25,1651,17,177,22897,177,1117,8,110,9171,110,534
214.144,1,2,270,2,107,214144,121,270,0,0,0,0,0
0.137,17,2,2382,2,1163,137,1163,2382,0,0,0,0,0
0.292,6,4,1037,2,0,223,0,104,2,853,73,853,933
1797.718,17,447,39580,403,35,4471,288,25676,44,288,40950,288,13904
257.127,17,4,240,2,32,257126,32,120,2,32,257126,32,120
1787.096,6,106,8388,68,64,26673,64,4896,38,58,48297,58,3492
0.086,17,2,672,2,308,86,308,672,0,0,0,0,0
2.211,6,2,176,0,0,0,0,0,2,96,2211,96,176
0.013,17,2,393,1,33,0,33,61,1,304,0,304,332
543.759,1,16,1696,16,78,36250,78,1696,0,0,0,0,0
0.124,17,2,2384,2,1164,124,1164,2384,0,0,0,0,0
0.136,17,2,136,1,32,0,32,60,1,48,0,48,76
153.461,6,50,10681,22,216,7307,1189,3269,28,298,5683,1420,7412
1786.644,6,106,8584,69,66,26274,66,5004,37,60,49626,60,3580
577.644,6,92,13282,48,115,12107,721,5750,44,360,13429,2007,7532
1628.622,1,7,392,7,28,271437,28,392,0,0,0,0,0
1774.131,6,182,15698,120,69,14908,69,8940,62,69,29076,69,6758
0.0,1,2,112,2,28,0,28,112,0,0,0,0,0
1795.081,17,449,39928,404,35,4454,288,25708,45,288,40021,288,14220
1785.727,17,140,11200,70,48,25880,48,5320,70,56,25880,56,5880
0.01,17,2,460,1,64,0,64,92,1,340,0,340,368
55.275,17,2,72,1,8,0,8,36,1,8,0,8,36
300.284,6,30,11854,17,592,18767,1402,4445,13,1120,20016,2804,7409
280.299,6,30,7432,13,158,23358,267,1317,17,543,17511,1400,6115
130.193,17,4,1344,4,308,43397,308,1344,0,0,0,0,0
0.434,6,61,25625,33,1054,13,1380,18295,28,515,14,1923,7330
10.94,6,18,5610,10,275,1215,275,958,8,1440,856,1440,4652
421.128,2,6,192,6,8,84225,8,192,0,0,0,0,0
1756.359,6,107,6374,60,27,29768,27,3525,47,27,38180,27,2849
18.368,17,44,14452,22,460,872,1350,10753,22,140,872,1350,3699
0.081,17,4,608,2,60,0,60,176,2,188,0,188,432
378.07,2,4,128,4,8,126023,8,128,0,0,0,0,0
0.352,6,12,1653,6,288,67,288,548,6,426,37,434,1105
2.176,17,2,677,1,300,0,300,328,1,321,0,321,349
280.314,6,29,7392,13,158,23359,267,1317,16,603,18685,1400,6075
1797.996,6,227,24023,113,80,16053,721,10484,114,235,15909,1440,13539
1740.512,17,30,31620,30,1026,60017,1026,31620,0,0,0,0,0
0.03,17,2,214,1,39,0,39,67,1,119,0,119,147
1.291,6,47,16376,25,807,53,1360,10720,22,433,53,1360,5656
1.415,6,25,8056,12,164,110,267,1288,13,869,100,1368,6768
1799.516,1,15,840,15,28,128536,28,840,0,0,0,0,0
0.163,6,46,21068,26,1070,6,1420,16047,20,467,8,1883,5021
0.99,6,25,5192,12,477,90,581,3044,13,285,81,580,2148
300.593,6,46,9101,23,315,13663,882,2273,23,327,604,1460,6828
4.49,6,38,7245,20,218,236,314,3423,18,516,248,1179,3822
1.312,6,49,18691,27,851,50,1360,13035,22,476,54,2715,5656
1744.016,6,95,7203,63,38,28129,205,4476,32,33,56247,98,2727
6.562,6,45,8425,23,227,298,314,4102,22,491,300,1179,4323
11.025,6,19,4362,11,275,1102,275,998,8,1010,891,2840,3364
374.601,6,27,1767,18,177,22035,177,1181,9,110,8674,110,586
1.489,6,25,8056,12,164,117,267,1288,13,869,108,1448,6768
1.353,6,25,8056,12,164,105,267,1288,13,1014,96,2491,6768
1.016,6,29,8200,15,222,60,540,1964,14,944,64,1591,6236
0.839,6,2,100,1,0,0,0,60,1,0,0,0,40
1778.595,1,58,4872,58,56,31203,56,4872,0,0,0,0,0
240.234,6,54,15885,28,683,8896,1418,13078,26,206,9608,580,2807
0.068,6,4,160,2,0,2,0,80,2,0,20,0,80
277.616,6,176,132345,107,1291,2619,1408,119245,69,731,1731,3847,13100
280.493,6,29,7392,13,158,23374,267,1317,16,603,18692,2076,6075
1.569,6,51,19049,29,864,56,1360,13336,22,437,65,2715,5713
50.818,6,22,7016,5,154,12704,267,672,17,435,3169,1420,6344
379.885,17,6,2248,6,346,75977,548,2248,0,0,0,0,0
300.4,6,33,18762,18,417,17670,1114,2650,15,1393,3643,4224,16112
240.25,6,53,15653,29,706,8580,1402,12815,24,197,10445,580,2838
0.01,17,2,452,1,48,0,48,76,1,348,0,348,376
1797.905,17,449,39928,404,35,4461,288,25708,45,288,40020,288,14220
240.358,6,45,9161,21,524,12017,1418,5817,24,232,10449,617,3344
2.07,6,29,10373,17,368,129,837,1789,12,1012,180,1420,8584
1623.909,1,14,784,14,28,124916,28,784,0,0,0,0,0
0.027,17,2,116,1,30,0,30,58,1,30,0,30,58
7.157,6,1461,1334815,916,1379,7,1408,1301811,545,776,12,1408,33004
0.036,17,2,164,1,46,0,46,74,1,62,0,62,90
0.097,6,2,80,1,0,0,0,40,1,0,0,0,40
0.318,17,2,157,1,31,0,31,59,1,70,0,70,98
1707.217,1,8,448,8,28,243888,28,448,0,0,0,0,0
1774.821,17,134,10712,68,48,26489,48,5168,66,56,27304,56,5544
21.941,6,20,3130,12,183,1994,517,1561,8,381,3130,499,1569
129.143,6,124,47188,59,717,2226,1152,38960,65,401,2013,1179,8228
1104.347,1,33,2772,33,56,34510,56,2772,0,0,0,0,0
1301.843,6,74,6018,50,49,26568,205,3884,24,36,49895,98,2134
142.595,6,125,97711,82,1258,1760,1368,87347,43,738,1782,2519,10364
1.002,6,16,4454,8,111,143,111,543,8,869,143,1448,3911
5.004,17,4,288,2,36,5003,36,128,2,52,4966,52,160
10.953,6,22,5998,11,275,1095,275,998,11,758,872,1420,5000
1.374,6,50,19321,27,893,52,1460,13625,23,433,53,1460,5696
115.883,6,215,162046,113,336,1034,339,7290,102,1573,1147,5632,154756
27.167,17,16,1408,8,48,3879,48,608,8,72,3878,72,800
42.958,6,36,8455,18,410,509,882,1982,18,478,2518,2720,6473
1791.606,1,276,15456,276,28,6514,28,15456,0,0,0,0,0
0.399,6,49,20076,27,988,15,1380,14954,22,421,17,1923,5122
8.182,6,23,8896,12,539,77,546,2171,11,697,818,961,6725
0.162,17,2,152,1,48,0,48,76,1,48,0,48,76
8.647,6,25,8255,14,315,665,1091,2303,11,1072,842,2736,5952
1772.074,6,101,9344,66,65,27262,65,5577,35,59,52116,59,3767
0.056,17,4,420,2,33,0,33,122,2,121,1,145,298
1780.637,17,236,79296,236,308,7577,308,79296,0,0,0,0,0
0.087,17,2,362,1,46,0,46,74,1,260,0,260,288
11.857,6,1745,1627180,1149,1364,10,1432,1598921,596,427,19,1432,28259
0.012,17,2,204,1,34,0,34,62,1,114,0,114,142
1790.86,17,144,11520,72,48,25223,48,5472,72,56,25222,56,6048
1.194,2,2,64,2,8,1194,8,64,0,0,0,0,0
0.916,6,11,1727,7,100,152,100,384,4,589,215,1152,1343
16.285,17,20,13543,9,610,2031,1350,5750,11,680,1624,1350,7793
0.284,17,2,144,1,36,0,36,64,1,52,0,52,80
62.256,6,38,19051,18,541,3662,1114,2605,20,1026,3263,2255,16446
240.673,6,42,9123,19,272,13370,681,2918,23,555,10931,1498,6205
1781.895,6,180,15480,117,69,15361,69,8682,63,69,28733,69,6798
1792.512,6,355,22618,205,69,8786,69,12340,150,69,12029,69,10278
1793.983,6,356,22520,208,69,8666,69,12460,148,69,12203,69,10060
280.393,6,30,7432,13,158,23366,267,1317,17,543,17518,1400,6115
360.856,6,21,1688,16,180,24057,180,1200,5,110,15099,110,488
24.951,6,20,3130,12,183,2268,517,1561,8,381,3559,499,1569
1597.192,6,143,17544,88,82,18358,267,7342,55,159,20686,1917,10202
1740.704,17,30,31680,30,1028,60024,1028,31680,0,0,0,0,0
0.198,17,2,214,1,39,0,39,67,1,119,0,119,147
0.37,6,10,968,5,256,89,256,460,5,304,89,304,508
9.942,6,85,26277,43,557,236,1152,20115,42,447,235,1179,6162
109.881,6,236,196859,146,1160,757,1402,35736,90,2334,1234,9311,161123
11.784,6,5,264,3,0,5892,0,160,2,0,1023,0,104
1772.352,6,180,15480,120,69,14893,69,8940,60,69,30035,69,6540
1799.874,17,767,46327,767,32,2349,37,46327,0,0,0,0,0
75.098,6,21,860,10,0,6024,0,404,11,0,7509,0,456
124.4,17,6,528,3,60,62199,60,264,3,60,62199,60,264
1772.75,6,180,15480,120,69,14897,69,8940,60,69,30042,69,6540
0.162,6,24,7660,12,176,14,334,1339,12,1137,13,1648,6321
90.134,6,24,8161,12,418,63,953,1780,12,736,8182,1360,6381
0.02,6,14,4895,8,134,2,137,693,6,1298,3,2278,4202
1795.943,17,448,39896,403,35,4467,288,25676,45,288,40013,288,14220
280.344,6,28,7352,12,158,25485,267,1277,16,603,18682,1400,6075
1791.428,1,250,14000,250,28,7194,28,14000,0,0,0,0,0
0.425,6,7,371,4,0,141,0,204,3,7,102,7,167
1.406,6,24,8004,12,164,108,267,1288,12,1014,108,2491,6716
1.372,6,47,18755,26,928,54,1440,13139,21,433,59,1440,5616
0.019,17,4,420,2,33,12,33,122,2,121,11,145,298
19.988,17,37,7374,16,165,1330,1350,3088,21,176,997,1350,4286
1745.976,6,99,7485,64,38,27713,205,4559,35,33,51340,98,2926
0.92,6,52,13869,24,551,40,1429,4840,28,438,33,1460,9029
43.725,17,34,9743,15,351,3120,1350,5685,19,185,2427,1350,4058
323.115,6,18,1704,2,106,14500,106,194,16,76,21540,90,1510
31.415,6,6,264,1,0,0,0,44,5,0,7500,0,220
0.05,17,2,384,1,32,0,32,60,1,296,0,296,324
9.678,6,56,21266,31,789,322,1360,15478,25,433,394,1360,5788
1741.854,6,87,6322,58,31,30558,31,3915,29,31,62208,31,2407
314.206,6,18,6346,2,106,500,106,194,16,393,20946,1420,6152
0.297,17,2,198,1,63,0,63,91,1,79,0,79,107
14.859,6,26,13075,12,296,1350,826,1967,14,1318,1114,3151,11108
378.3,2,3,96,3,8,189150,8,96,0,0,0,0,0
1.601,6,37,8212,19,320,88,1162,2716,18,476,82,2720,5496
1.263,6,40,11338,22,547,60,1360,5842,18,529,63,4075,5496
1.067,6,17,5898,10,290,118,517,1109,7,1102,175,1418,4789
1795.318,17,447,39864,402,35,4477,288,25644,45,288,40018,288,14220
0.046,17,4,284,2,32,0,32,120,2,54,36,60,164
5.832,6,40,7309,21,218,291,314,3463,19,513,308,1179,3846
281.704,17,4,1320,4,302,93901,308,1320,0,0,0,0,0
0.191,6,17,6476,9,137,23,182,763,8,1057,26,1408,5713
233.633,6,31,30112,19,519,12979,1408,3060,12,3302,21238,9824,27052
1797.762,17,449,39928,404,35,4460,288,25708,45,288,40019,288,14220
0.395,6,7,295,4,0,131,0,164,3,7,100,7,131
1.423,6,22,5040,11,137,142,267,1132,11,692,127,1467,3908
1667.548,1,7,742,7,78,277924,78,742,0,0,0,0,0
0.042,17,2,412,1,40,0,40,68,1,316,0,316,344
1799.925,6,144,9271,79,52,23075,208,5772,65,31,27604,31,3499
3.488,2,2,64,2,8,3488,8,64,0,0,0,0,0
0.701,6,24,6473,13,315,57,913,2099,11,786,68,1452,4374
7.71,6,14,1247,7,222,1283,222,728,7,231,1283,231,519
1786.854,17,142,11360,71,48,25525,48,5396,71,56,25525,56,5964
0.463,6,16,4010,10,75,51,75,603,6,1029,92,1500,3407
1750.415,17,12,498,11,14,175041,14,462,1,8,0,8,36
1655.564,1,50,4200,50,56,33787,56,4200,0,0,0,0,0
5.605,6,39,7285,20,218,295,314,3423,19,516,298,1179,3862
240.245,6,58,18245,29,751,8579,1402,15038,29,211,8579,580,3207
0.225,6,22,5040,11,137,22,267,1132,11,692,21,1467,3908
530.928,1,3,168,3,28,265464,28,168,0,0,0,0,0
771.251,6,68,8455,43,79,18363,722,4231,25,171,24380,2328,4224
0.025,6,3,120,2,0,25,0,80,1,0,0,0,40
1798.468,1,77,6468,0,0,0,0,0,77,56,23664,56,6468
0.86,6,20,5966,11,287,86,562,1306,9,716,96,1420,4660
0.116,17,2,157,1,31,0,31,59,1,70,0,70,98
54.405,6,26,7137,13,155,4533,267,1306,13,589,4533,4837,5831
1785.799,17,142,11360,71,48,25511,48,5396,71,56,25511,56,5964
166.452,6,35,19939,16,579,54,1460,3002,19,1243,9239,2374,16937
2.776,6,2,88,2,0,0,0,88,0,0,0,0,0
300.355,6,32,18581,15,391,21453,1018,2354,17,1179,2134,1448,16227
0.544,6,27,9049,13,205,45,633,1709,14,941,39,1368,7340
1798.736,17,142,11360,71,48,25696,48,5396,71,56,25696,56,5964
1775.034,6,180,15480,120,69,14916,69,8940,60,69,30076,69,6540
0.952,17,3,1164,3,360,476,360,1164,0,0,0,0,0
69.154,6,67,24933,33,704,2155,1360,16848,34,610,2089,1360,8085
0.742,17,21,9742,10,435,78,1350,4631,11,436,70,1350,5111
0.006,17,2,511,1,33,0,33,61,1,422,0,422,450
1681.736,17,14,1036,7,30,280287,30,406,7,62,280287,62,630
27.251,6,38,8465,20,184,1434,722,2284,18,908,1588,2760,6181
316.055,6,218,174464,135,1336,2358,1448,156827,83,604,1827,1448,17637
2.345,6,14,2351,8,188,335,245,700,6,703,419,1152,1651
0.079,17,2,144,1,36,0,36,64,1,52,0,52,80
0.994,17,2,685,1,308,0,308,336,1,321,0,321,349
0.207,17,2,152,1,48,0,48,76,1,48,0,48,76
1793.217,6,133,9123,74,63,24564,208,5709,59,31,30910,31,3414
1772.958,1,58,4872,58,56,31104,56,4872,0,0,0,0,0
1799.312,1,59,4956,59,56,31022,56,4956,0,0,0,0,0
0.841,6,64,30643,36,1056,24,1380,23728,28,470,29,1380,6915
10.423,6,83,25090,41,568,260,1152,19269,42,413,248,1152,5821
1040.171,17,56,18816,56,308,18912,308,18816,0,0,0,0,0
0.036,17,4,420,2,33,32,33,122,2,121,31,145,298
1.645,6,31,6152,16,138,109,267,1613,15,562,111,1452,4539
1253.692,17,14,1117,7,31,208945,37,413,7,72,208946,136,704
0.964,17,4,624,2,64,962,64,184,2,192,844,192,440
0.82,6,6,319,3,0,410,0,152,3,7,256,7,167
62.958,6,20,9181,11,514,78,1236,2014,9,1359,7849,3639,7167
55.686,6,25,6940,8,154,4656,267,792,17,420,3479,1420,6148
129.034,6,27,7127,14,275,9925,275,1118,13,684,10720,1414,6009
5.517,6,44,8369,22,227,262,314,4062,22,489,250,1179,4307
1789.862,6,121,14476,80,84,22656,498,6426,41,164,44744,2642,8050
300.337,6,59,44380,37,1297,8342,1448,38260,22,828,1512,1448,6120
0.708,6,10,924,5,283,123,283,551,5,105,115,105,373
2.896,17,2,178,1,29,0,29,57,1,93,0,93,121
1.408,6,43,10105,23,440,64,1360,4484,20,437,64,2720,5621
240.619,6,56,19399,24,623,10461,1418,8759,32,597,7761,1418,10640
1323.553,2,14,448,14,8,101811,8,448,0,0,0,0,0
504.018,2,4,128,4,8,168006,8,128,0,0,0,0,0
0.0,17,2,694,2,319,0,354,694,0,0,0,0,0
300.897,6,39,9638,21,540,15044,1360,4116,18,399,506,1360,5522
181.31,17,4,352,2,60,181308,60,176,2,60,181309,60,176
17.079,6,27,7292,8,137,2438,267,1155,19,447,948,1420,6137
1787.894,6,371,23865,213,75,8433,469,13405,158,69,11387,69,10460
1.299,6,37,9808,19,502,72,1440,4312,18,433,65,1440,5496
0.416,6,51,21578,28,1015,15,1380,16404,23,421,17,1923,5174
1742.19,6,95,7203,63,38,28099,205,4476,32,33,56188,98,2727
1796.986,1,345,28980,345,56,5223,56,28980,0,0,0,0,0
1798.145,6,191,18610,126,99,14385,469,11525,65,69,28091,69,7085
0.03,17,2,324,1,32,0,32,60,1,236,0,236,264
1797.779,1,67,5628,67,56,27239,56,5628,0,0,0,0,0
15.124,17,17,11164,10,878,1677,1350,9061,7,272,2515,1350,2103
3.899,17,8,1216,4,60,1297,60,352,4,188,1294,188,864
40.99,17,4,240,2,32,40989,32,120,2,32,40989,32,120
1799.196,17,449,39928,404,35,4464,288,25708,45,288,40024,288,14220
315.728,6,95,21048,50,297,6443,1360,11313,45,304,7132,4649,9735
281.305,6,30,7432,13,158,23442,267,1317,17,543,17578,1400,6115
48.846,6,26,7137,12,155,4440,267,1266,14,530,3756,2006,5871
2.346,6,2,111,0,0,0,0,0,2,31,2346,31,111
1777.809,17,73,3060,72,14,25039,14,3024,1,8,0,8,36
1380.883,6,75,5419,50,31,28181,31,3375,25,31,57534,31,2044
1.164,6,28,8631,15,236,69,625,2049,13,1008,79,1791,6582
368.831,17,3387,1931713,3364,545,109,1252,1930749,23,13,11561,56,964
104.053,2,3,96,3,8,52026,8,96,0,0,0,0,0
11.449,6,16,4050,9,275,1431,275,918,7,1420,1302,1420,3132
72.309,1,2,112,2,28,72309,28,112,0,0,0,0,0
1796.099,6,355,22480,207,69,8718,69,12420,148,69,12217,69,10060
1786.669,6,102,8296,68,65,26666,65,4930,34,59,54138,59,3366
281.134,6,31,7813,15,158,20081,267,1397,16,641,18738,3436,6416
1797.377,17,448,39896,403,35,4471,288,25676,45,288,40017,288,14220
46.206,1,3,168,3,28,23103,28,168,0,0,0,0,0
0.986,6,29,7520,17,306,61,1087,2826,12,701,88,1728,4694
14.642,17,29,16696,13,411,1220,1350,5710,16,658,969,1350,10986
100.012,6,47,10096,23,631,872,1360,4179,24,309,4340,2667,5917
5.09,17,2,2200,2,1072,5090,1072,2200,0,0,0,0,0
11.687,6,25,8473,13,275,973,275,1078,12,986,730,1440,7395
0.462,6,48,21894,28,1047,17,1420,16864,20,421,23,1883,5030
0.36,17,4,950,2,40,350,40,136,2,379,349,379,814
1.49,17,3,286,2,46,1000,46,148,1,110,0,110,138
131.664,6,39,9724,14,327,38,1189,2535,25,309,5485,1420,7189
1740.411,17,30,31680,30,1028,60014,1028,31680,0,0,0,0,0
0.241,17,2,602,1,46,0,46,74,1,500,0,500,528
10.546,6,1328,1028745,689,1395,15,1448,985053,639,776,16,1448,43692
3.614,17,5,290,5,30,903,30,290,0,0,0,0,0
257.788,6,29,4773,11,142,5525,174,874,18,263,15158,1452,3899
1.309,6,47,18832,26,934,52,1460,13216,21,433,56,1460,5616
280.262,6,31,7472,15,158,20018,267,1397,16,603,18681,2036,6075
104.949,6,23,2616,8,189,14992,517,1194,15,323,7496,499,1422
62.337,6,21,8586,11,563,97,1350,2161,10,1202,6906,3151,6425
40.572,6,43,8758,21,360,756,766,2001,22,366,1923,2128,6757
1744.697,2,26,832,26,8,69787,8,832,0,0,0,0,0
125.612,2,2,64,2,8,125612,8,64,0,0,0,0,0
0.074,17,4,360,2,30,0,30,116,2,94,31,94,244
316.093,6,97,34950,59,498,5449,1360,24861,38,503,8538,2720,10089
915.885,6,210,42687,94,387,9848,1360,26074,116,142,7963,2720,16613
4.668,6,733,672832,478,1368,9,1432,658329,255,427,17,1432,14503
0.133,17,2,211,1,59,0,59,87,1,96,0,96,124
1759.707,6,80,3680,40,0,45120,0,2080,40,0,45120,0,1600
1787.905,6,365,25501,212,99,8473,469,14965,153,69,11762,69,10536
316.964,6,48,17991,28,558,11739,1360,9532,20,695,16675,4649,8459
0.013,6,11,1112,6,517,2,517,837,5,7,3,7,275
31.457,17,4,352,2,60,31455,60,176,2,60,31456,60,176
183.117,6,43,6464,21,209,9155,585,2998,22,210,8698,580,3466
1799.967,17,449,39928,404,35,4466,288,25708,45,288,40017,288,14220
0.138,6,10,767,5,186,33,186,454,5,45,34,45,313
94.367,6,13,1079,12,43,8578,43,1019,1,0,0,0,60
1747.714,6,102,7970,66,45,26887,205,4902,36,35,49927,98,3068
1741.17,6,91,6604,59,31,30020,31,3998,32,31,56166,31,2606
2.009,6,37,13737,20,865,105,1360,8624,17,552,112,1384,5113
3.144,17,2,690,2,317,3144,317,690,0,0,0,0,0
240.197,6,53,18330,28,822,8895,1418,15445,25,197,10007,580,2885
248.937,17,4,352,2,60,248935,60,176,2,60,248936,60,176
1.488,6,48,19462,27,909,57,1460,13846,21,529,64,4075,5616
1.34,6,42,12004,22,612,63,1360,6428,20,476,60,2715,5576
1770.319,6,101,9410,66,66,27235,66,5610,35,60,52065,60,3800
5.198,6,22,3627,13,161,433,293,1652,9,537,604,1179,1975
0.509,6,20,7229,13,334,42,663,2021,7,1209,74,1946,5208
0.001,17,2,198,1,37,0,37,65,1,105,0,105,133
0.009,17,2,192,1,37,0,37,65,1,99,0,99,127
0.419,6,27,7296,13,155,34,267,1301,14,603,18,2036,5995
157.592,17,4,352,2,60,157591,60,176,2,60,157591,60,176
240.192,6,42,25912,17,310,15012,592,1823,25,1139,10005,1438,24089
119.929,6,112,89053,74,1272,1642,1408,78955,38,737,3235,2439,10098
12.546,6,1909,1709204,1207,1365,10,1380,1675573,702,387,17,1923,33631
1786.962,6,102,8296,68,65,26671,65,4930,34,59,54145,59,3366
3.165,6,46,27569,24,725,137,1360,6780,22,1326,143,2007,20789
1600.988,17,65,2730,65,14,25015,14,2730,0,0,0,0,0
0.306,17,2,266,1,41,0,41,69,1,169,0,169,197
0.49,6,125,88549,56,131,8,232,2769,69,1338,6,1430,85780
1787.413,17,87,3648,86,14,21028,14,3612,1,8,0,8,36
1.039,6,31,12102,17,525,64,1360,3350,14,818,66,1360,8752
1744.557,6,97,7307,63,38,28138,205,4476,34,33,52855,98,2831
109.098,17,4,352,2,60,109097,60,176,2,60,109097,60,176
0.653,6,24,8039,14,334,50,663,2085,10,1082,69,1946,5954
1799.137,17,449,39928,404,35,4464,288,25708,45,288,40021,288,14220
1793.909,1,192,10752,192,28,9392,28,10752,0,0,0,0,0
0.009,17,2,912,1,308,0,308,336,1,548,0,548,576
1.349,6,49,20153,27,956,51,1440,14497,22,433,55,1440,5656
33.474,6,28,4939,14,180,2574,722,1808,14,399,2559,2026,3131
1799.308,1,57,4788,57,56,32130,56,4788,0,0,0,0,0
180.411,6,21,9086,12,304,72,597,1425,9,1457,22528,4441,7661
2.999,17,3,1021,2,308,2000,308,672,1,321,0,321,349
1.647,6,27,10180,16,285,109,587,1499,11,1029,148,1420,8681
198.224,17,4,240,2,32,198223,32,120,2,32,198223,32,120
1796.492,2,22,704,22,8,85547,8,704,0,0,0,0,0
1786.601,17,276,72008,276,232,6496,422,72008,0,0,0,0,0
1.43,6,25,8056,12,164,110,267,1288,13,869,103,1368,6768
1788.784,1,58,4872,58,56,31382,56,4872,0,0,0,0,0
1776.416,17,140,11200,70,48,25744,48,5320,70,56,25744,56,5880
9.699,6,16,2706,8,152,1385,267,782,8,320,1349,1152,1924
503.852,2,5,160,5,8,125963,8,160,0,0,0,0,0
0.856,17,2,152,1,48,0,48,76,1,48,0,48,76
1797.666,1,55,4620,0,0,0,0,0,55,56,33290,56,4620
39.071,6,9,608,0,0,0,0,0,9,31,4883,31,608
1.422,6,8,335,4,0,474,0,164,4,7,117,7,171
91.261,6,29,11805,15,500,432,690,3634,14,759,7010,1460,8171
8.723,6,16,6058,4,106,2907,106,274,12,529,792,1420,5784
1762.33,6,206,14186,76,46,23497,46,5996,130,46,13660,46,8190
0.157,17,11,4548,5,399,31,1350,2139,6,373,25,1350,2409
1.525,6,38,8254,19,321,84,1164,2718,19,433,73,1440,5536
66.867,6,20,9311,11,418,61,944,1726,9,1442,8343,3950,7585
1799.052,6,369,24792,214,87,8446,469,14245,155,69,11681,69,10547
2.65,17,43,48127,42,1116,64,1472,48087,1,12,0,12,40
1772.333,6,180,15480,120,69,14893,69,8940,60,69,30032,69,6540
1.837,6,2,80,0,0,0,0,0,2,0,0,0,80
1785.231,6,358,22669,209,69,8582,69,12569,149,69,12062,69,10100
87.971,6,43,8843,17,363,3631,774,1801,26,299,3513,2128,7042
0.015,17,2,234,1,33,0,33,61,1,145,0,145,173
11.789,6,1812,1542178,1089,1361,10,1380,1509016,723,383,16,1380,33162
0.493,6,4,1037,2,0,221,0,104,2,853,273,853,933
191.58,17,4,304,4,48,63860,48,304,0,0,0,0,0
10.044,6,50,9850,24,233,436,314,4701,26,410,391,1152,5149
0.782,6,12,1653,6,288,152,288,548,6,426,84,434,1105
572.845,17,11799,2330290,9988,170,57,172,1985646,1811,162,302,172,344644
7.752,17,6,456,6,48,1550,48,456,0,0,0,0,0
0.081,6,9,1339,5,145,20,145,349,4,826,23,826,990
135.346,6,13,3287,3,92,67673,92,244,10,501,15005,1408,3043
1799.737,17,449,39928,404,35,4465,288,25708,45,288,40019,288,14220
9.158,6,15,2666,8,152,1308,267,782,7,400,1482,1179,1884
124.941,6,34,7935,12,155,29,267,1266,22,340,5949,3417,6669
25.838,17,39,7038,16,171,1720,1350,3199,23,138,1172,1350,3839
96.011,6,11,1056,5,110,24001,138,752,6,64,19201,64,304
867.646,17,288,19776,288,40,3023,41,19776,0,0,0,0,0
0.208,6,26,7256,13,155,17,267,1301,13,678,14,3436,5955
553.666,17,201,45201,92,312,6084,1350,31306,109,99,4913,1350,13895
1765.516,1,128,7168,128,28,13901,28,7168,0,0,0,0,0
0.086,6,9,1340,5,145,21,145,349,4,827,22,827,991
36.666,17,44,6468,22,48,1742,48,1672,22,190,1745,308,4796
0.227,17,2,136,1,32,0,32,60,1,48,0,48,76
280.193,6,28,7352,13,158,23349,267,1317,15,678,20011,3436,6035
1742.716,6,116,11276,72,93,24545,205,7656,44,31,40520,33,3620
26.77,6,46,13728,21,331,1338,722,3161,25,683,1103,2760,10567
191.76,6,27,8487,10,120,21306,267,1251,17,654,11983,1452,7236
1.468,6,44,17096,25,877,61,1460,11560,19,476,70,2615,5536
1405.788,6,290,18641,145,70,9762,138,9043,145,50,9762,69,9598
0.026,17,2,588,1,60,0,60,88,1,472,0,472,500
1787.909,6,357,22629,208,69,8637,69,12460,149,69,12080,69,10169
280.416,6,30,7432,13,158,23368,267,1317,17,543,17515,1400,6115
4.756,6,39,7285,21,218,237,314,3463,18,516,264,1179,3822
64.66,6,7,420,7,0,0,0,420,0,0,0,0,0
0.039,6,6,716,3,302,12,302,458,3,102,10,102,258
1795.245,17,447,39864,402,35,4476,288,25644,45,288,40016,288,14220
3.009,6,31,11747,17,751,188,1365,3909,14,886,207,1733,7838
1782.169,1,86,4816,86,28,20966,28,4816,0,0,0,0,0
6.123,17,6,1263,3,47,3055,47,225,3,318,3055,318,1038
5.552,6,12,3947,5,49,1388,92,367,7,1070,878,1448,3580
5.35,6,41,7349,23,218,243,314,3543,18,513,298,1179,3806
1797.604,6,385,27184,220,102,8208,469,16099,165,69,10958,69,11085
240.346,6,43,9263,21,524,12016,1418,5818,22,254,11443,617,3445
1772.414,6,180,15480,120,69,14894,69,8940,60,69,30036,69,6540
0.027,17,2,144,1,36,0,36,64,1,52,0,52,80
0.231,6,22,5960,12,181,21,537,1526,10,558,24,1408,4434
1748.327,6,121,12174,74,63,23949,722,6216,47,94,38000,1448,5958
129.612,6,38,7501,17,231,419,314,3234,21,489,6468,1179,4267
0.009,6,2,192,1,112,0,112,152,1,0,0,0,40
34.014,17,10,760,10,48,3779,48,760,0,0,0,0,0
0.005,17,2,363,1,32,0,32,60,1,275,0,275,303
0.987,17,2,312,2,128,987,128,312,0,0,0,0,0
21.552,6,13,760,5,0,5388,0,280,8,0,2204,0,480
1477.093,17,24,7872,24,300,64221,300,7872,0,0,0,0,0
0.037,6,12,3705,6,171,7,171,491,6,964,4,1448,3214
0.008,17,2,393,1,33,0,33,61,1,304,0,304,332
4.187,17,8,1680,4,39,1391,39,268,4,325,1391,332,1412
1.315,6,50,19711,27,921,50,1460,14015,23,433,51,1460,5696
10.786,6,20,4402,11,275,1078,275,998,9,758,749,1420,3404
125.091,2,2,64,2,8,125091,8,64,0,0,0,0,0
301.151,6,84,56567,48,1296,6407,1440,47898,36,754,1398,1440,8669
1787.495,6,359,22709,209,69,8593,69,12569,150,69,11995,69,10140
7.241,6,4,240,4,0,0,0,240,0,0,0,0,0
0.078,6,4,208,0,0,0,0,0,4,0,0,0,208
1789.397,17,142,11360,71,48,25562,48,5396,71,56,25562,56,5964
82.785,6,27,8374,13,419,60,954,1833,14,596,6358,1360,6541
71.196,6,36,10004,12,294,6472,1189,2546,24,381,3085,1460,7458
240.325,6,44,8447,22,449,11443,1408,5648,22,205,11443,580,2799
2.07,17,2,124,2,34,2070,34,124,0,0,0,0,0
65.485,6,14,1522,6,302,13097,302,912,8,83,9348,83,610
1.152,6,25,8080,12,164,88,267,1312,13,869,81,1408,6768
47.76,17,34,8254,14,235,3673,1350,3694,20,200,2409,1350,4560
280.24,6,29,7392,13,158,23353,267,1317,16,603,18681,1400,6075
3.36,17,5,295,5,31,840,31,295,0,0,0,0,0
255.494,6,30,8872,13,158,21291,267,1317,17,687,15966,1400,7555
1770.468,6,112,10342,70,66,25658,66,5974,42,60,43179,60,4368
1772.114,6,180,15480,120,69,14891,69,8940,60,69,30032,69,6540
1120.877,17,10,2745,5,30,280216,30,290,5,463,280215,463,2455
98.892,6,9,606,4,214,19985,214,394,5,0,24689,0,212
132.1,6,20,7461,11,261,96,467,1365,9,802,16490,1408,6096
8.179,6,40,8465,19,218,454,314,3383,21,604,395,1179,5082
1786.051,6,104,8376,68,65,26657,65,4930,36,59,51027,59,3446
0.49,17,3,451,2,39,468,39,134,1,289,0,289,317
1763.98,17,48,16080,48,307,37531,308,16080,0,0,0,0,0
0.229,6,21,4415,12,165,20,456,1446,9,415,27,888,2969
1744.717,2,18,576,18,8,102630,8,576,0,0,0,0,0
0.092,17,2,136,1,32,0,32,60,1,48,0,48,76
1770.734,6,103,9382,66,64,27242,64,5544,37,58,49184,58,3838
0.906,6,10,1687,7,100,151,100,384,3,1179,321,1179,1303
1787.78,6,356,22520,208,69,8636,69,12460,148,69,12161,69,10060
0.336,17,2,152,1,48,0,48,76,1,48,0,48,76
1774.729,6,132,12948,80,65,22464,722,6730,52,85,34787,1448,6218
10.868,6,20,4442,11,275,1086,275,998,9,768,759,1440,3444
1.276,6,51,20147,28,886,47,1360,14451,23,433,50,1360,5696
1798.149,6,366,24603,213,87,8481,469,14136,153,69,11828,69,10467
0.101,17,2,144,1,36,0,36,64,1,52,0,52,80
1793.378,17,381,44566,179,154,10075,1350,32619,202,31,8921,60,11947
60.359,6,44,13987,24,917,383,1360,8340,20,402,3167,2667,5647
1792.805,17,144,11520,72,48,25246,48,5472,72,56,25246,56,6048
3.615,6,20,6314,9,268,446,517,1281,11,744,356,1418,5033
1.836,17,6,552,3,64,917,64,276,3,64,917,64,276
1787.645,6,356,22520,208,69,8635,69,12460,148,69,12160,69,10060
0.01,17,3,639,2,39,0,39,134,1,477,0,477,505
280.182,6,30,7432,13,158,23348,267,1317,17,543,17510,1400,6115
34.556,6,28,7217,13,155,2879,267,1306,15,482,2467,1997,5911
361.896,6,48,6604,21,109,18094,722,2414,27,185,12196,1448,4190
1799.872,17,450,39960,405,35,4455,288,25740,45,288,40020,288,14220
13.89,6,2485,2294168,1581,1373,8,1408,2242496,904,776,15,1408,51672
7.429,6,28,8979,17,243,464,564,1658,11,982,723,2760,7321
0.466,6,13,1693,6,288,92,288,548,7,426,41,434,1145
4.67,2,3,96,3,8,2335,8,96,0,0,0,0,0
1.228,6,50,19575,27,911,47,1360,13879,23,433,48,1360,5696
1777.463,6,190,17963,126,94,14219,469,10987,64,69,28207,69,6976
1673.34,1,7,392,7,28,278890,28,392,0,0,0,0,0
8.995,17,4,1344,4,308,2998,308,1344,0,0,0,0,0
3.729,6,35,6209,18,206,219,314,2784,17,456,216,1152,3425
0.374,6,10,1992,5,288,88,288,508,5,424,51,434,1484
1783.811,6,358,22669,209,69,8576,69,12500,149,69,12052,69,10169
48.829,6,47,10399,22,533,716,910,3131,25,329,2027,2128,7268
2.53,6,14,2351,8,188,361,245,700,6,703,453,1152,1651
1785.659,6,104,8308,68,64,26651,64,4896,36,58,51015,58,3412
1680.705,17,12,498,11,14,168070,14,462,1,8,0,8,36
5.753,6,3,1540,1,0,0,0,40,2,1420,3022,1420,1500
1787.547,17,87,3648,86,14,21029,14,3612,1,8,0,8,36
97.631,6,33,8056,14,474,7510,841,2182,19,286,5423,1541,5874
26.463,17,16,1408,8,48,3778,48,608,8,72,3777,72,800
1772.624,6,180,15480,120,69,14896,69,8940,60,69,30041,69,6540
1787.356,6,102,8296,68,65,26676,65,4930,34,59,54158,59,3366
0.073,17,2,176,1,60,0,60,88,1,60,0,60,88
0.667,17,3,234,2,39,194,39,134,1,72,0,72,100
300.827,6,50,10526,25,433,12534,910,3258,25,312,530,1460,7268
552.387,1,6,336,6,28,110477,28,336,0,0,0,0,0
29.127,6,39,8661,19,410,481,882,2046,20,414,1525,2720,6615
0.345,17,2,204,1,34,0,34,62,1,114,0,114,142
0.015,6,14,4044,8,88,2,88,452,6,1670,3,1880,3592
1787.315,6,106,8446,69,64,26284,64,4936,37,58,49644,58,3510
0.174,17,2,144,1,36,0,36,64,1,52,0,52,80
10.93,17,4,824,2,48,10909,48,152,2,308,10911,308,672
3.057,17,4,240,4,32,1019,32,240,0,0,0,0,0
1699.406,17,12,498,11,14,169940,14,462,1,8,0,8,36
0.179,17,280,299801,66,104,2,1350,8728,214,1332,0,1350,291073
30.946,17,3,528,3,148,15473,352,528,0,0,0,0,0
1782.408,1,154,16324,154,78,11649,78,16324,0,0,0,0,0
0.371,6,22,7072,12,209,26,517,1889,10,775,32,1408,5183
1782.407,6,85,6925,55,65,33007,65,3955,30,59,61459,59,2970
11.568,6,25,8473,13,275,964,275,1078,12,986,753,1440,7395
0.346,6,26,8892,13,237,28,589,1634,13,1095,27,2804,7258
0.016,17,2,550,2,247,16,247,550,0,0,0,0,0
1775.834,17,73,3060,72,14,25011,14,3024,1,8,0,8,36
1.408,6,35,13194,20,584,74,1360,4350,15,823,84,1379,8844
1.361,6,16,2024,8,256,192,256,1092,8,304,192,304,932
0.207,6,20,4960,10,137,23,267,1092,10,692,22,1467,3868
3.189,6,7,476,1,0,0,0,40,6,31,315,31,436
34.033,6,31,5414,18,210,2001,210,1658,13,616,2836,904,3756
1743.955,6,95,7203,63,38,28128,205,4476,32,33,56248,98,2727
0.129,6,10,1060,5,517,32,517,785,5,7,32,7,275
298.415,1,4,224,4,28,99471,28,224,0,0,0,0,0
8.128,6,18,10839,7,242,1326,275,768,11,1203,795,2840,10071
79.901,6,34,6221,17,165,4993,722,2050,17,364,4982,2026,4171
207.224,6,32,8952,14,158,15940,267,1357,18,624,12187,1400,7595
1797.747,17,179,13962,179,50,10099,50,13962,0,0,0,0,0
19.783,17,6,456,6,48,3956,48,456,0,0,0,0,0
16.341,17,21,5096,10,248,1812,1350,2763,11,184,1630,1350,2333
29.538,6,29,8785,12,216,275,314,1996,17,610,1830,1152,6789
1798.576,17,180,14040,180,50,10047,50,14040,0,0,0,0,0
300.596,6,500,491320,331,145,910,230,18752,169,2810,1789,18304,472568
9.429,6,9,527,5,43,2357,43,311,4,0,3109,0,216
280.925,6,30,7432,13,158,23410,267,1317,17,543,17547,1400,6115
41.656,17,24,2112,12,48,3786,48,912,12,72,3786,72,1200
9.728,6,82,24805,41,560,243,1152,19008,41,461,236,1179,5797
72.49,6,43,22769,20,1088,3815,1408,13037,23,609,3171,2042,9732
0.036,17,4,284,2,32,32,32,120,2,54,28,60,164
9.153,6,81,24461,41,533,228,1152,18720,40,459,228,1179,5741
1.187,17,4,368,2,32,989,32,120,2,96,917,96,248
6.083,17,6,471,3,31,3025,31,177,3,70,3019,70,294
1.07,17,4,344,2,47,0,47,150,2,69,0,75,194
141.833,17,4,240,2,32,141832,32,120,2,32,141832,32,120
0.023,17,4,480,3,60,0,60,264,1,188,0,188,216
1798.901,6,373,26028,216,98,8366,469,15263,157,69,11528,69,10765
7.61,17,6,528,3,60,3804,60,264,3,60,3804,60,264
0.729,6,22,7342,13,335,60,668,2026,9,1210,84,1946,5316
1.502,6,54,19613,27,903,57,1440,13757,27,433,50,1440,5856
1753.415,1,71,5964,71,56,25048,56,5964,0,0,0,0,0
5.49,6,40,7309,21,218,274,314,3463,19,513,290,1179,3846
251.78,2,3,96,3,8,125890,8,96,0,0,0,0,0
2.991,17,31,21738,17,841,186,1350,14780,14,469,224,1350,6958
0.304,17,2,198,1,39,0,39,67,1,103,0,103,131
1770.688,6,101,9344,66,65,27241,65,5577,35,59,52076,59,3767
1785.623,6,356,22520,208,69,8626,69,12460,148,69,12147,69,10060
1784.427,6,356,22520,208,69,8620,69,12460,148,69,12138,69,10060
3.913,17,8,1176,4,48,1301,48,304,4,190,1300,308,872
56.739,6,50,10507,23,533,711,910,3159,27,312,2177,1460,7348
0.109,6,10,1677,6,555,19,951,1354,4,159,36,159,323
0.58,6,12,1653,6,288,112,288,548,6,426,43,434,1105
1749.231,6,95,7203,63,38,28213,205,4476,32,33,56416,98,2727
0.638,6,7,288,4,0,212,0,164,3,0,211,0,124
1.05,6,116,97058,67,226,15,517,4984,49,2081,21,9928,92074
70.498,17,4,947,2,33,70484,37,123,2,384,70420,463,824
281.852,6,29,7392,13,158,23487,267,1317,16,603,18762,1400,6075
300.899,6,37,8537,20,308,15836,888,2103,17,478,546,2720,6434
2.569,1,5,420,5,56,642,56,420,0,0,0,0,0
0.083,17,4,284,2,32,76,32,120,2,54,74,60,164
1770.152,6,99,9240,66,65,27233,65,5577,33,59,55314,59,3663
20.126,6,31,6476,16,181,1341,537,1766,15,651,1089,1440,4710
1798.842,6,390,27122,222,96,8139,469,15917,168,69,10771,69,11205
280.324,6,25,7094,11,181,28032,267,1168,14,595,21558,1400,5926
73.609,6,72,48949,47,1157,1600,1408,39497,25,740,3058,2439,9452
0.008,17,3,704,2,60,0,60,176,1,500,0,500,528
0.32,17,5,1679,5,307,80,333,1679,0,0,0,0,0
2.153,17,3,174,3,30,1076,30,174,0,0,0,0,0
134.71,17,4,352,2,60,134709,60,176,2,60,134709,60,176
0.091,17,4,420,2,33,1,33,122,2,121,39,145,298
1786.569,6,102,8296,68,65,26665,65,4930,34,59,54135,59,3366
4.217,17,5,295,5,31,1054,31,295,0,0,0,0,0
0.304,17,2,212,1,46,0,46,74,1,110,0,110,138
3.912,6,2,88,2,0,0,0,88,0,0,0,0,0
1684.487,2,14,448,14,8,129575,8,448,0,0,0,0,0
78.148,6,32,14701,15,585,69,1460,3557,17,950,4875,1460,11144
1799.796,17,448,39896,403,35,4477,288,25676,45,288,40018,288,14220
0.272,6,9,1338,5,145,68,145,349,4,825,43,825,989
1.711,6,14,2351,8,188,244,245,700,6,703,288,1152,1651
219.784,6,19,6518,3,106,238,106,234,16,402,14651,1420,6284
18.741,17,21,8311,10,304,2078,1350,3320,11,425,1870,1350,4991
11.073,6,1774,1524844,1053,1391,10,1420,1491783,721,467,15,1883,33061
227.101,6,26,6409,9,272,240,516,1180,17,324,14188,1452,5229
1682.627,17,14,1036,7,30,280430,30,406,7,62,280431,62,630
10.07,17,3,244,2,48,10070,48,152,1,64,0,64,92
280.1,6,30,7432,14,158,21546,267,1357,16,603,18666,2800,6075
1798.906,6,251,47713,155,483,11681,483,37555,96,83,18935,83,10158
372.458,6,25,1651,17,177,23278,177,1117,8,110,9253,110,534
1.352,6,47,19247,27,897,52,1360,13671,20,476,61,2715,5576
31.575,6,7,336,1,0,0,0,48,6,0,6310,0,288
1091.364,17,216,16416,216,48,5076,48,16416,0,0,0,0,0
0.113,17,2,154,1,33,0,33,61,1,65,0,65,93
0.142,17,2,198,1,63,0,63,91,1,79,0,79,107
1792.209,6,364,65144,242,302,7436,302,48832,122,83,14811,83,16312
0.002,17,2,216,1,49,0,49,77,1,111,0,111,139
280.595,6,30,7432,13,158,23382,267,1317,17,543,17526,1400,6115
1.314,6,50,20146,28,889,48,1360,14490,22,433,54,1360,5656
11.233,6,3,156,3,0,0,0,156,0,0,0,0,0
3.379,17,10,2563,5,40,841,40,340,5,416,842,423,2223
0.831,17,2,677,1,300,0,300,328,1,321,0,321,349
480.261,2,3,96,3,8,240130,8,96,0,0,0,0,0
11.746,6,1865,1627031,1130,1386,10,1420,1593386,735,467,15,1883,33645
1787.907,6,390,37225,224,181,8017,1189,21843,166,112,10835,917,15382
1783.818,6,373,25959,215,98,8335,469,15223,158,69,11361,69,10736
269.954,1,6,336,6,28,53990,28,336,0,0,0,0,0
1734.422,17,154,26004,154,140,11336,392,26004,0,0,0,0,0
192.525,17,4,284,2,32,192518,32,120,2,54,192518,60,164
10.945,6,26,7673,14,301,841,721,1771,12,774,977,2840,5902
1799.774,1,16,896,16,28,119984,28,896,0,0,0,0,0
1785.573,6,102,8228,68,64,26650,64,4896,34,58,54105,58,3332
8.199,6,18,6767,9,275,1024,275,643,9,1150,943,1414,6124
377.282,6,23,1538,16,180,25152,180,1056,7,110,10405,110,482
1745.22,6,94,7151,62,38,28610,205,4424,32,33,56288,98,2727
0.421,6,12,1653,6,288,82,288,548,6,426,46,434,1105
1752.664,6,95,7203,63,38,28268,205,4476,32,33,56525,98,2727
1773.012,6,180,15480,120,69,14899,69,8940,60,69,30050,69,6540
21.6,17,2,642,1,300,0,300,328,1,286,0,286,314
280.474,6,29,7392,13,158,23372,267,1317,16,678,18695,3456,6075
1620.341,1,7,392,7,28,270056,28,392,0,0,0,0,0
158.908,6,243,78052,115,750,1393,1440,56558,128,278,1246,1440,21494
13.162,6,19,2818,11,152,1316,267,898,8,320,1732,1152,1920
4.296,6,39,7269,19,218,238,314,3383,20,440,212,1152,3886
228.311,17,8,2688,8,308,32615,308,2688,0,0,0,0,0
1796.243,17,764,46132,764,32,2354,37,46132,0,0,0,0,0
1799.267,17,449,39928,404,35,4464,288,25708,45,288,40018,288,14220
1.338,6,47,19676,27,927,51,1360,14100,20,476,60,2715,5576
113.313,6,18,3736,4,92,37771,92,296,14,336,8699,1408,3440
1796.735,17,140,11200,70,48,26039,48,5320,70,56,26039,56,5880
1786.821,6,104,8444,68,66,26668,66,4964,36,60,51049,60,3480
1.218,6,25,8068,12,164,93,267,1300,13,869,86,1408,6768
402.61,6,27,1994,15,177,28757,177,1142,12,110,12388,110,852
0.158,6,24,7176,13,155,13,267,1301,11,905,15,4845,5875
0.502,17,3,451,2,39,177,39,134,1,289,0,289,317
4.875,6,40,7309,21,218,243,314,3463,19,513,256,1179,3846
13.267,1,3,312,0,0,0,0,0,3,76,6633,76,312
1.359,6,49,19587,28,913,50,1360,13971,21,433,58,1360,5616
317.136,6,98,21433,40,320,8131,1360,10304,58,209,5559,1360,11129
31.843,6,39,10301,24,138,1384,159,2652,15,623,2273,1418,7649
6.308,6,2,1175,1,0,0,0,40,1,1095,0,1095,1135
1794.739,6,355,22618,204,69,8841,69,12369,151,69,11964,69,10249
0.174,6,26,7256,13,155,14,267,1301,13,603,13,2036,5955
17.217,17,18,12349,11,905,1718,1350,10266,7,269,2864,1350,2083
15.118,17,2,152,2,48,15118,48,152,0,0,0,0,0
0.031,6,10,1800,6,616,5,1073,1477,4,159,9,159,323
14.944,6,28,6584,12,179,1358,722,1720,16,444,983,1408,4864
382.449,6,11,668,9,106,47805,106,580,2,0,382439,0,88
1793.626,6,355,22480,207,69,8706,69,12420,148,69,12201,69,10060
10.787,6,20,4322,11,275,1078,275,998,9,738,754,1380,3324
39.915,6,48,9028,23,360,538,734,2106,25,328,1656,1360,6922
1746.335,6,132,8459,74,50,23922,208,5240,58,31,30630,31,3219
0.013,17,2,588,1,39,0,39,67,1,493,0,493,521
1790.885,1,342,28728,342,56,5251,56,28728,0,0,0,0,0
280.226,6,28,7352,13,158,23352,267,1317,15,678,20012,2045,6035
1666.85,1,7,392,7,28,277808,28,392,0,0,0,0,0
1.273,6,16,1224,9,256,157,256,628,7,304,210,304,596
117.119,6,24,980,10,0,5403,0,404,14,0,9008,0,576
1050.083,17,75,4800,75,36,14190,36,4800,0,0,0,0,0
1789.19,6,356,22520,208,69,8643,69,12460,148,69,12171,69,10060
2.082,17,10,3616,10,333,231,361,3616,0,0,0,0,0
1797.31,17,304,90683,304,270,5931,422,90683,0,0,0,0,0
24.631,1,4,224,4,28,8210,28,224,0,0,0,0,0
1740.49,17,30,31680,30,1028,60016,1028,31680,0,0,0,0,0
1.596,6,34,8271,19,281,88,780,1918,15,574,103,4848,6353
50.353,6,27,7177,12,155,4577,267,1266,15,482,3596,1420,5911
0.866,6,10,1687,7,100,144,100,384,3,1179,307,1179,1303
1786.376,17,87,3648,86,14,21016,14,3612,1,8,0,8,36
1789.469,6,356,22589,207,69,8686,69,12420,149,69,12090,69,10169
376.653,6,43,2942,25,51,15693,208,1974,18,35,22145,62,968
132.341,6,20,8239,11,525,84,1237,2048,9,1163,16520,3151,6191
1775.594,17,163,36890,163,198,10960,422,36890,0,0,0,0,0
300.889,6,47,10396,19,266,16708,720,1914,28,334,11138,1360,8482
253.121,1,2,750,2,347,253121,347,750,0,0,0,0,0
3.942,17,5,514,4,32,1310,32,240,1,246,0,246,274
161.748,6,9,558,6,43,32349,43,394,3,0,80870,0,164
1661.108,1,7,392,7,28,276851,28,392,0,0,0,0,0
0.472,17,4,368,2,32,450,32,120,2,96,452,96,248
99.959,17,4,352,2,60,99958,60,176,2,60,99958,60,176
36.37,6,41,14160,22,960,420,1360,8598,19,399,2011,1360,5562
1779.836,17,142,11360,71,48,25426,48,5396,71,56,25426,56,5964
1788.967,6,322,30012,135,67,13349,659,11268,187,100,9617,1460,18744
1.111,6,25,8080,12,164,86,267,1312,13,869,79,1408,6768
0.026,17,2,570,1,30,0,30,58,1,484,0,484,512
111.01,6,32,8254,12,257,10091,721,1772,20,405,5427,1420,6482
1705.457,17,12,498,11,14,170545,14,462,1,8,0,8,36
1741.083,2,17,544,17,8,108817,8,544,0,0,0,0,0
0.031,6,12,3705,6,171,6,171,491,6,964,4,1448,3214
1785.699,17,87,3648,86,14,21008,14,3612,1,8,0,8,36
14.769,6,59,21490,31,473,492,1360,5201,28,797,440,1360,16289
71.384,6,26,12184,12,549,66,1360,2708,14,1113,5480,1360,9476
1786.869,6,102,8296,68,65,26669,65,4930,34,59,54143,59,3366
468.144,6,52,6700,29,96,16719,722,2849,23,189,21267,2026,3851
1797.978,1,56,4704,56,56,32690,56,4704,0,0,0,0,0
0.192,6,3,144,2,0,192,0,92,1,0,0,0,52
0.0,6,5,8456,1,0,0,0,40,4,2052,0,2736,8416
1.283,6,50,19025,27,872,49,1360,13329,23,433,50,1360,5696
2.209,17,439,426349,126,153,17,1350,22812,313,1261,6,1350,403537
1.207,6,47,18161,26,882,48,1360,12545,21,476,52,2720,5616
240.149,6,47,9614,25,168,10006,346,2500,22,595,11435,2798,7114
0.004,17,2,358,1,30,0,30,58,1,272,0,272,300
5.703,6,533,466284,336,1322,16,1368,451376,197,931,28,2736,14908
377.807,2,3,96,3,8,188903,8,96,0,0,0,0,0
0.275,17,4,284,2,32,268,32,120,2,54,266,60,164
4.877,6,39,7269,20,218,256,314,3423,19,513,256,1179,3846
0.004,17,2,398,1,34,0,34,62,1,308,0,308,336
9.022,1,9,756,9,56,1127,56,756,0,0,0,0,0
1742.667,6,97,7307,63,38,28107,205,4476,34,33,52795,98,2831
1.32,17,6,1486,3,30,653,30,174,3,409,655,468,1312
133.724,17,2,672,2,308,133724,308,672,0,0,0,0,0
1772.461,6,181,15589,120,69,14894,69,8940,61,69,29533,69,6649
5.283,6,40,7309,20,218,278,314,3423,20,513,263,1179,3886
13.627,2,3,96,3,8,6813,8,96,0,0,0,0,0
1794.231,6,356,22520,208,69,8667,69,12460,148,69,12205,69,10060
150.554,6,15,2391,7,125,25092,245,660,8,1407,21469,1407,1731
1703.297,1,8,448,8,28,243328,28,448,0,0,0,0,0
2.706,17,5,884,3,36,1348,36,192,2,318,2677,318,692
1.375,17,4,368,2,32,663,32,120,2,96,571,96,248
11.644,6,1837,1607417,1112,1390,10,1420,1574196,725,467,16,1883,33221
0.506,17,3,451,2,39,7,39,134,1,289,0,289,317
4.775,6,15,3491,6,288,889,288,560,9,639,574,853,2931
94.21,6,22,8470,11,288,72,555,1338,11,954,9407,1440,7132
1214.225,1,66,3696,66,28,18680,28,3696,0,0,0,0,0
14.716,6,5,284,2,0,9910,0,104,3,0,2529,0,180
1.741,6,9,527,5,43,435,43,311,4,0,578,0,216
0.006,17,2,526,1,41,0,41,69,1,429,0,429,457
17.657,6,9,529,5,45,4414,45,313,4,0,5884,0,216
4.483,6,38,7245,20,218,235,314,3423,18,516,248,1179,3822
1744.643,2,30,960,30,8,60160,8,960,0,0,0,0,0
41.094,17,4,3964,4,963,13698,1451,3964,0,0,0,0,0
1684.519,17,12,498,11,14,168451,14,462,1,8,0,8,36
1796.461,17,449,39928,404,35,4457,288,25708,45,288,40019,288,14220
0.398,6,12,1641,6,288,72,288,548,6,420,46,422,1093
0.08,17,2,2384,2,1164,80,1164,2384,0,0,0,0,0
1.434,6,25,8056,12,164,107,267,1288,13,869,101,1448,6768
1799.16,17,449,39928,404,35,4464,288,25708,45,288,40018,288,14220
0.153,17,2,144,1,36,0,36,64,1,52,0,52,80
6.984,2,2,64,2,8,6984,8,64,0,0,0,0,0
1.107,6,56,17842,28,697,41,1360,8813,28,493,40,3546,9029
1787.289,6,156,16503,84,106,21533,722,9148,72,78,25167,1448,7355
0.475,6,13,1693,6,288,90,288,548,7,426,44,434,1145
0.345,6,22,5031,13,117,28,179,994,9,734,42,1734,4037
1777.39,17,73,3060,72,14,25033,14,3024,1,8,0,8,36
125.998,2,2,64,2,8,125998,8,64,0,0,0,0,0
1684.467,2,12,384,12,8,153133,8,384,0,0,0,0,0
0.145,17,2,198,1,39,0,39,67,1,103,0,103,131
0.096,17,2,588,1,39,0,39,67,1,493,0,493,521
1786.458,6,102,8296,68,65,26663,65,4930,34,59,54132,59,3366
0.61,17,4,554,2,40,609,40,136,2,181,595,194,418
196.344,17,4,352,2,60,196343,60,176,2,60,196343,60,176
145.326,17,4,240,2,32,145325,32,120,2,32,145324,32,120
1786.653,17,87,3648,86,14,21019,14,3612,1,8,0,8,36
1.032,6,11,3653,6,171,205,171,491,5,1447,257,2676,3162
216.443,17,17,1258,17,46,13527,46,1258,0,0,0,0,0
297.47,1,4,326,4,53,99156,78,326,0,0,0,0,0
1764.517,6,119,7158,65,26,27569,26,3886,54,26,33291,26,3272
1779.664,6,354,22440,207,69,8639,69,12420,147,69,12189,69,10020
6.743,6,43,7429,24,218,293,314,3583,19,440,359,1152,3846
292.372,17,5,4378,5,847,73093,1284,4378,0,0,0,0,0
1792.722,6,286,36710,115,142,15724,1360,17309,171,147,10544,2720,19401
299.525,6,6,364,4,31,99841,31,222,2,31,299511,31,142
4.996,17,4,558,2,36,4985,36,128,2,187,4977,187,430
84.155,6,13,1079,12,43,7650,43,1019,1,0,0,0,60
1775.184,17,140,11200,70,48,25727,48,5320,70,56,25727,56,5880
52.326,6,33,8925,15,290,3737,965,2351,18,417,3077,1997,6574
1794.579,17,142,11360,71,48,25636,48,5396,71,56,25636,56,5964
5.215,6,37,6289,20,206,274,314,2864,17,456,310,1152,3425
1.24,2,3,120,3,16,620,16,120,0,0,0,0,0
214.653,6,52,9281,24,112,9332,267,2091,28,263,7942,1420,7190
1798.598,6,129,12773,77,62,23665,722,6370,52,90,35261,1408,6403
1.453,6,37,8214,19,321,80,1164,2718,18,476,74,2715,5496
0.885,6,10,1687,7,100,147,100,384,3,1179,316,1179,1303
0.073,17,2,136,1,32,0,32,60,1,48,0,48,76
243.666,6,75,52690,25,210,10152,519,2618,50,1249,4972,1408,50072
240.39,6,43,7641,20,156,12650,517,2145,23,429,10926,1418,5496
594.059,6,56,6778,32,302,19163,302,4680,24,83,25828,83,2098
251.664,2,2,64,2,8,251664,8,64,0,0,0,0,0
1.659,6,13,2311,8,188,237,245,700,5,1407,351,1407,1611
1771.508,6,101,9410,66,66,27253,66,5610,35,60,52099,60,3800
11.341,6,1810,1542760,1088,1362,10,1380,1509638,722,421,15,1923,33122
59.608,6,34,9572,11,174,59,267,1493,23,376,2709,1460,8079
1785.153,6,368,25621,213,99,8420,469,15005,155,69,11591,69,10616
41.714,17,31,13270,14,486,3206,1350,7208,17,328,2605,1350,6062
1.321,6,50,21422,29,913,47,1360,15806,21,476,57,2715,5616
1765.922,1,63,8089,63,100,28482,351,8089,0,0,0,0,0
0.0,17,2,180,1,30,0,30,58,1,94,0,94,122
1781.761,6,365,23156,210,69,8525,69,12747,155,69,11569,69,10409
11.906,17,4,304,4,48,3968,48,304,0,0,0,0,0
1.17,6,4,184,2,0,1170,0,88,2,0,1015,0,96
122.594,17,4,1344,4,308,40864,308,1344,0,0,0,0,0
1769.76,6,99,9306,66,66,27227,66,5610,33,60,55302,60,3696
1750.416,6,96,7255,62,38,28695,205,4424,34,33,53035,98,2831
10.748,6,20,4442,11,275,1074,275,998,9,768,746,1440,3444
1793.694,17,144,11520,72,48,25258,48,5472,72,56,25259,56,6048
3.651,17,4,352,2,48,3645,48,152,2,72,3643,72,200
22.454,17,15,6801,8,539,3196,1350,4540,7,295,3730,1350,2261
980.071,1,5,280,5,28,245017,28,280,0,0,0,0,0
1764.162,2,14,448,14,8,135704,8,448,0,0,0,0,0
1740.404,17,30,31680,30,1028,60013,1028,31680,0,0,0,0,0
1782.954,6,102,8364,68,66,26611,66,4964,34,60,54025,60,3400
11.738,6,19,3793,10,234,1304,564,1464,9,463,922,1343,2329
393.932,6,28,1819,18,177,23172,177,1181,10,110,8482,110,638
0.098,6,10,2115,6,597,19,1034,1438,4,513,32,513,677
11.936,6,25,8473,13,275,994,275,1078,12,986,893,1440,7395
2.981,6,9,2803,5,100,745,100,304,4,1165,782,1179,2499
1791.738,17,179,13962,179,50,10065,50,13962,0,0,0,0,0
1.385,6,48,19006,27,877,53,1360,13390,21,433,60,1360,5616
280.2,6,29,7392,13,158,23350,267,1317,16,603,18677,2800,6075
11.177,17,15,17678,15,1150,798,1451,17678,0,0,0,0,0
148.266,17,6,2016,6,308,29653,308,2016,0,0,0,0,0
0.488,6,20,7196,12,325,43,626,1932,8,1210,68,1906,5264
0.329,6,24,7458,13,335,26,668,2038,11,968,32,1906,5420
1.104,17,2,146,2,45,1104,45,146,0,0,0,0,0
2.933,17,3,468,3,128,1466,128,468,0,0,0,0,0
1700.579,17,13,534,11,14,170041,14,462,2,8,1700410,8,72
0.039,17,6,552,3,32,12,32,180,3,96,12,96,372
1797.027,17,360,45976,173,173,10447,1350,34855,187,31,9660,60,11121
106.846,6,960,482777,529,848,202,1152,460746,431,398,247,1152,22031
11.58,17,4,304,4,48,3860,48,304,0,0,0,0,0
1772.179,6,180,15480,120,69,14892,69,8940,60,69,30033,69,6540
28.445,6,7,418,3,106,14210,106,234,4,0,9469,0,184
0.898,6,10,1687,7,100,149,100,384,3,1179,321,1179,1303
300.85,6,45,16185,25,955,12535,1460,10583,20,399,455,1460,5602
750.502,17,20,1760,10,48,83388,48,760,10,72,83388,72,1000
240.647,2,2,64,2,8,240647,8,64,0,0,0,0,0
113.183,6,24,6248,9,272,118,516,1180,15,372,8077,1452,5068
0.699,6,2,1175,1,0,0,0,40,1,1095,0,1095,1135
365.796,6,18,1242,14,180,28138,180,916,4,110,20056,110,326
3.473,6,33,16365,18,294,204,584,2415,15,1196,233,1408,13950
58.148,6,50,10507,23,533,690,910,3159,27,312,2231,1460,7348
407.849,6,62,6320,31,211,13594,661,3544,31,88,13594,457,2776
300.281,6,51,35347,31,1257,10009,1448,29294,20,715,1556,1448,6053
35.825,6,28,7217,13,155,2985,267,1306,15,482,2558,1420,5911
1740.576,6,88,6405,58,31,30536,31,3915,30,31,60019,31,2490
0.514,17,3,255,2,32,260,32,120,1,107,0,107,135
0.831,6,23,6429,13,314,68,909,2095,10,982,91,1731,4334
0.496,17,3,451,2,39,298,39,134,1,289,0,289,317
1.264,6,48,18695,27,854,48,1360,13079,21,433,54,1360,5616
0.066,17,2,136,1,32,0,32,60,1,48,0,48,76
1783.806,6,366,23196,212,69,8454,69,12827,154,69,11658,69,10369
300.557,6,39,8731,20,335,15818,994,2217,19,441,468,1360,6514
1.019,17,2,122,2,33,1019,33,122,0,0,0,0,0
30.763,17,397,416432,88,185,353,1350,18812,309,1258,99,1350,397620
2.094,6,27,5853,13,123,174,267,1388,14,780,150,1460,4465
1783.133,17,83,3480,82,14,22013,14,3444,1,8,0,8,36
1772.511,6,203,22290,130,75,13740,267,10057,73,134,24613,1997,12233
0.17,17,2,152,1,48,0,48,76,1,48,0,48,76
88.084,6,13,1533,6,302,17616,302,912,7,83,14645,83,621
14.004,6,24,6993,13,275,1167,275,1078,11,910,899,1440,5915
1788.575,1,237,13272,237,28,7578,28,13272,0,0,0,0,0
0.241,17,2,677,1,300,0,300,328,1,321,0,321,349
300.695,6,29,8177,16,173,20046,385,1547,13,849,20053,1408,6630
0.014,17,6,462,3,33,0,33,183,3,65,0,65,279
1773.837,1,58,4872,0,0,0,0,0,58,56,31119,56,4872
1781.766,6,365,24963,212,94,8444,469,14496,153,69,11722,69,10467
0.152,6,13,4526,8,290,21,517,993,5,1088,35,1418,3533
77.101,17,6,528,3,60,38550,60,264,3,60,38550,60,264
1740.626,6,87,6322,58,31,30537,31,3915,29,31,62164,31,2407
1785.786,6,359,22709,209,69,8585,69,12569,150,69,11985,69,10140
0.512,17,3,451,2,39,183,39,134,1,289,0,289,317
1786.496,6,190,42650,110,466,16389,1302,29143,80,183,22612,1452,13507
1745.35,6,94,7151,62,38,28612,205,4424,32,33,56289,98,2727
4.017,6,15,2391,9,188,502,245,740,6,703,751,1152,1651
1.206,17,8,2934,8,338,172,361,2934,0,0,0,0,0
1772.114,6,180,15480,120,69,14891,69,8940,60,69,30030,69,6540
1779.63,17,140,11200,70,48,25791,48,5320,70,56,25791,56,5880
0.183,17,2,136,1,32,0,32,60,1,48,0,48,76
8.161,6,72,20734,37,554,226,1152,15891,35,429,232,1152,4843
601.638,2,8,256,8,8,85948,8,256,0,0,0,0,0
3.355,17,5,290,5,30,838,30,290,0,0,0,0,0
0.151,17,2,517,1,34,0,34,62,1,427,0,427,455
40.013,17,11,530,10,16,4445,58,446,1,56,0,56,84
28.193,6,12,3980,4,92,9397,92,296,8,1084,3991,1408,3684
1.257,6,52,20094,30,876,43,1360,14393,22,400,52,1360,5701
1798.12,6,356,22520,208,69,8686,69,12460,148,69,12232,69,10060
159.181,6,21,9138,12,304,70,597,1425,9,1468,19878,4441,7713
16.962,17,23,9165,11,491,1693,1350,5719,12,259,1539,1350,3446
1792.009,6,362,24774,211,94,8533,469,14387,151,69,11943,69,10387
88.786,6,23,11018,12,745,62,1360,3494,11,1414,8864,3940,7524
169.078,6,236,199422,158,1295,1076,1368,184456,78,641,1666,2519,14966
1772.241,6,180,15480,120,69,14892,69,8940,60,69,30035,69,6540
1798.465,1,266,14896,266,28,6786,28,14896,0,0,0,0,0
39.698,17,22,1936,11,48,3968,48,836,11,72,3968,72,1100
3.942,17,5,290,5,30,985,30,290,0,0,0,0,0
1186.475,1,73,4088,73,28,16478,28,4088,0,0,0,0,0
3.192,6,11,467,6,0,638,0,248,5,7,751,7,219
1740.394,1,15,870,15,30,124313,30,870,0,0,0,0,0
0.591,1,10,840,10,56,65,56,840,0,0,0,0,0
0.347,17,2,184,1,32,0,32,60,1,96,0,96,124
0.044,17,4,284,2,32,0,32,120,2,54,27,60,164
1744.669,2,28,896,28,8,64617,8,896,0,0,0,0,0
0.511,17,3,507,2,39,441,39,134,1,345,0,345,373
1795.709,17,429,144144,429,308,4195,308,144144,0,0,0,0,0
0.853,6,10,1687,7,100,142,100,384,3,1179,304,1179,1303
0.156,17,2,154,1,33,0,33,61,1,65,0,65,93
1795.392,17,445,39516,401,35,4488,288,25612,44,288,40953,288,13904
149.628,6,30,7432,13,158,12469,267,1317,17,543,9350,1400,6115
2.609,17,2,152,1,48,0,48,76,1,48,0,48,76
154.084,17,4,558,2,36,154079,36,128,2,187,154078,187,430
280.502,6,27,7312,12,158,25500,267,1277,15,678,20033,2085,6035
2.163,6,13,2311,8,188,309,245,700,5,1407,474,1407,1611
121.133,6,41,27188,25,667,43,1360,4367,16,2015,8063,5440,22821
1791.129,6,356,22589,207,69,8694,69,12420,149,69,12102,69,10169
126.591,6,33,11785,17,407,7900,1440,2960,16,998,8427,1440,8825
1763.904,2,13,416,13,8,146992,8,416,0,0,0,0,0
17.231,6,462,378770,266,1349,65,1368,362020,196,749,87,1368,16750
366.531,6,47,11116,29,338,13090,1360,5594,18,399,512,1360,5522
1773.979,17,120,9600,60,48,30067,48,4560,60,56,30067,56,5040
1795.374,17,312,23712,312,48,5772,48,23712,0,0,0,0,0
252.48,6,6,370,4,106,84160,106,274,2,0,1024,0,96
1785.216,6,354,22440,207,69,8666,69,12420,147,69,12227,69,10020
134.172,17,4,1334,4,305,44724,322,1334,0,0,0,0,0
1798.473,6,159,11451,84,76,21668,208,7242,75,31,24297,31,4209
23.931,6,35,8207,16,188,1595,721,1963,19,548,1302,1440,6244
15.15,6,5,752,3,46,7575,46,166,2,506,14962,506,586
1.002,6,23,6395,13,310,83,889,2075,10,979,110,1731,4320
240.231,6,54,17560,29,740,8579,1418,14853,25,174,10009,580,2707
0.295,6,27,8936,13,236,24,585,1630,14,938,22,1402,7306
1779.86,6,365,23225,212,69,8435,69,12758,153,69,11709,69,10467
1754.947,17,306,55840,306,154,5753,385,55840,0,0,0,0,0
0.372,17,2,154,1,33,0,33,61,1,65,0,65,93
1.441,6,41,11378,21,616,72,1460,5802,20,433,65,1460,5576
2.013,6,23,6606,14,229,154,498,1712,9,647,240,1420,4894
0.024,17,2,224,1,58,0,58,86,1,110,0,110,138
1.523,2,3,96,3,8,761,8,96,0,0,0,0,0
1799.834,17,140,11200,70,48,26084,48,5320,70,56,26084,56,5880
1772.107,6,180,15480,120,69,14891,69,8940,60,69,30033,69,6540
0.699,6,22,7312,13,325,58,626,1984,9,1210,82,1946,5328
1756.624,6,107,6374,60,27,29772,27,3525,47,27,38186,27,2849
1770.68,6,99,9306,66,66,27241,66,5610,33,60,55331,60,3696
0.153,6,12,3705,6,171,29,171,491,6,964,30,1448,3214
2.608,17,6,462,3,33,1000,33,183,3,65,0,65,279
0.146,17,2,290,1,40,0,40,68,1,194,0,194,222
3.713,17,6,840,3,64,1528,64,276,3,160,0,160,564
11.355,6,1838,1579057,1115,1363,10,1380,1545883,723,383,15,1380,33174
1745.27,6,96,7300,63,38,28149,205,4488,33,33,54529,98,2812
1780.4,6,379,30989,216,75,8280,267,13773,163,154,10990,1452,17216
10.014,6,6,328,4,0,3338,0,216,2,0,10006,0,112
1782.508,17,359,58603,359,135,4979,391,58603,0,0,0,0,0
1784.235,6,363,23076,211,69,8496,69,12856,152,69,11816,69,10220
0.058,6,3,187,1,0,0,0,52,2,31,0,31,135
1774.353,6,180,15480,120,69,14910,69,8940,60,69,30067,69,6540
1094.61,17,216,16416,216,48,5091,48,16416,0,0,0,0,0
7.277,6,25,8255,14,315,559,1091,2303,11,1072,708,2736,5952
1786.307,6,104,8504,69,66,26269,66,5004,35,60,52535,60,3500
251.223,2,2,64,2,8,251223,8,64,0,0,0,0,0
63.513,1,4,224,4,28,21171,28,224,0,0,0,0,0
0.245,17,3,451,2,39,32,39,134,1,289,0,289,317
205.411,2,5,160,5,8,51352,8,160,0,0,0,0,0
0.288,17,3,507,2,39,41,39,134,1,345,0,345,373
0.101,6,9,1340,5,145,25,145,349,4,827,31,827,991
125.251,6,32,7717,12,155,11386,267,1266,20,376,6591,2006,6451
0.089,17,4,352,2,37,52,37,130,2,83,38,89,222
1.537,17,12,7511,7,762,256,1350,5536,5,367,292,1350,1975
0.175,6,46,21926,27,1056,6,1420,16945,19,467,9,1883,4981
1.713,6,8,1607,6,100,342,100,344,2,1179,250,1179,1263
1.15,17,2,198,1,39,0,39,67,1,103,0,103,131
1799.855,6,385,25915,222,86,8144,469,14841,163,69,11110,69,11074
541.438,2,4,128,4,8,180479,8,128,0,0,0,0,0
1.242,6,53,13954,25,551,51,1429,4916,28,439,42,1986,9038
14.731,6,28,7223,13,156,1227,267,1312,15,482,1051,1997,5911
66.383,17,7,532,7,48,11063,48,532,0,0,0,0,0
1787.44,6,104,8444,68,66,26678,66,4964,36,60,51066,60,3480
13.83,6,189,136885,99,553,141,1408,7359,90,1451,155,2816,129526
101.254,6,10,1116,2,226,13356,226,338,8,110,14438,110,778
1793.819,6,357,22629,208,69,8665,69,12460,149,69,12117,69,10169
911.532,17,180,13680,180,48,5092,48,13680,0,0,0,0,0
100.565,6,32,8952,14,158,7735,267,1357,18,624,5905,1400,7595
184.329,6,68,39854,39,1181,4850,1448,31592,29,749,2208,1448,8262
1800.0,6,252,17498,97,46,18388,46,7158,155,46,11688,46,10340
0.211,17,2,2384,2,1164,211,1164,2384,0,0,0,0,0
377.456,2,4,128,4,8,125818,8,128,0,0,0,0,0
312.26,17,5,1680,5,308,78065,308,1680,0,0,0,0,0
1788.808,1,58,4872,0,0,0,0,0,58,56,31382,56,4872
0.389,6,380,530363,183,207,2,276,10352,197,2614,1,8412,520011
5.023,17,4,288,2,36,5022,36,128,2,52,5023,52,160
1505.004,2,13,416,13,8,125417,8,416,0,0,0,0,0
0.256,17,2,476,1,39,0,39,67,1,381,0,381,409
8.413,6,79,24733,39,561,221,1152,18976,40,461,209,1179,5757
1791.802,1,290,16240,290,28,6200,28,16240,0,0,0,0,0
1.027,17,4,1006,2,40,1016,40,136,2,407,1015,407,870
1787.437,6,102,8364,68,66,26678,66,4964,34,60,54160,60,3400
2.965,6,11,467,6,0,593,0,248,5,7,695,7,219
1783.844,6,364,25392,212,100,8454,469,14896,152,69,11813,69,10496
0.135,17,2,588,1,39,0,39,67,1,493,0,493,521
0.248,1,2,112,2,28,248,28,112,0,0,0,0,0
1315.539,6,94,11883,54,88,23647,501,4460,40,161,33729,1420,7423
6.893,6,5,264,3,0,3446,0,160,2,0,998,0,104
1774.128,6,180,15480,120,69,14908,69,8940,60,69,30061,69,6540
60.339,6,21,7464,12,127,5485,127,754,9,1056,7533,1704,6710
1783.813,6,435,28301,217,99,8258,469,15165,218,34,8220,64,13136
1798.18,1,345,28980,345,56,5227,56,28980,0,0,0,0,0
15.405,6,19,6827,9,275,1925,275,647,10,1440,1494,1440,6180
38.702,17,11,836,11,48,3870,48,836,0,0,0,0,0
2.69,17,2,179,1,32,0,32,60,1,91,0,91,119
11.817,6,1697,1594834,1118,1377,10,1432,1567350,579,428,20,1871,27484
0.362,6,18,6970,11,249,36,517,1482,7,1039,38,2682,5488
56.825,6,37,6034,18,213,3342,585,2881,19,196,3155,580,3153
1797.85,6,334,30419,162,370,11094,841,11363,172,63,10513,1418,19056
0.304,6,26,7256,13,155,25,267,1301,13,678,22,3436,5955
6.678,17,27,14441,5,997,32,1350,5125,22,395,316,1350,9316
0.104,6,10,1512,5,503,26,503,771,5,473,26,473,741
1.682,6,29,5851,15,111,120,267,1386,14,650,112,1380,4465
1.358,6,49,19643,27,919,52,1460,13987,22,433,56,1460,5656
34.047,6,38,8535,18,410,508,882,1982,20,441,1785,1440,6553
240.231,6,53,18135,28,802,8897,1418,15099,25,216,10009,580,3036
1772.207,1,74,7844,74,78,24276,78,7844,0,0,0,0,0
886.189,1,8,448,8,28,126598,28,448,0,0,0,0,0
0.169,6,24,7176,13,155,14,267,1301,11,775,16,4836,5875
369.489,6,25,1651,17,177,23093,177,1117,8,110,9226,110,534
2.078,6,13,2311,8,188,296,245,700,5,1407,459,1407,1611
280.22,6,28,7352,13,158,23351,267,1317,15,678,20013,4200,6035
1772.616,6,180,15480,120,69,14895,69,8940,60,69,30036,69,6540
1790.14,17,170,10880,170,36,10592,36,10880,0,0,0,0,0
283.115,6,29,7392,13,158,23592,267,1317,16,603,18870,2036,6075
191.414,17,4,352,2,60,191413,60,176,2,60,191413,60,176
1773.96,17,140,11200,70,48,25709,48,5320,70,56,25709,56,5880
0.219,17,2,2384,2,1164,219,1164,2384,0,0,0,0,0
1.478,6,47,18449,26,904,59,1460,12833,21,476,64,2615,5616
9.949,6,1191,996470,665,1408,14,1448,961314,526,776,18,1448,35156
3.643,17,2,656,2,300,3643,300,656,0,0,0,0,0
1790.565,6,356,22520,208,69,8650,69,12460,148,69,12180,69,10060
1007.678,6,151,21389,78,105,13086,894,8491,73,343,12288,1414,12898
0.605,6,12,3704,7,171,100,171,543,5,1446,147,2675,3161
1.273,6,46,18124,26,882,50,1360,12548,20,433,58,1360,5576
1786.48,6,104,8444,68,66,26663,66,4964,36,60,51039,60,3480
1.234,6,24,8004,12,164,95,267,1288,12,1014,95,2331,6716
0.569,17,22,14857,11,727,56,1350,8315,11,566,45,1350,6542
3.826,6,33,6145,17,206,239,314,2744,16,551,237,1179,3401
252.194,2,2,64,2,8,252194,8,64,0,0,0,0,0
0.045,17,4,284,2,32,30,32,120,2,54,30,60,164
8.929,6,809,694360,459,1430,19,1448,670416,350,776,25,1448,23944
0.297,6,27,9064,13,252,24,646,1694,14,947,22,1402,7370
10.765,6,18,4266,10,275,1196,275,958,8,992,856,1440,3308
1788.101,17,87,3648,86,14,21036,14,3612,1,8,0,8,36
54.691,17,40,10360,40,231,1402,388,10360,0,0,0,0,0
280.409,6,27,7312,13,158,23367,267,1317,14,775,21566,4836,5995
0.442,6,12,1653,6,288,86,288,548,6,426,44,434,1105
10.235,6,80,25322,42,579,249,1152,19661,38,459,269,1179,5661
6.094,17,21,15645,13,909,507,1350,12184,8,404,743,1350,3461
0.524,17,3,543,2,39,371,39,134,1,381,0,381,409
66.996,6,25,7478,9,272,151,516,1180,16,434,4459,1452,6298
281.102,6,68,16078,25,199,11712,1189,3794,43,319,6692,1420,12284
107.478,6,40,8516,15,159,3242,267,1722,25,304,4477,1420,6794
5.479,6,37,7189,19,218,304,314,3383,18,513,306,1179,3806
1.497,6,25,7522,14,335,115,668,2102,11,806,145,1368,5420
25.17,17,4,240,2,32,25169,32,120,2,32,25169,32,120
4.337,6,16,4075,9,49,542,92,575,7,626,168,2026,3500
2.17,6,13,2311,8,188,310,245,700,5,1407,481,1407,1611
39.016,17,4,240,2,32,39016,32,120,2,32,39015,32,120
0.014,6,3,182,2,31,14,31,111,1,31,0,31,71
1772.462,6,180,15480,120,69,14894,69,8940,60,69,30040,69,6540
4.438,6,38,7245,19,218,246,314,3383,19,516,231,1179,3862
0.013,17,2,455,1,43,0,43,71,1,356,0,356,384
9.552,6,12,1767,6,100,1910,100,344,6,589,1857,1152,1423
1776.559,17,73,3060,72,14,25021,14,3024,1,8,0,8,36
1773.574,6,180,15480,120,69,14903,69,8940,60,69,30051,69,6540
27.372,6,3496,3245377,2202,1393,12,1448,3173425,1294,776,21,1448,71952
240.223,6,53,18328,28,822,8896,1418,15447,25,196,10008,580,2881
88.044,6,71,48303,45,1174,2001,1408,38810,26,903,2463,2816,9493
300.228,6,34,12073,19,592,16679,1408,4584,15,837,17209,2816,7489
0.375,17,4,304,2,37,367,37,130,2,59,365,65,174
61.69,6,16,8267,7,290,10281,517,965,9,1365,7706,2419,7302
248.773,6,46,10135,29,266,8884,1360,4653,17,435,536,2667,5482
0.064,6,3,120,2,0,64,0,80,1,0,0,0,40
299.797,6,22,4811,9,220,7719,516,1246,13,337,24974,1452,3565
1796.113,1,342,28728,342,56,5267,56,28728,0,0,0,0,0
6.212,6,1160,1044623,715,1383,8,1408,1016819,445,931,13,2801,27804
2.289,6,15,2391,9,188,286,245,740,6,703,408,1152,1651
280.571,6,29,7392,13,158,23380,267,1317,16,603,18699,1400,6075
154.176,6,25,6318,9,272,93,516,1180,16,345,10272,1452,5138
29.148,6,23,6180,14,117,2242,159,1337,9,873,3641,1675,4843
1775.021,6,180,15480,120,69,14916,69,8940,60,69,30078,69,6540
0.881,6,2,80,1,0,0,0,40,1,0,0,0,40
1796.119,17,448,39896,403,35,4467,288,25676,45,288,40021,288,14220
0.864,6,20,5966,11,287,86,562,1306,9,716,96,1420,4660
0.426,6,25,7510,13,335,34,668,2038,12,806,37,1448,5472
2.913,6,29,14459,18,772,171,1360,6160,11,1569,275,3934,8299
2.888,17,2,122,2,33,2888,33,122,0,0,0,0,0
0.253,6,3,120,2,0,253,0,80,1,0,0,0,40
0.03,6,2,116,1,0,0,0,52,1,0,0,0,64
42.77,17,7,532,7,48,7128,48,532,0,0,0,0,0
1772.306,6,180,15480,120,69,14893,69,8940,60,69,30034,69,6540
1798.501,1,144,15264,144,78,12576,78,15264,0,0,0,0,0
1.966,17,3,222,3,46,983,46,222,0,0,0,0,0
0.008,6,2,220,1,0,0,0,40,1,128,0,128,180
0.384,17,8,2758,8,316,54,355,2758,0,0,0,0,0
1772.34,6,180,15480,120,69,14893,69,8940,60,69,30034,69,6540
0.948,6,28,9274,16,203,63,458,1498,12,1040,70,3926,7776
899.256,6,12,728,8,31,128465,31,444,4,31,299732,31,284
1775.426,1,140,7840,140,28,12772,28,7840,0,0,0,0,0
14.465,17,2,124,2,34,14465,34,124,0,0,0,0,0
1746.654,1,22,3007,22,108,83174,320,3007,0,0,0,0,0
0.393,6,13,1182,7,146,64,146,430,6,254,76,506,752
1715.697,1,8,448,8,28,245099,28,448,0,0,0,0,0
7.072,6,44,8385,23,227,321,314,4102,21,491,340,1179,4283
1671.25,6,27,4775,18,279,98308,413,3233,9,131,208878,269,1542
1756.786,6,146,8997,79,45,22522,208,5418,67,31,26614,31,3579
10.088,6,44,8535,23,208,458,314,3836,21,550,491,1179,4699
1796.809,1,304,25536,304,56,5930,56,25536,0,0,0,0,0
3.807,6,2,88,2,0,0,0,88,0,0,0,0,0
10.314,6,84,24885,43,526,245,1152,19088,41,461,251,1179,5797
1789.724,1,58,4872,58,56,31398,56,4872,0,0,0,0,0
48.531,17,4,240,2,32,48530,32,120,2,32,48529,32,120
1786.951,6,116,13755,76,80,23826,504,6024,40,161,45816,1420,7731
1783.808,6,365,25101,211,93,8494,469,14594,154,69,11658,69,10507
1769.851,6,101,9344,66,65,27228,65,5577,35,59,52051,59,3767
574.505,6,149,17882,77,166,7559,1189,8097,72,229,8091,1420,9785
0.56,17,8,2750,8,315,80,354,2750,0,0,0,0,0
1624.335,2,16,512,16,8,108289,8,512,0,0,0,0,0
3.181,6,2,1520,0,0,0,0,0,2,1440,3181,1440,1520
1.422,6,47,19438,27,907,54,1460,13862,20,529,64,4075,5576
11.854,6,1936,1640401,1157,1363,10,1380,1604999,779,421,15,1923,35402
1774.67,6,83,4496,42,26,43283,26,2274,41,26,44365,26,2222
225.749,6,31,7472,14,158,17365,267,1357,17,543,14106,1400,6115
1.577,6,47,19158,27,890,60,1360,13582,20,433,72,1360,5576
1751.656,6,95,7203,63,38,28252,205,4476,32,33,56497,98,2727
280.237,6,26,7272,12,158,25476,267,1277,14,775,21553,4200,5995
5.032,6,42,8289,21,227,251,314,4022,21,489,238,1179,4267
352.84,6,44,13149,22,258,16801,1440,3771,22,681,16782,1440,9378
10.763,6,20,4442,11,275,1076,275,998,9,768,761,1440,3444
62.74,6,31,24672,19,884,32,1360,6097,12,2583,5691,6097,18575
0.01,17,2,371,1,65,0,65,93,1,250,0,250,278
77.831,6,37,8495,18,410,517,882,1982,19,441,4313,1360,6513
11.855,6,25,8473,13,275,987,275,1078,12,986,864,1440,7395
9.087,17,3,1167,3,361,4543,361,1167,0,0,0,0,0
27.944,6,48,15491,22,164,1330,267,2037,26,689,1110,1400,13454
61.969,6,83,60376,52,1232,1215,1368,52028,31,841,2057,2736,8348
23.129,6,24,4099,14,211,1778,211,1385,10,545,2218,904,2714
503.956,2,5,160,5,8,125989,8,160,0,0,0,0,0
0.499,6,28,7336,13,155,41,267,1301,15,543,31,1400,6035
1786.614,6,102,8364,68,66,26665,66,4964,34,60,54137,60,3400
11.108,6,13,1554,7,325,1836,586,1022,6,212,2203,212,532
0.49,6,12,1653,6,288,92,288,548,6,426,58,434,1105
5.978,6,29,6175,15,338,427,1314,2294,14,368,459,1420,3881
0.302,6,26,8868,13,227,25,547,1592,13,941,24,1438,7276
818.871,1,8,448,8,28,116981,28,448,0,0,0,0,0
280.423,6,28,7352,13,158,23368,267,1317,15,678,20027,2085,6035
240.118,6,41,5398,21,247,12005,834,2833,20,189,12637,541,2565
1.132,17,419,437202,91,153,12,1350,16482,328,1254,3,1350,420720
504.571,2,4,128,4,8,168190,8,128,0,0,0,0,0
1770.686,1,58,4872,58,56,31064,56,4872,0,0,0,0,0
0.077,1,2,112,2,28,77,28,112,0,0,0,0,0
1787.914,6,368,26090,213,105,8433,469,15474,155,69,11609,69,10616
1747.953,6,95,7203,63,38,28192,205,4476,32,33,56377,98,2727
1788.753,6,360,22887,209,69,8599,69,12500,151,69,11924,69,10387
0.566,17,12,7794,6,679,113,1350,4244,6,563,70,1350,3550
0.676,6,35,8416,18,308,39,885,1984,17,478,29,2720,6432
0.047,17,4,308,2,38,0,38,132,2,60,10,66,176
40.831,6,27,7177,13,155,3402,267,1306,14,530,3139,3417,5871
1.528,17,2,144,1,36,0,36,64,1,52,0,52,80
510.143,6,69,5224,27,69,19615,295,2529,42,48,12438,78,2695
300.651,6,43,8820,22,286,14316,797,2104,21,390,491,4080,6716
1770.809,6,99,9174,66,64,27243,64,5544,33,58,55335,58,3630
1.677,6,21,5000,11,137,167,267,1132,10,692,162,1467,3868
1785.177,1,58,4872,58,56,31318,56,4872,0,0,0,0,0
313.069,6,23,2585,7,242,52177,517,1111,16,323,20870,499,1474
3.151,6,15,3632,8,150,450,174,624,7,681,271,1452,3008
14.141,6,13,892,0,0,0,0,0,13,24,1178,24,892
1788.616,6,278,34476,114,142,15827,1360,17028,164,135,10972,4662,17448
2.011,17,23,10747,11,477,201,1350,5563,12,404,149,1350,5184
2.072,6,30,5868,15,125,148,267,1359,15,780,128,1459,4509
8.152,2,2,64,2,8,8152,8,64,0,0,0,0,0
1795.318,17,448,39896,403,35,4465,288,25676,45,288,40020,288,14220
25.804,6,18,3376,7,49,2064,92,471,11,1164,2561,1448,2905
1795.175,1,278,15568,278,28,6480,28,15568,0,0,0,0,0
101.55,6,48,10136,23,631,864,1360,4179,25,290,4223,1360,5957
20.159,6,24,6232,14,117,1550,159,1337,10,727,2238,1418,4895
1798.597,17,142,11360,71,48,25694,48,5396,71,56,25694,56,5964
1740.556,17,30,7050,30,207,60019,207,7050,0,0,0,0,0
70.576,17,4,1344,4,308,23525,308,1344,0,0,0,0,0
33.715,6,29,5186,14,180,2593,721,1806,15,370,2392,2026,3380
3.84,17,4,352,2,48,3828,48,152,2,72,3828,72,200
72.818,6,37,13652,19,705,132,1440,5756,18,716,4273,1440,7896
1785.23,6,102,8364,68,66,26645,66,4964,34,60,54095,60,3400
0.124,17,2,439,2,191,124,338,439,0,0,0,0,0
272.378,17,6,456,6,48,54475,48,456,0,0,0,0,0
240.278,6,43,9052,22,523,11441,1408,5866,21,231,12013,617,3186
1681.187,1,15,840,15,28,120084,28,840,0,0,0,0,0
0.144,17,2,181,1,32,0,32,60,1,93,0,93,121
300.797,6,46,10280,24,433,13078,910,3194,22,364,736,2720,7086
300.703,6,38,8566,19,315,16705,882,2053,19,441,472,1460,6513
0.209,17,2,166,1,47,0,47,75,1,63,0,63,91
2.903,17,4,610,3,39,687,39,201,1,381,0,381,409
1744.676,2,18,576,18,8,102628,8,576,0,0,0,0,0
40.999,17,6,528,3,48,20495,48,228,3,72,20491,72,300
0.052,17,4,334,2,39,41,39,134,2,72,0,72,200
55.225,17,2,72,1,8,0,8,36,1,8,0,8,36
188.534,6,75,53909,49,1201,3927,1408,45825,26,747,2462,1408,8084
1793.661,1,245,13720,245,28,7351,28,13720,0,0,0,0,0
1657.13,1,7,392,7,28,276188,28,392,0,0,0,0,0
7.003,6,40,7309,20,218,368,314,3423,20,513,353,1179,3886
541.393,2,6,192,6,8,108278,8,192,0,0,0,0,0
0.203,6,25,7216,13,155,16,267,1301,12,775,17,2800,5915
19.427,17,15,8594,8,618,2764,1350,5175,7,460,3070,1350,3419
47.054,6,27,7177,13,155,3921,267,1306,14,530,3618,3417,5871
1795.347,1,296,31376,296,78,6085,78,31376,0,0,0,0,0
174.42,6,24,10054,12,532,60,1360,2642,12,1153,15843,2574,7412
1783.416,17,83,3480,82,14,22017,14,3444,1,8,0,8,36
264.701,17,2,136,2,40,264701,47,136,0,0,0,0,0
280.273,6,29,7392,13,158,23356,267,1317,16,603,18683,2036,6075
1740.925,17,29,6699,29,203,62175,203,6699,0,0,0,0,0
1787.21,6,115,11736,72,130,25171,1271,7562,43,68,42550,241,4174
1785.83,6,104,8444,68,66,26654,66,4964,36,60,51021,60,3480
2.811,6,56,14699,29,274,100,753,2399,27,509,102,1360,12300
1.293,17,26,16262,14,942,96,1350,13582,12,195,113,1350,2680
1700.483,17,12,498,11,14,170048,14,462,1,8,0,8,36
0.387,6,25,6032,12,164,35,453,1442,13,558,30,1448,4590
1741.461,1,15,840,15,28,124390,28,840,0,0,0,0,0
39.781,17,44,6468,22,48,1893,48,1672,22,190,1893,308,4796
0.005,17,3,1007,1,137,0,137,165,2,393,0,393,842
0.971,6,8,1607,5,100,242,100,304,3,1179,358,1179,1303
1740.504,17,29,30566,29,1026,62160,1026,30566,0,0,0,0,0
65.213,6,38,10273,19,783,493,1360,4711,19,399,3613,1360,5562
1797.108,17,449,39928,404,35,4459,288,25708,45,288,40021,288,14220
0.169,17,2,656,2,300,169,300,656,0,0,0,0,0
1732.909,1,84,4704,84,28,20878,28,4704,0,0,0,0,0
0.164,17,2,255,1,43,0,43,71,1,156,0,156,184
1771.403,6,101,9344,66,65,27252,65,5577,35,59,52097,59,3767
12.579,6,769,661441,485,1293,25,1368,642009,284,776,43,1473,19432
1794.362,17,142,11360,71,48,25633,48,5396,71,56,25633,56,5964
560.427,17,6,1647,3,30,280211,30,174,3,463,280210,463,1473
597.373,1,8,448,8,28,85339,28,448,0,0,0,0,0
87.138,17,4,352,2,60,87137,60,176,2,60,87137,60,176
0.144,6,8,475,5,43,36,43,311,3,0,16,0,164
1785.857,6,365,25501,213,99,8423,469,15005,152,69,11826,69,10496
7.701,17,24,9234,10,381,855,1350,4093,14,339,525,1350,5141
247.14,6,27,7312,12,158,22467,267,1277,15,678,17649,2045,6035
101.671,6,43,27291,26,667,42,1360,4407,17,2219,6342,8160,22884
0.455,6,23,5080,11,137,45,267,1132,12,577,40,1400,3948
43.573,17,24,1824,24,48,1894,48,1824,0,0,0,0,0
1788.262,6,370,26170,214,105,8395,469,15514,156,69,11537,69,10656
323.942,1,5,280,5,28,80985,28,280,0,0,0,0,0
300.605,6,47,9166,24,318,13069,927,2337,23,346,684,2128,6829
81.69,6,26,1068,12,0,4969,0,488,14,0,6280,0,580
1.492,17,6,360,3,32,745,32,180,3,32,745,32,180
0.613,6,15,1785,8,288,61,288,640,7,426,72,434,1145
62.638,6,7,292,4,0,20879,0,164,3,0,30655,0,128
1.02,6,10,767,5,186,254,186,454,5,45,252,45,313
1741.59,6,87,6322,58,31,30554,31,3915,29,31,62199,31,2407
0.107,6,15,1967,8,227,15,517,1320,7,87,15,156,647
25.201,6,22,4421,12,265,2291,517,2237,10,411,2798,499,2184
1758.17,17,72,3018,71,14,25116,14,2982,1,8,0,8,36
69.652,17,4,240,2,32,69651,32,120,2,32,69650,32,120
0.365,6,47,17866,25,976,15,1380,12744,22,421,15,1923,5122
0.799,6,15,1805,8,288,89,288,660,7,426,104,434,1145
377.974,2,4,128,4,8,125991,8,128,0,0,0,0,0
255.434,6,12,5455,4,106,85140,106,274,8,970,36488,1452,5181
26.931,6,1638,1472552,1039,1341,25,1368,1436728,599,776,44,1473,35824
0.041,17,4,344,2,47,0,47,150,2,69,2,75,194
0.675,6,9,1339,5,145,168,145,349,4,826,83,826,990
355.725,6,47,11709,26,151,14229,1402,3333,21,519,12196,1402,8376
1766.518,6,77,4056,39,26,46486,26,2054,38,26,47742,26,2002
1785.823,6,286,35742,116,150,15528,1360,17850,170,127,10565,1360,17892
26.974,6,20,2629,13,211,2247,211,1178,7,545,4495,904,1451
1756.541,6,110,6576,62,26,28794,26,3652,48,26,37372,26,2924
1772.762,6,181,15589,120,69,14897,69,8940,61,69,29542,69,6649
64.704,6,58,35643,36,1124,1848,1448,27746,22,749,2929,1448,7897
37.655,17,11,836,11,48,3765,48,836,0,0,0,0,0
0.867,6,21,5938,11,275,86,517,1683,10,931,95,1906,4255
6.176,17,4,240,2,32,6175,32,120,2,32,6174,32,120
0.178,17,2,230,1,40,0,40,68,1,134,0,134,162
1795.611,6,127,16907,78,221,23318,1302,11770,49,81,37406,241,5137
1799.869,17,29,9686,29,306,64281,306,9686,0,0,0,0,0
1795.029,17,447,39864,402,35,4476,288,25644,45,288,40018,288,14220
77.107,17,4,352,2,60,77106,60,176,2,60,77106,60,176
5.664,17,5,320,5,36,1416,36,320,0,0,0,0,0
0.091,6,2,142,1,0,0,0,40,1,62,0,62,102
167.12,17,15,1140,15,48,11937,48,1140,0,0,0,0,0
0.907,6,10,1687,7,100,151,100,384,3,1179,322,1179,1303
899.491,6,96,8325,61,71,14991,138,4648,35,69,26454,69,3677
32.015,6,147,138596,52,129,627,309,3091,95,1434,340,2836,135505
0.262,17,2,152,1,48,0,48,76,1,48,0,48,76
0.02,6,13,3980,7,88,3,88,388,6,1670,3,2920,3592
0.017,17,2,382,1,37,0,37,65,1,289,0,289,317
127.549,6,33,7757,12,155,89,267,1266,21,352,6376,1420,6491
3.396,17,2,656,2,300,3396,300,656,0,0,0,0,0
1645.308,1,55,4620,55,56,30468,56,4620,0,0,0,0,0
62.711,6,21,8512,11,545,118,1329,2108,10,998,6944,2720,6404
41.567,6,11,597,4,0,13855,0,204,7,7,6881,7,393
0.876,6,34,8400,17,308,54,885,1968,17,441,44,1360,6432
0.327,1,3,671,3,195,163,362,671,0,0,0,0,0
0.99,6,52,13853,24,549,43,1429,4824,28,438,35,1460,9029
1.752,6,26,5916,12,161,159,267,1451,14,780,127,1460,4465
1794.141,17,142,11360,71,48,25630,48,5396,71,56,25630,56,5964
364.14,6,51,3670,20,61,19158,294,1723,31,47,12134,78,1947
281.559,6,32,7512,14,158,21658,267,1357,18,603,16559,1400,6155
1788.602,17,87,3648,86,14,21042,14,3612,1,8,0,8,36
11.663,6,15,2309,9,211,1454,211,910,6,545,2332,904,1399
0.546,17,3,543,2,39,83,39,134,1,381,0,381,409
1788.062,1,251,14056,251,28,7152,28,14056,0,0,0,0,0
0.075,17,8,2750,8,315,10,354,2750,0,0,0,0,0
44.792,6,37,8368,18,367,513,786,1854,19,441,2480,1460,6514
240.195,6,54,16972,29,704,8578,1402,14200,25,183,10007,580,2772
1.003,17,4,694,3,32,494,32,180,1,486,0,486,514
128.07,6,36,5788,15,148,9147,722,1977,21,246,6384,1408,3811
1787.402,6,104,8376,68,65,26677,65,4930,36,59,51065,59,3446
0.411,6,10,968,5,256,98,256,460,5,304,97,304,508
2.418,6,13,2311,8,188,345,245,700,5,1407,530,1407,1611
38.333,17,22,1672,22,48,1825,48,1672,0,0,0,0,0
1.719,17,17,10681,9,585,214,1350,5521,8,617,170,1350,5160
5.008,17,4,514,2,36,5003,36,128,2,165,5003,187,386
0.022,17,5,1000,3,60,5,60,264,2,340,10,340,736
1360.34,6,84,6658,50,64,26518,64,3600,34,51,41219,58,3058
0.341,6,9,1348,5,145,85,145,349,4,835,88,835,999
371.594,6,25,1651,17,177,23224,177,1117,8,110,9232,110,534
0.045,17,2,162,1,34,0,34,62,1,72,0,72,100
10.699,6,16,5255,9,275,1337,275,643,7,1440,944,1440,4612
106.587,17,4,352,2,60,106585,60,176,2,60,106586,60,176
0.055,17,2,180,1,30,0,30,58,1,94,0,94,122
0.004,17,2,356,1,32,0,32,60,1,268,0,268,296
85.818,6,9,515,5,43,21454,43,299,4,0,28604,0,216
1771.689,6,101,9344,66,65,27256,65,5577,35,59,52104,59,3767
1791.424,1,58,4872,0,0,0,0,0,58,56,31428,56,4872
304.973,17,6,528,3,60,152486,60,264,3,60,152486,60,264
1645.481,1,7,742,7,78,274246,78,742,0,0,0,0,0
1.006,6,29,8200,15,222,60,540,1964,14,809,63,1460,6236
0.086,17,2,470,1,46,0,46,74,1,368,0,368,396
1786.871,6,102,8364,68,66,26669,66,4964,34,60,54142,60,3400
1777.012,6,205,23841,131,89,13669,981,11078,74,139,24335,2086,12763
1797.421,17,448,39896,403,35,4471,288,25676,45,288,40017,288,14220
17.91,17,4,352,2,60,17909,60,176,2,60,17909,60,176
1263.425,2,12,384,12,8,114856,8,384,0,0,0,0,0
33.813,6,4564,4475550,3164,1341,10,1368,4398086,1400,776,24,1473,77464
13.888,6,2746,2549646,1749,1378,7,1408,2493138,997,931,13,2816,56508
1770.96,1,58,4872,58,56,31069,56,4872,0,0,0,0,0
280.05,6,30,7432,13,158,23337,267,1317,17,543,17502,1400,6115
5.009,17,4,558,2,36,5002,36,128,2,187,5003,187,430
280.076,6,30,7432,14,158,21544,267,1357,16,603,18666,2800,6075
1785.854,6,363,24345,211,88,8504,469,13987,152,69,11826,69,10358
1772.537,6,180,15480,120,69,14895,69,8940,60,69,30037,69,6540
317.008,6,79,19456,40,325,8128,1360,9777,39,337,8336,1360,9679
12.763,6,85,24621,43,550,303,1152,18800,42,459,303,1179,5821
1.348,17,6,1449,3,40,664,40,204,3,387,663,391,1245
1.62,6,45,18623,27,858,62,1360,13127,18,476,83,2715,5496
41.875,6,48,9926,25,450,1744,766,2893,23,469,733,2720,7033
1784.143,6,486,39606,247,118,7252,1189,18417,239,81,7496,1420,21189
0.989,17,3,215,2,33,890,33,122,1,65,0,65,93
902.405,2,8,256,8,8,128915,8,256,0,0,0,0,0
3.809,6,34,6169,18,206,224,314,2784,16,548,236,1179,3385
240.167,6,53,17028,28,744,8894,1402,14115,25,200,10006,580,2913
1791.863,1,342,28728,342,56,5254,56,28728,0,0,0,0,0
1.598,17,4,240,2,32,1597,32,120,2,32,1596,32,120
34.618,17,5,1935,5,359,8654,371,1935,0,0,0,0,0
1790.061,1,172,9632,172,28,10468,28,9632,0,0,0,0,0
1785.854,6,369,23385,212,69,8463,69,12896,157,69,11447,69,10489
1785.858,6,362,24305,211,88,8504,469,13918,151,69,11905,69,10387
1772.413,6,180,15480,120,69,14894,69,8940,60,69,30037,69,6540
86.531,6,27,6690,19,268,4807,517,1802,8,892,32,2447,4888
29.876,6,633,533331,374,1351,80,1368,514041,259,1124,114,2736,19290
199.825,6,212,169158,135,1301,1491,1408,152846,77,647,2399,1408,16312
1772.296,6,180,15480,120,69,14893,69,8940,60,69,30037,69,6540
0.413,6,12,1653,6,288,77,288,548,6,426,47,434,1105
36.856,6,29,7257,14,155,2835,267,1346,15,482,2632,2840,5911
0.08,6,20,7002,10,146,8,173,954,10,920,7,1408,6048
1.201,17,22,9447,10,531,133,1350,5593,12,293,82,1350,3854
1772.824,6,180,15480,120,69,14897,69,8940,60,69,30040,69,6540
301.857,6,29,3321,12,324,27440,585,1301,17,223,18865,580,2020
367.058,6,23,1538,16,180,24470,180,1056,7,110,10416,110,482
1681.627,17,14,1036,7,30,280263,30,406,7,62,280263,62,630
0.264,17,2,198,1,39,0,39,67,1,103,0,103,131
67.443,6,49,10133,24,450,647,766,2865,25,347,2804,3488,7268
1799.092,1,83,8798,83,78,21940,78,8798,0,0,0,0,0
0.45,6,61,29017,34,1050,13,1380,20380,27,626,16,3303,8637
1770.618,6,221,19470,82,83,21857,368,8931,139,70,12829,1062,10539
1.128,6,24,9042,14,270,86,722,1673,10,1159,101,2720,7369
1795.212,17,449,39928,404,35,4454,288,25708,45,288,40020,288,14220
406.008,17,12,4016,12,306,36909,308,4016,0,0,0,0,0
0.085,17,2,192,1,60,0,60,88,1,76,0,76,104
1795.764,17,447,39864,402,35,4478,288,25644,45,288,40016,288,14220
0.033,17,4,284,2,32,0,32,120,2,54,4,60,164
30.776,6,16,4904,10,290,3419,517,1109,6,1158,6151,1487,3795
0.084,17,2,602,1,46,0,46,74,1,500,0,500,528
15.858,17,12,5304,6,490,3156,1350,3110,6,337,3157,1350,2194
1793.86,1,196,10976,196,28,9199,28,10976,0,0,0,0,0
3.984,17,4,240,4,32,1328,32,240,0,0,0,0,0
1683.057,6,32,4497,20,241,88581,241,3005,12,92,152965,92,1492
40.264,6,39,9184,23,538,1830,1228,5499,16,203,2684,1282,3685
1.68,6,25,8753,15,283,120,582,1454,10,985,168,1420,7299
1772.737,6,186,15927,122,69,14650,69,9089,64,69,28134,69,6838
0.123,17,2,136,1,32,0,32,60,1,48,0,48,76
3.224,17,3,1173,3,363,1612,363,1173,0,0,0,0,0
0.012,17,2,136,1,32,0,32,60,1,48,0,48,76
0.008,17,4,344,2,36,0,36,128,2,80,1,92,216
1495.613,6,1541,1419006,572,129,2619,346,36566,969,1458,1545,7090,1382440
377.12,6,25,1651,17,177,23570,177,1117,8,110,9287,110,534
240.705,6,122,80427,55,555,4457,1402,7326,67,1265,3646,2804,73101
232.202,17,4,352,2,60,232201,60,176,2,60,232201,60,176
0.028,6,10,1514,5,503,7,503,771,5,475,7,475,743
0.135,6,9,1002,5,213,33,213,417,4,421,36,421,585
240.197,6,41,13043,22,141,11437,336,1883,19,848,13343,2816,11160
0.268,6,30,6286,15,164,19,453,1610,15,486,18,1408,4676
69.0,6,654,312508,353,821,196,1152,294963,301,423,229,1179,17545
1386.044,2,9,288,9,8,173255,8,288,0,0,0,0,0
1710.186,1,8,448,8,28,244312,28,448,0,0,0,0,0
0.257,17,2,213,1,44,0,44,72,1,113,0,113,141
1799.313,17,451,151512,451,307,3998,320,151512,0,0,0,0,0
466.207,17,5,380,5,48,116551,48,380,0,0,0,0,0
630.601,2,4,128,4,8,210200,8,128,0,0,0,0,0
52.581,17,2,672,2,308,52581,308,672,0,0,0,0,0
1798.973,17,449,39928,404,35,4463,288,25708,45,288,40015,288,14220
416.238,17,7,539,7,49,69373,49,539,0,0,0,0,0
0.177,17,2,574,1,32,0,32,60,1,486,0,486,514
241.17,6,55,17907,29,794,8612,1418,15016,26,190,9646,580,2891
15.882,6,21,6825,12,275,1443,275,1038,9,1353,1357,1440,5787
1793.116,6,375,23280,208,69,8662,69,12460,167,52,10801,69,10820
125.272,6,25,9817,12,523,61,1440,2605,13,954,10428,1440,7212
1.189,6,51,21270,29,901,42,1360,15614,22,529,49,4075,5656
0.0,17,2,912,1,308,0,308,336,1,548,0,548,576
7.676,6,44,12909,21,208,383,721,2513,23,728,325,1440,10396
1794.594,1,58,4872,58,56,31484,56,4872,0,0,0,0,0
20.207,6,21,5418,12,107,1837,159,1074,9,967,2524,1659,4344
170.047,6,24,9863,12,410,68,922,1742,12,953,15445,1696,8121
0.043,17,2,152,1,48,0,48,76,1,48,0,48,76
4.938,6,38,7229,19,218,274,314,3383,19,440,260,1152,3846
0.786,6,17,5164,9,150,98,174,664,8,835,97,1452,4500
107.944,17,4,352,2,60,107943,60,176,2,60,107943,60,176
19.459,6,70,25426,35,882,572,1440,14735,35,543,564,1440,10691
4.037,17,6,5701,2,723,4037,1350,1503,4,1021,912,1350,4198
10.923,6,18,4214,10,275,1213,275,958,8,974,877,1414,3256
96.688,6,42,9913,16,290,2047,1189,2684,26,309,3867,1420,7229
1679.183,17,19,8284,19,408,93287,1249,8284,0,0,0,0,0
4.5,17,2,656,2,300,4500,300,656,0,0,0,0,0
2.223,6,13,2311,8,188,317,245,700,5,1407,492,1407,1611
259.04,1,4,224,4,28,86346,28,224,0,0,0,0,0
0.11,17,4,288,2,36,63,36,128,2,52,48,52,160
1670.232,17,4120,197760,2060,20,811,20,98880,2060,20,811,20,98880
1786.704,6,104,8444,68,66,26667,66,4964,36,60,51043,60,3480
11.476,6,1826,1585400,1097,1391,10,1414,1552019,729,467,15,1889,33381
240.316,6,43,8901,21,524,12015,1418,5817,22,214,11443,617,3084
0.05,17,2,212,1,46,0,46,74,1,110,0,110,138
1741.504,1,16,896,16,28,116100,28,896,0,0,0,0,0
5.629,6,578,536918,384,1335,14,1368,522166,194,776,28,1473,14752
1794.536,17,134,10720,67,48,27189,48,5092,67,56,27189,56,5628
1684.498,2,17,544,17,8,105281,8,544,0,0,0,0,0
0.698,6,21,7293,13,334,58,663,2033,8,967,95,1471,5260
0.79,6,20,5948,11,281,79,544,1288,9,716,89,1420,4660
1.77,17,20,5180,20,231,93,388,5180,0,0,0,0,0
1771.169,6,116,10790,74,66,24262,66,6338,42,60,43196,60,4452
0.735,6,479,435385,280,236,2,256,18127,199,2065,3,12672,417258
0.091,17,2,142,1,35,0,35,63,1,51,0,51,79
131.259,17,6,528,3,48,65625,48,228,3,72,65625,72,300
375.975,6,18,1242,14,180,28921,180,916,4,110,20072,110,326
1786.435,6,109,8759,71,65,25520,65,5115,38,59,48279,59,3644
197.24,17,8,704,4,48,65743,48,304,4,72,65743,72,400
0.157,17,2,672,2,308,157,308,672,0,0,0,0,0
1.505,6,48,19275,27,896,57,1360,13659,21,476,64,2715,5616
1.104,6,25,8080,12,164,85,267,1312,13,869,78,1408,6768
1797.983,17,448,39896,403,35,4472,288,25676,45,288,40019,288,14220
255.265,6,74,12047,33,198,5907,1189,3709,41,247,6381,1460,8338
256.425,1,4,224,4,28,85475,28,224,0,0,0,0,0
0.217,6,22,5040,10,137,24,267,1092,12,577,19,1400,3948
14.829,6,2,486,2,191,14829,191,486,0,0,0,0,0
1780.755,1,152,16112,152,78,11793,78,16112,0,0,0,0,0
1.972,6,30,12189,16,458,131,1360,3424,14,909,135,1380,8765
23.319,17,2,160,2,52,23319,52,160,0,0,0,0,0
0.026,6,19,4192,10,101,2,101,629,9,441,3,500,3563
1.656,6,6,340,3,0,828,0,160,3,0,529,0,180
120.404,6,11,676,4,106,40131,106,274,7,90,20065,90,402
2.905,6,2,120,2,0,0,0,120,0,0,0,0,0
24.322,6,3,132,0,0,0,0,0,3,0,0,0,132
220.48,17,4,352,2,60,220479,60,176,2,60,220479,60,176
0.1,6,2,446,1,354,0,354,406,1,0,0,0,40
0.152,17,4,524,2,39,136,39,134,2,167,136,167,390
1799.536,17,80,3354,79,14,23070,14,3318,1,8,0,8,36
591.249,6,37,2897,23,66,26874,66,1646,14,57,45474,60,1251
15.134,17,18,11628,10,910,1678,1350,9384,8,252,2157,1350,2244
1.228,6,8,342,4,0,409,0,164,4,7,289,7,178
11.707,6,1858,1620359,1123,1388,10,1414,1586702,735,420,15,1414,33657
0.176,6,3,151,1,0,0,0,40,2,31,0,31,111
362.074,6,80,19590,34,372,1457,1460,9586,46,254,8043,2920,10004
0.075,17,4,588,2,48,42,48,152,2,190,44,308,436
46.926,6,28,7217,13,155,3910,267,1306,15,482,3351,2840,5911
287.403,17,4,352,2,60,287401,60,176,2,60,287402,60,176
1793.356,17,87,3648,86,14,21098,14,3612,1,8,0,8,36
1776.314,17,73,3060,72,14,25018,14,3024,1,8,0,8,36
0.061,17,2,146,1,37,0,37,65,1,53,0,53,81
18.093,17,14,6139,7,504,3010,1350,3725,7,316,3009,1350,2414
0.216,6,9,527,5,43,54,43,311,4,0,69,0,216
0.038,6,3,120,2,0,38,0,80,1,0,0,0,40
0.18,6,3,160,2,0,180,0,100,1,0,0,0,60
84.846,6,20,4463,9,341,10605,722,1488,11,342,8450,1408,2975
83.187,6,30,7432,13,158,6932,267,1317,17,543,5198,1400,6115
1716.606,1,8,448,8,28,245229,28,448,0,0,0,0,0
253.989,1,41,1804,41,16,6349,16,1804,0,0,0,0,0
1792.138,1,68,3808,68,28,26748,28,3808,0,0,0,0,0
130.125,6,204,152202,121,1317,1084,1448,136716,83,620,1584,1598,15486
77.904,17,4,240,2,32,77902,32,120,2,32,77903,32,120
81.868,6,101,72962,63,1241,1320,1408,62861,38,811,2206,3847,10101
1787.008,6,102,8296,68,65,26671,65,4930,34,59,54148,59,3366
1748.741,6,121,12098,75,62,23631,722,6235,46,91,38854,1408,5863
1741.322,17,27,28458,27,1026,66973,1026,28458,0,0,0,0,0
1679.567,17,12,498,11,14,167956,14,462,1,8,0,8,36
104.177,17,4,304,4,48,34725,48,304,0,0,0,0,0
228.523,17,4,352,2,60,228522,60,176,2,60,228522,60,176
0.169,6,30,16938,15,129,12,129,917,15,1269,12,1448,16021
240.2,6,52,15237,28,676,8895,1402,12286,24,211,10442,580,2951
122.356,6,30,7432,13,158,10196,267,1317,17,543,7644,1400,6115
1787.716,6,375,26108,216,98,8314,469,15263,159,69,11312,69,10845
55.83,6,7,364,0,0,0,0,0,7,0,0,0,364
1770.852,6,101,9410,66,66,27243,66,5610,35,60,52081,60,3800
6.391,6,22,4426,12,213,581,597,1689,10,552,689,1767,2737
1799.999,6,228,19782,85,77,21428,337,8993,143,70,12675,1062,10789
163.723,6,9,515,5,43,40930,43,299,4,0,54573,0,216
1793.098,17,144,11520,72,48,25254,48,5472,72,56,25254,56,6048
4.082,6,6,328,4,0,1360,0,216,2,0,3940,0,112
98.424,6,92,65716,57,1228,1757,1368,57004,35,747,1971,1368,8712
0.351,17,8,2774,8,318,50,357,2774,0,0,0,0,0
281.218,6,29,7392,13,158,23434,267,1317,16,603,18745,2036,6075
0.038,17,2,166,1,39,0,39,67,1,71,0,71,99
1786.8,6,163,20860,96,302,18808,302,14688,67,83,27072,83,6172
1772.204,6,180,15480,120,69,14892,69,8940,60,69,30035,69,6540
1750.959,17,12,498,11,14,175095,14,462,1,8,0,8,36
1.229,6,25,8080,12,164,94,267,1312,13,869,86,1408,6768
1770.347,6,99,9306,66,66,27236,66,5610,33,60,55320,60,3696
127.828,17,27,4561,27,140,4916,352,4561,0,0,0,0,0
0.012,6,9,1547,5,515,3,515,783,4,548,4,548,764
99.71,6,47,13907,24,892,4327,1460,8154,23,370,4524,1460,5753
4.801,17,25,7734,10,305,533,1350,3338,15,265,227,1350,4396
302.003,1,4,224,4,28,100667,28,224,0,0,0,0,0
3.294,17,5,290,5,30,823,30,290,0,0,0,0,0
489.502,6,892,816056,333,183,1474,900,19918,559,1420,876,2836,796138
1799.019,1,345,28980,345,56,5229,56,28980,0,0,0,0,0
461.906,17,10,3380,10,310,51322,322,3380,0,0,0,0,0
59.736,17,7,532,7,48,9956,48,532,0,0,0,0,0
0.001,1,3,354,3,90,0,90,354,0,0,0,0,0
0.314,6,27,8955,13,234,26,575,1620,14,942,23,1438,7335
1681.291,17,14,3811,7,30,280214,30,406,7,458,280214,463,3405
0.013,17,2,348,1,43,0,43,71,1,249,0,249,277
7.573,6,19,6785,7,275,1262,275,834,12,910,667,2760,5951
17.038,6,21,12771,4,153,1607,180,486,17,828,1053,1360,12285
1796.838,17,144,11520,72,48,25307,48,5472,72,56,25307,56,6048
1770.338,6,210,16164,78,68,22989,296,7656,132,48,13514,78,8508
1780.26,1,342,28728,342,56,5220,56,28728,0,0,0,0,0
1754.185,6,187,11425,94,47,18862,208,6806,93,31,19064,31,4619
1781.791,6,84,4472,43,26,42422,26,2288,41,26,44543,26,2184
0.209,17,2,152,1,48,0,48,76,1,48,0,48,76
0.009,17,2,514,1,58,0,58,86,1,400,0,400,428
164.041,6,22,7902,11,367,74,798,1561,11,841,16389,2720,6341
0.008,17,2,515,1,137,0,137,165,1,322,0,322,350
1776.204,17,73,3060,72,14,25016,14,3024,1,8,0,8,36
23.86,6,1995,1743347,1227,1364,19,1380,1706181,768,468,31,3303,37166
1773.336,6,180,15480,120,69,14901,69,8940,60,69,30050,69,6540
10.767,6,18,5550,10,275,1196,275,958,8,1420,856,1420,4592
1787.576,6,104,8444,68,66,26680,66,4964,36,60,51069,60,3480
217.825,17,4,352,2,60,217824,60,176,2,60,217824,60,176
0.006,6,2,80,1,0,0,0,40,1,0,0,0,40
61.063,6,10,544,6,0,12212,0,320,4,0,20312,0,224
1755.418,1,71,5964,0,0,0,0,0,71,56,25077,56,5964
1.624,6,42,18867,22,694,77,1360,5823,20,815,67,1360,13044
0.389,6,12,1641,6,288,72,288,548,6,420,43,422,1093
40.017,6,19,5891,11,420,4001,984,1842,8,906,5715,1413,4049
1770.307,6,99,9174,66,64,27235,64,5544,33,58,55319,58,3630
1799.166,17,448,39612,404,35,4464,288,25708,44,288,40951,288,13904
1744.773,6,97,7307,63,38,28141,205,4476,34,33,52862,98,2831
11.677,6,1875,1624420,1147,1363,10,1380,1591058,728,421,16,1923,33362
41.393,6,48,10415,23,533,688,910,3147,25,329,1719,2720,7268
0.004,17,2,439,1,43,0,43,71,1,340,0,340,368
0.516,6,22,5962,12,108,46,147,919,10,927,55,1608,5043
90.659,17,4,1344,4,308,30219,308,1344,0,0,0,0,0
11.796,6,25,8473,13,275,983,275,1078,12,986,853,1440,7395
0.018,17,4,668,2,32,13,32,120,2,246,13,246,548
14.336,6,10,580,4,0,4778,0,220,6,0,2044,0,360
1742.968,6,96,7255,62,38,28573,205,4424,34,33,52804,98,2831
105.609,6,183,143293,115,1280,926,1368,130240,68,679,1572,2519,13053
1682.746,17,14,1036,7,30,280449,30,406,7,62,280446,62,630
0.714,6,17,5132,9,150,89,174,664,8,828,91,1420,4468
69.527,6,28,7286,13,155,5793,267,1306,15,488,4965,2840,5980
1771.606,6,99,9240,66,65,27255,65,5577,33,59,55359,59,3663
12.584,6,14,2242,8,210,1796,210,844,6,545,2509,904,1398
4.191,6,58,17641,31,776,139,1460,11408,27,340,144,1460,6233
779.185,17,12,504,12,14,70835,14,504,0,0,0,0,0
240.233,6,54,19246,29,828,8579,1418,16425,25,189,10009,580,2821
0.404,6,13,1693,7,288,62,288,588,6,426,47,434,1105
1794.014,17,180,11520,180,36,10022,36,11520,0,0,0,0,0
1799.584,17,449,39928,404,35,4465,288,25708,45,288,40020,288,14220
1249.962,1,16,896,16,28,83330,28,896,0,0,0,0,0
1798.776,17,142,11360,71,48,25696,48,5396,71,56,25696,56,5964
0.978,6,27,8506,15,229,58,583,2007,12,1201,73,3151,6499
5.377,6,27,6095,14,338,413,1314,2254,13,414,447,1420,3841
84.996,6,43,8823,21,367,745,787,2034,22,368,4040,2720,6789
1746.466,6,95,7203,63,38,28168,205,4476,32,33,56328,98,2727
75.123,17,4,288,2,36,75104,36,128,2,52,75105,52,160
18.284,6,24,6786,9,133,2285,267,901,15,586,1304,1926,5885
1750.24,6,94,7151,62,38,28692,205,4424,32,33,56451,98,2727
131.063,17,10,880,5,48,32763,48,380,5,72,32763,72,500
0.273,17,2,144,1,36,0,36,64,1,52,0,52,80
240.212,6,53,18086,28,814,8896,1408,15318,25,182,10008,580,2768
300.258,6,40,12495,21,592,15012,1408,4736,19,614,13538,1578,7759
326.303,6,21,11311,8,275,46587,275,603,13,1272,27176,1440,10708
1796.07,6,134,8725,75,51,24271,208,5218,59,31,30962,31,3507
1774.26,6,187,15967,123,69,14543,69,9129,64,69,28157,69,6838
1797.692,17,449,39416,404,34,4460,288,25444,45,282,40019,288,13972
1799.195,17,142,11360,71,48,25702,48,5396,71,56,25702,56,5964
0.665,6,5,272,3,0,332,0,164,2,0,480,0,108
13.854,6,24,6993,13,275,1154,275,1078,11,910,884,1420,5915
0.109,6,9,1002,5,213,27,213,417,4,421,32,421,585
10.074,17,4,352,2,60,10073,60,176,2,60,10073,60,176
1796.942,1,345,28980,345,56,5223,56,28980,0,0,0,0,0
0.429,6,10,1669,6,551,85,947,1346,4,159,142,159,323
3.038,17,4,340,2,37,3031,37,130,2,77,3031,77,210
295.484,1,4,224,4,28,98494,28,224,0,0,0,0,0
15.334,17,10,880,5,48,3831,48,380,5,72,3831,72,500
373.647,6,19,1303,14,177,28742,177,925,5,110,15774,110,378
0.493,17,3,451,2,39,348,39,134,1,289,0,289,317
3.213,17,5,360,5,44,803,44,360,0,0,0,0,0
105.385,6,30,7435,11,155,238,267,1226,19,388,5854,1420,6209
1.425,6,19,3781,10,234,158,564,1452,9,463,155,1343,2329
64.351,6,17,4186,4,151,21385,210,518,13,297,5338,1448,3668
1740.442,17,30,7050,30,207,60015,207,7050,0,0,0,0,0
1.385,6,39,8292,19,320,76,1162,2716,20,433,62,1360,5576
1794.083,17,144,11520,72,48,25268,48,5472,72,56,25268,56,6048
1.428,6,46,18588,26,852,57,1360,13012,20,476,65,2715,5576
1.084,6,29,13181,17,529,67,1360,3370,12,1164,83,2720,9811
1781.253,1,102,5712,102,28,17636,28,5712,0,0,0,0,0
101.854,6,136,34135,68,81,1520,224,4928,68,483,1408,1418,29207
15.764,17,20,7705,9,512,1965,1350,4864,11,230,1572,1350,2841
1791.444,1,84,4704,84,28,21583,28,4704,0,0,0,0,0
1741.772,6,87,6322,58,31,30557,31,3915,29,31,62205,31,2407
1796.901,1,342,28728,342,56,5269,56,28728,0,0,0,0,0
9.202,17,4,352,2,60,9200,60,176,2,60,9200,60,176
0.433,6,4,1037,2,0,231,0,104,2,853,203,853,933
0.628,6,148,99025,79,1325,8,1432,92020,69,467,8,1871,7005
43.312,17,6,1236,3,48,21652,48,228,3,308,21651,308,1008
2.371,6,11,975,6,304,474,304,624,5,83,588,83,351
33.694,6,28,4939,14,154,2591,722,1807,14,480,2577,1440,3132
0.17,17,2,152,1,48,0,48,76,1,48,0,48,76
166.873,17,4,352,2,60,166872,60,176,2,60,166872,60,176
71.798,6,52,10222,25,450,587,766,2905,27,327,2755,1360,7317
21.399,17,2,152,2,48,21399,48,152,0,0,0,0,0
1.499,17,2,178,1,47,0,47,75,1,75,0,75,103
3.629,6,33,6129,17,206,226,314,2744,16,548,224,1179,3385
3.846,6,34,6185,18,206,226,314,2784,16,551,239,1179,3401
1679.576,17,12,498,11,14,167957,14,462,1,8,0,8,36
1742.95,6,95,7203,63,38,28112,205,4476,32,33,56217,98,2727
7.617,6,29,9224,11,155,51,267,1226,18,519,447,1420,7998
1.132,6,30,5973,14,123,87,267,1428,16,650,66,1452,4545
1749.191,6,94,7151,62,38,28675,205,4424,32,33,56411,98,2727
378.0,2,3,96,3,8,189000,8,96,0,0,0,0,0
1651.393,1,7,392,7,28,275232,28,392,0,0,0,0,0
0.022,17,2,180,1,30,0,30,58,1,94,0,94,122
1783.122,17,83,3480,82,14,22013,14,3444,1,8,0,8,36
1799.905,6,3486,4100086,1224,148,1471,852,74886,2262,1786,796,11216,4025200
1794.15,17,80,3354,79,14,23001,14,3318,1,8,0,8,36
143.739,6,7,422,5,53,35621,53,342,2,0,939,0,80
3.795,17,4,268,4,39,1265,39,268,0,0,0,0,0
1800.0,6,289,19986,116,46,15372,46,8144,173,46,10465,46,11842
2.993,1,4,336,4,56,997,56,336,0,0,0,0,0
90.247,6,8,320,1,0,0,0,40,7,0,15039,0,280
0.03,17,2,168,1,48,0,48,76,1,64,0,64,92
1.183,17,19,9583,9,399,147,1350,3849,10,545,107,1350,5734
4.611,6,38,7229,19,218,256,314,3383,19,513,241,1179,3846
787.734,1,16,896,16,28,52515,28,896,0,0,0,0,0
1.593,17,21,9190,10,542,177,1350,5708,11,288,117,1350,3482
1.354,6,48,19228,27,892,52,1360,13612,21,433,58,1360,5616
0.105,17,2,410,1,46,0,46,74,1,308,0,308,336
1786.41,6,117,9188,74,64,24471,64,5264,43,58,42531,58,3924
360.706,6,109,86561,73,1276,5009,1448,76579,36,675,2235,1448,9982
4.65,6,39,7269,19,218,258,314,3383,20,440,231,1152,3886
5.252,6,2,92,1,0,0,0,40,1,0,0,0,52
1786.423,6,102,8296,68,65,26663,65,4930,34,59,54131,59,3366
1785.86,6,378,26228,217,98,8267,469,15372,161,69,11161,69,10856
68.267,17,2784,3297490,389,77,175,1350,40905,2395,1331,28,1350,3256585
1764.04,1,116,6496,116,28,15339,28,6496,0,0,0,0,0
59.736,17,8,1648,4,48,19906,48,304,4,308,19904,308,1344
11.282,6,21,6825,12,275,1025,275,1038,9,1353,781,1440,5787
263.148,6,51,9459,23,108,8711,267,2128,28,269,9745,2840,7331
1691.205,17,18,6086,18,310,99482,1438,6086,0,0,0,0,0
373.847,6,19,1303,14,177,28757,177,925,5,110,15177,110,378
8.329,6,1099,954295,660,1366,12,1408,926803,439,931,18,2816,27492
0.101,6,9,1002,5,213,25,213,417,4,421,27,421,585
16.408,17,6,528,3,48,8200,48,228,3,72,8199,72,300
0.255,6,9,1338,5,549,63,549,753,4,421,58,421,585
6.238,6,45,12893,22,199,297,721,2477,23,730,274,1420,10416
1211.031,17,57,2388,56,14,22018,14,2352,1,8,0,8,36
7.823,6,78,24677,39,561,205,1152,18976,39,413,199,1152,5701
0.177,6,46,20981,26,1064,7,1420,15960,20,467,8,1883,5021
1772.052,6,180,15480,120,69,14891,69,8940,60,69,30032,69,6540
0.069,6,2,80,1,0,0,0,40,1,0,0,0,40
1739.695,6,87,6322,58,31,30520,31,3915,29,31,62131,31,2407
12.645,6,47,9905,23,450,574,766,2801,24,383,491,1360,7104
121.91,6,17,6300,2,106,250,106,194,15,422,8707,1420,6106
415.003,17,8,2688,8,308,59286,308,2688,0,0,0,0,0
1780.083,1,342,28728,342,56,5220,56,28728,0,0,0,0,0
890.565,6,63,9108,35,103,17798,500,2960,28,200,32981,1420,6148
0.072,17,2,152,1,48,0,48,76,1,48,0,48,76
0.407,17,3,1167,3,361,203,361,1167,0,0,0,0,0
4.648,6,10,1102,6,483,929,483,803,4,83,1546,83,299
1791.287,6,364,23116,211,69,8529,69,12718,153,69,11784,69,10398
240.347,6,42,8792,21,523,12017,1408,5810,21,235,12017,619,2982
1760.328,6,80,3200,40,0,45136,0,1600,40,0,45136,0,1600
103.869,6,728,323458,370,810,281,1152,303276,358,418,290,1179,20182
14.786,6,1886,1738392,1218,1374,12,1380,1704722,668,421,22,1923,33670
0.09,17,2,220,1,33,0,33,61,1,131,0,131,159
2.365,6,56,14836,27,537,90,1301,5469,29,454,81,3546,9367
1745.671,6,97,7307,63,38,28155,205,4476,34,33,52891,98,2831
129.072,6,1061,523662,569,849,227,1152,497795,492,412,262,1179,25867
0.771,6,26,5887,13,156,64,267,1462,13,650,58,1420,4425
1682.289,17,16,4392,8,30,240326,30,464,8,463,240326,463,3928
122.089,17,4,352,2,60,122088,60,176,2,60,122087,60,176
0.436,6,13,1693,6,288,83,288,548,7,426,40,434,1145
0.177,17,2,136,1,32,0,32,60,1,48,0,48,76
1744.93,6,95,7203,63,38,28144,205,4476,32,33,56273,98,2727
1797.567,1,342,28728,342,56,5271,56,28728,0,0,0,0,0
0.039,17,4,284,2,32,35,32,120,2,54,33,60,164
1.965,6,49,19283,27,833,75,1360,13615,22,476,80,2715,5668
1735.656,1,18,1008,18,28,102097,28,1008,0,0,0,0,0
4.616,6,51,33636,26,751,184,1360,6378,25,1458,185,2720,27258
1.001,6,30,12084,17,525,62,1360,3350,13,820,67,1380,8734
1795.314,17,80,3354,79,14,23016,14,3318,1,8,0,8,36
1740.573,17,29,6815,29,207,62163,207,6815,0,0,0,0,0
0.576,6,14,1745,7,288,66,288,600,7,426,67,434,1145
0.099,6,7,423,4,43,9,43,259,3,0,37,0,164
1794.352,6,356,22520,208,69,8668,69,12460,148,69,12206,69,10060
280.045,6,30,7432,14,158,21541,267,1357,16,678,18666,3456,6075
0.431,6,10,968,5,256,104,256,460,5,304,104,304,508
3.991,17,8,736,4,32,1326,32,240,4,96,1327,96,496
236.764,6,40,12156,20,633,12461,1360,4647,20,558,12448,1360,7509
156.0,6,22,7972,11,511,85,1194,2005,11,787,15582,1440,5967
1793.684,6,244,35804,152,302,11878,302,26032,92,83,19710,83,9772
1772.93,6,180,15480,120,69,14898,69,8940,60,69,30046,69,6540
0.059,17,2,384,1,32,0,32,60,1,296,0,296,324
150.249,6,47,8598,24,108,6532,267,2160,23,393,6829,1997,6438
0.138,17,4,420,2,33,0,33,122,2,121,88,145,298
1771.481,6,99,9174,66,64,27253,64,5544,33,58,55355,58,3630
8.427,6,1528,1367393,940,1375,8,1408,1332153,588,931,14,2801,35240
8.785,6,17,4130,9,275,1098,275,918,8,1440,1115,1440,3212
5.281,6,41,7349,20,218,277,314,3423,21,440,250,1152,3926
1779.302,17,142,11360,71,48,25418,48,5396,71,56,25418,56,5964
1799.989,1,15,840,15,28,128570,28,840,0,0,0,0,0
47.556,17,4,352,2,60,47555,60,176,2,60,47554,60,176
1772.155,6,180,15480,120,69,14892,69,8940,60,69,30033,69,6540
1764.02,6,228,22100,114,86,15610,721,11079,114,174,15608,1440,11021
2.697,17,4,1564,4,363,899,363,1564,0,0,0,0,0
94.735,6,34,18693,16,747,268,1460,4407,18,1129,5555,1460,14286
1777.672,17,142,11360,71,48,25394,48,5396,71,56,25394,56,5964
1797.93,6,371,25410,215,93,8401,469,14754,156,69,11598,69,10656
8.557,6,25,8855,14,295,658,579,1479,11,1154,843,3057,7376
116.583,6,47,9134,22,410,752,882,2226,25,327,4851,1360,6908
1772.155,6,180,15480,120,69,14892,69,8940,60,69,30031,69,6540
1741.293,17,30,31680,30,1028,60044,1028,31680,0,0,0,0,0
0.063,1,6,624,0,0,0,0,0,6,76,12,76,624
0.056,17,4,368,2,32,17,32,120,2,96,0,96,248
93.408,17,6,528,3,60,46703,60,264,3,60,46703,60,264
158.577,17,4,352,2,60,158576,60,176,2,60,158576,60,176
1796.356,17,142,11360,71,48,25662,48,5396,71,56,25662,56,5964
615.952,6,144,19124,60,96,10439,615,5864,84,159,7419,3289,13260
1741.336,17,30,31620,30,1026,60046,1026,31620,0,0,0,0,0
11.567,6,96,30753,48,606,246,1152,24351,48,407,240,1152,6402
0.263,6,10,1379,5,145,65,145,349,5,826,49,826,1030
1799.577,6,368,25759,214,99,8448,469,15045,154,69,11761,69,10714
125.38,6,12,3040,6,92,25076,92,400,6,581,25037,1402,2640
28.24,6,2814,2637249,1858,1343,15,1408,2582873,956,776,29,1408,54376
1731.66,1,92,5152,92,28,19029,28,5152,0,0,0,0,0
5.004,17,4,288,2,36,4987,36,128,2,52,4984,52,160
1789.738,17,140,11200,70,48,25938,48,5320,70,56,25938,56,5880
280.227,6,26,7272,12,158,25475,267,1277,14,775,21551,2800,5995
31.537,6,7,308,1,0,0,0,44,6,0,6291,0,264
1794.017,17,88,3684,86,14,21103,14,3612,2,8,1793834,8,72
0.12,17,2,136,1,32,0,32,60,1,48,0,48,76
166.0,6,95,72976,37,747,24,1360,4512,58,1271,2910,1360,68464
32.0,6,2,1762,2,829,32000,829,1762,0,0,0,0,0
1748.921,6,95,7203,63,38,28208,205,4476,32,33,56403,98,2727
280.318,6,29,7392,13,158,23359,267,1317,16,603,18682,2800,6075
18.078,17,34,17968,15,718,1289,1350,11191,19,328,1002,1350,6777
377.645,2,4,128,4,8,125881,8,128,0,0,0,0,0
280.438,6,28,7352,13,158,23369,267,1317,15,603,20027,2760,6035
365.712,6,18,1242,14,180,28131,180,916,4,110,20058,110,326
62.978,6,73,55979,49,1227,1312,1408,47981,24,963,2728,3847,7998
1740.415,17,29,30624,29,1028,62157,1028,30624,0,0,0,0,0
0.127,6,9,1340,5,145,31,145,349,4,827,29,827,991
1741.6,6,87,6322,58,31,30554,31,3915,29,31,62199,31,2407
15.297,17,20,6765,9,433,1908,1350,4149,11,209,1526,1350,2616
374.05,6,31,2249,16,64,24936,64,1088,15,46,26365,58,1161
1.526,17,4,396,2,39,1000,39,134,2,103,0,103,262
0.493,6,24,5980,12,164,44,453,1442,12,651,41,1448,4538
240.177,6,45,5691,24,235,10442,751,2918,21,185,12008,616,2773
73.705,6,15,3202,6,92,14741,92,400,9,1165,9143,1448,2802
1699.627,17,12,498,11,14,169962,14,462,1,8,0,8,36
1750.392,6,94,7151,62,38,28694,205,4424,32,33,56457,98,2727
67.36,6,27,7177,13,155,5613,267,1306,14,530,5180,3417,5871
1772.764,6,180,15480,120,69,14897,69,8940,60,69,30041,69,6540
38.768,17,22,1936,11,48,3873,48,836,11,72,3871,72,1100
1.242,6,25,8056,12,164,96,267,1288,13,869,87,1448,6768
0.345,17,8,2742,8,314,49,353,2742,0,0,0,0,0
2.519,17,4,1560,4,362,839,362,1560,0,0,0,0,0
1782.414,17,227,64817,227,257,7886,394,64817,0,0,0,0,0
0.095,17,2,192,1,37,0,37,65,1,99,0,99,127
0.175,17,2,152,1,48,0,48,76,1,48,0,48,76
0.35,6,24,6064,12,181,31,537,1526,12,651,29,1448,4538
1.332,6,38,8252,19,320,74,1162,2716,19,476,63,2715,5536
1785.268,17,87,3648,86,14,21003,14,3612,1,8,0,8,36
933.136,6,194,39930,86,429,10976,1460,31398,108,85,8719,1062,8532
7.738,6,50,19987,25,416,322,1360,4016,25,787,308,1360,15971
96.774,17,6,456,6,48,19354,48,456,0,0,0,0,0
1081.005,17,212,16112,212,48,5123,48,16112,0,0,0,0,0
0.888,6,10,1687,7,100,148,100,384,3,1179,323,1179,1303
5.004,17,4,288,2,36,4986,36,128,2,52,4985,52,160
1739.758,1,56,4704,56,56,31631,56,4704,0,0,0,0,0
0.154,1,2,112,2,28,154,28,112,0,0,0,0,0
689.464,6,98,16457,50,87,14070,721,4627,48,366,14664,1414,11830
1775.459,17,140,11200,70,48,25730,48,5320,70,56,25730,56,5880
0.13,17,2,206,1,44,0,44,72,1,106,0,106,134
7.611,6,1462,1329015,888,1416,8,1448,1294479,574,776,12,1448,34536
667.18,6,81,5552,30,46,23006,46,2362,51,46,13340,46,3190
0.014,17,2,455,1,43,0,43,71,1,356,0,356,384
7.367,6,1216,1171311,782,1423,9,1448,1144067,434,776,16,1448,27244
45.145,6,6,336,4,0,15048,0,216,2,0,8837,0,120
1763.917,2,15,480,15,8,125994,8,480,0,0,0,0,0
0.051,17,2,251,1,36,0,36,64,1,159,0,159,187
0.368,6,10,1865,6,649,73,1141,1542,4,159,113,159,323
103.368,17,4,1312,4,300,34456,300,1312,0,0,0,0,0
0.012,17,2,2142,2,1043,12,1043,2142,0,0,0,0,0
1705.88,1,8,848,8,78,243697,78,848,0,0,0,0,0
1795.505,2,26,832,26,8,71820,8,832,0,0,0,0,0
34.72,6,17,6107,4,98,11570,106,365,13,578,2892,1420,5742
4.974,2,2,64,2,8,4974,8,64,0,0,0,0,0
1.422,6,48,19686,27,925,54,1460,14070,21,433,61,1460,5616
1782.256,17,140,11200,70,48,25829,48,5320,70,56,25829,56,5880
1.051,6,10,1687,7,100,175,100,384,3,1179,395,1179,1303
21.289,17,2,642,1,300,0,300,328,1,286,0,286,314
7.365,6,1181,1063677,705,1427,10,1448,1034249,476,776,15,1448,29428
183.258,17,4,352,2,60,183257,60,176,2,60,183257,60,176
1795.568,1,58,4872,58,56,31501,56,4872,0,0,0,0,0
1797.497,6,371,25410,215,93,8399,469,14754,156,69,11594,69,10656
0.038,17,2,212,1,46,0,46,74,1,110,0,110,138
300.885,6,51,10578,26,433,12035,910,3310,25,329,627,2720,7268
0.196,6,9,1050,5,261,49,261,465,4,421,52,421,585
0.263,6,10,861,5,222,63,222,426,5,231,63,231,435
0.174,2,2,64,2,8,174,8,64,0,0,0,0,0
4.37,6,38,7229,19,218,242,314,3383,19,513,228,1179,3846
1776.216,17,73,3060,72,14,25017,14,3024,1,8,0,8,36
1783.573,6,102,8296,68,65,26620,65,4930,34,59,54045,59,3366
1773.092,6,181,15589,120,69,14899,69,8940,61,69,29550,69,6649
4.52,6,3,132,3,0,0,0,132,0,0,0,0,0
0.035,17,3,208,2,36,8,36,128,1,52,0,52,80
1771.413,6,103,9448,66,65,27252,65,5577,37,59,49202,59,3871
0.48,17,3,1170,3,362,240,362,1170,0,0,0,0,0
7.524,6,65,20086,34,540,228,1152,15419,31,489,240,1179,4667
0.514,17,2,685,1,308,0,308,336,1,321,0,321,349
1795.628,17,452,40136,405,35,4444,288,25780,47,277,38281,288,14356
33.553,6,30,5041,14,180,2581,721,1807,16,299,2223,1408,3234
31.65,6,8,376,2,0,31650,0,88,6,0,6294,0,288
5.257,17,4,304,4,48,1752,48,304,0,0,0,0,0
0.182,6,12,3462,6,75,36,75,395,6,1373,36,1448,3067
421.099,2,6,192,6,8,84219,8,192,0,0,0,0,0
3.825,17,3,228,3,48,1912,48,228,0,0,0,0,0
0.011,17,2,378,1,36,0,36,64,1,286,0,286,314
1795.578,17,449,39928,404,35,4455,288,25708,45,288,40018,288,14220
1688.294,17,14,3232,14,202,129868,682,3232,0,0,0,0,0
72.932,6,667,303117,341,830,214,1152,284231,326,417,223,1179,18886
1799.998,6,218,17079,82,73,21852,375,8216,136,49,13332,143,8863
1680.05,17,13,534,11,14,167985,14,462,2,8,1679863,8,72
45.226,6,372,170120,197,810,230,1152,158638,175,447,258,1179,11482
330.103,6,83,30731,39,595,8686,1418,10962,44,728,7676,1418,19769
0.822,17,2,122,2,33,822,33,122,0,0,0,0,0
0.051,17,2,192,1,60,0,60,88,1,76,0,76,104
0.019,6,3,168,2,0,15,0,104,1,0,0,0,64
42.483,6,35,8288,17,367,549,787,1814,18,478,2489,2128,6474
9.066,6,16,3911,9,275,1133,275,643,7,992,686,1440,3268
85.517,6,47,10139,19,263,1907,1189,2873,28,341,3166,1917,7266
1.178,17,12,7734,6,679,235,1350,4243,6,553,114,1350,3491
280.279,6,28,7352,12,158,25479,267,1277,16,603,18682,1400,6075
1786.419,6,102,8364,68,66,26662,66,4964,34,60,54130,60,3400
376.609,1,22,1232,22,28,17933,28,1232,0,0,0,0,0
0.064,17,2,167,1,39,0,39,67,1,72,0,72,100
26.054,6,6,328,4,0,8684,0,216,2,0,26046,0,112
8.115,1,9,756,0,0,0,0,0,9,56,1014,56,756
102.595,17,4,352,2,60,102594,60,176,2,60,102594,60,176
158.886,2,3,96,3,8,79443,8,96,0,0,0,0,0
5.027,17,4,288,2,36,5009,36,128,2,52,5005,52,160
1795.118,17,80,3354,79,14,23014,14,3318,1,8,0,8,36
0.869,6,2,1253,1,0,0,0,40,1,1173,0,1173,1213
0.039,17,2,586,1,46,0,46,74,1,484,0,484,512
0.288,6,21,5000,10,137,32,267,1092,11,692,28,1467,3908
1.337,6,46,18090,26,880,53,1360,12514,20,476,61,2715,5576
0.023,17,2,656,1,300,0,300,328,1,300,0,300,328
0.062,6,7,759,3,69,30,69,189,4,205,4,341,570
356.512,6,22,9953,4,106,1610,106,274,18,559,20970,1452,9679
1.361,17,20,10099,9,587,170,1350,5537,11,386,89,1350,4562
1793.084,6,383,23648,209,69,8620,69,12500,174,48,10364,69,11148
220.352,6,59,37924,37,1170,6120,1448,30024,22,749,2932,1448,7900
1679.646,1,8,448,8,28,239949,28,448,0,0,0,0,0
1.709,6,47,18888,26,938,68,1460,13272,21,433,74,1460,5616
10.92,6,87,27402,45,555,248,1152,21240,42,447,259,1179,6162
65.655,17,5,2136,5,399,16413,548,2136,0,0,0,0,0
0.834,6,4,253,2,31,834,31,111,2,31,565,31,142
5.007,17,2,150,2,47,5007,47,150,0,0,0,0,0
1772.88,6,181,15589,120,69,14898,69,8940,61,69,29545,69,6649
280.429,6,28,7352,14,158,21571,267,1357,14,678,21567,3456,5995
150.632,17,4,352,2,60,150631,60,176,2,60,150630,60,176
3.497,17,4,352,4,60,1165,60,352,0,0,0,0,0
4.18,6,28,11504,16,759,278,1408,3878,12,1398,378,4981,7626
1793.902,17,66,2766,65,14,28029,14,2730,1,8,0,8,36
1.157,6,25,8080,12,164,89,267,1312,13,869,81,1408,6768
1798.197,17,144,11520,72,48,25326,48,5472,72,56,25326,56,6048
23.866,6,22,2250,11,444,2380,666,1332,11,231,2384,231,918
1785.031,6,102,8364,68,66,26642,66,4964,34,60,54089,60,3400
1794.845,6,369,23454,213,69,8449,69,12936,156,69,11576,69,10518
3.016,6,40,19076,20,686,158,1440,5651,20,1051,150,1440,13425
90.994,6,18,1532,6,180,108,180,680,12,110,8257,110,852
0.723,6,12,3462,6,75,144,75,395,6,1373,144,1448,3067
1798.736,17,449,39928,404,35,4463,288,25708,45,288,40021,288,14220
0.246,17,2,157,1,31,0,31,59,1,70,0,70,98
1773.16,6,180,15480,120,69,14900,69,8940,60,69,30052,69,6540
1796.076,17,173,39840,173,202,10442,422,39840,0,0,0,0,0
4.782,6,34,6169,18,206,281,314,2784,16,456,300,1152,3385
24.499,17,24,3528,12,48,2213,48,912,12,190,2208,308,2616
6.585,6,45,8425,23,227,299,314,4102,22,491,301,1179,4323
1.857,17,2,178,1,29,0,29,57,1,93,0,93,121
240.211,6,51,16596,28,715,8896,1402,13635,23,251,10918,580,2961
1645.485,1,7,392,7,28,274247,28,392,0,0,0,0,0
300.76,2,4,128,4,8,100253,8,128,0,0,0,0,0
0.113,17,2,904,2,424,113,548,904,0,0,0,0,0
1793.549,1,193,10808,193,28,9341,28,10808,0,0,0,0,0
5.043,17,4,288,2,36,5012,36,128,2,52,5011,52,160
0.351,6,4,220,2,0,351,0,100,2,0,295,0,120
0.938,17,4,624,2,64,937,64,184,2,192,822,192,440
0.298,6,22,4442,11,165,29,456,1394,11,493,28,888,3048
660.072,17,106,35129,106,303,6286,329,35129,0,0,0,0,0
162.484,17,4,352,2,60,162483,60,176,2,60,162483,60,176
0.426,6,21,7203,13,318,35,600,1958,8,1607,58,3299,5245
20.142,6,20,5524,12,115,1831,159,1221,8,966,2875,1674,4303
23.834,6,989,869775,618,1333,38,1368,845371,371,776,63,1473,24404
10.986,6,18,5610,10,275,1220,275,958,8,1440,845,1440,4652
860.107,6,170,10733,98,69,8867,69,5921,72,69,12114,69,4812
73.187,6,31,8912,14,158,5629,267,1357,17,687,4570,1781,7555
0.493,17,8,2758,8,316,70,355,2758,0,0,0,0,0
280.308,6,29,7392,14,158,21562,267,1357,15,678,20020,3436,6035
1680.948,1,15,870,15,30,120067,30,870,0,0,0,0,0
1.782,6,3,144,1,0,0,0,40,2,0,6,0,104
207.229,17,4,240,2,32,207228,32,120,2,32,207228,32,120
1.474,2,3,96,3,8,737,8,96,0,0,0,0,0
42.764,6,36,8328,18,367,507,786,1854,18,478,2508,2720,6474
1786.667,6,102,8364,68,66,26666,66,4964,34,60,54138,60,3400
0.495,17,2,241,1,36,0,36,64,1,149,0,149,177
25.718,6,9,488,5,0,6429,0,280,4,0,2335,0,208
1681.55,1,15,840,15,28,120110,28,840,0,0,0,0,0
1795.77,6,358,22669,209,69,8633,69,12500,149,69,12133,69,10169
1.381,6,24,8004,12,164,105,267,1288,12,1014,107,2491,6716
557.871,1,80,4480,80,28,7061,28,4480,0,0,0,0,0
1785.202,6,104,8376,68,65,26644,65,4930,36,59,51003,59,3446
0.389,17,8,2774,8,318,55,357,2774,0,0,0,0,0
1739.471,6,87,6322,58,31,30517,31,3915,29,31,62123,31,2407
0.048,6,10,1866,6,649,9,1142,1543,4,159,15,159,323
260.83,17,4,352,2,60,260829,60,176,2,60,260828,60,176
37.708,17,11,836,11,48,3770,48,836,0,0,0,0,0
1711.07,1,8,848,8,78,244438,78,848,0,0,0,0,0
417.501,17,30,2384,17,48,26093,48,1292,13,56,26019,56,1092
1.364,6,29,9692,15,222,84,540,1996,14,1017,91,1591,7696
145.453,6,23,9806,12,410,53,922,1754,11,1085,14533,1696,8052
150.001,6,22,8784,11,325,65,634,1447,11,983,14987,1360,7337
294.895,1,4,224,4,28,98298,28,224,0,0,0,0,0
0.151,17,2,240,1,48,0,48,76,1,136,0,136,164
280.464,6,27,7312,12,158,25496,267,1277,15,775,20027,3465,6035
73.998,6,40,6214,20,165,3894,722,2528,20,293,3884,1408,3686
21.713,6,9,527,5,43,5428,43,311,4,0,7229,0,216
280.383,6,28,7352,12,158,25489,267,1277,16,603,18681,1400,6075
1798.973,17,449,39928,404,35,4463,288,25708,45,288,40016,288,14220
1091.355,17,216,16416,216,48,5076,48,16416,0,0,0,0,0
601.636,2,7,224,7,8,100272,8,224,0,0,0,0,0
379.899,6,23,1499,14,177,29223,177,913,9,110,10187,110,586
21.546,1,8,832,0,0,0,0,0,8,76,3078,76,832
280.079,6,28,7352,13,158,23339,267,1317,15,678,20000,2800,6035
1791.825,1,156,8736,156,28,11560,28,8736,0,0,0,0,0
481.287,2,7,224,7,8,80214,8,224,0,0,0,0,0
1765.65,1,7,392,7,28,294275,28,392,0,0,0,0,0
0.019,17,2,120,1,32,0,32,60,1,32,0,32,60
1794.786,1,45,3780,45,56,40790,56,3780,0,0,0,0,0
1772.81,6,180,15480,120,69,14897,69,8940,60,69,30038,69,6540
1775.126,6,180,15480,120,69,14917,69,8940,60,69,30077,69,6540
66.416,17,9,684,9,48,8302,48,684,0,0,0,0,0
1789.432,17,82,3438,81,14,22367,14,3402,1,8,0,8,36
1771.025,6,99,9306,66,66,27246,66,5610,33,60,55342,60,3696
7.223,6,1446,1205244,791,1427,8,1448,1160568,655,776,10,1448,44676
858.736,6,219,33316,110,209,7878,1440,23060,109,256,7929,1440,10256
6.16,2,2,64,2,8,6160,8,64,0,0,0,0,0
0.014,6,12,1867,7,125,2,125,497,5,367,3,500,1370
9.973,17,4,4250,4,1034,3324,1044,4250,0,0,0,0,0
1796.652,17,448,39896,403,35,4469,288,25676,45,288,40018,288,14220
15.956,6,64,18878,32,743,514,1360,11047,32,343,437,3494,7831
0.198,6,10,1102,6,483,39,483,803,4,83,63,83,299
0.014,17,2,334,1,32,0,32,60,1,246,0,246,274
0.036,6,11,3653,6,171,5,171,491,5,1447,8,2676,3162
8.946,6,4,240,4,0,0,0,240,0,0,0,0,0
842.217,2,7,224,7,8,140369,8,224,0,0,0,0,0
280.322,6,28,7352,12,158,25483,267,1277,16,603,18682,1400,6075
0.171,17,4,284,2,32,36,32,120,2,54,159,60,164
1771.627,6,99,9240,66,65,27255,65,5577,33,59,55359,59,3663
15.399,6,2761,2665863,1787,1414,8,1448,2610539,974,776,15,1448,55324
5.691,6,41,7349,21,218,284,314,3463,20,513,283,1179,3886
31.638,6,7,336,1,0,0,0,48,6,0,6324,0,288
1.337,17,2,784,2,364,1337,364,784,0,0,0,0,0
1752.913,6,95,7203,63,38,28272,205,4476,32,33,56533,98,2727
1.643,6,10,1687,7,100,273,100,384,3,1179,691,1179,1303
1.497,6,38,8254,19,321,83,1164,2718,19,433,73,1440,5536
1.024,6,10,1687,7,100,170,100,384,3,1179,379,1179,1303
19.169,17,4,352,2,48,19161,48,152,2,72,19160,72,200
0.182,6,26,7256,14,155,14,267,1341,12,678,15,4200,5915
1798.871,6,374,23723,215,69,8405,69,13223,159,69,11385,69,10500
0.027,17,4,1123,2,33,0,33,122,2,472,0,507,1001
0.444,6,48,20817,27,1045,17,1380,15747,21,421,19,1923,5070
1.321,6,46,18745,27,864,50,1360,13209,19,433,63,1360,5536
12.225,17,20,4325,10,47,1357,47,750,10,329,1357,341,3575
0.318,6,26,9060,13,271,26,726,1771,13,943,26,1408,7289
8.072,6,20,6326,13,563,672,1046,2373,7,716,1244,1780,3953
221.683,17,4,352,2,60,221682,60,176,2,60,221682,60,176
11.21,6,1805,1533506,1083,1361,10,1380,1500384,722,421,15,1923,33122
2.937,17,3,228,2,48,2903,48,152,1,48,0,48,76
1740.745,17,30,31680,30,1028,60025,1028,31680,0,0,0,0,0
11.799,6,1828,1630008,1107,1419,10,1432,1596935,721,467,16,1871,33073
0.001,17,2,411,2,177,1,197,411,0,0,0,0,0
1125.285,17,220,16720,220,48,5138,48,16720,0,0,0,0,0
1.7,6,14,2351,8,188,242,245,700,6,703,289,1152,1651
1747.964,1,57,4788,57,56,31213,56,4788,0,0,0,0,0
1772.115,6,180,15480,120,69,14891,69,8940,60,69,30035,69,6540
302.66,6,34,6471,17,286,18916,1314,2405,17,307,18915,1420,4066
82.364,6,15,612,6,0,6006,0,244,9,0,10293,0,368
1770.737,6,85,6156,56,31,32195,31,3780,29,31,63240,31,2376
78.429,6,14,1080,4,226,119,226,442,10,110,8694,110,638
95.663,6,918,444759,497,827,192,1152,422787,421,427,227,1179,21972
1790.634,6,389,24005,213,69,8446,69,12660,176,48,10232,69,11345
20.295,6,23,5533,13,107,1691,159,1126,10,966,2251,1708,4407
5.022,17,4,288,2,36,5004,36,128,2,52,4993,52,160
1759.946,6,154,9627,84,44,21204,208,5711,70,31,25503,31,3916
366.613,6,47,10492,29,290,13093,1360,4970,18,399,511,1360,5522
0.036,17,2,238,1,59,0,59,87,1,123,0,123,151
1786.5,6,104,8504,69,66,26272,66,5004,35,60,52540,60,3500
11.409,6,22,6817,12,275,1037,275,1038,10,1073,710,1440,5779
5.682,6,1660,1580953,1075,1395,5,1408,1545857,585,776,9,1408,35096
11.326,6,59,20279,33,333,353,333,2433,26,686,451,1368,17846
0.88,6,28,5967,13,156,73,267,1462,15,650,58,1304,4505
0.233,1,2,112,2,28,233,28,112,0,0,0,0,0
1797.471,6,1940,2092595,618,126,2913,347,41432,1322,1587,1360,4206,2051163
39.068,6,7,480,5,92,9767,92,360,2,0,3176,0,120
1.274,17,23,8767,11,414,124,1350,4872,12,296,112,1350,3895
219.357,6,324,267600,210,1330,1049,1408,245155,114,569,1922,2816,22445
107.822,6,20,8678,11,316,70,640,1421,9,1377,13462,3928,7257
1.263,6,55,20721,31,909,42,1360,14940,24,400,47,1360,5781
2.876,6,14,1435,7,283,449,283,938,7,105,450,105,497
201.697,6,114,91972,78,1256,2619,1368,81973,36,738,2370,2519,9999
0.092,17,2,157,1,31,0,31,59,1,70,0,70,98
1789.995,6,533,70267,290,249,6193,1189,39326,243,173,7396,1460,30941
1768.975,6,99,9174,66,64,27215,64,5544,33,58,55276,58,3630
0.013,6,11,1566,6,503,2,503,823,5,475,3,475,743
1.604,6,11,1727,7,100,267,100,384,4,589,447,1152,1343
280.483,6,30,7432,13,158,23373,267,1317,17,678,17524,2760,6115
12.695,6,23,6953,13,275,1057,275,1078,10,1092,853,2840,5875
1.63,6,7,376,4,0,543,0,216,3,0,639,0,160
1797.787,6,367,29653,206,75,8769,267,13442,161,131,11236,2006,16211
188.738,6,6,1255,4,327,62912,413,814,2,180,188546,269,441
8.276,6,68,20526,34,552,250,1152,15723,34,491,243,1179,4803
15.545,17,28,15587,15,796,1106,1350,12371,13,219,1288,1350,3216
1799.458,17,4593,220464,2297,20,783,20,110256,2296,20,784,20,110208
1797.255,1,345,28980,345,56,5224,56,28980,0,0,0,0,0
53.565,6,13,1079,12,43,4869,43,1019,1,0,0,0,60
3.803,6,32,6089,17,206,237,314,2744,15,548,252,1179,3345
142.365,6,19,4133,9,407,17795,722,1278,10,333,15796,1408,2855
0.556,17,2,384,1,39,0,39,67,1,289,0,289,317
1.049,17,3,451,2,39,89,39,134,1,289,0,289,317
1799.652,1,16,896,16,28,119976,28,896,0,0,0,0,0
0.778,17,4,368,2,64,777,64,184,2,64,777,64,184
221.892,6,39,8416,15,124,15849,267,1731,24,317,9647,1420,6685
0.281,17,2,152,1,48,0,48,76,1,48,0,48,76
1796.492,6,352,32010,196,105,9212,469,15516,156,124,11590,1452,16494
1740.013,17,29,19517,29,645,62143,645,19517,0,0,0,0,0
1777.735,6,189,16185,124,69,14453,69,9100,65,69,27776,69,7085
1746.852,6,95,7203,63,38,28175,205,4476,32,33,56343,98,2727
1720.63,17,12,498,11,14,172063,14,462,1,8,0,8,36
0.024,17,2,200,1,48,0,48,76,1,96,0,96,124
25.132,17,16,1408,8,48,3588,48,608,8,72,3588,72,800
440.529,17,6,528,3,60,220264,60,264,3,60,220264,60,264
0.018,17,8,2438,8,276,2,315,2438,0,0,0,0,0
1786.308,17,87,3648,86,14,21015,14,3612,1,8,0,8,36
280.649,17,14,4199,7,39,46774,39,469,7,504,46774,512,3730
1.421,6,47,18160,26,882,56,1360,12544,21,433,61,1360,5616
2.677,6,30,11053,15,208,191,475,1514,15,811,178,1440,9539
197.733,6,25,6318,9,272,95,516,1180,16,345,13176,1452,5138
0.469,6,10,968,5,256,103,256,460,5,304,110,304,508
1771.554,6,101,9344,66,65,27254,65,5577,35,59,52101,59,3767
4.485,6,104,70831,52,1012,87,1460,13247,52,1353,84,1607,57584
238.166,17,4,240,2,32,238165,32,120,2,32,238165,32,120
0.014,17,2,358,1,30,0,30,58,1,272,0,272,300
0.009,17,2,189,1,30,0,30,58,1,103,0,103,131
5.895,6,49,9469,24,233,256,314,4701,25,470,235,1179,4768
1741.737,17,30,7050,30,207,60059,207,7050,0,0,0,0,0
1731.98,1,8,848,8,78,247425,78,848,0,0,0,0,0
1.431,6,53,23879,30,997,49,1460,18183,23,433,55,1460,5696
1254.145,6,155,11664,59,66,21620,295,5549,96,48,13200,78,6115
229.47,6,31,6806,13,189,9174,516,1470,18,307,13493,1452,5336
108.473,6,49,10479,23,533,893,910,3171,26,312,4333,1360,7308
1783.59,17,83,3480,82,14,22019,14,3444,1,8,0,8,36
0.104,17,2,396,1,39,0,39,67,1,301,0,301,329
0.028,17,6,462,3,33,0,33,183,3,65,0,65,279
0.098,17,2,904,2,424,98,548,904,0,0,0,0,0
280.677,6,32,7853,14,158,21590,267,1357,18,524,16509,1400,6496
1795.346,17,445,39800,400,35,4499,288,25580,45,288,40015,288,14220
1776.261,1,54,4536,0,0,0,0,0,54,56,33514,56,4536
1786.702,6,102,8296,68,65,26667,65,4930,34,59,54139,59,3366
242.163,17,4,240,2,32,242162,32,120,2,32,242162,32,120
3.1,17,25,6357,10,261,344,1350,2898,15,202,111,1350,3459
0.088,6,3,2037,2,0,65,0,80,1,1917,0,1917,1957
1772.773,6,180,15480,120,69,14897,69,8940,60,69,30040,69,6540
10.049,6,12,820,5,92,2512,92,348,7,92,1523,92,472
0.039,17,2,237,1,72,0,72,100,1,109,0,109,137
1.056,17,2,144,1,36,0,36,64,1,52,0,52,80
1.494,17,2,154,1,33,0,33,61,1,65,0,65,93
1786.676,17,87,3648,86,14,21019,14,3612,1,8,0,8,36
3.858,17,8,1176,4,48,1282,48,304,4,190,1281,308,872
693.388,6,45,3488,24,63,25911,63,1716,21,46,34665,57,1772
283.581,6,33,7828,12,158,25474,267,1277,21,407,14178,1400,6551
1787.532,6,117,13900,76,82,23833,515,6004,41,160,44685,1452,7896
11.265,6,26,11333,13,275,938,275,1078,13,1215,904,2840,10255
1791.543,1,145,15370,145,78,12441,78,15370,0,0,0,0,0
1785.993,6,581,45761,299,176,5993,1189,24459,282,52,6355,432,21302
1789.124,17,142,11360,71,48,25558,48,5396,71,56,25558,56,5964
34.488,6,20,1709,10,333,3830,444,1070,10,231,3830,231,639
0.024,17,2,438,1,42,0,42,70,1,340,0,340,368
1.093,6,181,137601,106,1340,10,1432,130301,75,389,13,1432,7300
280.244,6,29,7392,13,158,23353,267,1317,16,603,18680,2800,6075
108.986,6,32,7653,11,155,623,267,1226,21,348,5448,1420,6427
13.026,6,2174,1788805,1171,1427,10,1448,1722783,1003,702,12,1448,66022
58.886,1,4,224,4,28,19628,28,224,0,0,0,0,0
0.579,17,15,5667,6,429,115,1350,2746,9,296,48,1350,2921
1682.787,17,14,1036,7,30,280455,30,406,7,62,280458,62,630
1781.243,17,136,10872,69,48,26194,48,5244,67,56,26988,56,5628
1.197,6,115,86933,50,131,24,232,2529,65,1363,16,1430,84404
1771.374,6,120,14040,78,86,23004,481,7355,42,118,43201,1368,6685
372.428,6,33,2033,20,33,19515,62,1296,13,36,30933,62,737
5.023,17,3,208,2,36,5000,36,128,1,52,0,52,80
1798.203,17,448,39896,403,35,4473,288,25676,45,288,40020,288,14220
1786.55,6,149,23872,90,292,20073,1302,16740,59,106,30801,268,7132
79.989,6,135,92407,76,1266,1066,1448,81236,59,674,1375,1448,11171
1798.925,1,58,4872,0,0,0,0,0,58,56,31560,56,4872
1753.296,6,141,8806,76,43,23377,208,4873,65,31,27388,31,3933
30.308,6,136,90045,79,1317,388,1460,82276,57,304,477,1460,7769
3.185,17,4,1560,4,362,1061,362,1560,0,0,0,0,0
1798.728,6,366,25072,214,94,8444,469,14576,152,69,11909,69,10496
0.064,17,4,284,2,32,45,32,120,2,54,21,60,164
17.411,17,2,134,2,39,17411,45,134,0,0,0,0,0
48.219,17,4,352,2,60,48217,60,176,2,60,48218,60,176
0.96,6,11,1727,7,100,160,100,384,4,589,235,1152,1343
0.741,6,11,3652,6,171,129,171,491,5,1446,180,2675,3161
118.239,6,20,11230,20,566,6223,1402,11230,0,0,0,0,0
73.66,6,17,4032,9,127,9207,127,531,8,1056,10417,1704,3501
1794.779,17,142,11360,71,48,25639,48,5396,71,56,25639,56,5964
30.602,17,4,304,4,48,10200,48,304,0,0,0,0,0
1789.332,1,250,14000,250,28,7186,28,14000,0,0,0,0,0
52.682,6,10,648,10,31,5853,31,648,0,0,0,0,0
115.853,6,30,7432,13,158,9654,267,1317,17,543,7236,1400,6115
8.82,6,10,5458,4,106,2940,106,274,6,1234,1698,3417,5184
5.157,17,3,208,2,36,5006,36,128,1,52,0,52,80
1787.91,6,371,25879,214,99,8393,469,15114,157,69,11460,69,10765
1.424,6,24,8004,12,164,111,267,1288,12,1014,109,2491,6716
10.645,17,54,33114,21,153,532,1350,3805,33,860,331,1350,29309
1.902,17,3,1170,3,362,951,362,1170,0,0,0,0,0
149.529,6,20,10080,11,433,68,990,1771,9,1587,18674,3928,8309
60.092,2,2,64,2,8,60092,8,64,0,0,0,0,0
12.232,17,10,2240,5,46,3054,46,370,5,346,3054,346,1870
1742.115,6,114,11172,72,93,24536,205,7656,42,31,42484,33,3516
281.295,6,29,7392,13,158,23441,267,1317,16,603,18739,2236,6075
0.175,1,2,112,2,28,175,28,112,0,0,0,0,0
1769.87,6,99,9306,66,66,27228,66,5610,33,60,55305,60,3696
1.401,6,50,19038,27,873,53,1360,13342,23,433,55,1360,5696
21.539,6,77,26182,36,828,615,1440,14833,41,481,529,1440,11349
1741.554,1,56,4704,0,0,0,0,0,56,56,31664,56,4704
1788.8,17,87,3648,86,14,21044,14,3612,1,8,0,8,36
2.51,6,20,3833,11,234,251,564,1504,9,463,289,1343,2329
1743.567,6,95,7203,63,38,28122,205,4476,32,33,56229,98,2727
0.33,6,21,5000,10,137,36,267,1092,11,692,32,1467,3908
0.065,17,2,279,1,36,0,36,64,1,187,0,187,215
56.051,6,44,12321,26,347,2242,1360,4546,18,640,2734,2720,7775
10.109,6,1606,1391094,965,1387,10,1420,1361233,641,467,15,1883,29861
1772.214,6,180,15480,120,69,14892,69,8940,60,69,30030,69,6540
768.003,6,10,1435,10,103,85333,138,1435,0,0,0,0,0
1782.059,6,103,8464,68,66,26597,66,4964,35,60,52410,60,3500
1772.814,6,149,14181,78,59,23023,517,5432,71,199,25325,2412,8749
36.127,6,28,7217,13,155,3010,267,1306,15,482,2579,1420,5911
0.007,6,2,92,1,0,0,0,40,1,0,0,0,52
1772.945,6,180,15480,120,69,14898,69,8940,60,69,30043,69,6540
0.01,17,2,166,1,39,0,39,67,1,71,0,71,99
47.327,1,12,672,12,28,4302,28,672,0,0,0,0,0
0.285,6,21,5000,10,137,31,267,1092,11,577,26,1400,3908
1799.999,6,212,16725,78,74,22987,365,8010,134,49,13533,80,8715
1774.656,6,180,15480,120,69,14913,69,8940,60,69,30073,69,6540
300.91,6,63,34421,37,711,8358,1408,6347,26,1484,9662,8340,28074
165.834,6,25,8747,12,641,79,1460,3077,13,856,13803,1547,5670
9.884,6,6,690,0,0,0,0,0,6,90,1976,90,690
748.183,6,71,8178,38,82,20216,722,3545,33,153,23374,2330,4633
10.763,6,21,5958,11,275,1076,275,998,10,909,979,2840,4960
1770.779,6,110,10116,70,65,25663,66,5943,40,59,45402,60,4173
3.66,17,2,178,1,29,0,29,57,1,93,0,93,121
3.996,17,3,186,3,34,1998,34,186,0,0,0,0,0
1786.428,6,104,8376,68,65,26663,65,4930,36,59,51038,59,3446
274.786,6,21,6652,3,112,295,112,240,18,355,16163,1420,6412
1798.849,1,202,11312,202,28,8949,28,11312,0,0,0,0,0
7.475,17,36,8639,11,280,746,1350,3395,25,181,309,1350,5244
6.365,6,44,8369,22,227,303,314,4062,22,489,290,1179,4307
0.023,17,3,244,2,32,0,32,120,1,96,0,96,124
0.541,6,53,24588,30,1013,18,1380,17503,23,558,22,1923,7085
1.394,6,50,19943,27,938,53,1460,14247,23,433,54,1460,5696
9.403,6,82,25034,43,568,223,1152,19333,39,459,241,1179,5701
1745.368,1,89,4984,89,28,19833,28,4984,0,0,0,0,0
444.559,6,62,8209,28,109,16459,722,2788,34,159,13466,2026,5421
280.24,6,29,7392,14,158,21556,267,1357,15,678,20015,3436,6035
1799.571,1,56,4704,0,0,0,0,0,56,56,32719,56,4704
1787.029,6,104,8308,68,64,26672,64,4896,36,58,51055,58,3412
5.038,17,4,558,2,36,5027,36,128,2,187,5028,187,430
1.404,6,51,19042,27,871,54,1360,13306,24,433,53,1360,5736
100.983,6,46,9719,23,259,775,464,1802,23,635,4584,3488,7917
1789.383,17,142,11360,71,48,25562,48,5396,71,56,25562,56,5964
0.014,6,11,3285,6,80,2,80,400,5,872,3,1448,2885
24.729,6,40,12156,20,633,1301,1360,4647,20,558,1292,1360,7509
0.262,17,3,451,2,39,137,39,134,1,289,0,289,317
84.659,17,4,352,2,60,84658,60,176,2,60,84658,60,176
354.928,6,36,7471,24,113,15431,516,2440,12,454,24658,1452,5031
0.425,6,230,211330,146,183,2,230,8557,84,2419,3,7040,202773
122.597,6,53,14446,25,168,5108,267,2525,28,674,4540,2800,11921
280.202,6,27,7312,12,158,25472,267,1277,15,678,20011,2045,6035
0.238,17,8,2750,8,315,34,354,2750,0,0,0,0,0
1.292,6,46,18121,26,882,51,1460,12545,20,433,58,1460,5576
11.809,6,1833,1632002,1109,1418,10,1432,1598809,724,420,16,1432,33193
280.478,6,31,7813,14,158,21575,267,1357,17,577,17528,2036,6456
1790.544,6,363,24883,211,94,8526,469,14456,152,69,11857,69,10427
5.398,6,38,7245,19,218,299,314,3383,19,516,285,1179,3862
1797.658,6,337,23244,143,46,12658,46,9504,194,46,9313,46,13740
241.212,6,29,3289,14,324,18554,585,1385,15,223,17197,580,1904
1748.606,6,104,8136,68,45,26098,205,5006,36,34,49949,98,3130
0.033,17,4,608,2,60,13,60,176,2,188,17,188,432
0.181,6,2,142,1,62,0,62,102,1,0,0,0,40
62.44,6,31,7725,11,155,12,267,1226,20,355,3286,3417,6499
669.281,1,9,908,9,72,83660,121,908,0,0,0,0,0
109.979,6,32,8952,14,158,8459,267,1357,18,624,6463,1400,7595
2.988,6,2,88,2,0,0,0,88,0,0,0,0,0
1.42,6,10,924,5,283,235,283,551,5,105,238,105,373
1741.434,17,27,28458,27,1026,66978,1026,28458,0,0,0,0,0
11.055,6,19,4362,11,275,1105,275,998,8,1010,892,2840,3364
240.232,6,52,17798,29,750,8579,1418,15017,23,225,10919,580,2781
7.796,6,9,10056,9,1369,974,1448,10056,0,0,0,0,0
1740.455,17,28,29568,28,1028,64461,1028,29568,0,0,0,0,0
140.817,6,3,2564,0,0,0,0,0,3,1222,70408,1222,2564
19.936,6,16,2439,8,125,2848,245,700,8,703,2414,1152,1739
1786.345,6,420,25149,210,69,8547,69,12540,210,34,8547,48,12609
1741.705,6,94,6834,60,31,29520,31,4081,34,31,52778,31,2753
1.208,6,44,17259,26,518,48,1360,9386,18,714,62,3289,7873
1787.991,1,264,27984,264,78,6798,78,27984,0,0,0,0,0
31.707,6,7,308,1,0,0,0,44,6,0,6093,0,264
1771.66,6,101,9344,66,65,27256,65,5577,35,59,52105,59,3767
1777.253,6,184,17095,122,83,14688,981,10001,62,74,29130,405,7094
1720.614,17,13,534,11,14,172043,14,462,2,8,1720422,8,72
9.467,6,85,25538,44,579,220,1152,19741,41,461,230,1179,5797
0.551,6,14,1745,7,288,64,288,600,7,426,62,434,1145
0.572,17,2,144,1,36,0,36,64,1,52,0,52,80
98.03,6,25,9999,13,410,68,922,1830,12,959,8898,2720,8169
21.137,6,6,2105,0,0,0,0,0,6,373,4227,373,2105
1763.377,17,150,24194,150,133,11834,373,24194,0,0,0,0,0
1763.676,6,80,4160,40,0,45218,0,2080,40,0,45218,0,2080
3.703,6,10,1000,5,177,925,177,622,5,110,839,110,378
2.94,6,14,2309,8,288,416,288,1204,6,426,510,434,1105
0.019,6,12,3462,6,75,3,75,395,6,1373,3,1448,3067
0.165,17,2,144,1,36,0,36,64,1,52,0,52,80
5.155,17,3,208,2,36,5005,36,128,1,52,0,52,80
1773.359,17,140,11200,70,48,25700,48,5320,70,56,25700,56,5880
116.869,6,36,8338,18,371,516,797,1865,18,478,6865,2720,6473
36.859,17,22,1936,11,48,3684,48,836,11,72,3684,72,1100
6.222,1,7,308,7,16,1037,16,308,0,0,0,0,0
296.173,17,24,3816,12,40,26923,40,816,12,222,26923,249,3000
1.309,6,49,19577,27,914,50,1360,13921,22,433,54,1360,5656
17.49,17,4,1344,4,308,5830,308,1344,0,0,0,0,0
47.195,6,14,5981,4,92,15731,92,296,10,1286,5213,1408,5685
310.981,6,219,175812,140,1299,2237,1408,159395,79,683,1862,2816,16417
12.058,6,55,9764,26,233,482,314,4785,29,380,421,1152,4979
1787.198,6,102,8296,68,65,26674,65,4930,34,59,54153,59,3366
0.048,17,4,352,2,37,0,37,130,2,83,10,89,222
1784.741,17,142,11360,71,48,25495,48,5396,71,56,25495,56,5964
0.058,6,10,1495,5,507,14,507,727,5,556,14,556,768
8.255,6,77,24637,39,561,217,1152,18976,38,413,215,1152,5661
170.658,1,4,224,4,28,56886,28,224,0,0,0,0,0
9.885,6,88,27649,45,551,224,1152,21090,43,439,229,1179,6559
66.855,6,27,7173,13,155,5571,267,1306,14,530,5141,3537,5867
0.007,17,2,550,2,247,7,247,550,0,0,0,0,0
101.361,17,6,1968,6,300,20272,300,1968,0,0,0,0,0
2.665,6,53,13930,25,551,111,1429,4892,28,416,83,1460,9038
1746.196,6,95,7203,63,38,28164,205,4476,32,33,56321,98,2727
0.088,6,9,1002,5,213,22,213,417,4,421,23,421,585
62.965,2,4,128,4,8,20988,8,128,0,0,0,0,0
0.061,1,4,224,4,28,20,28,224,0,0,0,0,0
1745.53,6,96,7286,63,38,28153,205,4476,33,33,54538,98,2810
2.413,6,109,87391,43,131,57,232,2249,66,1374,35,1455,85142
1745.584,6,95,7203,63,38,28154,205,4476,32,33,56298,98,2727
1744.612,2,30,960,30,8,60159,8,960,0,0,0,0,0
1795.99,6,126,8188,73,51,24944,208,5138,53,31,34532,31,3050
61.352,6,37,15983,22,805,2921,1408,9205,15,665,4364,1408,6778
240.702,6,47,18004,21,208,12021,582,2352,26,952,9622,1418,15652
0.059,17,4,284,2,32,40,32,120,2,54,46,60,164
1.614,6,19,3781,10,234,179,564,1452,9,463,175,1343,2329
1786.742,6,103,8404,68,66,26667,66,4964,35,60,52547,60,3440
7.165,6,60,11725,29,242,255,314,6019,31,446,230,1179,5706
1739.158,6,87,6322,58,31,30511,31,3915,29,31,62111,31,2407
592.053,1,6,489,6,53,118410,78,489,0,0,0,0,0
1800.0,6,219,18573,80,71,22405,301,8066,139,69,13043,1062,10507
1.681,6,49,19390,29,897,60,1360,13769,20,437,76,2715,5621
1776.491,17,138,11040,69,48,26124,48,5244,69,56,26124,56,5796
0.012,17,3,286,2,46,6,46,148,1,110,0,110,138
240.22,6,107,80501,40,217,6159,690,3612,67,1287,3639,1502,76889
20.141,6,21,3840,12,215,1831,517,1720,9,411,2516,499,2120
1792.54,1,160,8960,160,28,11273,28,8960,0,0,0,0,0
1798.42,17,179,13962,179,50,10103,50,13962,0,0,0,0,0
165.697,17,11,836,11,48,16569,48,836,0,0,0,0,0
1787.12,6,102,8180,68,63,26673,64,4872,34,57,54152,58,3308
496.895,17,8,673,4,31,165614,37,239,4,80,165615,136,434
0.585,17,2,174,1,45,0,45,73,1,73,0,73,101
11.719,6,16,5004,9,290,1464,517,1057,7,1191,1921,1396,3947
69.825,6,79,54523,49,1213,1454,1368,46227,30,841,2131,2519,8296
1007.825,2,7,224,7,8,167970,8,224,0,0,0,0,0
1771.3,6,99,9306,66,66,27250,66,5610,33,60,55350,60,3696
9.664,6,52,12454,27,174,371,624,3216,25,604,392,1438,9238
0.027,17,8,2742,8,314,3,353,2742,0,0,0,0,0
167.659,6,28,6515,11,216,6309,501,1310,17,322,10472,1420,5205
1.021,6,9,1046,3,69,506,69,258,6,137,135,341,788
21.216,6,12,2219,5,275,5304,275,479,7,1440,3483,1440,1740
21.097,17,4,240,2,32,21096,32,120,2,32,21096,32,120
0.709,6,24,5755,13,158,58,370,1315,11,799,70,1420,4440
300.242,6,31,11812,17,588,18765,1438,4437,14,948,18481,1488,7375
0.175,6,26,7256,13,155,14,267,1301,13,678,13,3436,5955
1797.344,6,371,25948,216,99,8359,469,15194,155,69,11670,69,10754
61.338,6,37,16752,22,809,2920,1448,9243,15,746,4363,1448,7509
0.13,6,38,14461,22,870,6,1420,9600,16,420,8,1420,4861
0.154,17,2,176,1,48,0,48,76,1,72,0,72,100
7.279,6,29,4685,14,195,559,293,2129,15,488,500,1179,2556
1783.761,17,361,103417,361,258,4954,422,103417,0,0,0,0,0
2.625,6,22,6421,10,268,285,517,1333,12,744,234,1418,5088
16.672,17,19,14540,12,1004,1511,1350,12394,7,278,2768,1350,2146
12.205,17,20,1420,10,32,1355,32,600,10,54,1355,60,820
125.623,2,2,64,2,8,125623,8,64,0,0,0,0,0
336.458,17,14,2884,7,48,56074,48,532,7,308,56074,308,2352
0.873,6,154,118255,94,1314,9,1432,111564,60,475,14,1871,6691
99.515,6,39,8268,16,149,6634,267,1692,23,332,4522,1420,6576
0.065,1,2,163,2,53,65,78,163,0,0,0,0,0
374.021,6,27,1767,18,177,22001,177,1181,9,110,8970,110,586
7.085,6,652,573772,409,1334,16,1368,556472,243,931,28,2736,17300
1.029,17,4,950,2,40,1017,40,136,2,379,1019,379,814
364.684,6,19,1303,14,177,28052,177,925,5,110,15155,110,378
346.8,6,247,43165,161,304,2167,304,32116,86,83,4076,83,11049
0.471,6,22,7345,14,334,36,663,2085,8,967,61,1946,5260
16.216,6,2266,2084307,1404,1404,11,1448,2034807,862,776,18,1448,49500
39.6,17,30,13672,15,511,2826,1350,8089,15,344,2826,1350,5583
271.028,6,73,51001,47,1190,5891,1408,42918,26,960,2465,3847,8083
247.781,6,182,146702,118,1290,2117,1368,133854,64,679,2043,2736,12848
1719.979,17,14,587,12,14,156361,15,505,2,13,729600,18,82
0.047,6,10,1609,5,106,11,106,374,5,967,11,967,1235
5.749,6,41,7365,22,201,273,314,3503,19,516,304,1179,3862
752.957,1,16,896,16,28,50197,28,896,0,0,0,0,0
445.839,17,6,528,3,60,222919,60,264,3,60,222919,60,264
0.365,6,3,144,2,0,365,0,92,1,0,0,0,52
1796.232,1,58,4872,58,56,31512,56,4872,0,0,0,0,0
1772.997,6,180,15480,120,69,14899,69,8940,60,69,30043,69,6540
32.609,6,18,5172,10,194,3621,427,1304,8,688,4656,1440,3868
0.201,6,33,7945,17,278,12,517,1815,16,498,12,1420,6130
0.383,6,2,80,1,0,0,0,40,1,0,0,0,40
5.082,6,12,1314,7,186,847,186,558,5,244,1265,476,756
1786.379,6,102,8296,68,65,26662,65,4930,34,59,54130,59,3366
4.021,17,5,489,4,33,1338,33,244,1,217,0,217,245
1024.407,6,32,15201,10,202,112322,241,1018,22,739,48781,1624,14183
0.17,6,24,7660,12,176,15,334,1339,12,1137,14,1648,6321
1.37,6,40,8401,21,320,68,1162,2820,19,437,66,2715,5581
300.361,6,203,194602,139,145,2176,230,8044,64,3003,4767,16896,186558
1749.502,17,12,498,11,14,174950,14,462,1,8,0,8,36
0.0,17,1,494,1,466,0,466,494,0,0,0,0,0
1.308,6,47,18164,26,882,52,1360,12548,21,476,56,2715,5616
0.022,17,6,462,3,33,0,33,183,3,65,0,65,279
718.31,2,20,832,20,17,37805,24,832,0,0,0,0,0
531.345,6,63,8961,32,98,17137,517,2683,31,357,17708,1418,6278
125.445,6,14,3866,7,407,20907,722,1174,7,581,20875,1408,2692
2.992,17,2,1430,2,687,2992,687,1430,0,0,0,0,0
0.126,17,2,283,1,31,0,31,59,1,196,0,196,224
1779.288,17,142,11360,71,48,25418,48,5396,71,56,25418,56,5964
1.388,6,127,98647,57,262,24,517,4857,70,1365,19,1614,93790
0.014,17,2,504,1,31,0,31,59,1,417,0,417,445
40.999,17,6,456,6,48,8199,48,456,0,0,0,0,0
3.915,17,5,290,5,30,978,30,290,0,0,0,0,0
273.706,17,14,588,14,14,21054,14,588,0,0,0,0,0
56.105,6,23,1699,17,43,3506,43,1339,6,0,9908,0,360
2.061,17,2,154,1,33,0,33,61,1,65,0,65,93
1753.276,6,241,19086,121,93,14610,208,13294,120,31,14731,31,5792
1.022,17,3,360,2,60,988,60,176,1,156,0,156,184
369.557,6,27,1767,18,177,21738,177,1181,9,110,8600,110,586
77.013,6,9748,9225308,6421,1358,11,1408,9047640,3327,931,23,2816,177668
2.137,6,332,316297,116,737,18,1009,10464,216,1409,9,2876,305833
19.076,17,39,19230,20,533,1002,1350,11225,19,393,1058,1350,8005
0.4,6,21,7203,13,318,33,600,1958,8,964,55,1471,5245
59.817,6,27,7177,13,155,4984,267,1306,14,530,4600,3417,5871
1797.258,1,188,10528,188,28,9611,28,10528,0,0,0,0,0
0.02,17,2,166,1,39,0,39,67,1,71,0,71,99
420.711,6,45,3870,30,69,14507,69,2235,15,69,30033,69,1635
1757.08,6,84,4496,42,26,42854,26,2248,42,26,42854,26,2248
117.662,6,24,8707,12,641,82,1460,3077,12,856,10679,1547,5630
3.756,17,36,7133,16,192,248,1350,3528,20,152,196,1350,3605
1.776,6,50,18999,28,933,65,1460,13298,22,400,74,1460,5701
2.846,17,4,304,2,48,2838,48,152,2,48,2838,48,152
1.214,6,38,8252,19,320,67,1162,2716,19,433,58,1360,5536
5.065,17,4,558,2,36,4999,36,128,2,187,5055,187,430
13.662,6,2,87,1,0,0,0,40,1,7,0,7,47
280.422,6,29,7392,13,158,23368,267,1317,16,603,18693,2036,6075
0.016,17,4,360,2,30,1,30,116,2,94,4,94,244
62.29,6,73,52680,47,1204,1354,1368,44594,26,840,2479,2519,8086
240.666,2,3,96,3,8,120333,8,96,0,0,0,0,0
4.621,6,16,2021,9,304,577,304,1388,7,83,755,83,633
1796.327,17,448,39896,403,35,4468,288,25676,45,288,40020,288,14220
0.478,6,28,7336,13,155,39,267,1301,15,543,30,1400,6035
3.498,6,44,20563,24,525,152,1440,3710,20,1068,174,1440,16853
365.707,6,18,1242,14,180,28131,180,916,4,110,20064,110,326
1.553,6,60,43414,39,1227,40,1408,36417,21,1179,69,3819,6997
20.656,17,4,352,2,48,20636,48,152,2,72,20637,72,200
1682.524,17,16,1265,8,30,240357,37,471,8,71,240358,136,794
1780.752,6,132,13277,82,65,21984,721,6833,50,91,36336,2026,6444
1.003,6,24,8004,12,164,91,267,1288,12,869,74,1408,6716
522.129,17,5,691,5,110,130532,355,691,0,0,0,0,0
92.887,17,12,1056,6,48,18575,48,456,6,72,18575,72,600
1.502,6,46,18927,26,944,60,1460,13351,20,476,68,2615,5576
4.011,17,8,736,4,32,1333,32,240,4,96,1330,96,496
240.305,6,59,17403,29,750,8581,1418,14280,30,194,8285,580,3123
0.038,17,2,300,1,58,0,58,86,1,186,0,186,214
0.014,17,5,498,4,36,3,36,256,1,214,0,214,242
16.418,6,35,8039,14,156,1262,267,1819,21,413,819,1460,6220
0.585,6,15,1785,8,288,59,288,640,7,426,68,434,1145
0.191,17,2,2384,2,1164,191,1164,2384,0,0,0,0,0
1700.48,17,12,498,11,14,170048,14,462,1,8,0,8,36
1792.306,6,364,24923,211,94,8534,469,14456,153,69,11791,69,10467
1735.322,17,182,29203,182,132,9587,392,29203,0,0,0,0,0
300.704,6,55,34446,32,461,9700,1290,3585,23,1647,1878,8014,30861
6.443,6,20,6745,7,275,1073,275,559,13,514,433,1440,6186
2.32,6,21,6352,10,262,252,517,1316,11,744,227,1418,5036
280.414,6,29,7392,14,158,21570,267,1357,15,678,20025,3456,6035
300.575,6,26,8009,14,173,23121,385,1431,12,849,21869,1408,6578
1783.303,17,83,3480,82,14,22016,14,3444,1,8,0,8,36
0.443,6,10,968,5,256,109,256,460,5,304,108,304,508
6.695,6,12,5954,5,130,1673,130,398,7,1296,1009,1296,5556
250.286,17,4,288,2,36,250266,36,128,2,52,250269,52,160
1782.826,6,102,8228,68,64,26609,64,4896,34,58,54022,58,3332
470.52,6,3460,2607078,1534,575,306,1368,223792,1926,1330,244,2736,2383286
16.763,6,12,2199,5,275,4190,275,479,7,1420,2727,1420,1720
1741.331,17,29,6699,29,203,62190,203,6699,0,0,0,0,0
297.28,6,37,7458,18,248,17482,517,1951,19,900,16511,3820,5507
31.05,17,5,3575,5,687,7762,687,3575,0,0,0,0,0
2.214,17,2,677,1,300,0,300,328,1,321,0,321,349
1699.61,17,13,534,11,14,169943,14,462,2,8,1699431,8,72
1797.135,17,448,39896,403,35,4470,288,25676,45,288,40016,288,14220
1789.339,6,356,22520,208,69,8644,69,12460,148,69,12172,69,10060
1793.567,6,319,27068,187,75,9642,267,12406,132,133,13691,1997,14662
6.305,6,14,1247,7,222,1047,222,728,7,231,1046,231,519
280.284,6,29,7392,13,158,23357,267,1317,16,603,18678,2036,6075
33.698,6,30,5043,15,154,2407,722,1860,15,399,2392,1408,3183
0.478,6,23,5080,11,137,47,267,1132,12,577,42,1400,3948
139.522,6,35,23891,19,840,34,1360,5835,16,1933,9292,8160,18056
1754.196,6,184,11274,93,47,19067,208,6735,91,31,19488,31,4539
2.992,17,3,1021,2,308,1999,308,672,1,321,0,321,349
1.358,6,10,1687,7,100,226,100,384,3,1179,551,1179,1303
1771.68,6,101,9410,66,66,27256,66,5610,35,60,52105,60,3800
0.121,17,2,152,1,48,0,48,76,1,48,0,48,76
286.651,6,27,2914,14,323,22046,582,1394,13,282,23882,580,1520
0.233,6,21,7281,13,334,19,663,2021,8,1209,32,1906,5260
29.043,1,30,840,30,0,0,0,840,0,0,0,0,0
273.175,17,4,352,2,60,273174,60,176,2,60,273173,60,176
16.676,17,29,13233,15,637,1190,1350,9975,14,204,1279,1350,3258
0.704,17,19,7498,9,501,88,1350,4765,10,245,72,1350,2733
220.005,6,28,7352,13,158,18333,267,1317,15,678,15712,4200,6035
52.002,6,17,8444,8,204,7428,722,1854,9,1221,2322,1448,6590
1770.993,6,99,9306,66,66,27246,66,5610,33,60,55340,60,3696
14.362,6,22,6865,12,275,1305,275,1038,10,1353,1545,1440,5827
240.201,6,54,17841,29,784,8578,1402,14856,25,209,10008,580,2985
0.387,6,10,968,5,256,92,256,460,5,304,91,304,508
39.099,17,24,2112,12,48,3549,48,912,12,72,3547,72,1200
1786.784,6,154,19574,92,302,19634,302,13852,62,83,29291,83,5722
1783.693,17,83,3480,82,14,22020,14,3444,1,8,0,8,36
949.533,1,18,1008,18,28,55854,28,1008,0,0,0,0,0
38.703,1,44,4576,0,0,0,0,0,44,76,900,76,4576
1.338,6,50,18975,27,869,51,1360,13279,23,433,52,1360,5696
1795.456,17,449,39928,404,35,4455,288,25708,45,288,40021,288,14220
0.001,17,8,2454,8,278,0,317,2454,0,0,0,0,0
8.858,6,25,7122,15,122,632,267,1272,10,1061,704,1368,5850
0.409,6,7,295,4,0,136,0,164,3,7,108,7,131
300.587,6,11,866,6,180,60078,180,500,5,110,75098,110,366
0.283,6,27,8951,13,232,23,567,1612,14,943,21,2816,7339
1.843,17,19,7703,9,501,230,1350,4765,10,265,199,1350,2938
743.102,17,84,7077,78,30,9649,37,4545,6,394,136278,463,2532
375.951,6,89,17411,46,147,8350,721,5967,43,486,8947,1414,11444
1.827,6,37,8214,19,321,101,1164,2718,18,476,93,2615,5496
7.508,17,6,456,6,48,1501,48,456,0,0,0,0,0
1772.667,1,58,4872,58,56,31099,56,4872,0,0,0,0,0
1700.754,17,13,534,11,14,170057,14,462,2,8,1700574,8,72
180.441,17,13,4368,13,308,15036,308,4368,0,0,0,0,0
207.579,6,31,8912,14,158,15967,267,1357,17,687,12970,1400,7555
1.542,6,49,31233,30,1138,53,1408,24340,19,982,76,2411,6893
0.02,17,4,284,2,32,14,32,120,2,54,13,60,164
1637.925,17,16,4241,8,30,233988,37,471,8,443,233988,463,3770
1794.963,6,356,22520,208,69,8671,69,12460,148,69,12210,69,10060
1782.658,17,142,11360,71,48,25466,48,5396,71,56,25466,56,5964
0.025,6,12,3434,6,125,4,125,445,6,889,4,1448,2989
1743.416,6,95,7203,63,38,28119,205,4476,32,33,56230,98,2727
1.474,6,6,340,3,0,737,0,160,3,0,500,0,180
0.175,2,3,96,3,8,87,8,96,0,0,0,0,0
612.942,6,36,2647,20,31,32260,31,1350,16,31,35411,31,1297
0.214,6,3,127,1,0,0,0,40,2,7,212,7,87
2.849,6,50,20827,28,934,105,1440,15171,22,433,127,1440,5656
7.92,6,6,260,2,0,7920,0,84,4,0,2359,0,176
0.935,6,11,1727,7,100,155,100,384,4,589,224,1152,1343
1798.593,17,140,11200,70,48,26066,48,5320,70,56,26066,56,5880
0.265,6,22,4442,11,165,26,456,1394,11,493,25,888,3048
1782.314,17,142,11360,71,48,25461,48,5396,71,56,25460,56,5964
1734.76,17,144,24390,144,141,12131,373,24390,0,0,0,0,0
1770.849,6,99,9306,66,66,27243,66,5610,33,60,55336,60,3696
3.176,17,2,632,1,288,0,288,316,1,288,0,288,316
0.431,6,50,21352,28,942,15,1380,16230,22,421,17,1923,5122
2.993,17,3,201,3,39,1496,39,201,0,0,0,0,0
0.783,17,2,685,1,308,0,308,336,1,321,0,321,349
0.932,6,25,8662,13,208,77,475,1386,12,969,68,1460,7276
171.642,17,8,2688,8,308,24520,308,2688,0,0,0,0,0
1739.323,6,87,6322,58,31,30514,31,3915,29,31,62117,31,2407
1768.881,1,58,4872,58,56,31033,56,4872,0,0,0,0,0
1764.664,2,14,448,14,8,135743,8,448,0,0,0,0,0
8.202,6,32,8952,14,158,630,267,1357,18,624,473,1400,7595
280.44,6,30,7432,13,158,23370,267,1317,17,678,17525,2760,6115
1.137,6,2,1253,1,0,0,0,40,1,1173,0,1173,1213
373.712,6,25,1639,16,177,24914,177,1053,9,110,8653,110,586
280.188,6,28,7352,13,158,23349,267,1317,15,603,20012,2036,6035
0.004,6,7,6144,6,1448,0,1448,6104,1,0,0,0,40
60.119,2,2,64,2,8,60119,8,64,0,0,0,0,0
1766.315,6,211,20572,108,75,16428,721,10047,103,193,17314,2535,10525
179.661,6,20,8239,11,525,84,1237,2048,9,1163,22437,3151,6191
72.32,6,18,4958,7,407,12053,722,1174,11,1069,7212,1448,3784
11.685,6,43,29283,24,243,508,444,1998,19,1877,648,5632,27285
840.719,17,10,2594,5,31,210177,37,297,5,431,210176,463,2297
1777.937,17,128,10240,64,48,28221,48,4864,64,56,28221,56,5376
1786.702,6,104,8376,68,65,26667,65,4930,36,59,51046,59,3446
0.798,6,4,191,1,0,0,0,40,3,31,68,31,151
50.099,6,39,10156,19,627,502,1460,3300,20,464,2627,1460,6856
82.199,6,23,948,10,0,6144,0,412,13,0,6849,0,536
6.699,1,4,224,4,28,2233,28,224,0,0,0,0,0
33.899,17,2,672,2,308,33899,308,672,0,0,0,0,0
505.505,6,68,11282,38,118,13662,267,4495,30,371,4871,1917,6787
280.916,6,29,7392,12,158,25537,267,1277,17,543,17554,1400,6115
62.236,6,74,51433,46,1201,1383,1368,43241,28,841,2295,2736,8192
3.052,17,3,1167,3,361,1526,361,1167,0,0,0,0,0
2.0,17,6,462,3,33,999,33,183,3,65,999,65,279
0.119,17,2,198,1,39,0,39,67,1,103,0,103,131
0.412,6,13,1693,6,288,76,288,548,7,426,37,434,1145
2.541,17,2,154,1,33,0,33,61,1,65,0,65,93
140.866,6,105,75724,65,1268,2201,1448,65544,40,674,1855,1448,10180
2.075,1,2,112,2,28,2075,28,112,0,0,0,0,0
0.258,6,2,115,1,23,0,23,75,1,0,0,0,40
158.549,6,43,6471,20,209,8344,585,2946,23,211,7190,580,3525
1795.798,17,142,11360,71,48,25654,48,5396,71,56,25654,56,5964
1793.308,6,358,22738,208,69,8663,69,12460,150,69,12035,69,10278
1795.958,17,447,39864,402,35,4478,288,25644,45,288,40018,288,14220
175.023,6,286,221739,172,1304,1023,1368,204557,114,641,1473,2519,17182
1.429,6,52,21426,29,908,51,1360,15730,23,433,56,1360,5696
274.859,17,4,240,2,32,274858,32,120,2,32,274858,32,120
280.481,6,28,7352,13,158,23373,267,1317,15,678,20026,3456,6035
1796.556,17,449,39928,404,35,4457,288,25708,45,288,40018,288,14220
1800.0,6,224,18003,79,76,22692,513,8253,145,50,12500,174,9750
267.519,6,2107,1864391,1417,1323,188,1360,1823968,690,147,388,1360,40423
222.108,6,31,8912,14,158,17085,267,1357,17,687,13877,1781,7555
1798.258,1,58,4872,58,56,31548,56,4872,0,0,0,0,0
0.966,17,2,204,1,34,0,34,62,1,114,0,114,142
0.104,6,11,913,6,182,20,182,490,5,77,16,134,423
0.115,17,2,152,1,48,0,48,76,1,48,0,48,76
8.558,6,19,4230,9,92,1069,92,624,10,385,930,1408,3606
95.823,6,47,10284,23,702,831,1360,4522,24,399,4157,1360,5762
15.464,17,20,2940,10,48,1716,48,760,10,190,1716,308,2180
1796.459,1,58,4872,0,0,0,0,0,58,56,31516,56,4872
7.615,6,1196,1042370,695,1417,10,1448,1011630,501,776,14,1448,30740
1783.595,6,356,22520,208,69,8616,69,12460,148,69,12131,69,10060
16.568,17,21,8804,10,321,1831,1350,3493,11,454,1652,1350,5311
1795.02,17,448,39896,403,35,4465,288,25676,45,288,40025,288,14220
87.816,6,34,24830,19,884,29,1360,6133,15,1808,6264,8160,18697
302.89,6,59,18911,31,890,10096,1440,8490,28,464,397,1440,10421
9.34,6,87,27770,45,582,212,1152,21608,42,407,221,1152,6162
3.002,17,3,1021,2,308,2001,308,672,1,321,0,321,349
1743.79,6,104,7550,66,31,26827,31,4503,38,31,47129,31,3047
1772.646,6,180,15480,120,69,14896,69,8940,60,69,30038,69,6540
280.511,6,30,7432,13,158,23375,267,1317,17,543,17528,1400,6115
5.0,17,4,288,2,36,5000,36,128,2,52,4999,52,160
215.566,6,54,11539,19,126,11975,267,2158,35,274,6339,1460,9381
1792.651,17,138,11040,69,48,26362,48,5244,69,56,26362,56,5796
0.25,1,2,112,2,28,250,28,112,0,0,0,0,0
46.211,6,30,7432,13,158,3850,267,1317,17,543,2886,1400,6115
2.07,1,2,112,2,28,2070,28,112,0,0,0,0,0
1798.456,6,376,27017,218,110,8287,469,16212,158,69,11454,69,10805
1700.453,17,12,498,11,14,170045,14,462,1,8,0,8,36
0.105,17,2,198,1,39,0,39,67,1,103,0,103,131
0.23,17,2,764,2,354,230,354,764,0,0,0,0,0
3.356,17,5,290,5,30,839,30,290,0,0,0,0,0
10.825,6,18,5610,10,275,1202,275,958,8,1440,829,1440,4652
0.513,6,9,527,5,43,128,43,311,4,0,86,0,216
2.415,17,4,1556,4,361,805,361,1556,0,0,0,0,0
1792.444,6,356,22520,208,69,8659,69,12460,148,69,12193,69,10060
1781.985,17,142,11360,71,48,25456,48,5396,71,56,25456,56,5964
1564.237,2,15,480,15,8,111731,8,480,0,0,0,0,0
1799.454,2,25,800,25,8,74977,8,800,0,0,0,0,0
1771.514,6,94,8797,63,65,28572,65,5356,31,59,59047,59,3441
8.884,6,38,8002,18,218,522,314,3343,20,550,454,1179,4659
401.4,17,10,880,5,48,100347,48,380,5,72,100347,72,500
1773.085,6,180,15480,120,69,14899,69,8940,60,69,30048,69,6540
0.502,17,3,451,2,39,379,39,134,1,289,0,289,317
1740.953,6,87,6322,58,31,30543,31,3915,29,31,62176,31,2407
1.271,6,47,19392,27,907,48,1360,13816,20,433,57,1360,5576
1795.055,17,29,9512,29,300,64109,300,9512,0,0,0,0,0
57.122,17,50,7704,25,48,2379,48,1900,25,204,2379,308,5804
121.487,6,21,8224,11,549,88,1309,2120,10,948,13479,1591,6104
280.497,6,30,7432,13,158,23374,267,1317,17,603,17527,1380,6115
1774.712,6,268,32433,108,137,16584,1460,15726,160,128,11160,1642,16707
21.21,6,29,7252,6,106,4242,106,354,23,313,959,512,6898
1786.903,6,102,8296,68,65,26670,65,4930,34,59,54144,59,3366
1.651,6,17,2349,8,324,235,585,1061,9,396,163,580,1288
0.796,17,18,7286,9,496,99,1350,4717,9,257,92,1350,2569
183.458,17,4,352,2,60,183457,60,176,2,60,183457,60,176
1770.189,6,27,4077,18,241,104128,241,2889,9,92,221247,92,1188
1252.204,6,254,16025,146,69,8635,69,8876,108,69,11702,69,7149
883.291,6,66,22455,36,584,25236,1360,12594,30,576,30452,2720,9861
1.544,6,46,19042,27,885,59,1360,13506,19,476,74,2720,5536
0.123,17,4,588,2,48,114,48,152,2,190,114,308,436
1775.45,1,148,8288,148,28,12077,28,8288,0,0,0,0,0
5.118,6,295,237110,175,967,29,1360,20294,120,1876,41,8160,216816
1799.863,1,345,28980,345,56,5232,56,28980,0,0,0,0,0
301.234,6,38,8578,20,315,15854,882,2105,18,441,534,1360,6473
1776.173,6,192,11749,95,47,18895,208,6877,97,31,18499,31,4872
62.873,17,4,304,2,48,62872,64,152,2,48,62872,64,152
1685.378,17,14,1036,7,30,280891,30,406,7,62,280888,62,630
17.026,17,40,14570,20,518,894,1350,10920,20,154,894,1350,3650
33.882,6,33,5198,16,154,2258,722,1912,17,299,2104,1408,3286
137.447,6,36,8522,17,401,4164,889,1916,19,416,7627,3488,6606
156.927,17,2,908,2,426,156927,687,908,0,0,0,0,0
280.58,6,28,7352,12,158,25507,267,1277,16,678,18696,2760,6075
92.437,6,11436,11053173,7679,1362,12,1408,10853047,3757,950,24,2801,200126
19.194,17,44,14878,22,463,912,1350,10808,22,157,912,1350,4070
0.309,6,26,9039,13,266,25,705,1750,13,943,25,1402,7289
0.058,6,9,1338,5,145,14,145,349,4,825,14,825,989
1783.811,6,363,24388,211,83,8490,965,13545,152,74,11813,256,10843
61.299,6,37,15966,22,801,2919,1408,9188,15,665,4361,1408,6778
1799.639,1,57,4788,57,56,32136,56,4788,0,0,0,0,0
125.338,6,15,3393,7,92,20889,92,452,8,420,17880,1402,2941
0.119,17,2,152,1,48,0,48,76,1,48,0,48,76
1798.39,17,142,11360,71,48,25691,48,5396,71,56,25691,56,5964
1737.804,1,56,4704,56,56,31596,56,4704,0,0,0,0,0
298.266,6,58,7142,26,182,11930,585,3375,32,149,9620,580,3767
5.23,6,20,7013,8,275,747,275,874,12,628,440,2840,6139
0.023,17,2,395,1,33,0,33,61,1,306,0,306,334
1787.848,6,104,8504,69,66,26291,66,5004,35,60,52580,60,3500
41.721,17,12,2784,12,204,3792,204,2784,0,0,0,0,0
1797.506,17,448,39896,403,35,4471,288,25676,45,288,40021,288,14220
0.042,17,4,480,3,60,11,60,264,1,188,0,188,216
336.495,17,14,2884,7,48,56079,48,532,7,308,56080,308,2352
4.091,17,14,14097,5,836,1022,1350,4323,9,1058,320,1350,9774
35.497,6,66,14256,33,401,754,889,2760,33,390,1104,2128,11496
94.33,6,615,306994,336,850,281,1152,293164,279,380,337,643,13830
57.876,17,4,352,2,60,57875,60,176,2,60,57875,60,176
299.558,6,6,364,4,31,99852,31,222,2,31,299537,31,142
0.017,6,15,5703,9,134,2,134,538,6,2456,3,2920,5165
1725.402,17,12,498,11,14,172540,14,462,1,8,0,8,36
2.764,6,8,8612,7,1368,10,1368,8572,1,0,0,0,40
1791.064,6,356,22520,208,69,8652,69,12460,148,69,12184,69,10060
6.765,6,32,7584,13,155,563,267,1306,19,367,375,1420,6278
1.317,6,39,11298,22,547,62,1360,5842,17,476,71,2720,5456
12.973,2,2,64,2,8,12973,8,64,0,0,0,0,0
1.774,6,12,1304,6,256,351,256,756,6,304,352,304,548
1786.552,1,83,6972,83,56,21787,56,6972,0,0,0,0,0
1632.236,6,24,3624,16,241,108815,241,2568,8,92,233149,92,1056
1771.914,6,180,15480,120,69,14890,69,8940,60,69,30030,69,6540
8.974,6,13,1451,7,332,1495,332,1036,6,83,1790,83,415
19.587,17,38,11004,18,252,1150,1350,5052,20,269,1029,1350,5952
1794.761,6,119,8847,66,27,27611,27,3927,53,107,34504,427,4920
27.77,17,9,3016,9,307,3471,308,3016,0,0,0,0,0
8.374,6,10,787,5,275,2093,275,479,5,96,1508,96,308
0.885,6,10,1687,7,100,147,100,384,3,1179,314,1179,1303
1792.873,6,356,22520,208,69,8661,69,12460,148,69,12196,69,10060
240.976,6,44,8845,23,140,10953,517,2596,21,396,12048,1511,6249
1671.349,1,8,448,8,28,238764,28,448,0,0,0,0,0
1789.958,6,367,25581,212,100,8483,469,14896,155,69,11623,69,10685
16.559,17,35,22469,18,753,972,1350,14072,17,465,1032,1350,8397
1792.103,6,363,23214,209,69,8615,69,12500,154,69,11713,69,10714
1684.611,17,12,498,11,14,168461,14,462,1,8,0,8,36
0.789,17,2,204,1,34,0,34,62,1,114,0,114,142
78.851,17,4,352,2,60,78850,60,176,2,60,78849,60,176
71.093,6,30,7435,13,155,5924,267,1306,17,453,4442,3417,6129
0.004,17,2,192,1,37,0,37,65,1,99,0,99,127
1772.659,6,180,15480,120,69,14896,69,8940,60,69,30039,69,6540
0.444,6,14,2181,8,324,63,585,1061,6,396,86,580,1120
1799.509,17,138,11040,69,48,26463,48,5244,69,56,26463,56,5796
1741.484,17,30,7050,30,207,60051,207,7050,0,0,0,0,0
1283.964,17,52,17472,52,308,25175,308,17472,0,0,0,0,0
5.558,6,43,8329,22,227,264,314,4062,21,489,264,1179,4267
240.186,6,54,18108,29,808,8577,1408,15257,25,192,10007,580,2851
1.346,6,54,21612,31,911,44,1360,15871,23,437,53,2715,5741
1740.433,17,30,31620,30,1026,60014,1026,31620,0,0,0,0,0
3.01,17,8,568,4,32,1002,32,240,4,54,1002,60,328
23.614,6,14,2676,6,821,4721,1420,1886,8,231,3372,231,790
1.318,6,28,7480,17,306,82,1087,2826,11,701,130,1728,4654
0.04,17,5,738,3,60,11,60,264,2,209,20,230,474
95.267,6,25,12110,13,493,150,832,2525,12,1136,8648,3928,9585
1.496,6,46,17176,25,877,62,1460,11560,21,476,65,2615,5616
4.32,6,38,7229,20,218,227,314,3423,18,513,239,1179,3806
1783.654,17,83,3480,82,14,22020,14,3444,1,8,0,8,36
1773.208,6,183,15738,121,69,14776,69,8980,62,69,29062,69,6758
0.002,17,2,136,1,32,0,32,60,1,48,0,48,76
4.908,17,22,7754,10,375,541,1350,4034,12,282,442,1350,3720
9.138,6,1757,1507508,986,1434,9,1448,1455348,771,776,11,1448,52160
8.254,6,1594,1454959,1001,1377,8,1408,1419459,593,931,13,2816,35500
1785.444,6,362,22967,210,69,8542,69,12747,152,69,11824,69,10220
1770.965,6,103,9448,66,65,27245,65,5577,37,59,49191,59,3871
34.283,6,30,5087,15,180,2448,722,1859,15,349,2435,1448,3228
359.617,6,29,7006,12,185,9957,499,1409,17,327,22469,1420,5597
1774.888,6,189,16254,122,69,14668,69,9089,67,69,26886,69,7165
1769.95,6,101,9344,66,65,27230,65,5577,35,59,52053,59,3767
4.747,6,14,3165,5,92,1186,92,348,9,772,565,2026,2817
1.43,6,50,30466,29,1155,51,1408,23469,21,1179,63,3819,6997
1793.111,6,356,22520,208,69,8662,69,12460,148,69,12197,69,10060
1.55,6,29,10388,17,373,96,851,1803,12,1012,133,1420,8585
0.21,6,9,527,5,43,52,43,311,4,0,34,0,216
1784.591,6,184,15847,122,69,14748,69,9089,62,69,29249,69,6758
2.888,17,4,734,3,46,1000,46,222,1,484,0,484,512
0.292,17,5,1752,5,322,73,353,1752,0,0,0,0,0
7.487,17,12,1764,6,48,1495,48,456,6,190,1495,308,1308
0.115,6,14,4570,7,155,19,155,527,7,917,19,1448,4043
1682.458,17,16,1184,8,30,240348,30,464,8,62,240348,62,720
0.31,1,6,624,0,0,0,0,0,6,76,62,76,624
240.333,6,43,9185,21,517,12015,1418,5758,22,252,11443,638,3427
172.474,17,4,352,2,60,172473,60,176,2,60,172473,60,176
82.623,6,15,612,6,0,7318,0,244,9,0,10326,0,368
1783.48,6,368,25152,213,93,8412,469,14605,155,69,11580,69,10547
35.909,6,1828,1629430,1125,1363,31,1368,1581282,703,776,50,1473,48148
120.151,6,24,10294,12,433,70,990,1835,12,995,10910,1390,8459
32.177,6,334,310085,124,122,261,289,8123,210,1412,153,2836,301962
0.902,6,10,1687,7,100,150,100,384,3,1179,319,1179,1303
0.912,17,4,624,2,64,883,64,184,2,192,560,192,440
0.808,6,10,1687,7,100,134,100,384,3,1179,272,1179,1303
0.326,6,7,716,4,226,108,226,442,3,110,81,110,274
0.052,6,14,1105,9,182,6,182,682,5,77,11,134,423
4.533,6,169,135337,73,226,62,255,7434,96,1321,47,2241,127903
1774.476,6,186,15927,122,69,14665,69,9089,64,69,28161,69,6838
0.015,17,2,572,1,39,0,39,67,1,477,0,477,505
64.303,17,4,352,2,60,64302,60,176,2,60,64302,60,176
3.394,6,2,88,2,0,0,0,88,0,0,0,0,0
0.646,6,54,21371,29,1062,23,1380,16084,25,355,25,1380,5287
0.867,6,31,15677,17,634,54,1360,3249,14,1185,52,2720,12428
290.867,6,30,8914,11,181,29086,267,1168,19,498,15975,1400,7746
1783.814,6,362,22967,210,69,8534,69,12609,152,69,11813,69,10358
215.151,17,4,5512,4,1350,71717,1350,5512,0,0,0,0,0
3.485,17,5,290,5,30,871,30,290,0,0,0,0,0
3.014,17,4,324,2,34,3006,34,124,2,72,3006,72,200
21.821,17,40,8187,17,167,1362,1350,3320,23,183,990,1350,4867
1682.732,17,14,1036,7,30,280448,30,406,7,62,280445,62,630
0.467,6,6,324,4,0,155,0,216,2,0,235,0,108
1772.308,6,180,15480,120,69,14893,69,8940,60,69,30037,69,6540
9.815,6,68,20398,35,547,288,1152,15651,33,427,298,1152,4747
1740.72,17,30,7050,30,207,60024,207,7050,0,0,0,0,0
1794.05,6,367,25581,213,99,8462,469,15005,154,69,11725,69,10576
43.559,6,10,949,6,330,8711,330,650,4,83,14515,83,299
1787.518,6,103,8268,68,64,26679,64,4896,35,58,52571,58,3372
24.748,6,22,8275,10,290,230,517,1109,12,816,2235,1288,7166
280.311,6,30,7432,13,158,23359,267,1317,17,543,17515,1400,6115
4.046,6,32,7856,19,456,224,1408,5560,13,230,336,580,2296
1792.653,17,130,10400,65,48,28009,48,4940,65,56,28009,56,5460
1740.39,6,87,6322,58,31,30533,31,3915,29,31,62155,31,2407
12.242,17,18,1274,10,33,1359,33,610,8,55,1311,61,664
8.937,6,582,494554,361,1302,24,1368,478398,221,776,39,1473,16156
1797.97,6,392,32747,223,102,8098,469,16329,169,128,10702,1460,16418
280.036,6,30,7432,14,158,21541,267,1357,16,603,18666,2800,6075
1.127,6,23,7952,12,164,87,267,1288,11,1216,95,2816,6664
1796.182,17,449,39928,404,35,4457,288,25708,45,288,40020,288,14220
22.327,6,41,6900,19,180,1240,314,3111,22,414,1047,1179,3789
240.3,6,55,19187,30,816,8285,1418,16264,25,201,10012,580,2923
0.014,17,2,352,1,49,0,49,77,1,247,0,247,275
2.303,17,20,5190,20,231,121,389,5190,0,0,0,0,0
0.072,6,6,718,3,304,31,304,460,3,102,27,102,258
1791.228,6,112,9003,73,65,24878,65,5260,39,59,47110,59,3743
1794.582,17,168,10752,168,36,10746,36,10752,0,0,0,0,0
1.877,6,15,1291,8,222,266,222,772,7,231,310,231,519
0.262,6,3,120,1,0,0,0,40,2,0,262,0,80
1759.044,1,76,6384,76,56,23453,56,6384,0,0,0,0,0
368.831,6,27,1767,18,177,21695,177,1181,9,110,8963,110,586
0.129,6,3,120,1,0,0,0,40,2,0,129,0,80
1772.642,6,180,15480,120,69,14896,69,8940,60,69,30036,69,6540
0.446,6,52,22114,29,984,15,1380,15029,23,558,18,1923,7085
0.479,6,20,7229,13,334,39,663,2021,7,1209,73,1946,5208
1779.994,17,140,11200,70,48,25796,48,5320,70,56,25796,56,5880
234.152,6,42,6049,21,128,11698,722,2382,21,285,11698,1448,3667
1794.762,17,460,78122,460,141,3910,378,78122,0,0,0,0,0
1.518,6,10,1687,7,100,253,100,384,3,1179,638,1179,1303
0.385,6,10,968,5,256,93,256,460,5,304,93,304,508
0.169,6,2,123,1,0,0,0,40,1,31,0,31,83
80.277,6,29,12948,16,524,5351,1440,4521,13,1104,6664,1440,8427
3.799,17,5,295,5,31,949,31,295,0,0,0,0,0
7.156,6,1522,1413253,970,1380,7,1408,1379885,552,931,12,2816,33368
317.054,6,72,19445,37,352,8807,1360,9972,35,350,9319,1360,9473
299.193,1,4,224,4,28,99731,28,224,0,0,0,0,0
1772.552,6,180,15480,120,69,14895,69,8940,60,69,30037,69,6540
3.742,6,32,6089,17,206,233,314,2744,15,548,248,1179,3345
1.639,6,13,2311,8,188,234,245,700,5,1407,348,1407,1611
1770.093,6,101,9212,66,63,27232,63,5511,35,57,52058,57,3701
1782.41,17,257,51922,257,174,6962,358,51922,0,0,0,0,0
1721.271,1,8,448,8,28,245895,28,448,0,0,0,0,0
4.115,6,22,6504,10,293,447,517,1409,12,893,367,2450,5095
8.828,6,26,9826,15,311,630,625,1590,11,1112,868,3928,8236
132.067,6,27,3656,9,304,16508,304,1704,18,83,7767,83,1952
1644.0,1,8,448,8,28,234857,28,448,0,0,0,0,0
299.603,6,6,364,4,31,99867,31,222,2,31,299574,31,142
1798.332,17,447,39864,402,35,4484,288,25644,45,288,40017,288,14220
28.607,6,43,9901,21,635,763,1360,4095,22,327,1353,2667,5806
1604.57,1,7,392,7,28,267428,28,392,0,0,0,0,0
1681.622,17,14,1036,7,30,280264,30,406,7,62,280265,62,630
300.782,6,38,16357,19,195,16710,431,1824,19,1128,3907,1408,14533
13.809,6,20,9474,8,517,1972,517,1494,12,1221,1254,1537,7980
0.035,17,2,144,1,36,0,36,64,1,52,0,52,80
14.151,6,84,24645,43,552,336,1152,18864,41,459,347,1179,5781
3.75,6,2,88,2,0,0,0,88,0,0,0,0,0
1564.214,2,14,448,14,8,120324,8,448,0,0,0,0,0
3.369,17,10,785,5,31,834,31,295,5,70,830,70,490
1747.242,1,8,448,8,28,249606,28,448,0,0,0,0,0
138.078,6,47,14823,20,213,1411,721,2511,27,660,5303,2840,12312
0.124,17,2,672,2,308,124,308,672,0,0,0,0,0
0.011,17,2,376,1,39,0,39,67,1,281,0,281,309
1772.099,6,180,15480,120,69,14891,69,8940,60,69,30033,69,6540
1745.845,6,95,7203,63,38,28158,205,4476,32,33,56309,98,2727
114.477,6,23,9192,12,703,81,1360,3324,11,1083,11429,3113,5868
20.205,17,27,8024,11,280,2017,1350,3390,16,261,1344,1350,4634
10.035,17,4,308,2,41,10003,41,138,2,57,10004,57,170
3.025,17,2,1430,2,687,3025,687,1430,0,0,0,0,0
18.827,17,22,13347,13,814,1566,1350,10951,9,238,2349,1350,2396
125.185,17,4,352,2,60,125184,60,176,2,60,125184,60,176
1773.42,6,180,15480,120,69,14902,69,8940,60,69,30050,69,6540
1745.932,6,96,7286,63,38,28160,205,4476,33,33,54548,98,2810
112.059,6,123,91280,76,1258,1494,1368,80714,47,676,2430,1368,10566
11.264,6,75,21390,40,521,288,1152,16202,35,472,323,1179,5188
281.81,6,29,7392,13,158,23484,267,1317,16,603,18767,2036,6075
280.552,6,29,7392,13,158,23379,267,1317,16,775,18699,4836,6075
1681.74,17,14,1036,7,30,280284,30,406,7,62,280284,62,630
1744.4,6,95,7203,63,38,28135,205,4476,32,33,56261,98,2727
0.384,6,23,7385,13,334,31,663,2021,10,1209,41,1906,5364
165.5,6,23,10009,12,531,57,1360,2637,11,1384,16537,3934,7372
109.707,17,4,1344,4,308,36569,308,1344,0,0,0,0,0
0.002,17,2,154,1,33,0,33,61,1,65,0,65,93
155.073,17,12,920,6,40,31011,41,412,6,56,31009,57,508
2.483,17,2,456,1,35,0,35,63,1,365,0,365,393
14.315,6,99,30435,49,577,298,1152,23922,50,409,287,1179,6513
240.212,6,56,19914,28,866,8896,1418,17064,28,173,8896,580,2850
280.52,6,29,7392,14,158,21578,267,1357,15,678,20027,3456,6035
0.196,6,25,7216,12,155,17,267,1261,13,678,15,2045,5955
3.462,17,5,290,5,30,865,30,290,0,0,0,0,0
0.555,17,3,1008,3,308,277,308,1008,0,0,0,0,0
0.114,17,2,2382,2,1163,114,1163,2382,0,0,0,0,0
0.018,17,6,460,3,40,1,41,206,3,56,2,57,254
2.977,17,4,1568,4,364,992,364,1568,0,0,0,0,0
1796.318,17,141,11276,71,48,25661,48,5396,70,56,25670,56,5880
1751.995,6,187,11425,94,47,18838,208,6806,93,31,19040,31,4619
1784.175,17,83,3480,82,14,22026,14,3444,1,8,0,8,36
8.62,6,24,5410,13,383,718,885,2589,11,448,844,1440,2821
8.477,6,23,4958,13,233,706,613,1837,10,648,920,1767,3121
1740.584,17,30,7050,30,207,60020,207,7050,0,0,0,0,0
40.402,17,36,5764,18,48,2375,48,1368,18,216,2375,308,4396
0.039,6,17,3174,8,459,4,803,1802,9,224,4,694,1372
186.362,6,42,6445,18,177,10962,722,2541,24,176,7543,1408,3904
31.445,6,7,336,1,0,0,0,48,6,0,6286,0,288
0.652,17,2,784,2,364,652,364,784,0,0,0,0,0
1787.872,17,82,3438,81,14,22348,14,3402,1,8,0,8,36
1.665,17,19,13640,11,986,165,1350,11154,8,282,232,1350,2486
4.077,17,5,290,5,30,1019,30,290,0,0,0,0,0
1792.132,17,162,40699,162,223,11131,479,40699,0,0,0,0,0
65.316,1,13,1352,0,0,0,0,0,13,76,5443,76,1352
1760.037,6,80,4250,40,26,45128,26,2132,40,26,45128,26,2118
1792.348,17,180,14040,180,50,10013,50,14040,0,0,0,0,0
1799.936,17,449,39928,404,35,4466,288,25708,45,288,40022,288,14220
20.181,6,21,5418,12,107,1834,159,1074,9,967,2519,1659,4344
846.248,17,19,7476,19,365,47013,548,7476,0,0,0,0,0
240.337,6,43,8866,21,524,12015,1418,5818,22,210,11444,618,3048
10.641,6,4,436,0,0,0,0,0,4,92,3547,138,436
0.706,6,3,182,1,0,0,0,40,2,31,704,31,142
298.816,6,29,10216,19,665,16600,1360,3454,10,1270,66,3595,6762
280.506,6,30,7432,14,158,21577,267,1357,16,678,18693,3456,6075
145.767,6,1128,1484378,524,296,278,426,29330,604,2384,241,14020,1455048
3.846,6,23,3770,12,323,349,582,1338,11,264,379,580,2432
1786.764,6,104,8376,68,65,26668,65,4930,36,59,51046,59,3446
240.29,6,45,9479,22,524,11441,1418,5882,23,239,10921,619,3597
1.713,6,14,2351,8,188,244,245,700,6,703,289,1152,1651
1799.818,6,358,22669,209,69,8652,69,12500,149,69,12160,69,10169
1.238,6,36,8192,19,241,68,619,1758,17,441,65,1460,6434
9.545,6,11,2997,4,92,3181,92,296,7,1164,1538,1448,2701
0.024,17,2,299,1,46,0,46,74,1,197,0,197,225
1759.06,6,77,4094,39,26,46290,26,2080,38,26,47541,26,2014
0.029,17,4,768,2,39,14,39,134,2,289,17,289,634
1794.369,17,342,54564,342,131,5262,391,54564,0,0,0,0,0
94.12,6,24,10168,13,549,65,1360,2749,11,1161,9396,2720,7419
0.108,17,2,234,1,41,0,41,69,1,137,0,137,165
280.038,6,29,7392,14,158,21541,267,1357,15,678,19999,3536,6035
1790.77,6,350,22487,199,69,9044,69,12100,151,69,11938,69,10387
37.486,1,43,4472,0,0,0,0,0,43,76,892,76,4472
1669.282,1,7,392,7,28,278213,28,392,0,0,0,0,0
0.088,6,10,766,5,185,21,185,453,5,45,14,45,313
240.214,6,53,17983,28,804,8896,1418,15146,25,191,10008,580,2837
1793.669,6,426,35176,236,104,7632,469,17918,190,130,9489,1917,17258
3.999,17,5,1160,5,204,999,204,1160,0,0,0,0,0
11.122,6,1723,1535974,1043,1418,10,1432,1504553,680,420,16,1432,31421
1.162,6,27,9633,14,350,89,1042,1993,13,1015,79,1460,7640
1788.528,17,83,3480,82,14,22080,14,3444,1,8,0,8,36
155.56,6,19,6518,4,106,51853,106,274,15,433,11110,2006,6244
0.009,17,2,306,1,33,0,33,61,1,217,0,217,245
1.483,6,10,1687,7,100,247,100,384,3,1179,616,1179,1303
59.574,17,4,1328,2,308,59574,308,672,2,300,44,300,656
0.13,17,2,2754,2,1349,130,1349,2754,0,0,0,0,0
300.773,2,5,160,5,8,75193,8,160,0,0,0,0,0
1798.185,17,450,39960,405,35,4450,288,25740,45,288,40022,288,14220
2.337,6,13,2311,8,188,333,245,700,5,1407,480,1407,1611
18.908,17,2,152,2,48,18908,48,152,0,0,0,0,0
1771.98,6,180,15480,120,69,14890,69,8940,60,69,30032,69,6540
1784.092,6,103,8404,68,66,26628,66,4964,35,60,52470,60,3440
26.726,17,3,228,3,48,13363,48,228,0,0,0,0,0
1.202,6,40,11338,22,547,57,1360,5842,18,476,58,2715,5496
1746.933,6,96,7286,63,38,28176,205,4476,33,33,54583,98,2810
240.642,6,43,5558,21,247,12031,832,2855,22,172,11458,614,2703
174.046,6,25,10113,13,531,56,1360,2701,12,988,15809,1360,7412
11.77,6,1830,1630978,1151,1362,10,1420,1599419,679,427,17,1420,31559
84.48,6,22,8452,11,314,81,634,1415,11,940,8434,1460,7037
54.307,6,6,364,4,31,18102,31,222,2,31,54291,31,142
447.817,6,296,179431,178,1003,1709,1360,87659,118,1101,3826,6800,91772
1798.774,17,449,39928,404,35,4463,288,25708,45,288,40018,288,14220
1786.255,17,259,77872,259,272,6923,422,77872,0,0,0,0,0
8.227,6,25,12388,11,275,822,275,994,14,984,458,2840,11394
4.972,17,4,530,2,36,4967,36,128,2,173,4967,187,402
537.637,1,6,336,6,28,107527,28,336,0,0,0,0,0
13.557,1,4,224,4,28,4519,28,224,0,0,0,0,0
3.2,6,21,6353,10,262,350,517,1316,11,744,315,1418,5037
1783.809,6,442,26152,232,69,7722,69,13420,210,35,8534,64,12732
1793.184,17,142,11360,71,48,25616,48,5396,71,56,25616,56,5964
0.392,6,10,968,5,256,95,256,460,5,304,95,304,508
1787.23,6,460,27973,225,69,7978,69,13554,235,36,7637,69,14419
1.273,6,25,8056,12,164,99,267,1288,13,869,90,1408,6768
0.528,17,2,384,1,39,0,39,67,1,289,0,289,317
18.079,17,4,352,2,48,18070,48,152,2,72,18066,72,200
1744.689,2,30,960,30,8,60161,8,960,0,0,0,0,0
31.536,6,7,308,1,0,0,0,44,6,0,6287,0,264
14.397,6,33,10496,17,324,899,721,2958,16,1147,946,1420,7538
96.248,6,834,399099,444,834,217,1152,377312,390,412,246,1179,21787
1631.707,1,7,392,7,28,271951,28,392,0,0,0,0,0
1675.041,1,7,742,7,78,279173,78,742,0,0,0,0,0
13.368,6,13,4769,9,290,1671,517,1057,4,1748,238,2916,3712
1.415,17,39,28798,23,1083,64,1350,25565,16,174,73,1350,3233
5.29,17,3,208,2,36,5000,36,128,1,52,0,52,80
0.057,17,2,412,1,33,0,33,61,1,323,0,323,351
107.949,6,23,10009,12,531,60,1360,2637,11,1384,10781,2720,7372
37.29,6,22,7936,8,156,5327,267,798,14,657,2853,1452,7138
1745.921,6,95,7203,63,38,28160,205,4476,32,33,56306,98,2727
0.436,6,26,8884,13,236,36,585,1630,13,938,34,1438,7254
1681.515,17,16,1265,8,30,240214,37,471,8,71,240214,136,794
99.62,17,4,352,2,60,99619,60,176,2,60,99614,60,176
20.354,17,31,2320,19,40,1130,41,1304,12,56,1682,57,1016
1799.029,6,355,22480,207,69,8733,69,12420,148,69,12237,69,10060
0.049,6,19,11417,12,125,4,125,793,7,2563,8,3012,10624
1786.471,6,104,8308,68,64,26663,64,4896,36,58,51039,58,3412
1796.847,6,360,22818,209,69,8638,69,12638,151,69,11975,69,10180
0.519,17,2,152,1,48,0,48,76,1,48,0,48,76
1681.966,17,14,1036,7,30,280319,30,406,7,62,280319,62,630
1773.042,6,180,15480,120,69,14899,69,8940,60,69,30045,69,6540
1.306,6,3,151,1,0,0,0,40,2,31,1306,31,111
1.387,6,38,8252,19,320,77,1162,2716,19,433,66,1360,5536
72.731,1,6,336,6,28,14546,28,336,0,0,0,0,0
1777.239,17,73,3060,72,14,25031,14,3024,1,8,0,8,36
0.078,6,9,1339,5,145,19,145,349,4,826,20,826,990
1.729,6,14,2351,8,188,247,245,700,6,703,292,1152,1651
197.657,17,4,352,2,60,197656,60,176,2,60,197656,60,176
366.997,6,21,1422,15,180,26214,180,992,6,110,12240,110,430
165.621,6,23,940,9,0,6411,0,364,14,0,12738,0,576
104.039,6,95,67647,60,1240,1763,1408,57688,35,739,2478,2816,9959
0.018,6,2,80,1,0,0,0,40,1,0,0,0,40
240.19,6,130,112731,41,216,6003,589,3438,89,1341,2729,2836,109293
178.325,6,12,829,7,31,29720,31,445,5,31,44534,31,384
1744.743,6,97,7307,63,38,28141,205,4476,34,33,52862,98,2831
299.525,6,7,404,4,31,99841,31,222,3,31,149758,31,182
1376.502,17,10,414,9,14,172062,14,378,1,8,0,8,36
1776.332,1,60,5040,0,0,0,0,0,60,56,30107,56,5040
0.012,17,2,366,1,36,0,36,64,1,274,0,274,302
1796.677,17,68,2847,66,13,27637,14,2767,2,12,1796446,16,80
1.251,6,24,8004,12,164,96,267,1288,12,1014,96,2804,6716
9.303,6,57,10673,29,238,332,314,5460,28,454,334,1179,5213
0.004,17,2,366,1,63,0,63,91,1,247,0,247,275
280.232,6,28,7352,12,158,25475,267,1277,16,603,18680,1400,6075
14.947,6,13,2133,8,324,2135,585,1073,5,396,3672,580,1060
1768.395,6,27,4077,18,241,104023,241,2889,9,92,221026,92,1188
1797.638,1,345,28980,345,56,5225,56,28980,0,0,0,0,0
8.981,6,3,180,3,0,0,0,180,0,0,0,0,0
1.65,17,3,1173,3,363,825,363,1173,0,0,0,0,0
0.044,17,4,368,2,32,30,32,120,2,96,24,96,248
1790.81,1,342,28728,342,56,5251,56,28728,0,0,0,0,0
1.768,6,50,19490,27,905,68,1460,13794,23,433,71,1460,5696
235.64,6,8,2017,5,355,58910,413,1267,3,210,117710,269,750
0.61,6,10,924,5,283,109,283,551,5,105,106,105,373
184.559,6,32,14768,20,741,9710,1215,9207,12,705,16774,1571,5561
1084.627,17,114,9754,105,30,10429,37,6125,9,375,127859,463,3629
1799.303,17,142,11360,71,48,25704,48,5396,71,56,25704,56,5964
1799.999,6,354,24176,154,46,11561,46,10058,200,46,9045,46,14118
193.648,6,18,1523,12,169,17604,169,1163,6,0,1614,0,360
1766.503,6,100,7525,65,38,27601,205,4611,35,33,51944,98,2914
1619.73,1,7,392,7,28,269955,28,392,0,0,0,0,0
2.384,17,3,174,3,30,1192,30,174,0,0,0,0,0
47.256,17,4,352,2,60,47254,60,176,2,60,47255,60,176
1786.804,6,107,8556,70,64,25895,64,5104,37,58,49630,58,3452
159.447,17,4,240,2,32,159446,32,120,2,32,159446,32,120
72.727,17,20,1760,10,48,8079,48,760,10,72,8079,72,1000
1681.665,1,15,840,15,28,120118,28,840,0,0,0,0,0
1750.832,6,94,7151,62,38,28702,205,4424,32,33,56465,98,2727
0.292,6,28,9149,14,257,22,667,1767,14,1105,22,2816,7382
1786.668,6,104,8376,68,65,26666,65,4930,36,59,51044,59,3446
88.113,6,45,7616,18,218,373,314,3343,27,455,3379,1179,4273
0.403,6,47,21145,26,1070,16,1380,16063,21,421,17,1923,5082
1799.784,6,369,26144,210,99,8611,469,14954,159,69,11390,69,11190
0.006,17,2,247,1,36,0,36,64,1,155,0,155,183
15.799,6,11,764,5,92,3949,92,348,6,92,3046,92,416
1787.878,17,87,3648,86,14,21033,14,3612,1,8,0,8,36
1783.973,17,86,3606,85,14,21237,14,3570,1,8,0,8,36
61.737,6,27,7177,13,155,5144,267,1306,14,530,4748,3417,5871
1790.002,17,87,3648,86,14,21058,14,3612,1,8,0,8,36
0.272,17,2,152,1,48,0,48,76,1,48,0,48,76
13.652,6,13,3332,8,204,1950,204,628,5,1218,3398,1705,2704
1.646,6,50,21221,29,900,58,1360,15605,21,433,72,1360,5616
280.439,6,31,7472,13,158,23369,267,1317,18,543,16493,1380,6155
0.05,6,14,5639,8,134,7,134,474,6,2456,10,3453,5165
0.306,6,21,5000,10,137,34,267,1092,11,577,29,1400,3908
190.929,17,2,128,2,36,190929,36,128,0,0,0,0,0
1792.0,6,357,22629,208,69,8656,69,12460,149,69,12108,69,10169
0.821,6,10,1687,7,100,136,100,384,3,1179,276,1179,1303
2.028,6,51,21171,28,954,75,1460,15475,23,433,71,1460,5696
0.075,6,9,1348,5,145,18,145,349,4,835,23,835,999
0.06,17,2,128,1,28,0,28,56,1,44,0,44,72
280.032,6,27,7312,13,158,23336,267,1317,14,775,21538,3445,5995
2.065,6,36,8433,18,269,121,780,2110,18,621,110,1360,6323
0.025,6,2,104,1,0,0,0,40,1,0,0,0,64
60.346,17,4,352,2,60,60345,60,176,2,60,60345,60,176
1783.153,17,83,3480,82,14,22014,14,3444,1,8,0,8,36
0.645,6,391,550571,249,183,2,230,13565,142,3782,3,18226,537006
37.345,17,22,1936,11,48,3733,48,836,11,72,3733,72,1100
0.12,17,2,2752,2,1348,120,1348,2752,0,0,0,0,0
376.523,6,23,1535,16,177,25101,177,1053,7,110,10413,110,482
1740.409,1,16,896,16,28,116027,28,896,0,0,0,0,0
5.377,6,37,7189,19,218,298,314,3383,18,513,299,1179,3806
1746.885,6,146,9205,78,49,22686,208,5524,68,31,26069,31,3681
201.626,17,4,352,2,60,201625,60,176,2,60,201625,60,176
4.0,17,5,1160,5,204,1000,204,1160,0,0,0,0,0
12.09,6,6,280,2,0,12090,0,88,4,0,2357,0,192
39.221,17,22,1936,11,48,3919,48,836,11,72,3917,72,1100
1795.958,17,87,3648,86,14,21128,14,3612,1,8,0,8,36
0.336,6,28,8995,13,231,28,563,1608,15,824,23,1408,7387
3.136,6,16,6063,5,186,780,267,581,11,718,312,1452,5482
280.977,6,30,7432,13,158,23414,267,1317,17,603,17551,1380,6115
0.42,6,10,1386,5,145,105,145,349,5,833,86,833,1037
1745.033,6,95,7215,63,38,28145,205,4488,32,33,56279,98,2727
31.491,6,7,336,1,0,0,0,48,6,0,6294,0,288
1744.74,2,27,864,27,8,67105,8,864,0,0,0,0,0
274.692,6,11,680,7,92,45754,92,464,4,0,91501,0,216
1781.101,6,354,22440,207,69,8646,69,12420,147,69,12199,69,10020
210.454,17,4,288,2,36,210422,36,128,2,52,210420,52,160
3.053,17,8,1682,4,45,1001,45,292,4,319,1001,339,1390
162.269,6,21,8279,11,525,93,1237,2048,10,969,18008,1791,6231
0.017,17,2,421,1,47,0,47,75,1,318,0,318,346
59.815,17,4,240,2,32,59814,32,120,2,32,59814,32,120
14.669,6,12,524,5,0,3667,0,216,7,0,2206,0,308
0.026,17,2,251,1,36,0,36,64,1,159,0,159,187
0.11,6,2,92,1,0,0,0,40,1,0,0,0,52
0.006,17,2,227,1,31,0,31,59,1,140,0,140,168
8.988,6,17,5391,9,275,1123,275,643,8,1104,1121,1440,4748
1750.745,6,357,32847,170,105,9652,469,13795,187,104,9412,1452,19052
0.528,17,3,543,2,39,45,39,134,1,381,0,381,409
5.088,17,3,208,2,36,5004,36,128,1,52,0,52,80
0.326,17,3,543,2,39,84,39,134,1,381,0,381,409
316.035,1,3,168,3,28,158017,28,168,0,0,0,0,0
1771.226,6,101,9344,66,65,27249,65,5577,35,59,52092,59,3767
1.532,6,48,19310,27,898,58,1360,13694,21,433,66,1360,5616
1798.821,17,449,39928,404,35,4463,288,25708,45,288,40019,288,14220
0.021,6,9,1547,5,515,5,515,783,4,548,7,548,764
287.318,17,4,240,2,32,287317,32,120,2,32,287317,32,120
2.97,6,28,8224,15,350,211,1089,2356,13,890,246,1731,5868
1798.555,17,449,39928,404,35,4462,288,25708,45,288,40024,288,14220
53.068,2,2,64,2,8,53068,8,64,0,0,0,0,0
0.143,6,44,21193,26,1085,5,1420,16252,18,467,7,1883,4941
20.088,17,38,15123,18,573,1180,1350,10821,20,187,1055,1350,4302
240.118,6,42,5483,21,205,12005,517,2549,21,202,12005,851,2934
1795.306,17,81,3390,79,14,23014,14,3318,2,8,1795123,8,72
1792.623,1,340,28560,340,56,5287,56,28560,0,0,0,0,0
0.97,17,5,1176,3,32,482,32,180,2,470,5,470,996
7.75,17,37,9538,11,332,774,1350,3970,26,186,308,1350,5568
0.163,6,2,111,1,0,0,0,40,1,31,0,31,71
0.189,1,2,112,2,28,189,28,112,0,0,0,0,0
42.58,6,9,570,6,43,8516,43,406,3,0,21288,0,164
1790.162,1,58,4872,58,56,31406,56,4872,0,0,0,0,0
1787.719,1,255,14280,255,28,7038,28,14280,0,0,0,0,0
461.272,17,71,25852,71,336,6589,358,25852,0,0,0,0,0
347.323,6,41,8496,16,123,23154,267,1633,25,308,14471,2840,6863
957.064,6,190,12016,111,69,8700,69,6648,79,69,12269,69,5368
96.375,6,34,7871,13,155,8031,267,1306,21,357,4818,3417,6565
300.74,6,41,8743,22,315,14320,882,2185,19,413,474,1360,6558
1352.698,6,82,6494,53,63,26013,64,3776,29,57,48307,58,2718
2.954,17,3,228,2,48,2893,48,152,1,48,0,48,76
5.953,6,4,176,4,0,0,0,176,0,0,0,0,0
1796.359,1,230,12880,230,28,7844,28,12880,0,0,0,0,0
0.796,6,10,1687,7,100,132,100,384,3,1179,267,1179,1303
1785.357,17,87,3648,86,14,21004,14,3612,1,8,0,8,36
1740.464,17,29,30624,29,1028,62159,1028,30624,0,0,0,0,0
29.215,1,4,224,4,28,9738,28,224,0,0,0,0,0
1745.64,6,100,7866,66,45,26856,205,4902,34,35,52888,98,2964
1772.705,6,180,15480,120,69,14896,69,8940,60,69,30039,69,6540
286.275,6,28,7352,12,158,26025,267,1277,16,603,18978,1400,6075
0.081,17,2,362,1,46,0,46,74,1,260,0,260,288
1789.627,17,479,55373,221,153,8134,1350,40134,258,31,6963,60,15239
331.512,6,54,8554,30,74,11431,517,2709,24,456,14388,1418,5845
64.071,6,36,9131,15,325,135,1173,2559,21,440,3203,1420,6572
301.623,6,100,58912,56,514,5484,986,5983,44,1265,917,4307,52929
31.398,6,7,336,1,0,0,0,48,6,0,6277,0,288
20.122,6,19,5314,12,107,1829,159,1074,7,1289,3352,3077,4240
279.54,17,4,304,2,48,279527,48,152,2,48,279526,48,152
18.841,17,38,9483,19,292,1045,1350,6082,19,151,1045,1350,3401
0.286,6,27,8920,13,227,23,547,1592,14,941,21,1408,7328
0.253,17,6,2008,6,306,50,354,2008,0,0,0,0,0
1682.651,1,71,7526,71,78,24037,78,7526,0,0,0,0,0
0.248,6,9,1339,5,145,62,145,349,4,826,67,826,990
361.415,17,4,784,4,168,120471,168,784,0,0,0,0,0
19.438,17,43,14913,22,481,923,1350,11218,21,147,970,1350,3695
601.666,2,7,224,7,8,100277,8,224,0,0,0,0,0
1203.222,2,14,448,14,8,92555,8,448,0,0,0,0,0
240.313,6,44,9056,22,516,11443,1402,5796,22,234,11443,618,3260
1.211,6,50,19233,27,887,46,1360,13537,23,433,47,1360,5696
1787.586,17,87,3648,86,14,21030,14,3612,1,8,0,8,36
150.43,6,23,9977,12,523,58,1360,2605,11,1384,15029,3934,7372
1.848,6,30,8988,18,289,108,599,1591,12,987,151,1452,7397
0.102,6,10,1669,6,551,20,947,1346,4,159,34,159,323
0.376,17,2,152,1,48,0,48,76,1,48,0,48,76
61.313,6,35,16025,22,819,2919,1408,9351,13,855,5088,3847,6674
0.075,17,2,670,2,307,75,331,670,0,0,0,0,0
0.524,17,3,451,2,39,442,39,134,1,289,0,289,317
0.132,17,6,2047,6,313,26,354,2047,0,0,0,0,0
10.033,17,4,744,2,34,10021,34,124,2,282,10021,282,620
1.311,6,57,24144,32,999,42,1360,18323,25,437,47,2715,5821
11.383,6,1802,1572013,1091,1387,10,1420,1539352,711,467,16,1883,32661
4.001,17,4,296,4,46,1333,46,296,0,0,0,0,0
1773.391,6,181,15589,120,69,14902,69,8940,61,69,29553,69,6649
0.99,2,3,128,3,18,495,24,128,0,0,0,0,0
310.399,6,33,7088,13,189,9789,516,1470,20,283,16331,1452,5618
1681.698,17,14,1036,7,30,280280,30,406,7,62,280280,62,630
315.775,6,110,21595,58,240,5539,1360,11396,52,253,6080,2720,10199
0.819,17,4,420,2,33,0,33,122,2,121,0,145,298
0.093,6,9,1002,5,213,23,213,417,4,421,27,421,585
0.046,17,2,197,1,41,0,41,69,1,100,0,100,128
1699.557,17,12,498,11,14,169955,14,462,1,8,0,8,36
6.127,6,90,65107,57,876,109,1360,13782,33,2173,186,6800,51325
1790.345,1,342,28728,342,56,5250,56,28728,0,0,0,0,0
1797.48,17,449,39928,404,35,4460,288,25708,45,288,40015,288,14220
317.05,6,75,19547,38,335,8568,1360,9948,37,337,8802,1360,9599
0.493,6,22,7342,12,335,44,668,1974,10,1210,54,1906,5368
1798.897,17,441,39104,397,35,4542,288,25200,44,288,40949,288,13904
0.907,17,2,312,2,128,907,128,312,0,0,0,0,0
0.685,6,23,7307,13,318,57,600,1958,10,964,69,1471,5349
6.048,1,3,180,3,32,3024,32,180,0,0,0,0,0
159.859,6,42,26427,18,740,64,1360,3726,24,1207,6944,1360,22701
1792.828,1,239,13384,239,28,7532,28,13384,0,0,0,0,0
0.066,6,12,3702,6,170,10,170,490,6,964,8,1448,3212
1744.521,6,95,7203,63,38,28137,205,4476,32,33,56262,98,2727
1795.153,1,278,15568,278,28,6480,28,15568,0,0,0,0,0
0.457,6,21,7203,12,318,40,600,1906,9,964,54,1471,5297
0.102,17,4,240,2,32,101,32,120,2,32,101,32,120
1740.491,17,30,31680,30,1028,60016,1028,31680,0,0,0,0,0
16.602,17,38,24091,19,789,920,1350,15528,19,422,920,1350,8563
118.094,6,43,10070,19,249,6560,1189,3011,24,338,5133,1420,7059
1783.65,17,84,3516,82,14,22017,14,3444,2,8,1783421,8,72
1797.826,6,356,22520,208,69,8685,69,12460,148,69,12230,69,10060
1787.906,6,376,26548,216,104,8315,469,15732,160,69,11244,69,10816
0.451,17,4,588,2,48,304,48,152,2,190,298,308,436
41.725,6,40,15621,22,651,1976,1360,5542,18,778,2444,1591,10079
1798.931,17,449,39928,404,35,4463,288,25708,45,288,40022,288,14220
1787.406,6,104,8252,68,63,26677,64,4868,36,57,51066,58,3384
0.04,17,4,344,2,47,1,47,150,2,69,1,75,194
60.607,17,39,13102,18,357,3563,1350,6934,21,265,3028,1350,6168
8.179,6,30,19447,22,963,389,1368,13663,8,1072,1139,2736,5784
132.759,17,6,2016,6,308,26551,308,2016,0,0,0,0,0
60.976,6,12,1220,7,180,10162,180,732,5,110,15182,110,488
13.651,6,24,4711,12,154,1221,722,1716,12,591,1225,1448,2995
42.531,1,48,4992,0,0,0,0,0,48,76,904,76,4992
22.018,17,4,530,2,36,22014,36,128,2,173,22013,187,402
2.991,6,2,120,2,0,0,0,120,0,0,0,0,0
1778.189,6,102,8222,67,64,26942,64,4792,35,58,52295,58,3430
0.564,6,119,88830,64,131,8,232,3089,55,1670,10,5182,85741
1785.384,6,137,8468,73,27,24796,27,4447,64,27,28338,27,4021
335.995,6,91,31015,46,586,7466,1402,11206,45,727,7636,2804,19809
16.049,17,18,11058,10,850,1779,1350,8783,8,256,2287,1350,2275
125.733,2,2,64,2,8,125733,8,64,0,0,0,0,0
0.138,6,11,1127,6,518,27,518,838,5,21,33,21,289
1660.565,1,7,392,7,28,276760,28,392,0,0,0,0,0
1.356,6,45,18591,27,855,52,1360,13095,18,529,69,4075,5496
13.549,6,2321,2162988,1487,1376,9,1408,2114956,834,931,16,2816,48032
14.754,6,18,2477,11,211,1472,211,1018,7,545,1602,904,1459
178.988,17,12,960,6,48,35795,48,456,6,56,35795,56,504
0.065,17,2,230,1,40,0,40,68,1,134,0,134,162
0.024,6,14,4044,8,88,3,88,452,6,1670,4,1880,3592
280.511,6,31,7472,13,158,23375,267,1317,18,603,16494,2076,6155
3.213,17,2,178,1,29,0,29,57,1,93,0,93,121
0.028,6,3,182,2,31,28,31,111,1,31,0,31,71
1790.586,6,285,25570,169,75,10658,267,11617,116,134,15570,1460,13953
38.884,17,22,1936,11,48,3887,48,836,11,72,3887,72,1100
1786.576,6,105,8544,68,66,26665,66,4964,37,60,49624,60,3580
15.539,17,21,14484,13,916,1287,1350,12283,8,247,2210,1350,2201
0.068,6,11,819,6,186,11,186,506,5,45,16,45,313
92.919,6,18,740,6,0,10833,0,244,12,0,8446,0,496
2.09,6,30,10408,18,367,122,833,1825,12,1012,181,1420,8583
371.918,6,25,1651,17,177,23244,177,1117,8,110,9257,110,534
1799.403,17,449,39928,404,35,4465,288,25708,45,288,40012,288,14220
15.05,17,10,880,5,48,3760,48,380,5,72,3759,72,500
240.782,6,56,18225,30,803,8302,1418,15234,26,202,9630,580,2991
9.675,6,46,8540,22,227,460,314,4062,24,439,407,1179,4478
306.081,6,29,12970,17,315,19130,619,2471,12,1096,5987,2816,10499
1744.727,2,30,960,30,8,60163,8,960,0,0,0,0,0
66.514,6,72,48576,45,1189,1511,1408,40438,27,747,2368,1408,8138
18.939,6,8,537,0,0,0,0,0,8,31,2705,31,537
1772.457,1,21,2485,21,90,88622,117,2485,0,0,0,0,0
22.506,17,17,6916,9,482,2809,1350,4590,8,262,3210,1350,2326
301.149,6,313,292663,108,230,2814,517,7237,205,1401,1476,2876,285426
39.632,17,4,352,2,60,39630,60,176,2,60,39631,60,176
3.739,17,4,236,4,31,1246,31,236,0,0,0,0,0
0.114,6,2,604,1,0,0,0,40,1,512,0,512,564
64.992,17,4,352,2,60,64991,60,176,2,60,64991,60,176
2.4,6,13,2311,8,188,342,245,700,5,1407,534,1407,1611
69.552,6,30,7366,13,155,5796,267,1306,17,413,4346,1420,6060
0.496,17,17,8589,8,657,70,1350,5481,9,317,35,1350,3108
133.627,6,22,8510,11,313,68,632,1413,11,949,13349,1440,7097
129.988,6,24,4764,9,243,16248,722,1436,15,282,9269,1408,3328
0.255,6,19,4286,11,165,25,456,1394,8,493,34,888,2892
1720.869,17,13,534,11,14,172068,14,462,2,8,1720686,8,72
0.629,17,4,560,2,64,628,64,184,2,160,510,160,376
1.391,6,47,19014,27,880,53,1360,13438,20,529,64,4075,5576
1775.453,6,181,15589,120,69,14919,69,8940,61,69,29588,69,6649
64.403,6,11,452,5,0,6082,0,204,6,0,12877,0,248
5.321,6,39,7269,20,218,280,314,3423,19,513,281,1179,3846
1.743,6,50,19193,27,884,67,1360,13497,23,433,69,1360,5696
0.314,6,23,6012,12,181,28,537,1526,11,781,28,2224,4486
5.008,17,4,558,2,36,5003,36,128,2,187,5002,187,430
0.481,6,9,1340,5,145,120,145,349,4,827,151,827,991
10.698,6,18,4226,10,275,1188,275,958,8,978,845,1420,3268
1745.474,6,95,7203,63,38,28152,205,4476,32,33,56292,98,2727
240.18,6,55,18277,30,758,8281,1402,15219,25,218,10007,580,3058
9.074,6,22,6474,7,154,1512,267,752,15,464,640,1452,5722
1786.401,6,162,21204,92,304,19630,304,14544,70,83,25889,83,6660
0.437,17,2,136,1,32,0,32,60,1,48,0,48,76
1774.073,6,180,15480,120,69,14908,69,8940,60,69,30063,69,6540
1759.232,1,8,848,8,78,251318,78,848,0,0,0,0,0
1774.819,6,453,138058,223,557,7994,1360,111011,230,189,7749,2720,27047
795.064,1,6,336,6,28,159012,28,336,0,0,0,0,0
1772.994,6,181,15589,120,69,14899,69,8940,61,69,29547,69,6649
1746.642,6,98,7421,64,38,27724,205,4528,34,33,52922,98,2893
1.364,6,23,5084,12,137,124,267,1172,11,692,135,1467,3912
1764.226,2,14,448,14,8,135709,8,448,0,0,0,0,0
11.763,6,1860,1626812,1104,1419,10,1432,1592327,756,420,15,1432,34485
1786.45,6,127,13047,80,80,22613,513,6422,47,128,38833,1380,6625
0.468,6,47,19305,26,1011,18,1380,14223,21,421,21,1923,5082
0.036,17,2,169,1,34,0,34,62,1,79,0,79,107
560.467,17,6,1647,3,30,280196,30,174,3,463,280229,463,1473
245.763,6,54,9942,26,554,9830,1408,6422,28,171,9102,580,3520
61.568,6,45,26629,29,1030,2198,1408,19049,16,962,4089,3847,7580
10.847,6,1965,1821403,1249,1380,8,1408,1779507,716,931,14,2816,41896
1.553,6,19,3781,10,234,172,564,1452,9,463,172,1343,2329
1773.177,6,180,15480,120,69,14900,69,8940,60,69,30048,69,6540
32.4,6,23,6533,9,142,4050,267,938,14,628,2476,1460,5595
1.122,6,23,6068,12,281,102,544,1328,11,716,104,1420,4740
28.433,6,43,13787,21,315,1421,722,3371,22,866,1312,2760,10416
10.155,6,85,25021,44,563,236,1152,19240,41,459,247,1179,5781
98.618,6,22,9065,11,377,69,797,1604,11,1001,9848,1440,7461
1.429,17,6,552,3,32,714,32,180,3,96,695,96,372
1796.914,17,449,39928,404,35,4458,288,25708,45,288,40022,288,14220
0.979,6,24,8999,14,264,75,700,1687,10,1380,88,4080,7312
0.172,17,4,624,2,64,171,64,184,2,192,53,192,440
364.447,6,19,1303,14,177,28034,177,925,5,110,19235,110,378
1744.624,2,25,800,25,8,72692,8,800,0,0,0,0,0
0.001,17,3,1164,3,360,0,360,1164,0,0,0,0,0
1.017,6,20,5920,11,285,101,556,1300,9,709,112,1380,4620
0.578,6,15,1785,8,288,58,288,640,7,426,67,434,1145
1.0,17,2,677,1,300,0,300,328,1,321,0,321,349
301.255,6,45,16115,25,948,12552,1440,10513,20,399,473,1440,5602
44.032,6,21,3231,12,180,4002,595,1712,9,347,5500,580,1519
1786.504,6,104,8376,68,65,26664,65,4930,36,59,51040,59,3446
4.067,17,6,870,3,40,2018,40,204,3,194,1960,194,666
0.011,17,2,235,1,36,0,36,64,1,143,0,143,171
2.308,6,33,13319,17,529,144,1360,3370,16,845,103,1360,9949
0.419,6,8,335,4,0,139,0,164,4,7,67,7,171
198.616,6,27,5146,11,220,5848,516,1325,16,244,13235,1452,3821
18.08,17,2,152,2,48,18080,48,152,0,0,0,0,0
14.85,6,2008,1821917,1221,1410,12,1448,1776305,787,776,18,1448,45612
60.72,6,12,5538,4,106,20240,106,274,8,822,8627,1460,5264
0.046,17,4,284,2,32,5,32,120,2,54,9,60,164
0.0,6,1,64,0,0,0,0,0,1,0,0,0,64
0.62,6,14,1745,7,288,72,288,600,7,426,71,434,1145
0.415,6,8,335,4,0,138,0,164,4,7,66,7,171
4.422,6,37,7189,19,218,245,314,3383,18,513,245,1179,3806
1773.222,6,180,15480,120,69,14901,69,8940,60,69,30051,69,6540
0.23,6,9,1002,5,213,57,213,417,4,421,57,421,585
1751.273,17,12,498,11,14,175127,14,462,1,8,0,8,36
1738.196,17,160,25901,160,133,10932,392,25901,0,0,0,0,0
0.428,6,48,18606,27,886,16,1380,13524,21,421,19,1923,5082
888.038,6,113,14619,66,82,12488,267,5289,47,177,19304,1917,9330
180.427,2,3,96,3,8,90213,8,96,0,0,0,0,0
0.422,6,84,57024,52,1264,8,1432,51444,32,389,12,1432,5580
11.147,6,1746,1525784,1059,1386,10,1420,1494083,687,467,16,1883,31701
241.282,6,46,8684,22,449,11489,1418,5648,24,178,10490,580,3036
1798.013,1,345,28980,345,56,5226,56,28980,0,0,0,0,0
0.413,6,10,968,5,256,101,256,460,5,304,101,304,508
1796.151,1,338,28392,338,56,5329,56,28392,0,0,0,0,0
4.489,17,2,656,2,300,4489,300,656,0,0,0,0,0
1790.722,1,58,4872,0,0,0,0,0,58,56,31416,56,4872
0.334,17,7,2368,7,310,55,354,2368,0,0,0,0,0
0.161,17,2,330,1,30,0,30,58,1,244,0,244,272
1744.685,2,25,800,25,8,72695,8,800,0,0,0,0,0
416.204,2,4,128,4,8,138734,8,128,0,0,0,0,0
92.889,6,24,9833,13,465,56,1360,2414,11,1161,9275,2574,7419
1798.173,6,367,25650,214,99,8442,469,15045,153,69,11829,69,10605
0.165,17,2,154,1,33,0,33,61,1,65,0,65,93
59.786,6,10,480,9,0,7473,0,392,1,48,0,48,88
271.522,6,362,155535,172,877,1587,1402,136209,190,196,1436,2804,19326
1504.054,2,14,448,14,8,115696,8,448,0,0,0,0,0
1791.676,17,144,11520,72,48,25234,48,5472,72,56,25234,56,6048
388.06,6,21,6619,12,122,35278,267,1225,9,1005,1017,1926,5394
6.162,6,1569,1452791,991,1388,6,1408,1418071,578,931,10,2816,34720
4.26,6,715,596219,423,1370,10,1420,580318,292,467,14,1883,15901
3.39,6,3,511,2,0,3390,0,80,1,391,0,391,431
240.846,6,48,9182,25,519,10034,1402,5984,23,220,10947,617,3198
1780.837,17,138,11040,69,48,26188,48,5244,69,56,26188,56,5796
0.125,17,2,439,1,33,0,33,61,1,350,0,350,378
240.208,6,54,18093,29,800,8578,1408,15132,25,206,10008,580,2961
1785.125,17,87,3648,86,14,21001,14,3612,1,8,0,8,36
1.649,6,10,1687,7,100,274,100,384,3,1179,697,1179,1303
0.545,6,5,248,3,0,272,0,144,2,0,445,0,104
573.929,6,307,127578,159,802,3632,1460,105888,148,286,3903,1638,21690
0.524,6,50,20353,28,937,19,1380,15231,22,421,22,1923,5122
1785.997,6,154,25004,92,483,19626,483,19282,62,83,29278,83,5722
25.849,6,7,435,0,0,0,0,0,7,31,4308,31,435
0.039,17,2,198,1,39,0,39,67,1,103,0,103,131
2.277,6,12,2271,7,188,379,245,660,5,1407,506,1407,1611
1779.568,6,351,22734,197,69,9079,69,11951,154,69,11538,69,10783
2.157,6,13,2311,8,188,308,245,700,5,1407,472,1407,1611
1744.434,6,95,7203,63,38,28136,205,4476,32,33,56260,98,2727
782.072,2,9,288,9,8,97759,8,288,0,0,0,0,0
33.213,6,29,7392,13,158,2767,267,1317,16,603,2211,2036,6075
1790.62,6,356,22520,208,69,8650,69,12460,148,69,12180,69,10060
1.257,6,10,1687,7,100,209,100,384,3,1179,504,1179,1303
0.091,6,15,3681,8,126,13,126,562,7,1373,15,1448,3119
1795.058,17,448,39896,403,35,4465,288,25676,45,288,40021,288,14220
0.023,6,7,364,0,0,0,0,0,7,0,0,0,364
7.237,6,1429,1313142,903,1377,7,1408,1281126,526,931,13,2801,32016
1788.677,17,87,3648,86,14,21043,14,3612,1,8,0,8,36
125.905,6,246,202054,159,1310,796,1368,186482,87,612,1394,2736,15572
164.028,6,40,8723,16,139,6231,267,1900,24,292,7131,1460,6823
4.846,6,30,5482,16,195,323,293,2209,14,541,353,1179,3273
10.428,6,84,24917,42,561,254,1152,19096,42,413,248,1152,5821
2.292,6,26,8228,15,400,163,663,2812,11,806,224,1368,5416
70.418,6,31,7475,13,155,5868,267,1306,18,388,4141,1420,6169
279.012,17,4,352,2,60,279011,60,176,2,60,279011,60,176
15.559,17,17,11819,10,928,1725,1350,9567,7,293,2587,1350,2252
127.411,17,4,352,2,60,127410,60,176,2,60,127410,60,176
1775.864,17,140,11200,70,48,25736,48,5320,70,56,25736,56,5880
365.675,6,18,1242,14,180,28128,180,916,4,110,20055,110,326
1772.357,6,180,15480,120,69,14893,69,8940,60,69,30035,69,6540
3.995,17,8,736,4,64,1331,64,368,4,64,1330,64,368
375.063,6,27,1767,18,177,22062,177,1181,9,110,8940,110,586
15.489,17,20,12849,11,941,1540,1350,10664,9,214,1931,1350,2185
280.307,6,29,7392,13,158,23358,267,1317,16,603,18681,1400,6075
1798.194,6,356,22520,208,69,8686,69,12460,148,69,12232,69,10060
1796.708,17,448,39612,404,35,4458,288,25708,44,288,40948,288,13904
1.292,6,24,8004,12,164,99,267,1288,12,1014,99,2896,6716
782.021,2,8,256,8,8,111717,8,256,0,0,0,0,0
0.148,17,4,284,2,32,137,32,120,2,54,12,60,164
1.344,6,47,19038,27,882,51,1360,13462,20,476,60,2720,5576
80.907,6,23,10128,12,549,71,1360,2709,11,1393,8077,3934,7419
2.078,6,9,527,5,43,519,43,311,4,0,674,0,216
2.81,6,3,120,1,0,0,0,40,2,0,5,0,80
393.904,6,23,1538,16,180,26260,180,1056,7,110,10383,110,482
280.208,6,26,7272,12,158,25473,267,1277,14,775,21549,3445,5995
280.318,6,29,7392,13,158,23359,267,1317,16,678,18685,2045,6075
1751.948,6,97,6302,62,47,28720,208,4003,35,31,51511,31,2299
9.122,17,2,148,2,46,9122,46,148,0,0,0,0,0
0.035,17,2,257,1,41,0,41,69,1,160,0,160,188
280.453,17,4,296,2,30,280375,30,116,2,62,280412,62,180
63.673,17,2,656,2,300,63673,300,656,0,0,0,0,0
82.376,6,133,114266,48,126,1752,302,2864,85,1371,980,1408,111402
125.862,2,2,64,2,8,125862,8,64,0,0,0,0,0
217.606,6,23,5143,7,92,313,92,488,16,293,14495,2026,4655
1.374,6,10,1687,7,100,229,100,384,3,1179,566,1179,1303
1.034,6,28,8503,15,225,61,561,1985,13,997,71,2720,6518
0.989,6,27,8120,14,266,62,540,1924,13,944,67,1591,6196
5.011,17,4,288,2,36,4996,36,128,2,52,4996,52,160
13.29,6,26,4706,13,204,1082,722,1708,13,463,1085,1448,2998
11.655,6,1736,1593842,1123,1368,10,1432,1565022,613,389,18,1432,28820
0.48,6,100,74299,64,1295,7,1420,68638,36,526,13,3303,5661
1640.344,1,7,392,7,28,273390,28,392,0,0,0,0,0
84.102,17,28,2200,23,31,3822,288,1364,5,139,19760,288,836
356.916,6,23,7118,4,154,90656,267,632,19,408,19828,2840,6486
0.63,17,3,451,2,39,60,39,134,1,289,0,289,317
53.021,6,7,10500,7,1448,8836,1448,10500,0,0,0,0,0
0.777,6,10,1687,7,100,129,100,384,3,1179,261,1179,1303
0.127,6,10,1569,5,627,31,627,895,5,406,31,406,674
1.616,6,10,1687,6,100,323,100,344,4,1179,443,1179,1343
1746.936,6,182,23528,94,77,18784,722,7999,88,266,20077,1380,15529
155.738,6,26,9818,13,556,107,1329,2244,13,880,12959,1791,7574
1706.04,1,13,728,13,28,142170,28,728,0,0,0,0,0
632.478,17,14,1232,7,48,105411,48,532,7,72,105411,72,700
1751.078,6,104,7464,64,31,27794,31,4394,40,31,44890,31,3070
0.032,17,2,190,1,59,0,59,87,1,75,0,75,103
0.646,17,14,7667,7,716,107,1350,5210,7,323,98,1350,2457
176.121,6,31,8652,19,222,9783,1226,2995,12,719,16009,1448,5657
1778.38,1,61,5124,0,0,0,0,0,61,56,29639,56,5124
3.363,17,4,236,4,31,1121,31,236,0,0,0,0,0
1.909,6,23,7428,14,273,146,663,2104,9,1209,234,2736,5324
127.177,17,6,360,3,32,63588,32,180,3,32,63588,32,180
149.381,1,20,1680,20,56,7862,56,1680,0,0,0,0,0
0.004,17,2,550,2,247,4,247,550,0,0,0,0,0
78.949,6,119,97623,80,1278,999,1408,86064,39,793,2072,2816,11559
0.346,6,27,9098,13,261,28,683,1728,14,947,26,2816,7370
0.259,17,2,157,1,31,0,31,59,1,70,0,70,98
299.572,6,6,364,4,31,99857,31,222,2,31,299538,31,142
2.017,17,3,696,3,204,1008,204,696,0,0,0,0,0
1793.842,1,271,15176,271,28,6643,28,15176,0,0,0,0,0
4.711,6,39,7269,20,218,247,314,3423,19,440,247,1152,3846
0.24,6,9,1343,5,145,60,145,349,4,830,58,830,994
1791.493,6,190,16363,123,69,14684,69,9060,67,69,27075,69,7303
10.811,6,18,5610,10,275,1201,275,958,8,1440,827,1440,4652
45.571,6,27,7177,13,155,3797,267,1306,14,530,3504,3417,5871
1771.222,6,101,9344,66,65,27249,65,5577,35,59,52092,59,3767
267.351,17,38,9277,23,40,12151,41,1578,15,485,19089,505,7699
1657.686,1,102,5712,102,28,16412,28,5712,0,0,0,0,0
240.351,6,64,20426,30,809,8286,1418,16944,34,213,7282,580,3482
280.423,6,30,7432,13,158,23368,267,1317,17,603,17524,2760,6115
4.12,17,8,792,4,39,1372,39,268,4,103,1373,103,524
0.163,6,24,7176,13,155,13,267,1301,11,775,15,3445,5875
0.269,6,10,1379,5,145,67,145,349,5,826,30,826,1030
1782.009,6,360,22887,210,69,8526,69,12540,150,69,11958,69,10347
1.447,17,2,244,2,94,1447,94,244,0,0,0,0,0
1799.6,17,140,11200,70,48,26080,48,5320,70,56,26080,56,5880
82.634,6,20,9181,11,514,75,1236,2014,9,1359,10309,2720,7167
1772.116,6,180,15480,120,69,14891,69,8940,60,69,30033,69,6540
240.264,6,43,9080,21,519,12012,1402,5773,22,239,11440,618,3307
0.007,17,2,235,1,36,0,36,64,1,143,0,143,171
0.098,17,2,2380,2,1162,98,1162,2380,0,0,0,0,0
0.009,17,4,350,2,34,1,34,124,2,85,2,91,226
3.137,17,2,152,1,48,0,48,76,1,48,0,48,76
1.942,6,15,2391,9,125,242,245,740,6,1407,334,1407,1651
0.198,6,21,5000,10,137,22,267,1092,11,692,19,1467,3908
121.942,6,22,9262,11,514,79,1237,2015,11,970,12176,1360,7247
114.608,17,4,352,2,60,114607,60,176,2,60,114607,60,176
15.208,17,5,380,5,48,3802,48,380,0,0,0,0,0
13.279,6,2311,2182578,1467,1409,8,1448,2134026,844,776,15,1448,48552
14.729,6,18,4271,8,316,2037,722,1373,10,393,1617,1448,2898
61.909,6,71,49265,45,1176,1407,1408,41180,26,747,2467,1408,8085
1787.188,6,104,8366,69,64,26282,64,4936,35,58,52560,58,3430
173.447,17,4,352,2,60,173446,60,176,2,60,173445,60,176
0.18,6,3,151,2,31,1,31,111,1,0,0,0,40
174.888,17,4,352,2,60,174887,60,176,2,60,174887,60,176
0.221,17,2,152,1,48,0,48,76,1,48,0,48,76
0.277,6,22,7333,12,334,24,663,1969,10,1209,29,1906,5364
1.255,6,48,18691,27,854,48,1360,13075,21,433,54,1360,5616
0.014,17,2,214,1,39,0,39,67,1,119,0,119,147
774.647,6,58134,66970987,24377,673,31,1368,1412462,33757,1896,22,13680,65558525
70.107,6,29,7392,13,158,5842,267,1317,16,603,4671,2036,6075
1787.804,1,58,4872,58,56,31364,56,4872,0,0,0,0,0
1799.894,17,448,39612,404,35,4466,288,25708,44,288,40949,288,13904
15.121,17,17,12103,11,878,1508,1350,9973,6,327,3016,1350,2130
9.155,6,16,3269,6,92,1831,92,400,10,579,987,1408,2869
166.984,17,14,1369,7,34,27827,37,434,7,105,27827,136,935
2.108,6,12,945,6,222,417,222,466,6,231,418,231,479
1787.605,6,102,8296,68,65,26680,65,4930,34,59,54166,59,3366
1795.216,1,58,4872,58,56,31495,56,4872,0,0,0,0,0
1787.856,6,104,8308,68,64,26684,64,4896,36,58,51079,58,3412
0.056,1,6,624,0,0,0,0,0,6,76,11,76,624
35.473,17,3,228,3,48,17736,48,228,0,0,0,0,0
1786.804,6,356,22520,208,69,8631,69,12460,148,69,12155,69,10060
1585.66,6,107,34741,59,542,27338,1360,18255,48,538,33733,2134,16486
1783.668,17,140,11200,70,48,25850,48,5320,70,56,25850,56,5880
1770.212,6,99,9306,66,66,27234,66,5610,33,60,55315,60,3696
0.092,17,2,334,1,32,0,32,60,1,246,0,246,274
1799.461,6,373,26511,207,98,8735,469,14972,166,69,10903,69,11539
1781.762,6,379,26337,218,97,8210,469,15481,161,69,11135,69,10856
1771.267,6,101,9344,66,65,27250,65,5577,35,59,52093,59,3767
1789.749,17,87,3648,86,14,21055,14,3612,1,8,0,8,36
4.981,6,44,7469,23,218,226,314,3543,21,440,236,1152,3926
1738.529,17,131,11888,119,30,14733,37,6944,12,384,158047,463,4944
131.17,6,17,1574,3,112,65585,112,240,14,82,10064,90,1334
1786.545,6,104,8376,68,65,26664,65,4930,36,59,51041,59,3446
1.893,6,54,18533,28,882,70,1460,12672,26,437,65,2615,5861
5.752,6,666,603357,426,1349,13,1368,586201,240,931,23,2841,17156
176.122,17,4,824,2,48,176112,48,152,2,308,176111,308,672
1.946,6,30,9733,18,372,114,850,1842,12,925,168,1452,7891
1784.408,6,356,22520,208,69,8620,69,12460,148,69,12138,69,10060
1786.557,6,102,8364,68,66,26665,66,4964,34,60,54135,60,3400
0.792,6,23,7437,14,274,60,668,2109,9,1210,94,3314,5328
1082.877,2,10,320,10,8,120319,8,320,0,0,0,0,0
31.92,6,9,396,2,0,3481,0,88,7,0,5306,0,308
1786.889,6,104,8308,68,64,26669,64,4896,36,58,51051,58,3412
0.56,6,12,1754,7,90,93,174,465,5,1085,139,1085,1289
166.186,6,35,8375,11,123,10149,267,1433,24,314,7225,2840,6942
0.339,17,8,2774,8,318,48,357,2774,0,0,0,0,0
1792.855,6,360,22818,210,69,8578,69,12678,150,69,12032,69,10140
1799.994,6,6640,772742,3333,183,540,337,565093,3307,77,543,145,207649
0.327,6,24,4571,12,165,29,456,1446,12,415,27,888,3125
187.041,17,4,352,2,60,187040,60,176,2,60,187040,60,176
120.399,2,2,64,2,8,120399,8,64,0,0,0,0,0
0.393,6,13,1693,7,288,63,288,588,6,426,45,434,1105
1788.103,17,87,3648,86,14,21036,14,3612,1,8,0,8,36
170.058,17,5,1692,5,310,42514,318,1692,0,0,0,0,0
0.587,17,4,624,2,64,586,64,184,2,192,465,192,440
11.884,6,1888,1642267,1142,1382,10,1414,1608194,746,420,15,1414,34073
60.684,6,52,26150,24,719,2630,1360,6822,28,957,2241,2720,19328
1.11,6,23,7952,12,164,85,267,1288,11,1216,94,3819,6664
1799.489,1,16,896,16,28,119965,28,896,0,0,0,0,0
11.154,6,21,6825,12,275,1014,275,1038,9,1353,767,1440,5787
372.082,6,18,1242,14,180,28621,180,916,4,110,20062,110,326
1781.765,6,362,22967,210,69,8525,69,12747,152,69,11799,69,10220
0.193,6,26,7256,13,155,16,267,1301,13,678,14,3436,5955
240.332,6,44,9146,21,519,12016,1402,5771,23,241,10923,618,3375
3.629,6,13,1636,7,279,604,279,918,6,191,636,272,718
240.472,6,54,17456,28,775,8904,1418,14645,26,181,9616,580,2811
0.238,6,21,5000,11,137,23,267,1132,10,692,25,2800,3868
1798.298,17,142,11360,71,48,25689,48,5396,71,56,25689,56,5964
272.847,6,41,12836,22,600,12992,1360,5129,19,630,15148,3494,7707
927.837,1,102,5712,102,28,9186,28,5712,0,0,0,0,0
15.442,6,14,2185,8,324,2206,585,1073,6,396,3043,580,1112
0.932,6,10,1687,7,100,155,100,384,3,1179,330,1179,1303
6.653,6,40,7325,20,218,350,314,3423,20,516,337,1179,3902
1772.045,6,180,15480,120,69,14891,69,8940,60,69,30033,69,6540
1.523,6,10,1514,5,503,380,503,771,5,475,380,475,743
280.286,6,30,7432,13,158,23357,267,1317,17,543,17511,1400,6115
654.888,1,14,784,14,28,50376,28,784,0,0,0,0,0
70.723,6,14,3888,8,127,10103,127,467,6,1056,14134,2920,3421
1783.811,6,376,26148,216,98,8296,469,15332,160,69,11218,69,10816
65.38,17,6,590,3,34,32686,37,187,3,106,32687,145,403
0.884,6,11,1727,7,100,147,100,384,4,589,209,1152,1343
240.353,6,50,9302,25,523,10014,1408,6027,25,190,10014,640,3275
101.148,6,37,8460,15,194,263,721,1967,22,431,4807,1420,6493
0.394,6,14,1733,7,288,61,288,588,7,284,36,434,1145
0.004,17,2,339,1,33,0,33,61,1,250,0,250,278
1773.436,6,180,15480,120,69,14902,69,8940,60,69,30050,69,6540
1776.579,17,73,3060,72,14,25022,14,3024,1,8,0,8,36
1794.612,6,376,26424,217,98,8308,469,15303,159,69,11357,69,11121
7.607,6,77,23745,38,563,205,1152,18417,39,470,193,1179,5328
1783.811,6,359,22778,209,69,8576,69,12500,150,69,11971,69,10278
524.356,17,31,10416,31,308,17478,308,10416,0,0,0,0,0
1.383,6,8,416,5,0,345,0,260,3,0,690,0,156
19.11,17,17,6989,8,534,2726,1350,4497,9,248,2385,1350,2492
1786.458,6,108,8664,69,66,26271,66,5004,39,60,47009,60,3660
1280.449,6,79,6123,44,42,26881,205,3178,35,33,37654,98,2945
1.378,17,2,136,1,32,0,32,60,1,48,0,48,76
125.394,6,16,3970,8,407,17913,722,1226,8,464,17885,1402,2744
0.284,17,2,476,1,39,0,39,67,1,381,0,381,409
41.723,17,4,352,2,48,41712,48,152,2,72,41712,72,200
1742.138,6,95,7203,63,38,28099,205,4476,32,33,56188,98,2727
1798.612,6,356,22520,208,69,8688,69,12460,148,69,12235,69,10060
1789.165,6,370,23425,213,69,8439,69,13005,157,69,11468,69,10420
164.589,17,4,352,2,60,164588,60,176,2,60,164587,60,176
290.148,6,35,4217,18,324,17067,585,1641,17,242,18133,580,2576
1032.631,1,10,560,10,28,114736,28,560,0,0,0,0,0
1799.984,6,221,17298,83,72,21585,375,8309,138,49,13137,143,8989
170.951,6,138,42501,59,910,2947,1418,35041,79,78,2191,580,7460
0.316,6,3,144,2,0,1,0,92,1,0,0,0,52
1794.73,17,144,11520,72,48,25277,48,5472,72,56,25277,56,6048
2.333,6,16,2125,8,288,307,288,928,8,426,307,434,1197
0.118,17,2,237,1,72,0,72,100,1,109,0,109,137
27.033,6,48,13044,23,182,1228,721,2568,25,676,1118,1440,10476
7.286,17,212,283646,210,1322,34,1472,283566,2,12,5003,12,80
1799.297,17,450,39960,405,35,4453,288,25740,45,288,40021,288,14220
281.23,6,34,8274,15,158,20087,267,1397,19,509,15623,1400,6877
11.832,6,8,336,4,0,3943,0,164,4,0,3940,0,172
1.261,6,47,19307,27,901,48,1360,13731,20,476,57,2715,5576
240.208,6,54,17747,29,782,8578,1408,14819,25,202,10008,580,2928
1354.784,6,291,28130,145,114,9408,469,12105,146,124,9343,1997,16025
1719.485,17,12,498,11,14,171948,14,462,1,8,0,8,36
1741.195,17,30,31680,30,1028,60041,1028,31680,0,0,0,0,0
0.355,6,10,766,5,185,88,185,453,5,45,82,45,313
1.424,6,50,18567,27,839,54,1360,12871,23,433,55,1360,5696
0.756,17,20,14803,12,1004,68,1350,12392,8,273,87,1350,2411
2.063,17,47,36479,19,391,114,1350,7963,28,990,65,1350,28516
6.107,6,1512,1426497,974,1389,6,1408,1393857,538,931,11,2801,32640
0.979,6,29,5933,15,123,69,267,1468,14,650,69,1452,4465
6.152,6,39,7285,20,218,323,314,3423,19,516,327,1179,3862
0.398,17,2,144,1,36,0,36,64,1,52,0,52,80
10.819,6,18,5610,10,275,1202,275,958,8,1440,828,1440,4652
0.549,6,59,25259,33,1035,17,1380,17997,26,475,20,1923,7262
1.595,6,37,8218,19,321,88,1168,2722,18,476,82,2715,5496
130.32,17,4,352,2,60,130319,60,176,2,60,130319,60,176
0.109,17,7,3482,4,418,36,1350,1787,3,537,24,1350,1695
1.401,6,45,15459,24,801,60,1360,9843,21,433,60,1360,5616
0.972,6,23,7940,13,164,81,267,1328,10,1216,88,3819,6612
29.915,17,9,684,9,48,3739,48,684,0,0,0,0,0
1.405,17,4,580,2,40,1381,40,136,2,194,1364,194,444
129.106,6,22,8019,11,525,98,1237,2048,11,919,12892,1591,5971
0.254,6,21,5000,10,137,28,267,1092,11,577,22,1400,3908
38.505,1,44,4576,0,0,0,0,0,44,76,895,76,4576
115.691,17,4,300,2,47,115690,47,150,2,47,115689,47,150
11.602,6,1887,1624145,1147,1363,10,1380,1590303,740,421,15,1923,33842
480.904,2,3,96,3,8,240452,8,96,0,0,0,0,0
1785.631,6,150,19770,90,316,20063,316,14160,60,83,30264,83,5610
0.027,17,2,363,1,29,0,29,57,1,278,0,278,306
45.883,6,6173,5870128,4059,1368,11,1408,5755512,2114,931,21,2816,114616
16.885,17,30,16108,15,885,1205,1350,13698,15,132,1203,1350,2410
63.92,1,11,3838,11,320,6392,498,3838,0,0,0,0,0
6.249,2,3,96,3,8,3124,8,96,0,0,0,0,0
1.095,6,11,1727,7,100,182,100,384,4,589,279,1152,1343
20.213,6,23,6180,13,147,1684,318,1285,10,873,2242,1669,4895
0.09,17,3,1170,3,362,45,362,1170,0,0,0,0,0
1791.581,6,402,38123,220,141,8180,1189,19456,182,129,9898,1452,18667
1797.603,6,436,26193,216,69,8360,69,12849,220,34,8208,64,13344
363.659,6,43,15343,28,418,13468,1360,7454,15,909,61,2597,7889
280.326,6,29,7392,13,158,23360,267,1317,16,603,18686,2036,6075
1743.132,6,97,7307,63,38,28115,205,4476,34,33,52815,98,2831
1.635,6,50,19322,27,893,62,1360,13626,23,433,64,1360,5696
1776.332,1,279,15624,279,28,6389,28,15624,0,0,0,0,0
300.29,6,48,29593,22,190,14299,444,1913,26,1253,9608,1461,27680
234.617,17,4,352,2,60,234616,60,176,2,60,234616,60,176
0.394,6,14,5792,7,135,65,135,507,7,1228,65,1448,5285
1.066,6,36,8192,19,241,59,619,1758,17,478,57,2720,6434
1799.338,6,389,27482,222,101,8141,469,16317,167,69,10838,69,11165
1771.653,6,101,9344,66,65,27256,65,5577,35,59,52104,59,3767
75.477,6,21,860,10,0,5501,0,404,11,0,7544,0,456
1772.621,6,184,15916,124,69,14411,69,9376,60,69,30038,69,6540
0.513,17,2,152,1,48,0,48,76,1,48,0,48,76
1773.487,6,80,4212,41,26,44336,26,2158,39,26,46669,26,2054
66.018,6,32,16716,18,1003,3883,1448,8986,14,777,5035,1448,7730
12.179,17,12,1056,6,37,2434,37,390,6,83,2434,89,666
0.028,6,4,220,2,0,0,0,116,2,0,0,0,104
9.603,6,9,504,4,0,3201,0,208,5,0,1113,0,296
1.557,6,50,21618,28,987,57,1460,15962,22,433,65,1460,5656
152.423,6,73,50790,47,1175,3313,1408,41296,26,903,2461,2816,9494
1783.838,6,356,22589,207,69,8659,69,12420,149,69,12052,69,10169
10.452,1,6,336,6,28,2090,28,336,0,0,0,0,0
2.561,6,57,19776,31,840,85,1360,13909,26,370,92,1360,5867
240.026,17,9,3488,9,359,30003,548,3488,0,0,0,0,0
0.987,6,24,8004,12,164,89,267,1288,12,869,73,1440,6716
81.994,17,12,920,6,40,16393,41,412,6,56,16394,57,508
0.034,17,2,148,1,38,0,38,66,1,54,0,54,82
6.509,6,30,8872,14,158,500,267,1357,16,858,426,3456,7515
4.006,17,5,337,4,33,1335,33,244,1,65,0,65,93
243.0,6,84,27136,35,662,7146,1408,13804,49,384,5062,1408,13332
19.079,6,2888,2717911,1881,1367,10,1408,2660883,1007,931,18,2816,57028
10.404,17,7,2352,7,308,1734,308,2352,0,0,0,0,0
3.68,6,30,8872,14,158,283,267,1357,16,763,241,1781,7515
18.15,17,4,352,2,48,18140,48,152,2,72,18137,72,200
1783.897,17,142,11360,71,48,25483,48,5396,71,56,25483,56,5964
1740.422,1,15,840,15,28,124315,28,840,0,0,0,0,0
1796.885,17,448,39896,403,35,4469,288,25676,45,288,40021,288,14220
0.366,6,6,328,4,0,122,0,216,2,0,184,0,112
350.216,17,49,10124,34,40,10612,41,2329,15,491,23251,505,7795
0.582,17,4,588,2,48,574,48,152,2,190,573,308,436
8.877,2,2,64,2,8,8877,8,64,0,0,0,0,0
119.332,17,26,3704,13,48,9943,48,988,13,180,9943,308,2716
19.957,17,2,152,2,48,19957,48,152,0,0,0,0,0
1791.582,6,367,23719,208,69,8654,69,12736,159,69,11339,69,10983
1.301,6,41,10760,21,539,65,1460,5184,20,433,59,1460,5576
0.506,17,14,7768,7,717,84,1350,5216,7,336,74,1350,2552
29.608,6,9,685,0,0,0,0,0,9,31,3701,31,685
280.26,6,28,7352,12,158,25478,267,1277,16,603,18680,1400,6075
1.328,6,37,8212,19,320,73,1162,2716,18,476,68,2715,5496
0.845,17,2,122,2,33,845,33,122,0,0,0,0,0
4.814,6,2,1175,1,0,0,0,40,1,1095,0,1095,1135
0.006,17,2,503,1,40,0,40,68,1,407,0,407,435
372.255,6,18,1239,14,177,28635,177,913,4,110,20061,110,326
0.06,6,16,6682,10,148,6,204,849,6,1378,11,4224,5833
0.216,6,9,1002,5,213,54,213,417,4,421,56,421,585
52.048,6,6,275,0,0,0,0,0,6,7,10409,7,275
0.189,17,2,2750,2,1347,189,1347,2750,0,0,0,0,0
5.026,17,4,530,2,36,5002,36,128,2,173,5015,187,402
12.04,17,6,456,6,48,2408,48,456,0,0,0,0,0
0.207,6,46,22482,27,1093,7,1420,17501,19,467,11,1883,4981
67.155,6,27,7177,13,155,5596,267,1306,14,530,5165,3417,5871
328.425,17,6,528,3,60,164212,60,264,3,60,164212,60,264
1792.58,17,142,11360,71,48,25607,48,5396,71,56,25607,56,5964
13.714,6,2042,1879480,1325,1364,10,1432,1846473,717,427,19,1432,33007
237.527,6,75,54164,49,1208,4948,1368,46075,26,841,2470,2736,8089
1797.23,17,448,39896,403,35,4470,288,25676,45,288,40016,288,14220
1772.448,6,180,15480,120,69,14894,69,8940,60,69,30036,69,6540
1770.979,6,99,9306,66,66,27245,66,5610,33,60,55340,60,3696
0.021,17,2,664,1,308,0,308,336,1,300,0,300,328
1785.822,6,358,22669,209,69,8585,69,12569,149,69,12066,69,10100
33.796,6,31,5093,15,154,2414,721,1858,16,342,2238,1368,3235
0.141,6,9,1343,5,145,35,145,349,4,830,42,830,994
0.162,17,2,312,1,64,0,64,92,1,192,0,192,220
1798.447,6,129,8370,74,51,24636,208,5178,55,31,33295,31,3192
0.232,17,3,942,3,286,116,292,942,0,0,0,0,0
0.059,6,12,3704,6,171,11,171,491,6,964,11,1448,3213
42.561,17,10,2320,10,204,4729,204,2320,0,0,0,0,0
2.973,17,4,240,4,32,991,32,240,0,0,0,0,0
240.192,6,55,18131,30,807,8282,1408,15290,25,191,10007,580,2841
8.135,6,81,24445,39,550,214,1152,18624,42,459,192,1179,5821
129.648,6,18,6045,8,186,18521,267,701,10,822,3740,1452,5344
300.258,6,26,8343,13,401,25021,1050,2302,13,669,5105,1408,6041
1722.702,1,226,23956,226,78,7656,78,23956,0,0,0,0,0
40.18,17,22,1672,22,48,1913,48,1672,0,0,0,0,0
64.611,17,4,240,2,32,64610,32,120,2,32,64610,32,120
1791.354,1,208,22048,208,78,8653,78,22048,0,0,0,0,0
291.055,6,267,43258,147,304,1993,304,30924,120,83,2445,83,12334
1741.044,17,300,49914,300,138,5822,363,49914,0,0,0,0,0
370.881,6,18,1242,14,180,28529,180,916,4,110,20076,110,326
1773.318,6,180,15480,120,69,14901,69,8940,60,69,30052,69,6540
240.202,6,55,17821,29,793,8578,1408,15024,26,179,9607,580,2797
1800.0,6,224,18222,84,80,21686,292,9098,140,49,12949,78,9124
240.13,6,39,4369,18,232,14125,651,2364,21,113,12006,457,2005
46.403,17,8,608,8,48,6629,48,608,0,0,0,0,0
0.136,17,2,152,1,48,0,48,76,1,48,0,48,76
0.062,17,4,284,2,32,55,32,120,2,54,52,60,164
1657.097,1,8,448,8,28,236728,28,448,0,0,0,0,0
369.461,6,18,1239,14,177,28420,177,913,4,110,20059,110,326
3.669,17,10,900,5,30,914,30,290,5,94,914,94,610
1771.692,6,278,33950,112,139,15960,1360,16378,166,130,10736,1360,17572
1779.686,17,301,50022,301,138,5932,389,50022,0,0,0,0,0
1793.783,17,144,11520,72,48,25264,48,5472,72,56,25264,56,6048
6.858,17,4,1344,4,308,2286,308,1344,0,0,0,0,0
32.044,6,9,396,2,0,3490,0,88,7,0,5325,0,308
300.692,6,38,8554,19,286,16697,766,1948,19,416,16697,2720,6606
1.37,6,44,13391,23,682,62,1360,7775,21,433,59,1360,5616
1796.773,17,763,46018,763,32,2357,37,46018,0,0,0,0,0
1785.698,1,152,16112,152,78,11825,78,16112,0,0,0,0,0
3.256,17,10,1287,5,31,810,31,295,5,170,810,196,992
192.715,6,32,7093,23,111,8759,504,2368,9,623,13636,1452,4725
0.886,17,2,134,2,39,886,39,134,0,0,0,0,0
5.868,6,41,7642,21,224,293,314,3756,20,440,295,1152,3886
167.25,17,4,352,2,60,167249,60,176,2,60,167249,60,176
14.56,6,8,440,5,0,3640,0,268,3,0,6990,0,172
1.325,6,50,19093,27,877,50,1360,13397,23,433,51,1360,5696
2.923,17,8,1524,4,36,972,36,256,4,289,973,318,1268
0.126,17,2,334,1,32,0,32,60,1,246,0,246,274
15.678,6,31,5304,15,154,1119,721,1870,16,324,1033,1408,3434
1.311,6,38,9848,21,440,65,1360,4392,17,433,70,1360,5456
162.203,17,4,352,2,60,162202,60,176,2,60,162202,60,176
100.671,17,4,244,2,33,100670,33,122,2,33,100670,33,122
1796.158,17,140,11200,70,48,26031,48,5320,70,56,26031,56,5880
0.163,6,26,7256,13,155,13,267,1301,13,603,12,2800,5955
1744.657,2,18,576,18,8,102626,8,576,0,0,0,0,0
0.017,6,14,5792,7,135,2,135,507,7,1228,2,1448,5285
1.383,6,24,8004,12,164,107,267,1288,12,1014,108,2331,6716
94.444,6,23,7328,5,154,2482,267,672,18,456,5555,2840,6656
0.096,6,10,1677,6,555,18,951,1354,4,159,31,159,323
0.405,6,12,1653,6,288,76,288,548,6,426,41,434,1105
1019.184,6,71,8577,40,76,24985,275,3129,31,145,33969,372,5448
0.078,17,2,396,1,39,0,39,67,1,301,0,301,329
2.815,17,2,134,2,39,2815,39,134,0,0,0,0,0
0.045,6,5,232,3,0,22,0,136,2,0,0,0,96
1738.667,6,122,7581,70,43,25198,208,4602,52,31,34087,31,2979
1796.279,6,415,24880,207,69,8719,69,12420,208,34,8677,64,12460
47.348,17,52,7644,26,48,1893,48,1976,26,190,1893,308,5668
198.459,6,10,1774,10,156,22051,177,1774,0,0,0,0,0
208.97,6,25,3580,15,483,14926,483,2720,10,83,23217,83,860
0.512,6,27,8942,13,232,42,569,1614,14,941,37,1438,7328
375.228,17,76,5776,76,48,5003,48,5776,0,0,0,0,0
302.247,17,14,4700,14,307,23249,320,4700,0,0,0,0,0
104.161,6,35,7911,13,152,5086,267,1444,22,348,4959,1420,6467
721.925,2,6,192,6,8,144385,8,192,0,0,0,0,0
1799.065,17,140,11192,71,48,25700,48,5396,69,56,26456,56,5796
0.325,6,27,9076,13,252,27,647,1692,14,831,24,1408,7384
8.383,6,1808,1658014,1133,1384,7,1408,1618250,675,931,12,2801,39764
18.848,6,30,8872,13,158,1570,267,1317,17,687,1174,1400,7555
0.015,17,2,454,1,67,0,67,95,1,331,0,331,359
191.999,6,4,346,4,46,63999,62,346,0,0,0,0,0
0.793,17,4,368,2,64,791,64,184,2,64,791,64,184
3.145,6,9,380,5,0,740,0,208,4,0,987,0,172
1745.201,1,192,20352,192,78,9137,78,20352,0,0,0,0,0
0.145,6,45,21063,26,1071,5,1420,16082,19,420,7,1420,4981
3.234,17,14,1579,14,84,248,350,1579,0,0,0,0,0
744.72,1,9,837,9,65,93090,88,837,0,0,0,0,0
1787.017,6,102,8296,68,65,26671,65,4930,34,59,54148,59,3366
315.504,6,40,8818,14,119,24268,267,1760,26,286,12619,1452,7058
25.824,6,3335,3100886,2096,1399,12,1448,3031770,1239,776,20,1448,69116
39.113,6,30,7297,14,155,3008,267,1346,16,441,2607,1420,5951
0.168,6,3,132,2,0,4,0,92,1,0,0,0,40
1786.312,6,106,8584,69,66,26269,66,5004,37,60,49617,60,3580
1786.025,6,104,8444,68,66,26657,66,4964,36,60,51026,60,3480
56.564,17,3,522,3,146,28282,346,522,0,0,0,0,0
0.28,6,27,9066,13,247,23,624,1696,14,947,21,1408,7370
100.209,1,2,726,2,335,100209,346,726,0,0,0,0,0
11.834,17,15,17682,15,1150,845,1451,17682,0,0,0,0,0
0.172,17,2,193,1,46,0,46,74,1,91,0,91,119
1.591,6,52,18730,29,841,56,1360,12989,23,400,63,1360,5741
1798.99,1,58,4872,58,56,31561,56,4872,0,0,0,0,0
1.007,17,6,360,3,32,502,32,180,3,32,503,32,180
3.918,17,4,352,4,60,1306,60,352,0,0,0,0,0
1797.628,17,764,46132,764,32,2356,37,46132,0,0,0,0,0
1788.73,17,32,10496,32,300,57700,300,10496,0,0,0,0,0
0.3,6,9,1340,5,145,75,145,349,4,827,30,827,991
1.383,6,51,19551,29,902,49,1360,13850,22,400,57,1360,5701
4.121,6,39,7269,19,218,228,314,3383,20,440,203,1152,3886
3.338,17,5,295,5,31,834,31,295,0,0,0,0,0
0.043,17,2,407,1,29,0,29,57,1,322,0,322,350
0.968,6,28,8160,15,222,57,540,1964,13,944,66,1591,6196
12.721,6,20,14332,6,122,267,122,382,14,1337,968,1929,13950
1.385,6,26,8108,12,164,107,267,1288,14,869,90,1368,6820
1786.681,6,102,8296,68,65,26666,65,4930,34,59,54138,59,3366
1789.948,6,360,24156,210,88,8564,469,13878,150,69,12013,69,10278
0.023,17,2,664,1,308,0,308,336,1,300,0,300,328
1787.902,6,356,22520,208,69,8637,69,12460,148,69,12162,69,10060
1.47,6,38,8254,19,321,81,1164,2718,19,476,71,2715,5536
0.945,6,21,7848,12,164,85,267,1288,9,1521,96,5227,6560
2.966,17,4,268,4,39,988,39,268,0,0,0,0,0
4.405,6,38,7245,19,218,244,314,3383,19,516,230,1179,3862
1796.642,17,448,39896,403,35,4469,288,25676,45,288,40018,288,14220
7.784,6,1249,1075543,751,1383,10,1420,1051402,498,467,15,2840,24141
1796.029,6,356,22520,208,69,8676,69,12460,148,69,12216,69,10060
6.93,6,65,20390,34,551,210,1152,15707,31,491,221,1179,4683
149.205,1,4,603,4,122,49735,173,603,0,0,0,0,0
0.517,17,3,451,2,39,336,39,134,1,289,0,289,317
2.788,17,3,1173,3,363,1394,363,1173,0,0,0,0,0
1793.193,17,142,11360,71,48,25616,48,5396,71,56,25616,56,5964
371.167,6,170,127830,103,1302,3638,1448,114774,67,683,1919,2359,13056
8.348,6,10,634,4,112,2780,112,280,6,90,1668,90,354
5.857,6,17,3562,5,92,1464,92,380,12,283,455,1408,3182
240.251,6,56,18333,31,807,8008,1418,15352,25,209,10010,580,2981
0.008,17,2,463,1,44,0,44,72,1,363,0,363,391
0.77,6,36,11398,22,675,36,1188,7219,14,573,53,1048,4179
1783.309,17,83,3480,82,14,22016,14,3444,1,8,0,8,36
0.085,17,2,554,1,30,0,30,58,1,468,0,468,496
1794.662,17,142,11360,71,48,25637,48,5396,71,56,25637,56,5964
1797.021,17,449,39928,404,35,4459,288,25708,45,288,40020,288,14220
801.273,1,10,560,10,28,89030,28,560,0,0,0,0,0
1785.855,6,370,23314,212,69,8463,69,12758,158,60,11374,69,10556
364.49,6,18,1242,14,180,28037,180,916,4,110,20059,110,326
0.029,17,4,768,2,39,17,39,134,2,289,20,289,634
0.411,17,8,2750,8,315,58,354,2750,0,0,0,0,0
5.623,6,40,7309,20,218,295,314,3423,20,440,281,1152,3886
1.433,6,55,24008,30,999,49,1360,18232,25,433,51,1360,5776
0.02,6,12,3462,6,75,4,75,395,6,1373,3,1448,3067
281.696,6,27,7312,13,158,23474,267,1317,14,678,21639,2045,5995
1757.306,6,95,7203,63,38,28343,205,4476,32,33,56677,98,2727
201.504,6,43,2755,24,69,8759,69,1512,19,69,11193,69,1243
6.067,6,39,7269,20,218,319,314,3423,19,513,322,1179,3846
1718.037,1,110,6160,110,28,15761,28,6160,0,0,0,0,0
0.988,6,4,160,4,0,0,0,160,0,0,0,0,0
439.745,6,33,8749,10,158,48860,267,1197,23,441,19985,1400,7552
0.253,17,2,384,1,39,0,39,67,1,289,0,289,317
0.115,17,2,394,1,33,0,33,61,1,305,0,305,333
131.199,6,208,171810,134,1328,986,1448,157077,74,604,1794,1448,14733
1799.223,17,448,39896,403,35,4475,288,25676,45,288,40020,288,14220
160.244,17,4,1344,4,308,53414,308,1344,0,0,0,0,0
197.685,17,102,26418,102,231,1957,388,26418,0,0,0,0,0
3.983,6,2,88,2,0,0,0,88,0,0,0,0,0
0.141,17,6,2014,6,307,28,355,2014,0,0,0,0,0
899.344,6,14,870,8,31,128477,31,444,6,31,179864,31,426
1799.782,17,87,3648,86,14,21173,14,3612,1,8,0,8,36
1786.341,6,102,8364,68,66,26661,66,4964,34,60,54128,60,3400
10.35,17,22,7396,9,448,1290,1350,4289,13,211,860,1350,3107
3.183,17,21,14800,10,664,353,1350,6923,11,688,143,1350,7877
1791.26,6,357,22629,208,69,8653,69,12460,149,69,12100,69,10169
1.316,17,2,778,2,361,1316,361,778,0,0,0,0,0
76.498,6,15,1947,8,302,10928,302,1318,7,83,12747,83,629
5.155,6,37,7189,19,218,286,314,3383,18,513,287,1179,3806
1.729,6,27,10169,16,283,115,582,1494,11,1028,155,1420,8675
1799.89,17,144,11520,72,48,25350,48,5472,72,56,25350,56,6048
1764.128,2,15,480,15,8,126009,8,480,0,0,0,0,0
213.392,17,4,240,2,32,213391,32,120,2,32,213390,32,120
1772.881,17,332,25232,332,48,5356,48,25232,0,0,0,0,0
0.33,17,2,136,1,32,0,32,60,1,48,0,48,76
10.224,6,1633,1416103,985,1385,10,1420,1385962,648,420,15,1420,30141
5.549,6,40,7325,21,218,277,314,3463,19,516,293,1179,3862
1752.889,6,128,8060,73,47,24345,208,4961,55,31,32453,31,3099
3.998,17,5,738,4,32,1308,32,240,1,470,0,470,498
1679.513,1,7,392,7,28,279918,28,392,0,0,0,0,0
127.957,6,23,10665,13,720,83,1308,3435,10,1136,14199,3151,7230
125.643,2,2,64,2,8,125643,8,64,0,0,0,0,0
27.978,6,26,6348,15,117,1998,159,1389,11,873,2793,1709,4959
62.816,17,4,352,2,48,62808,48,152,2,72,62806,72,200
0.086,17,4,404,2,46,0,46,148,2,100,34,106,256
1776.034,6,122,8956,66,26,27322,26,3924,56,115,32290,427,5032
10.985,6,20,4442,11,275,1098,275,998,9,768,777,1440,3444
1794.479,17,144,11520,72,48,25274,48,5472,72,56,25274,56,6048
62.249,6,70,47934,44,1173,1447,1368,39848,26,840,2480,2519,8086
9.085,6,17,5391,9,275,1135,275,643,8,1104,1258,1440,4748
1787.077,6,102,8364,68,66,26672,66,4964,34,60,54150,60,3400
0.206,6,39,15642,23,894,9,1420,10781,16,467,13,1883,4861
125.137,6,33,7757,12,155,31,267,1266,21,352,6256,1997,6491
9.173,6,81,24525,41,552,229,1152,18784,40,459,228,1179,5741
164.323,6,126,99010,82,1277,2028,1368,88596,44,738,2618,2519,10414
36.134,17,20,1760,10,48,4013,48,760,10,72,4013,72,1000
0.771,6,21,7606,11,318,74,600,1854,10,870,83,1471,5752
1744.569,2,28,896,28,8,64613,8,896,0,0,0,0,0
6.315,1,4,224,4,28,2105,28,224,0,0,0,0,0
94.565,6,851,425566,472,840,200,1152,405599,379,436,249,1179,19967
21.329,6,6,1255,4,327,7109,413,814,2,180,21140,269,441
381.248,17,6,528,3,60,190623,60,264,3,60,190623,60,264
130.439,1,3,168,3,28,65219,28,168,0,0,0,0,0
20.317,17,4,352,2,60,20315,60,176,2,60,20316,60,176
1790.338,1,342,28728,342,56,5250,56,28728,0,0,0,0,0
3.204,17,4,1564,4,363,1068,363,1564,0,0,0,0,0
124.275,6,23,9284,13,165,10356,300,1334,10,1237,13807,3188,7950
89.165,17,8,2624,8,300,12737,300,2624,0,0,0,0,0
0.696,6,21,7220,13,319,57,602,1960,8,1209,98,1906,5260
280.035,6,31,7472,14,158,21541,267,1357,17,543,17499,1400,6115
0.038,17,2,399,1,39,0,39,67,1,304,0,304,332
0.035,17,3,244,2,32,22,32,120,1,96,0,96,124
1745.575,6,104,8074,66,45,26855,205,4902,38,35,47170,98,3172
1788.053,6,381,26555,219,97,8201,469,15521,162,69,11104,69,11034
300.584,6,14,1043,7,177,50067,177,573,7,110,50067,110,470
199.564,17,4,240,2,32,199563,32,120,2,32,199563,32,120
1746.635,6,95,7203,63,38,28171,205,4476,32,33,56332,98,2727
1786.633,6,122,16843,78,223,23203,1302,11838,44,83,41547,241,5005
1755.71,6,3713,4535262,1422,152,1235,906,86451,2291,1953,766,9926,4448811
285.375,1,59,3304,0,0,0,0,0,59,28,4920,28,3304
0.16,17,2,2380,2,1162,160,1162,2380,0,0,0,0,0
0.036,17,2,290,1,40,0,40,68,1,194,0,194,222
1383.682,2,13,416,13,8,115306,8,416,0,0,0,0,0
0.768,6,26,5887,13,156,64,267,1462,13,650,58,1420,4425
1.137,6,24,8663,13,264,94,700,1611,11,942,95,1460,7052
0.037,17,2,184,1,32,0,32,60,1,96,0,96,124
4.041,17,5,4323,2,723,4041,1350,1503,3,912,716,1350,2820
0.023,17,2,184,1,32,0,32,60,1,96,0,96,124
36.702,6,19,832,8,0,5243,0,348,11,0,3029,0,484
0.129,6,3,168,1,0,0,0,52,2,0,109,0,116
1772.517,6,180,15480,120,69,14895,69,8940,60,69,30035,69,6540
1798.246,6,373,26028,216,98,8363,469,15263,157,69,11526,69,10765
1796.402,6,368,25690,215,99,8394,469,15085,153,69,11814,69,10605
293.17,6,72,48813,45,1196,6662,1408,40675,27,747,2369,1408,8138
1780.71,6,120,11042,75,65,24063,65,6365,45,59,40468,59,4677
1740.096,6,87,6322,58,31,30528,31,3915,29,31,62146,31,2407
1786.986,6,104,8308,68,64,26671,64,4896,36,58,51054,58,3412
1798.016,6,379,26406,218,97,8285,469,15481,161,69,11237,69,10925
1797.449,6,370,25908,215,99,8399,469,15085,155,69,11669,69,10823
2.223,6,20,3833,11,234,222,564,1504,9,463,254,1343,2329
219.512,17,124,34365,53,509,4221,1350,28467,71,55,3135,1350,5898
1795.718,1,65,5460,65,56,28058,56,5460,0,0,0,0,0
857.103,6,113,16604,58,85,15036,267,4715,55,201,15872,1452,11889
630.614,2,9,288,9,8,78826,8,288,0,0,0,0,0
3.858,6,2,88,2,0,0,0,88,0,0,0,0,0
1790.062,6,364,23047,211,69,8524,69,12787,153,69,11776,69,10260
1794.096,1,192,10752,192,28,9393,28,10752,0,0,0,0,0
389.514,17,5,380,5,48,97378,48,380,0,0,0,0,0
81.358,17,5,1920,5,356,20339,548,1920,0,0,0,0,0
0.037,17,2,144,1,36,0,36,64,1,52,0,52,80
107.148,17,16,5500,16,315,7143,354,5500,0,0,0,0,0
391.396,6,19,1306,14,180,30107,180,928,5,110,15177,110,378
1787.635,17,86,3606,85,14,21281,14,3570,1,8,0,8,36
13.057,6,1853,1733856,1221,1369,10,1380,1700547,632,511,20,1923,33309
284.724,17,34,5257,17,40,17794,43,1162,17,212,17794,249,4095
1.362,6,25,8056,12,164,105,267,1288,13,1014,96,2491,6768
1.481,6,26,6124,14,108,113,147,999,12,772,101,1608,5125
240.264,6,43,8802,21,173,12012,517,2311,22,533,11440,1418,6491
0.175,6,27,7296,13,155,14,267,1301,14,603,12,2800,5995
1737.818,1,18,2258,18,97,102224,173,2258,0,0,0,0,0
1780.736,6,420,25149,209,69,8561,69,12500,211,34,8479,48,12649
1775.573,17,142,11360,71,48,25365,48,5396,71,56,25365,56,5964
369.769,6,25,1651,17,177,23110,177,1117,8,110,9226,110,534
968.595,17,140,10640,140,48,6968,48,10640,0,0,0,0,0
31.7,6,12,5538,4,106,10566,106,274,8,822,4490,1460,5264
1772.68,6,180,15480,120,69,14896,69,8940,60,69,30042,69,6540
1795.043,17,447,39864,402,35,4476,288,25644,45,288,40015,288,14220
1790.994,1,274,15344,274,28,6560,28,15344,0,0,0,0,0
0.28,6,26,7256,13,155,23,267,1301,13,678,17,2800,5955
37.617,17,22,1672,22,48,1791,48,1672,0,0,0,0,0
2.985,6,2,88,2,0,0,0,88,0,0,0,0,0
371.177,6,25,1651,17,177,23198,177,1117,8,110,9227,110,534
31.016,17,6,604,6,72,6203,84,604,0,0,0,0,0
1786.404,6,102,8296,68,65,26662,65,4930,34,59,54130,59,3366
1795.261,17,81,3390,79,14,23013,14,3318,2,8,1795091,8,72
1386.646,2,10,320,10,8,154071,8,320,0,0,0,0,0
0.184,6,9,1340,5,145,46,145,349,4,827,27,827,991
21.43,17,26,9647,10,248,2377,1350,2767,16,402,1426,1350,6880
1.083,6,3,160,2,0,1083,0,100,1,0,0,0,60
0.376,6,7,295,4,0,125,0,164,3,7,92,7,131
1.348,6,50,20432,27,973,51,1460,14736,23,433,53,1460,5696
1741.693,6,87,6322,58,31,30556,31,3915,29,31,62202,31,2407
9.347,6,11,1003,6,332,1869,332,652,5,83,2323,83,351
1746.194,6,100,7866,66,45,26864,205,4902,34,35,52905,98,2964
240.527,6,316,382379,140,461,1730,1402,11037,176,2208,1374,9814,371342
96.04,6,37,7991,14,155,7387,267,1346,23,317,4364,1420,6645
1799.167,17,446,39832,401,35,4497,288,25612,45,288,40020,288,14220
365.92,6,27,1767,18,177,21524,177,1181,9,110,8529,110,586
1681.53,17,14,1036,7,30,280252,30,406,7,62,280253,62,630
1785.815,6,115,13647,75,80,24132,500,5916,40,161,45787,1420,7731
128.811,17,4,240,2,32,128810,32,120,2,32,128810,32,120
882.2,2,5,160,5,8,220550,8,160,0,0,0,0,0
2.271,17,13,6066,6,552,454,1350,3482,7,341,373,1350,2584
2.258,17,4,768,2,39,1775,39,134,2,289,1761,289,634
8.998,6,2,1175,1,0,0,0,40,1,1095,0,1095,1135
1783.368,17,83,3480,82,14,22016,14,3444,1,8,0,8,36
11.845,6,1809,1631161,1153,1362,10,1420,1600474,656,427,18,1420,30687
11.812,6,19,1534,9,275,1476,275,922,10,96,1284,96,612
1770.144,6,210,16153,78,68,22986,295,7645,132,48,13512,78,8508
0.938,6,10,1687,7,100,156,100,384,3,1179,332,1179,1303
2.946,17,30,13836,16,510,194,1350,8618,14,344,223,1350,5218
0.906,17,17,10166,10,703,99,1350,7311,7,379,144,1350,2855
1700.486,17,12,498,11,14,170048,14,462,1,8,0,8,36
1.443,6,45,18688,26,862,57,1360,13152,19,476,69,2720,5536
0.078,17,2,198,1,39,0,39,67,1,103,0,103,131
2.073,6,57,14728,29,533,74,1301,4996,28,477,75,4906,9732
53.853,6,12,664,7,0,8975,0,380,5,0,13432,0,284
299.53,6,6,364,4,31,99843,31,222,2,31,299504,31,142
0.272,6,21,7281,12,334,24,663,1969,9,967,33,1471,5312
33.771,6,31,5095,15,154,2412,722,1859,16,342,2234,1448,3236
1795.708,6,290,38872,121,160,14963,1360,19473,169,148,10687,4662,19399
0.4,6,10,968,5,256,96,256,460,5,304,95,304,508
1365.357,17,64,2682,63,14,22021,14,2646,1,8,0,8,36
0.034,6,2,2557,1,0,0,0,40,1,2465,0,2465,2517
15.552,6,2405,2205615,1529,1363,10,1408,2155399,876,931,17,2816,50216
1.471,6,37,8214,19,321,81,1164,2718,18,476,75,2715,5496
1798.967,17,450,39960,405,35,4452,288,25740,45,288,40020,288,14220
0.229,17,2,2754,2,1349,229,1349,2754,0,0,0,0,0
5.417,6,13,3125,7,92,902,92,472,6,1164,1011,1448,2653
366.999,6,27,1767,18,177,21588,177,1181,9,110,8543,110,586
47.653,6,30,7297,14,155,3665,267,1346,16,441,3176,1420,5951
1773.081,6,180,15480,120,69,14899,69,8940,60,69,30047,69,6540
1779.034,17,142,11360,71,48,25414,48,5396,71,56,25414,56,5964
1.807,6,25,8704,15,275,129,557,1429,10,981,180,1420,7275
1682.946,17,14,1036,7,30,280482,30,406,7,62,280481,62,630
1787.905,6,364,25461,211,100,8513,469,14856,153,69,11762,69,10605
29.94,6,13,944,4,106,9980,106,274,9,90,3723,90,670
300.57,6,18,1227,5,177,75099,177,445,13,110,25032,110,782
1791.269,6,208,20163,108,73,16740,721,9704,100,169,16752,2007,10459
240.361,6,43,8911,21,517,12016,1418,5759,22,222,11445,639,3152
1779.719,17,140,11200,70,48,25792,48,5320,70,56,25792,56,5880
8.504,6,5,264,3,0,4252,0,160,2,0,1051,0,104
9.529,17,4,824,2,48,9509,48,152,2,308,9514,308,672
367.395,6,24,1575,15,177,26242,177,989,9,110,9184,110,586
68.641,6,15,1657,9,177,8580,177,1007,6,110,13579,110,650
1787.134,17,87,3648,86,14,21025,14,3612,1,8,0,8,36
61.059,6,23,8593,11,107,6105,159,1022,12,991,5550,1668,7571
1791.273,17,179,13962,179,50,10063,50,13962,0,0,0,0,0
1.752,6,13,2311,8,188,250,245,700,5,1407,356,1407,1611
0.062,6,18,7245,9,138,7,138,614,9,1026,7,1448,6631
92.424,6,31,13745,16,741,39,1360,3725,15,940,6592,1360,10020
0.031,6,3,151,1,0,0,0,40,2,31,0,31,111
300.259,6,32,11869,17,589,18766,1438,4442,15,948,17165,1488,7427
2.29,6,14,5798,4,106,763,106,274,10,639,231,1460,5524
1740.707,17,29,30624,29,1028,62168,1028,30624,0,0,0,0,0
60.232,2,2,64,2,8,60232,8,64,0,0,0,0,0
1.283,6,48,19254,27,894,49,1360,13638,21,476,55,2715,5616
1799.259,17,449,39928,404,35,4464,288,25708,45,288,40018,288,14220
1789.642,17,84,3516,82,14,22091,14,3444,2,8,1789448,8,72
0.732,17,2,776,2,360,732,360,776,0,0,0,0,0
0.99,6,27,8120,14,266,64,540,1924,13,944,67,1591,6196
1780.288,17,136,10880,68,48,26571,48,5168,68,56,26571,56,5712
1681.224,17,16,4257,8,30,240174,37,471,8,445,240174,463,3786
5.041,17,3,208,2,36,5003,36,128,1,52,0,52,80
373.737,6,25,1651,17,177,23358,177,1117,8,110,9243,110,534
25.261,6,33,8171,16,199,1684,721,2038,17,681,1565,1440,6133
1756.04,6,106,6292,60,26,29762,26,3510,46,26,39022,26,2782
1787.319,6,104,8376,68,65,26676,65,4930,36,59,51062,59,3446
25.72,6,45,12895,22,199,1224,721,2479,23,730,1159,2840,10416
1773.011,6,180,15480,120,69,14899,69,8940,60,69,30046,69,6540
1796.704,17,142,11360,71,48,25666,48,5396,71,56,25666,56,5964
6.09,17,4,358,2,43,6042,43,142,2,80,6042,80,216
0.092,17,2,904,2,424,92,548,904,0,0,0,0,0
1.459,6,38,8258,19,321,81,1168,2722,19,433,70,1360,5536
2.817,1,3,168,3,28,1408,28,168,0,0,0,0,0
240.726,6,60,24009,33,545,7522,1408,6637,27,1140,9258,2816,17372
280.026,6,28,7352,13,158,23335,267,1317,15,678,20000,3436,6035
1741.296,6,91,6604,59,31,30022,31,3998,32,31,56170,31,2606
1797.286,1,336,28224,336,56,5365,56,28224,0,0,0,0,0
1789.503,6,356,22520,208,69,8644,69,12460,148,69,12170,69,10060
1.699,6,13,2311,8,188,242,245,700,5,1407,359,1407,1611
888.68,1,30,1680,30,28,30644,28,1680,0,0,0,0,0
483.239,1,10,560,10,28,53693,28,560,0,0,0,0,0
1240.645,17,49,16462,49,307,25846,326,16462,0,0,0,0,0
1772.371,6,180,15480,120,69,14893,69,8940,60,69,30037,69,6540
1315.716,17,20,6700,20,307,69248,320,6700,0,0,0,0,0
12.25,1,4,224,4,28,4083,28,224,0,0,0,0,0
8.236,6,15,2309,8,211,1176,211,858,7,545,1372,904,1451
0.16,6,13,4524,8,290,22,517,993,5,1631,37,2683,3531
1799.588,17,448,39896,403,35,4476,288,25676,45,288,40020,288,14220
1793.83,17,142,11360,71,48,25626,48,5396,71,56,25626,56,5964
0.01,17,2,378,1,30,0,30,58,1,292,0,292,320
378.073,2,4,128,4,8,126024,8,128,0,0,0,0,0
1789.125,17,142,11360,71,48,25558,48,5396,71,56,25558,56,5964
0.001,17,3,1063,3,326,0,354,1063,0,0,0,0,0
2.281,6,11,1754,7,100,380,100,384,4,603,675,1179,1370
1.198,6,24,8004,12,164,92,267,1288,12,1014,92,2804,6716
0.126,17,2,198,1,39,0,39,67,1,103,0,103,131
43.888,17,4,352,2,60,43887,60,176,2,60,43886,60,176
5.005,17,2,128,2,36,5005,36,128,0,0,0,0,0
1771.876,6,101,9278,66,64,27259,64,5544,35,58,52111,58,3734
3.917,6,14,2048,6,256,783,256,504,8,304,461,304,1544
1775.78,17,140,11200,70,48,25735,48,5320,70,56,25735,56,5880
1799.189,1,276,15456,276,28,6542,28,15456,0,0,0,0,0
0.626,6,22,7385,14,274,48,668,2109,8,1613,82,3314,5276
10.907,6,20,4442,11,275,1090,275,998,9,768,791,1440,3444
0.156,6,46,22028,27,1063,6,1420,17047,19,467,8,1883,4981
0.371,17,4,284,2,32,215,32,120,2,54,158,60,164
1263.3,2,14,448,14,8,97176,8,448,0,0,0,0,0
120.531,6,9,1647,5,100,30132,100,304,4,589,40088,1152,1343
1135.112,6,232,14662,133,69,8599,69,8080,99,69,11582,69,6582
64.954,6,69,47421,44,1196,1510,1368,39384,25,841,2569,2519,8037
1795.394,17,448,39896,403,35,4466,288,25676,45,288,40022,288,14220
5.562,6,30,5032,13,256,463,256,2828,17,304,346,304,2204
1798.458,17,449,39928,404,35,4462,288,25708,45,288,40019,288,14220
1787.113,6,102,8228,68,64,26673,64,4896,34,58,54152,58,3332
0.017,6,6,328,4,0,5,0,216,2,0,9,0,112
4.873,6,37,7189,19,218,270,314,3383,18,513,270,1179,3806
1.136,17,4,368,2,32,949,32,120,2,96,897,96,248
1.303,6,50,19352,27,896,50,1360,13656,23,433,51,1360,5696
1771.316,6,101,9410,66,66,27251,66,5610,35,60,52094,60,3800
13.081,6,14,2193,8,328,1868,593,1081,6,396,2613,580,1112
66.86,17,4,240,2,32,66858,32,120,2,32,66859,32,120
1740.492,17,30,31680,30,1028,60016,1028,31680,0,0,0,0,0
1757.464,6,186,11385,93,47,19102,208,6766,93,31,19100,31,4619
2.795,6,74,74115,41,131,69,201,2196,33,2434,82,8484,71919
0.095,17,2,144,1,36,0,36,64,1,52,0,52,80
4.452,6,41,7349,21,218,222,314,3463,20,440,220,1152,3886
2.866,17,4,624,4,128,955,128,624,0,0,0,0,0
375.939,6,75,11963,37,302,10442,1366,6169,38,211,10160,1344,5794
167.66,1,6,336,6,28,33532,28,336,0,0,0,0,0
0.31,6,26,6066,13,164,25,453,1494,13,555,24,1542,4572
61.54,6,35,5038,21,135,3077,174,1522,14,368,3392,1452,3516
0.395,6,50,20607,27,1022,15,1380,15445,23,421,16,1923,5162
32.405,17,8,608,8,48,4629,48,608,0,0,0,0,0
0.359,6,27,9112,13,271,29,726,1771,14,943,27,1408,7341
1.337,6,13,4892,7,125,221,125,497,6,1358,259,2462,4395
1799.026,1,788,88490,788,84,2285,85,88490,0,0,0,0,0
110.462,17,10,880,5,48,27613,48,380,5,72,27613,72,500
0.052,17,2,197,1,44,0,44,72,1,97,0,97,125
1751.0,6,163,9863,85,43,20845,208,5844,78,31,22736,31,4019
0.843,6,11,1727,7,100,140,100,384,4,589,194,1152,1343
1681.568,17,16,1265,8,30,240219,37,471,8,71,240219,136,794
1771.864,6,101,9410,66,66,27259,66,5610,35,60,52110,60,3800
1740.265,6,87,6322,58,31,30530,31,3915,29,31,62151,31,2407
1.727,6,25,8807,15,292,123,609,1481,10,988,170,1452,7326
0.014,17,2,412,1,48,0,48,76,1,308,0,308,336
11.945,6,1886,1649511,1146,1385,10,1420,1615666,740,467,16,1883,33845
18.774,6,6,328,4,0,6258,0,216,2,0,18752,0,112
11.786,6,1887,1628959,1133,1383,10,1420,1594578,754,467,15,1883,34381
1.557,6,47,19171,27,891,59,1360,13595,20,433,71,1360,5576
1784.366,6,356,22520,208,69,8620,69,12460,148,69,12138,69,10060
4.661,17,4,824,2,48,4654,48,152,2,308,4654,308,672
1785.753,6,105,8416,68,65,26653,65,4930,37,59,49601,59,3486
0.59,6,8,440,5,0,147,0,268,3,0,252,0,172
1775.654,1,58,4872,0,0,0,0,0,58,56,31151,56,4872
0.206,1,2,163,2,53,206,78,163,0,0,0,0,0
0.31,6,21,7290,12,335,27,668,1974,9,968,37,2816,5316
61.3,6,37,16031,22,810,2919,1448,9253,15,665,4360,1448,6778
0.015,6,10,1568,6,121,3,121,441,4,911,4,911,1127
1746.074,6,95,7203,63,38,28162,205,4476,32,33,56312,98,2727
1.139,6,24,8004,12,164,88,267,1288,12,1014,88,2816,6716
1744.662,2,30,960,30,8,60160,8,960,0,0,0,0,0
0.714,17,3,451,2,39,31,39,134,1,289,0,289,317
0.761,6,17,5132,9,150,95,174,664,8,828,95,1420,4468
176.479,6,9,528,2,112,176470,112,200,7,0,29411,0,328
360.247,1,9,504,9,28,45030,28,504,0,0,0,0,0
1786.668,6,104,8308,68,64,26666,64,4896,36,58,51045,58,3412
10.855,6,18,4266,10,275,1206,275,958,8,992,865,1440,3308
1797.779,6,335,30703,165,370,10962,841,11555,170,63,10617,1538,19148
0.051,17,8,2446,8,277,7,316,2446,0,0,0,0,0
1774.623,17,140,11200,70,48,25719,48,5320,70,56,25719,56,5880
102.436,17,4,1344,4,308,34145,308,1344,0,0,0,0,0
1799.225,1,61,5124,61,56,29987,56,5124,0,0,0,0,0
1.08,6,5,284,1,0,0,0,52,4,0,360,0,232
124.935,6,36,7952,13,156,27,267,1312,23,317,5678,1420,6640
1734.366,17,144,24660,144,143,12128,376,24660,0,0,0,0,0
16.314,6,18,2634,8,411,2329,585,1666,10,212,1811,212,968
1796.857,6,128,8069,72,44,25307,208,4620,56,31,32662,31,3449
0.342,6,4,1037,2,0,232,0,104,2,853,112,853,933
1.623,6,47,18736,27,860,62,1360,13160,20,476,74,2715,5576
33.856,6,3,734,3,289,16928,289,734,0,0,0,0,0
86.666,1,18,504,18,0,0,0,504,0,0,0,0,0
1.291,6,231,174534,132,1330,9,1420,166283,99,427,13,1420,8251
10.222,6,6,328,4,0,3407,0,216,2,0,10184,0,112
1386.083,2,10,320,10,8,154009,8,320,0,0,0,0,0
277.391,17,4,352,2,60,277389,60,176,2,60,277389,60,176
38.522,17,11,836,11,48,3852,48,836,0,0,0,0,0
283.244,6,26,7395,12,197,25749,267,1469,14,595,21775,1400,5926
1676.99,1,7,742,7,78,279498,78,742,0,0,0,0,0
325.83,6,994,769400,581,1329,561,1360,745101,413,204,81,1360,24299
16.298,6,1528,1401927,924,1434,17,1448,1362515,604,776,26,1448,39412
22.406,6,30,5624,18,174,1318,517,2350,12,440,2036,499,3274
0.082,17,2,172,1,50,0,50,78,1,66,0,66,94
1567.204,6,275,24735,155,77,9769,267,10622,120,134,13169,1997,14113
0.02,6,2,104,1,0,0,0,52,1,0,0,0,52
94.571,17,4,272,2,32,94566,32,120,2,48,94565,48,152
1787.906,6,367,26050,213,105,8433,469,15405,154,69,11685,69,10645
240.217,6,54,18210,28,815,8896,1408,15328,26,217,9608,580,2882
12.183,1,13,728,13,28,1015,28,728,0,0,0,0,0
8.388,6,71,20806,37,538,233,1152,16019,34,427,246,1152,4787
7.793,6,643,539801,301,183,25,230,18609,342,1480,22,2736,521192
153.19,2,5,160,5,8,38297,8,160,0,0,0,0,0
0.016,6,2,92,1,0,0,0,40,1,0,0,0,52
1780.446,17,149,31939,149,186,12030,422,31939,0,0,0,0,0
0.566,6,27,9063,13,209,47,653,1741,14,939,40,1368,7322
240.199,6,55,18924,30,792,8282,1408,15830,25,223,10008,580,3094
280.47,6,29,7392,13,158,23372,267,1317,16,678,18692,3456,6075
1792.155,17,180,14040,180,50,10012,50,14040,0,0,0,0,0
3.705,6,24,8360,11,265,370,764,1655,13,860,308,1408,6705
0.866,6,27,8506,15,229,53,583,2007,12,1201,64,3151,6499
1744.649,2,20,640,20,8,91823,8,640,0,0,0,0,0
174.835,17,4,352,2,60,174834,60,176,2,60,174834,60,176
0.089,6,11,911,6,181,17,181,489,5,77,20,133,422
1757.326,6,4466,4594362,1607,145,1094,867,100312,2859,1560,614,8508,4494050
234.56,17,4,352,2,60,234559,60,176,2,60,234559,60,176
2.552,6,13,2311,8,188,364,245,700,5,1407,577,1407,1611
33.667,6,27,7177,13,155,2805,267,1306,14,530,2589,2840,5871
1738.631,6,87,6322,58,31,30502,31,3915,29,31,62092,31,2407
0.249,17,2,180,1,30,0,30,58,1,94,0,94,122
1779.458,17,140,11200,70,48,25789,48,5320,70,56,25789,56,5880
1792.705,6,281,33932,113,139,16005,1460,16568,168,125,10733,1460,17364
10.755,6,1540,1451357,966,1421,10,1448,1413345,574,776,18,1448,38012
0.727,17,12,6354,6,617,145,1350,3870,6,386,88,1350,2484
280.155,1,3,180,3,32,140077,32,180,0,0,0,0,0
212.642,6,34,5839,13,168,11240,516,1535,21,216,10627,1452,4304
0.437,6,288,283869,199,194,2,230,12115,89,3070,4,21120,271754
601.61,2,7,224,7,8,100268,8,224,0,0,0,0,0
1773.117,6,30,4881,20,258,93321,414,3383,10,109,196994,270,1498
1785.86,17,140,11200,70,48,25881,48,5320,70,56,25881,56,5880
240.203,6,54,18152,29,804,8578,1418,15186,25,207,10008,580,2966
1.307,6,47,19999,28,887,48,1360,14463,19,476,63,2720,5536
0.482,17,3,451,2,39,96,39,134,1,289,0,289,317
10.854,17,15,17678,15,1150,775,1451,17678,0,0,0,0,0
56.986,6,14,1847,7,100,9497,100,384,7,589,9449,1152,1463
1795.398,17,448,39896,403,35,4466,288,25676,45,288,40017,288,14220
199.978,6,18,1296,7,31,33302,31,457,11,31,19980,31,839
0.15,17,4,588,2,48,120,48,152,2,190,127,308,436
0.126,6,16,9338,9,273,15,517,1297,7,2556,16,4709,8041
0.029,17,2,290,1,40,0,40,68,1,194,0,194,222
3.9,6,6,1257,4,327,1300,414,815,2,181,3683,270,442
0.254,6,21,5000,10,137,28,267,1092,11,692,24,1467,3908
7.112,6,114,99132,57,221,127,517,4125,57,1840,126,5632,95007
115.384,6,39,5808,16,165,7692,722,1987,23,187,5175,1408,3821
1743.052,6,95,7203,63,38,28113,205,4476,32,33,56221,98,2727
8.316,6,1503,1373336,919,1415,8,1448,1338304,584,776,13,1448,35032
0.24,17,14,5893,6,395,48,1350,2538,8,391,24,1350,3355
29.441,6,4129,3969671,2749,1367,10,1408,3893223,1380,776,21,1408,76448
1770.827,6,113,10723,73,70,24594,234,6376,40,60,45403,83,4347
6.514,6,1027,933549,641,1380,9,1408,908813,386,931,16,2816,24736
0.035,17,4,344,2,47,0,47,150,2,69,0,75,194
0.011,17,2,485,1,45,0,45,73,1,384,0,384,412
1714.69,1,15,840,15,28,122477,28,840,0,0,0,0,0
1790.924,6,254,37225,156,302,11554,302,26868,98,83,18462,83,10357
300.736,6,37,8440,20,284,15828,792,2007,17,478,534,1928,6433
0.937,6,27,8420,15,222,55,540,1964,12,1192,69,3151,6456
1700.597,17,13,534,11,14,170041,14,462,2,8,1700418,8,72
280.372,6,30,7432,13,158,23364,267,1317,17,543,17517,1400,6115
1675.02,1,8,448,8,28,239288,28,448,0,0,0,0,0
18.892,17,26,14862,12,443,1714,1350,5658,14,629,1450,1350,9204
1.909,17,3,222,3,46,954,46,222,0,0,0,0,0
1795.592,1,342,28728,342,56,5265,56,28728,0,0,0,0,0
60.42,6,11,2992,6,92,12084,92,400,5,1164,15058,1448,2592
1682.25,1,15,870,15,30,120160,30,870,0,0,0,0,0
300.3,6,34,17317,21,983,15015,1440,11921,13,785,4887,1440,5396
300.315,6,44,29517,27,190,11550,444,2305,17,2024,15116,9856,27212
182.934,17,4,1312,4,300,60978,308,1312,0,0,0,0,0
0.909,17,4,624,2,64,882,64,184,2,192,890,192,440
8.453,6,1695,1477322,1004,1386,8,1408,1434266,691,931,12,2801,43056
1681.927,17,14,1036,7,30,280315,30,406,7,62,280313,62,630
4.067,6,55,15984,26,553,162,1440,5557,29,543,137,1440,10427
281.119,6,31,7813,13,158,23426,267,1317,18,524,16532,1400,6496
78.042,6,217,171677,97,430,812,647,6678,120,1356,628,1408,164999
311.73,6,20,2429,7,242,51954,517,1111,13,323,25977,499,1318
96.785,17,4,352,2,60,96784,60,176,2,60,96784,60,176
24.879,6,3,180,3,0,0,0,180,0,0,0,0,0
1684.518,2,19,608,19,8,93584,8,608,0,0,0,0,0
0.012,17,4,284,2,32,1,32,120,2,54,1,60,164
0.004,17,2,227,1,31,0,31,59,1,140,0,140,168
1787.118,6,119,13875,75,81,24150,501,5950,44,162,41558,1420,7925
1789.342,6,105,6959,65,49,27958,208,4286,40,33,45867,112,2673
5.887,6,38,7245,19,218,327,314,3383,19,516,312,1179,3862
1.344,6,24,8004,12,164,101,267,1288,12,1014,104,2331,6716
8.296,6,68,20702,34,559,251,1152,15915,34,427,243,1152,4787
1796.534,1,231,12936,231,28,7811,28,12936,0,0,0,0,0
6.564,6,21,6895,11,330,628,517,1903,10,893,696,2451,4992
300.616,6,39,8545,21,299,15030,852,2071,18,478,498,2720,6474
10.545,6,2160,2031133,1397,1377,7,1408,1986793,763,931,13,2801,44340
1740.456,17,26,6110,26,207,69618,207,6110,0,0,0,0,0
0.027,17,2,339,1,33,0,33,61,1,250,0,250,278
0.323,6,26,8911,13,237,26,590,1635,13,941,26,1408,7276
0.877,6,25,5660,13,125,73,267,1275,12,780,68,1460,4385
1.077,6,55,17118,35,322,31,1360,9165,20,793,50,4649,7953
1516.33,6,248,27563,93,103,16481,1305,8134,155,109,9845,3289,19429
129.047,6,35,12708,12,285,11729,1189,2768,23,563,5864,4837,9940
285.507,1,2,112,2,28,285507,28,112,0,0,0,0,0
1799.125,6,186,11385,93,47,19555,208,6766,93,31,19552,31,4619
0.007,17,2,154,1,33,0,33,61,1,65,0,65,93
1.614,6,47,19570,27,920,62,1360,13994,20,476,74,2715,5576
0.032,17,8,2454,8,278,4,317,2454,0,0,0,0,0
1763.487,2,30,960,30,8,60809,8,960,0,0,0,0,0
318.06,6,68,8765,24,121,10105,722,2840,44,106,7392,1448,5925
0.098,17,4,368,2,32,97,32,120,2,96,52,96,248
1798.303,1,58,4872,58,56,31549,56,4872,0,0,0,0,0
1.189,17,2,782,2,363,1189,363,782,0,0,0,0,0
0.199,6,11,1737,6,125,39,125,385,5,1148,38,1148,1352
6.709,6,544,494309,350,1348,18,1368,479545,194,776,33,2736,14764
10.19,6,1683,1413175,981,1385,10,1420,1380862,702,420,14,1420,32313
1772.974,6,181,15589,120,69,14898,69,8940,61,69,29542,69,6649
363.225,6,23,1538,16,180,24215,180,1056,7,110,10384,110,482
0.412,6,47,19605,26,1034,16,1380,14523,21,421,18,1923,5082
1773.906,6,182,15629,121,69,14782,69,9049,61,69,29563,69,6580
10.097,6,91,27497,45,543,229,1152,20834,46,438,218,1179,6663
102.025,6,3,760,3,302,51012,302,760,0,0,0,0,0
1750.703,17,13,534,11,14,175051,14,462,2,8,1750520,8,72
3.856,17,4,352,2,48,3848,48,152,2,72,3846,72,200
67.289,6,18,5841,10,272,7476,516,1220,8,716,267,1452,4621
1.67,6,12,1163,6,222,330,222,688,6,231,331,231,475
0.123,17,2,672,2,308,123,308,672,0,0,0,0,0
1743.192,6,95,7203,63,38,28116,205,4476,32,33,56223,98,2727
27.758,6,38,8606,18,190,1632,721,2251,20,555,1449,1440,6355
4.994,17,4,288,2,36,4994,36,128,2,52,4993,52,160
3.787,17,10,2594,5,30,943,30,290,5,432,943,468,2304
14.295,6,1240,1131674,756,1417,18,1448,1100850,484,931,28,2761,30824
1792.709,6,369,23316,212,69,8496,69,12896,157,69,11491,69,10420
0.955,6,115,87553,49,131,19,232,2489,66,1351,12,1430,85064
1791.762,6,369,26130,214,105,8412,469,15514,155,69,11634,69,10616
23.951,6,21,3182,12,183,2177,517,1561,9,381,2992,499,1621
8.634,17,17,14356,6,703,916,1350,4387,11,878,859,1350,9969
1735.159,1,54,3024,54,28,32738,28,3024,0,0,0,0,0
16.138,6,11,612,6,0,3227,0,328,5,0,4024,0,284
1.089,6,1118,1203110,522,331,2,333,31289,596,1930,1,8208,1171821
102.888,17,10,800,5,48,25720,48,380,5,56,25720,56,420
1.2,6,29,8200,14,266,78,540,1924,15,809,71,1460,6276
13.785,6,58,22609,29,966,492,1440,16649,29,433,485,1440,5960
57.291,6,26,12859,8,187,956,187,551,18,1157,3362,1360,12308
38.14,17,19,6834,9,429,4763,1350,4118,10,243,4234,1350,2716
16.055,17,21,7433,10,436,1780,1350,4646,11,225,1602,1350,2787
0.332,6,27,9072,13,252,27,647,1692,14,949,24,2816,7380
0.127,17,2,154,1,33,0,33,61,1,65,0,65,93
1786.409,6,104,8308,68,64,26662,64,4896,36,58,51037,58,3412
35.965,17,4,240,2,32,35964,32,120,2,32,35965,32,120
6.5,6,30,8848,13,155,541,267,1306,17,527,405,3417,7542
369.876,6,25,1651,17,177,23117,177,1117,8,110,9222,110,534
11.907,6,1777,1639324,1156,1365,10,1432,1610169,621,427,19,1432,29155
412.111,6,8,475,6,31,82422,31,333,2,31,299515,31,142
3.986,17,4,268,4,39,1328,39,268,0,0,0,0,0
0.198,6,27,7296,14,155,15,267,1341,13,678,14,3436,5955
240.348,6,43,8773,21,529,12016,1418,5864,22,195,11444,618,2909
5.912,6,3,180,3,0,0,0,180,0,0,0,0,0
1007.921,2,8,256,8,8,143988,8,256,0,0,0,0,0
1675.753,1,7,392,7,28,279292,28,392,0,0,0,0,0
1787.39,6,104,8376,68,65,26677,65,4930,36,59,51064,59,3446
5.914,2,2,64,2,8,5914,8,64,0,0,0,0,0
8.679,17,33,10963,10,530,963,1350,5582,23,205,393,1350,5381
300.823,2,3,96,3,8,150411,8,96,0,0,0,0,0
60.564,6,3,187,3,31,30282,31,187,0,0,0,0,0
0.043,17,2,322,1,33,0,33,61,1,233,0,233,261
142.357,6,17,4126,8,92,20336,92,504,9,450,17770,2026,3622
1.468,6,38,9848,20,502,77,1460,4352,18,433,74,1460,5496
1773.625,6,180,15480,120,69,14904,69,8940,60,69,30054,69,6540
1770.386,17,259,52648,259,175,6861,422,52648,0,0,0,0,0
1773.199,6,180,15480,120,69,14900,69,8940,60,69,30049,69,6540
19.872,17,32,15483,15,388,1417,1350,6240,17,515,1240,1350,9243
8.551,6,33,13011,18,717,503,1360,5866,15,816,597,1360,7145
2.47,6,3,120,2,0,2470,0,80,1,0,0,0,40
16.814,6,2152,1895123,1253,1423,13,1448,1838487,899,776,18,1448,56636
1799.046,1,58,4872,0,0,0,0,0,58,56,31562,56,4872
241.721,17,11,836,11,48,24172,48,836,0,0,0,0,0
1744.762,6,95,7203,63,38,28141,205,4476,32,33,56268,98,2727
1680.891,17,12,498,11,14,168089,14,462,1,8,0,8,36
1780.62,17,142,11360,71,48,25436,48,5396,71,56,25436,56,5964
1744.623,2,28,896,28,8,64615,8,896,0,0,0,0,0
9.99,6,15,2295,9,210,1247,210,896,6,545,1997,905,1399
39.797,17,4,352,2,60,39796,60,176,2,60,39796,60,176
280.551,6,31,7472,13,158,23379,267,1317,18,603,16500,2076,6155
75.585,6,15,620,7,0,4142,0,284,8,0,10796,0,336
13.63,6,22,4526,12,275,1239,275,1038,10,768,990,1440,3488
3.344,6,2,88,2,0,0,0,88,0,0,0,0,0
0.133,17,2,186,1,41,0,41,69,1,89,0,89,117
1774.29,1,60,5040,60,56,30072,56,5040,0,0,0,0,0
1.337,6,28,5788,15,125,95,267,1359,13,780,97,1460,4429
258.349,6,68,9385,30,179,8908,585,3612,38,199,6982,717,5773
216.604,17,4,304,2,48,216601,64,152,2,48,216603,64,152
16.242,17,21,6727,9,336,2025,1350,3277,12,259,1472,1350,3450
1741.314,6,87,6322,58,31,30549,31,3915,29,31,62188,31,2407
0.277,6,10,1060,5,517,69,517,785,5,7,69,7,275
20.055,17,28,2050,20,40,1054,41,1373,8,56,3,57,677
280.813,6,31,7563,13,158,23401,267,1317,18,502,16513,1400,6246
280.252,6,29,7392,13,158,23354,267,1317,16,603,18682,1400,6075
5.861,6,41,7365,21,218,293,314,3463,20,516,295,1179,3902
4.123,17,4,300,2,47,4122,47,150,2,47,4121,47,150
10.836,17,8,1176,4,48,3609,48,304,4,190,3609,308,872
1785.136,6,102,8296,68,65,26643,65,4930,34,59,54091,59,3366
0.037,17,2,251,1,36,0,36,64,1,159,0,159,187
204.063,17,2,148,2,46,204063,46,148,0,0,0,0,0
0.324,6,22,7219,11,257,31,748,1611,11,1005,31,2381,5608
281.321,6,29,7392,13,158,23443,267,1317,16,603,18752,2036,6075
1799.591,17,446,39264,402,35,4487,288,25360,44,288,40953,288,13904
0.17,6,5,243,4,31,4,31,203,1,0,0,0,40
1.751,17,2,154,1,33,0,33,61,1,65,0,65,93
44.985,17,12,570,11,16,4498,58,486,1,56,0,56,84
29.449,17,18,8361,9,586,3681,1350,5527,9,286,49,1350,2834
1789.947,6,365,25432,213,100,8443,469,14936,152,69,11853,69,10496
1799.445,17,449,39928,404,35,4465,288,25708,45,288,40019,288,14220
3.417,17,20,13563,11,972,340,1350,11002,9,256,421,1350,2561
1772.137,6,180,15480,120,69,14891,69,8940,60,69,30034,69,6540
4.822,17,5,320,5,36,1205,36,320,0,0,0,0,0
1768.755,6,150,26566,88,364,20330,1271,19549,62,103,28995,241,7017
1638.091,2,12,384,12,8,148917,8,384,0,0,0,0,0
0.176,6,9,1339,5,145,44,145,349,4,826,36,826,990
1696.979,1,8,448,8,28,242425,28,448,0,0,0,0,0
1771.092,6,101,9410,66,66,27247,66,5610,35,60,52088,60,3800
4.171,6,38,7229,20,218,219,314,3423,18,513,230,1179,3806
1780.075,17,142,11360,71,48,25429,48,5396,71,56,25429,56,5964
1799.998,17,141,11276,71,48,25714,48,5396,70,56,25699,56,5880
261.542,17,4,240,2,32,261541,32,120,2,32,261541,32,120
0.019,6,15,3984,10,101,2,101,629,5,1029,4,1500,3355
13.986,6,21,6825,12,275,1271,275,1038,9,1353,1121,1440,5787
1774.854,6,180,15480,120,69,14914,69,8940,60,69,30076,69,6540
282.718,6,32,7779,14,176,21747,267,1624,18,543,16627,1400,6155
0.886,6,24,6420,13,299,73,842,2023,11,988,87,1731,4397
2.566,6,32,13167,17,511,160,1460,3299,15,924,170,1460,9868
0.129,17,7,2438,7,320,21,354,2438,0,0,0,0,0
0.545,17,4,852,2,39,531,39,134,2,331,14,345,718
0.026,6,9,1878,5,666,6,666,934,4,728,8,728,944
1749.282,6,131,13062,80,67,22142,721,6794,51,87,34981,1448,6268
1738.864,6,87,6322,58,31,30506,31,3915,29,31,62101,31,2407
241.394,6,45,5239,22,172,11494,595,2578,23,179,10972,580,2661
175.153,6,24,8494,11,181,17515,267,1168,13,850,14591,2076,7326
1739.976,6,178,13959,94,90,18709,208,9669,84,31,20959,31,4290
421.156,2,3,96,3,8,210578,8,96,0,0,0,0,0
1781.765,6,364,23047,211,69,8484,69,12787,153,69,11722,69,10260
122.344,6,74,48034,45,1160,2780,1408,38384,29,903,2200,2816,9650
0.539,6,22,7385,13,274,44,668,2057,9,1210,61,1946,5328
15.729,17,15,5123,7,360,2616,1350,2716,8,272,2242,1350,2407
52.153,6,6,7152,0,0,0,0,0,6,1152,10430,1152,7152
61.307,6,35,15936,22,811,2919,1408,9262,13,748,5088,2439,6674
1.315,6,47,18160,26,882,52,1360,12544,21,433,56,1360,5616
240.217,6,54,17584,29,770,8578,1418,14610,25,208,10008,580,2974
1797.812,17,449,39928,404,35,4461,288,25708,45,288,40023,288,14220
15.641,6,94,28021,48,523,332,1152,21310,46,442,341,1179,6711
1786.258,17,87,3648,86,14,21014,14,3612,1,8,0,8,36
13.378,6,5,473,1,0,0,0,40,4,91,4396,91,433
1775.072,17,142,11360,71,48,25358,48,5396,71,56,25358,56,5964
0.511,6,20,7238,13,335,42,668,2026,7,1210,78,1946,5212
369.639,6,18,1242,14,180,28433,180,916,4,110,20071,110,326
288.915,6,11,5041,6,744,57740,1247,1728,5,1037,72186,1661,3313
1.38,17,16,9185,8,822,197,1350,6803,8,269,90,1350,2382
755.701,2,5,160,5,8,188925,8,160,0,0,0,0,0
1762.472,6,121,12364,66,66,27113,517,4636,55,242,32636,2447,7728
303.25,17,73,4074,30,24,8897,29,1588,43,29,7220,84,2486
0.133,6,10,1514,5,503,33,503,771,5,475,33,475,743
1766.096,1,58,4872,58,56,30984,56,4872,0,0,0,0,0
6.335,6,39,7285,21,218,316,314,3463,18,516,357,1179,3822
76.585,6,642,295151,332,824,231,1152,277928,310,438,246,1179,17223
1.257,6,25,8056,12,164,96,267,1288,13,869,88,1448,6768
0.961,6,14,2185,8,326,137,589,1065,6,396,186,580,1120
458.292,17,5,4023,5,776,114573,1446,4023,0,0,0,0,0
1.334,17,3,1170,3,362,667,362,1170,0,0,0,0,0
5.014,17,4,288,2,36,5000,36,128,2,52,5004,52,160
240.206,6,57,17770,29,742,8578,1418,14886,28,177,8896,580,2884
12.057,6,56,19181,32,503,388,1360,4470,24,914,482,2720,14711
24.431,6,44,6185,20,163,1285,293,2928,24,458,1049,1179,3257
39.652,1,41,4264,0,0,0,0,0,41,76,991,76,4264
1.477,6,32,6507,16,164,98,267,1962,16,650,86,1380,4545
39.842,17,4,1344,4,308,13280,308,1344,0,0,0,0,0
1789.953,6,362,22898,209,69,8605,69,12638,153,69,11775,69,10260
240.249,6,49,10236,24,532,10445,1418,7141,25,198,10009,580,3095
36.138,17,20,1520,20,48,1902,48,1520,0,0,0,0,0
1.553,6,45,17774,26,858,62,1360,12238,19,476,73,2715,5536
104.64,6,20,8132,11,511,83,1194,2005,9,1151,13057,3151,6127
1798.546,17,142,11360,71,48,25693,48,5396,71,56,25693,56,5964
0.079,17,3,1173,1,137,0,137,165,2,476,29,476,1008
0.044,17,4,352,2,37,6,37,130,2,83,39,89,222
95.692,6,15,1083,4,177,119,177,393,11,110,9551,110,690
3.795,17,4,268,4,39,1265,39,268,0,0,0,0,0
2.15,17,25,9392,12,305,191,1350,3999,13,386,175,1350,5393
1.598,6,50,21293,29,905,57,1360,15677,21,476,69,2720,5616
2.256,17,14,7482,7,505,376,1350,3732,7,507,323,1350,3750
1082.897,2,11,352,11,8,108289,8,352,0,0,0,0,0
1720.459,17,12,498,11,14,172045,14,462,1,8,0,8,36
1769.89,6,103,9514,66,66,27229,66,5610,37,60,49159,60,3904
1.68,6,25,8469,15,175,120,362,1666,10,1045,141,2423,6803
0.081,17,2,586,1,46,0,46,74,1,484,0,484,512
0.138,17,4,420,2,33,0,33,122,2,121,91,145,298
1786.899,6,104,8308,68,64,26670,64,4896,36,58,51051,58,3412
1784.775,6,420,25176,210,69,8539,69,12540,210,34,8539,48,12636
0.591,6,10,924,5,283,101,283,551,5,105,98,105,373
38.182,17,44,6468,22,48,1817,48,1672,22,190,1817,308,4796
0.074,17,2,178,1,29,0,29,57,1,93,0,93,121
283.152,6,31,7476,13,158,23596,267,1317,18,543,16653,1400,6159
1740.654,6,87,6322,58,31,30537,31,3915,29,31,62165,31,2407
296.658,1,4,326,4,53,98886,78,326,0,0,0,0,0
365.899,6,25,1651,17,177,22868,177,1117,8,110,9168,110,534
0.002,6,2,589,2,254,2,301,589,0,0,0,0,0
1793.596,17,87,3648,86,14,21101,14,3612,1,8,0,8,36
8.675,6,814,664276,477,1316,17,1368,642088,337,776,25,1473,22188
87.166,17,4,240,2,32,87165,32,120,2,32,87164,32,120
0.634,6,14,2598,7,288,87,288,600,7,568,74,853,1998
1680.43,1,15,840,15,28,120030,28,840,0,0,0,0,0
1710.451,1,8,448,8,28,244350,28,448,0,0,0,0,0
0.504,17,3,451,2,39,407,39,134,1,289,0,289,317
1.334,6,25,8056,12,164,106,267,1288,13,869,97,1448,6768
75.812,6,30,7573,12,155,6892,267,1266,18,429,4459,3426,6307
2.077,6,110,86948,47,131,45,232,2409,63,1438,33,2840,84539
13.364,6,69,22080,33,552,417,1152,15683,36,550,374,1179,6397
41.86,17,4,1344,4,308,13953,308,1344,0,0,0,0,0
0.088,17,2,904,2,424,88,548,904,0,0,0,0,0
0.315,6,27,9076,14,252,24,646,1746,13,1105,25,2804,7330
1667.608,1,8,448,8,28,238229,28,448,0,0,0,0,0
3.75,6,11,3028,4,92,1250,92,296,7,472,540,2026,2732
15.033,6,4063,3873929,2645,1386,5,1408,3795529,1418,931,10,2816,78400
1.362,6,49,19365,27,899,52,1460,13709,22,476,56,2615,5656
7.246,6,42,7773,21,224,362,314,3756,21,453,347,1179,4017
1799.074,1,57,4788,57,56,32126,56,4788,0,0,0,0,0
5.01,17,4,542,2,36,5006,36,128,2,179,5006,187,414
1788.445,17,87,3648,86,14,21040,14,3612,1,8,0,8,36
1.372,6,48,19595,27,919,52,1360,13979,21,433,58,1360,5616
1796.07,6,253,45921,125,854,14484,1418,33017,128,63,14141,241,12904
1789.22,6,251,45967,124,864,14546,1418,33325,127,61,14197,580,12642
446.881,2,3,96,3,8,223440,8,96,0,0,0,0,0
1746.633,6,153,10224,81,61,21832,208,6445,72,31,24597,31,3779
1.622,6,38,8254,19,321,90,1164,2718,19,433,78,1460,5536
0.045,17,4,344,2,47,0,47,150,2,69,9,75,194
9.99,6,20,2587,9,209,1248,209,930,11,544,998,891,1657
0.06,6,9,1002,5,213,15,213,417,4,421,16,421,585
1772.735,17,44,14784,44,308,41226,308,14784,0,0,0,0,0
1787.364,6,102,8364,68,66,26677,66,4964,34,60,54159,60,3400
1745.93,6,95,7203,63,38,28160,205,4476,32,33,56306,98,2727
1798.021,17,142,11360,71,48,25685,48,5396,71,56,25685,56,5964
10.967,6,20,4322,11,275,1096,275,998,9,738,777,1380,3324
1.347,6,24,10551,13,692,112,1408,4144,11,728,115,2688,6407
0.849,6,10,1687,7,100,141,100,384,3,1179,303,1179,1303
1.221,6,47,18505,27,844,46,1360,12929,20,476,55,2715,5576
1783.355,17,83,3480,82,14,22016,14,3444,1,8,0,8,36
1763.729,2,14,448,14,8,135671,8,448,0,0,0,0,0
0.699,17,2,677,1,300,0,300,328,1,321,0,321,349
106.004,6,846,410347,456,836,232,1152,389615,390,427,271,1179,20732
1798.219,17,449,39416,404,34,4462,288,25444,45,282,40018,288,13972
1745.339,6,104,7550,66,31,26851,31,4484,38,31,47168,31,3066
0.375,6,11,1008,6,256,75,256,500,5,304,92,304,508
3.78,6,33,6145,17,206,236,314,2744,16,551,234,1179,3401
1776.696,17,142,11360,71,48,25380,48,5396,71,56,25380,56,5964
1.7,6,25,8757,15,284,121,584,1456,10,985,167,1420,7301
882.084,2,5,160,5,8,220521,8,160,0,0,0,0,0
0.837,6,31,7813,18,405,49,1360,2791,13,561,55,2744,5022
58.028,6,10,648,10,31,6447,31,648,0,0,0,0,0
97.95,17,3890,4713626,467,66,210,1350,43902,3423,1336,28,1350,4669724
0.011,6,2,186,1,106,0,106,146,1,0,0,0,40
0.116,6,10,582,5,42,29,42,310,5,0,27,0,272
1.384,6,49,19997,28,881,51,1360,14381,21,476,59,2715,5616
0.274,17,2,672,2,308,274,308,672,0,0,0,0,0
0.023,17,2,160,1,44,0,44,72,1,60,0,60,88
77.124,6,35,9193,13,155,75,267,1306,22,411,3672,1420,7887
1775.288,17,73,3060,72,14,25004,14,3024,1,8,0,8,36
75.385,6,31,15195,15,990,69,1460,6589,16,883,5014,1460,8606
1772.505,6,182,15629,121,69,14770,69,8980,61,69,29538,69,6649
35.463,17,20,1760,10,48,3939,48,760,10,72,3939,72,1000
1.212,6,25,8056,13,164,85,267,1340,12,869,93,1440,6716
1087.353,2,9,288,9,8,135919,8,288,0,0,0,0,0
35.946,6,35,6177,18,154,2114,722,2075,17,401,2232,1408,4102
11.558,17,8,704,4,48,3846,48,304,4,72,3848,72,400
1737.466,2,25,800,25,8,72394,8,800,0,0,0,0,0
218.923,17,4,352,2,60,218921,60,176,2,60,218922,60,176
885.535,17,233,26082,102,151,8767,1350,18345,131,31,6811,60,7737
0.772,6,10,1687,7,100,128,100,384,3,1179,259,1179,1303
0.254,17,3,451,2,39,68,39,134,1,289,0,289,317
1796.328,17,448,39896,403,35,4468,288,25676,45,288,40020,288,14220
0.535,6,21,7302,12,335,48,668,1986,9,968,66,1475,5316
560.578,17,8,673,4,31,186854,37,239,4,80,186854,136,434
0.759,17,26,18087,16,789,48,1350,13075,10,473,80,1350,5012
190.846,17,4,352,2,60,190845,60,176,2,60,190845,60,176
0.005,6,2,100,1,0,0,0,60,1,0,0,0,40
15.094,6,123,45774,66,686,232,1152,39012,57,407,265,1152,6762
367.0,6,18,1242,14,180,28230,180,916,4,110,20069,110,326
4.261,6,10,1102,6,483,852,483,803,4,83,1416,83,299
1797.675,17,449,39928,404,35,4460,288,25708,45,288,40017,288,14220
0.01,17,2,375,1,44,0,44,72,1,275,0,275,303
1785.776,17,1039,71345,1039,40,1720,41,71345,0,0,0,0,0
0.023,17,2,154,1,41,0,41,69,1,57,0,57,85
62.209,6,72,47997,44,1172,1446,1448,39817,28,746,2290,1448,8180
1781.345,6,352,22360,206,69,8689,69,12380,146,69,12284,69,9980
150.991,6,27,7312,12,158,13726,267,1277,15,678,10780,2045,6035
0.32,17,2,198,1,37,0,37,65,1,105,0,105,133
0.195,6,26,7256,13,155,16,267,1301,13,603,15,2036,5955
15.862,17,20,2940,10,48,1761,48,760,10,190,1761,308,2180
0.008,17,2,144,1,36,0,36,64,1,52,0,52,80
8.81,17,36,8720,11,280,880,1350,3396,25,184,365,1350,5324
1744.626,2,27,864,27,8,67101,8,864,0,0,0,0,0
299.72,17,4,240,2,32,299719,32,120,2,32,299719,32,120
1700.767,17,12,498,11,14,170076,14,462,1,8,0,8,36
0.098,1,2,163,2,53,98,78,163,0,0,0,0,0
28.873,6,18,1407,9,222,3607,222,808,9,231,3599,231,599
1.275,6,25,8056,12,164,99,267,1288,13,869,90,1408,6768
10.768,6,18,4226,10,275,1196,275,958,8,978,857,1420,3268
1786.233,17,140,11200,70,48,25886,48,5320,70,56,25886,56,5880
1781.894,6,356,22520,208,69,8608,69,12460,148,69,12121,69,10060
1772.004,6,99,9112,66,63,27261,64,5513,33,57,55372,58,3599
0.8,6,20,5948,11,281,80,544,1288,9,716,90,1420,4660
0.259,17,4,624,2,64,139,64,184,2,192,148,192,440
64.945,6,8,536,5,92,16236,92,360,3,0,1135,0,176
1.25,6,29,6387,15,164,89,267,1922,14,780,85,1460,4465
0.089,17,2,2384,2,1164,89,1164,2384,0,0,0,0,0
70.9,6,29,8733,12,258,114,486,1311,17,611,4424,1701,7422
0.039,17,2,192,1,37,0,37,65,1,99,0,99,127
1741.721,6,87,6322,58,31,30556,31,3915,29,31,62204,31,2407
18.673,1,24,2496,0,0,0,0,0,24,76,811,76,2496
1799.863,6,362,24912,211,94,8570,469,14456,151,69,11999,69,10456
1763.757,2,16,512,16,8,117583,8,512,0,0,0,0,0
1743.211,6,95,7203,63,38,28116,205,4476,32,33,56225,98,2727
21.011,17,23,4827,16,40,1399,41,1096,7,505,3499,505,3731
280.212,6,30,7432,13,158,23351,267,1317,17,543,17512,1400,6115
70.394,6,29,7395,13,155,5866,267,1306,16,453,4692,3417,6089
369.41,6,25,1639,16,177,24627,177,1053,9,110,9435,110,586
36.836,6,3,249,0,0,0,0,0,3,31,18418,31,249
1787.75,1,138,7728,138,28,13049,28,7728,0,0,0,0,0
79.046,6,29,4932,14,170,6080,722,1748,15,300,5610,1448,3184
1773.269,6,180,15480,120,69,14901,69,8940,60,69,30047,69,6540
5.228,6,23,6478,11,262,518,517,1376,12,893,471,2409,5102
1776.884,17,140,11200,70,48,25751,48,5320,70,56,25751,56,5880
280.657,6,30,7773,13,158,23388,267,1317,17,577,17539,1400,6456
0.059,17,2,383,1,33,0,33,61,1,294,0,294,322
427.503,6,35,6935,17,186,7629,502,1614,18,306,25142,1420,5321
123.78,6,33,7832,12,156,28,267,1272,21,357,6188,3417,6560
15.267,17,16,5385,7,371,2539,1350,2793,9,260,1904,1350,2592
1.294,6,44,15121,24,777,56,1460,9545,20,433,58,1460,5576
95.323,6,40,25427,20,840,39,1360,5887,20,1440,5009,5411,19540
1776.242,17,73,3060,72,14,25017,14,3024,1,8,0,8,36
1785.858,6,368,24752,213,88,8423,469,14067,155,69,11596,69,10685
1780.975,6,379,26889,210,97,8521,469,15161,169,69,10600,69,11728
1798.954,17,448,39896,403,35,4475,288,25676,45,288,40020,288,14220
280.185,6,27,7312,12,158,25471,267,1277,15,678,20012,2045,6035
0.084,17,4,352,2,37,52,37,130,2,83,33,89,222
246.512,6,47,9312,21,165,12325,517,2150,26,483,9860,1408,7162
1783.144,6,267,27817,134,155,13405,208,21505,133,31,13507,31,6312
0.146,17,2,904,2,424,146,548,904,0,0,0,0,0
1.351,6,47,16686,25,833,56,1440,11030,22,433,56,1440,5656
3.93,17,10,1415,5,31,980,31,295,5,196,979,196,1120
1.146,6,25,8056,12,164,88,267,1288,13,869,81,1408,6768
1.343,6,11,1727,7,100,223,100,384,4,589,362,1152,1343
1776.701,6,252,25531,103,67,17417,681,9534,149,133,12003,3298,15997
112.618,17,4,352,2,60,112616,60,176,2,60,112617,60,176
4.618,17,4,4382,4,1067,1539,1444,4382,0,0,0,0,0
1681.405,17,14,1036,7,30,280230,30,406,7,62,280231,62,630
1761.429,6,208,14761,104,73,17099,208,9671,104,31,17099,31,5090
0.204,6,14,4526,7,290,34,517,941,7,1071,26,1418,3585
1777.103,17,79,3312,78,14,23079,14,3276,1,8,0,8,36
1796.935,17,344,26144,344,48,5238,48,26144,0,0,0,0,0
99.221,17,10,13738,10,1345,11024,1350,13738,0,0,0,0,0
126.051,2,2,64,2,8,126051,8,64,0,0,0,0,0
7.237,2,4,184,4,22,2412,32,184,0,0,0,0,0
1712.065,1,8,448,8,28,244580,28,448,0,0,0,0,0
75.056,6,33,5341,17,165,4691,722,2038,16,308,4989,1408,3303
1766.909,1,86,4816,86,28,20787,28,4816,0,0,0,0,0
1772.996,6,207,22657,130,75,13744,267,10057,77,130,23324,1460,12600
280.228,6,27,7312,12,158,25475,267,1277,15,678,20010,2045,6035
1799.941,17,87774,3510952,43888,8,41,8,1579968,43886,16,41,16,1930984
69.805,6,29,12065,14,476,61,1360,2499,15,994,4976,3072,9566
9.475,6,2,144,0,0,0,0,0,2,64,9475,64,144
1.326,6,19,3781,10,234,147,564,1452,9,463,144,1343,2329
7.282,6,221,202329,139,133,52,201,6199,82,2440,87,22624,196130
1.36,6,4,184,2,0,1360,0,88,2,0,1003,0,96
1789.193,6,133,12951,75,62,24175,722,6259,58,81,31386,2026,6692
175.209,17,2,72,1,8,0,8,36,1,8,0,8,36
176.64,6,12,738,4,112,58880,112,280,8,90,25214,90,458
1551.451,6,175,18231,93,82,16863,721,8649,82,179,19136,1414,9582
1774.565,1,119,6664,119,28,15038,28,6664,0,0,0,0,0
10.828,6,19,4310,11,275,1082,275,998,8,992,866,1440,3312
0.233,17,8,2750,8,315,33,354,2750,0,0,0,0,0
234.061,6,42,9017,22,519,11145,1418,5824,20,268,12317,639,3193
281.666,6,31,7679,12,158,25468,267,1277,19,469,15647,1400,6402
4.458,6,38,7245,19,218,247,314,3383,19,516,233,1179,3862
1745.363,6,90,6540,60,31,29582,31,4050,30,31,60178,31,2490
0.973,6,24,8004,12,164,88,267,1288,12,869,71,1408,6716
371.944,6,23,1535,16,177,24796,177,1053,7,110,10382,110,482
1786.809,6,102,8364,68,66,26668,66,4964,34,60,54142,60,3400
3.042,6,4,192,1,0,0,0,48,3,0,1516,0,144
0.004,17,4,424,2,46,0,46,148,2,110,2,110,276
40.899,17,10,1352,5,48,10221,48,380,5,166,10220,308,972
160.065,17,4,352,2,60,160064,60,176,2,60,160064,60,176
1786.74,6,113,9110,73,66,24815,66,5230,40,60,45811,60,3880
0.55,6,24,6438,13,310,45,892,2078,11,783,54,1420,4360
15.164,17,18,6302,8,374,2161,1350,3220,10,280,1681,1350,3082
0.019,17,4,284,2,32,16,32,120,2,54,16,60,164
1784.169,6,354,22440,207,69,8661,69,12420,147,69,12220,69,10020
1795.105,6,356,22520,208,69,8672,69,12460,148,69,12211,69,10060
0.423,17,2,152,1,48,0,48,76,1,48,0,48,76
39.01,17,11,836,11,48,3901,48,836,0,0,0,0,0
198.389,6,24,5955,10,272,189,516,1220,14,379,15253,1452,4735
3.014,17,2,150,2,47,3014,47,150,0,0,0,0,0
103.262,6,42,25909,19,840,40,1460,5847,23,1195,4687,1460,20062
36.136,6,37,8463,18,399,510,882,1950,19,441,2000,1460,6513
1786.55,6,104,8444,68,66,26664,66,4964,36,60,51041,60,3480
0.686,6,107,87181,54,131,12,232,2689,53,1752,12,5520,84492
0.268,6,24,4571,12,165,24,456,1446,12,415,23,888,3125
1770.525,6,99,9306,66,66,27238,66,5610,33,60,55326,60,3696
0.231,6,46,21790,27,1047,8,1420,16809,19,467,12,1883,4981
1770.719,6,99,9240,66,65,27241,65,5577,33,59,55332,59,3663
49.905,6,7,396,2,0,6360,0,112,5,0,12472,0,284
1.42,6,16,1472,9,256,176,256,880,7,304,234,304,592
1782.371,6,354,22440,207,69,8652,69,12420,147,69,12207,69,10020
1791.659,1,284,15904,284,28,6330,28,15904,0,0,0,0,0
1521.668,6,372,23505,199,69,7685,69,13066,173,69,8846,69,10439
1790.416,1,130,7280,130,28,13879,28,7280,0,0,0,0,0
378.687,17,19,798,19,14,21038,14,798,0,0,0,0,0
57.053,6,40,8488,17,367,416,787,1814,23,522,2587,2720,6674
969.738,6,233,15706,107,46,9076,46,6572,126,46,7757,46,9134
10.204,6,82,24501,41,550,255,1152,18720,41,459,248,1179,5781
6.089,17,3,228,3,48,3044,48,228,0,0,0,0,0
0.011,17,3,442,2,32,10,32,120,1,294,0,294,322
0.012,1,3,180,3,32,6,32,180,0,0,0,0,0
1796.317,6,369,25730,214,99,8433,469,15045,155,69,11663,69,10685
1786.068,17,87,3648,86,14,21012,14,3612,1,8,0,8,36
0.783,6,144,98090,79,1294,10,1432,91199,65,427,11,1432,6891
1775.546,17,140,11200,70,48,25732,48,5320,70,56,25732,56,5880
3.23,17,2,656,2,300,3230,300,656,0,0,0,0,0
1681.972,17,14,1036,7,30,280326,30,406,7,62,280326,62,630
41.706,6,5487,5240387,3530,1405,11,1448,5133959,1957,776,21,1448,106428
280.463,6,29,7392,13,158,23371,267,1317,16,678,18693,3456,6075
0.021,17,2,162,1,36,0,36,64,1,70,0,70,98
0.003,17,7,2438,7,320,0,354,2438,0,0,0,0,0
7.533,2,3,96,3,8,3766,8,96,0,0,0,0,0
1.544,6,47,19000,27,879,59,1360,13424,20,433,70,1360,5576
300.169,6,43,12969,20,782,15788,1360,7092,23,309,13635,2667,5877
0.936,17,5,373,3,31,452,31,177,2,70,833,70,196
89.295,6,14,572,6,0,17859,0,244,8,0,12755,0,328
1795.266,17,448,39896,403,35,4465,288,25676,45,288,40021,288,14220
6.241,6,9,520,4,0,2080,0,220,5,0,1253,0,300
0.464,6,22,7300,12,325,41,626,1932,10,1210,50,1906,5368
12.532,6,89,26501,45,559,284,1152,20259,44,447,284,1179,6242
301.49,6,113,128925,67,430,4568,647,4842,46,2829,1470,9856,124083
1746.297,6,95,7203,63,38,28166,205,4476,32,33,56326,98,2727
5.057,17,3,208,2,36,4986,36,128,1,52,0,52,80
1.653,6,7,376,4,0,551,0,216,3,0,641,0,160
0.047,17,2,136,1,32,0,32,60,1,48,0,48,76
4.04,17,10,2531,5,40,1006,40,340,5,410,1006,423,2191
1.308,6,38,8254,19,321,72,1164,2718,19,433,62,1460,5536
101.878,17,4,304,4,48,33959,48,304,0,0,0,0,0
1785.87,6,371,25810,215,99,8345,469,15154,156,69,11521,69,10656
17.571,6,15,2237,8,324,2510,585,1073,7,396,2923,580,1164
3.96,17,2,134,2,39,3960,39,134,0,0,0,0,0
1786.458,6,133,18874,81,250,22330,1301,13254,52,86,35026,240,5620
741.191,17,84,7005,78,30,9624,37,4545,6,382,136277,463,2460
1781.162,6,82,4368,42,26,43441,26,2236,40,26,45669,26,2132
1746.465,6,95,7203,63,38,28168,205,4476,32,33,56325,98,2727
33.58,6,30,5043,15,154,2398,722,1860,15,399,2384,1448,3183
96.543,6,16,2307,9,329,12067,595,1135,7,396,16087,580,1172
218.225,6,57,10927,24,231,9487,1189,3280,33,300,6819,1420,7647
389.279,17,8,3174,8,368,55611,548,3174,0,0,0,0,0
0.195,6,6,240,3,0,14,0,120,3,0,91,0,120
1797.013,17,448,39896,403,35,4470,288,25676,45,288,40017,288,14220
6.864,6,29,7464,12,155,624,267,1266,17,423,428,3417,6198
4.1,6,34,6185,18,206,241,314,2784,16,551,254,1179,3401
1787.486,6,116,13755,76,81,23833,501,5990,40,162,45830,1420,7765
1787.383,6,104,8308,68,64,26677,64,4896,36,58,51065,58,3412
371.083,6,25,1651,17,177,23192,177,1117,8,110,9211,110,534
129.508,6,13,2311,7,188,21584,245,660,6,1407,25849,1407,1651
14.044,6,2482,2358696,1628,1372,8,1408,2309624,854,931,16,2801,49072
1682.827,17,14,1036,7,30,280464,30,406,7,62,280463,62,630
1790.1,17,178,11392,178,36,10113,36,11392,0,0,0,0,0
0.134,6,12,1587,6,507,26,507,779,6,556,26,556,808
485.938,1,6,336,6,28,97187,28,336,0,0,0,0,0
44.028,17,4,558,2,36,44022,36,128,2,187,44023,187,430
4.817,6,39,7269,19,218,267,314,3383,20,440,239,1152,3886
8.71,6,3,180,3,0,0,0,180,0,0,0,0,0
1785.858,6,397,24851,205,69,8754,69,12547,192,46,9350,69,12304
280.35,6,27,7312,12,158,25486,267,1277,15,678,20022,2045,6035
1.031,6,10,968,5,256,246,256,460,5,304,250,304,508
23.667,6,16,2446,7,666,3941,1110,1616,9,231,2956,231,830
1773.228,6,180,15480,120,69,14901,69,8940,60,69,30048,69,6540
1794.92,17,140,11200,70,48,26013,48,5320,70,56,26013,56,5880
0.097,17,4,588,2,48,92,48,152,2,190,91,308,436
1.39,6,50,19397,27,899,53,1460,13701,23,433,54,1460,5696
7.685,6,32,8952,14,158,591,267,1357,18,624,449,1400,7595
1744.655,2,26,832,26,8,69786,8,832,0,0,0,0,0
24.558,6,11,448,3,0,12279,0,124,8,0,3505,0,324
64.962,6,13,532,6,0,6108,0,244,7,0,10824,0,288
1790.496,6,355,22480,207,69,8691,69,12420,148,69,12179,69,10060
1793.489,17,275,57902,275,182,6545,422,57902,0,0,0,0,0
295.504,6,67,10271,27,306,11365,778,5734,40,128,7576,580,4537
225.746,6,119,89055,76,1245,3009,1408,78694,43,811,1747,3847,10361
240.649,2,2,64,2,8,240649,8,64,0,0,0,0,0
1471.754,6,128,25846,72,247,20728,1040,17989,56,400,4731,1440,7857
77.169,17,2,244,2,94,77169,94,244,0,0,0,0,0
236.14,17,4,352,2,60,236139,60,176,2,60,236139,60,176
48.934,6,25,7097,12,155,4448,267,1266,13,589,4077,3426,5831
60.155,2,2,64,2,8,60155,8,64,0,0,0,0,0
38.585,6,513,373531,274,1345,10,1360,358067,239,226,161,1360,15464
1787.151,6,104,8376,68,65,26673,65,4930,36,59,51057,59,3446
2.287,17,2,192,1,44,0,44,72,1,92,0,92,120
0.091,17,2,194,1,61,0,61,89,1,77,0,77,105
1750.608,17,12,498,11,14,175060,14,462,1,8,0,8,36
0.012,17,2,554,1,30,0,30,58,1,468,0,468,496
0.685,6,109,86865,47,131,14,232,2409,62,1438,10,2860,84456
6.493,6,2,111,2,31,6493,31,111,0,0,0,0,0
951.321,1,16,896,16,28,63421,28,896,0,0,0,0,0
1770.349,6,99,9306,66,66,27236,66,5610,33,60,55320,60,3696
291.1,6,33,6976,16,262,19403,517,1628,17,744,18190,1418,5348
3.678,6,44,15911,26,702,147,1408,13310,18,236,215,580,2601
18.649,17,35,7480,15,186,1329,1350,3215,20,185,979,1350,4265
1798.983,17,450,39960,405,35,4452,288,25740,45,288,40023,288,14220
1771.399,6,99,9240,66,65,27252,65,5577,33,59,55353,59,3663
31.077,17,47,25394,23,666,1412,1350,15965,24,364,1347,1350,9429
1787.564,6,102,8296,68,65,26680,65,4930,34,59,54163,59,3366
44.657,6,27,7177,13,155,3721,267,1306,14,530,3434,3417,5871
0.028,1,2,112,2,28,28,28,112,0,0,0,0,0
6.294,6,1510,1224396,796,1435,7,1448,1174328,714,776,8,1448,50068
16.642,6,21,4527,11,211,1664,722,1623,10,793,1827,1440,2904
1772.314,6,180,15480,120,69,14893,69,8940,60,69,30037,69,6540
2.2,17,2,144,1,36,0,36,64,1,52,0,52,80
1740.502,17,30,7050,30,207,60017,207,7050,0,0,0,0,0
299.529,6,7,404,4,31,99843,31,222,3,31,149758,31,182
0.037,6,25,38930,14,281,2,517,1580,11,5252,2,14080,37350
94.676,6,31,7704,10,155,262,267,1186,21,354,4733,1460,6518
1790.062,17,144,11520,72,48,25211,48,5472,72,56,25211,56,6048
0.014,17,2,602,1,46,0,46,74,1,500,0,500,528
0.069,17,2,245,1,32,0,32,60,1,157,0,157,185
54.524,6,65,9613,35,304,1603,304,6724,30,83,1879,83,2889
367.115,1,5,280,5,28,91778,28,280,0,0,0,0,0
56.822,6,27,7177,13,155,4735,267,1306,14,530,4370,2840,5871
21.177,1,6,624,0,0,0,0,0,6,76,4235,76,624
1681.614,17,14,1036,7,30,280263,30,406,7,62,280263,62,630
11.533,6,25,8453,13,275,961,275,1078,12,983,739,1420,7375
0.189,6,4,493,2,241,189,241,321,2,92,2,92,172
254.352,6,10,734,9,106,31794,106,686,1,0,0,0,48
7.998,6,28,7836,14,215,615,721,1854,14,774,497,1414,5982
24.779,6,16,3474,8,151,3514,210,726,8,463,3514,1408,2748
1089.72,6,67,5115,37,44,30265,205,2721,30,33,37570,98,2394
10.961,6,19,4362,11,275,1096,275,998,8,1010,883,2840,3364
60.463,6,45,7866,19,218,347,314,3383,26,491,2408,1179,4483
0.066,17,2,160,1,48,0,48,76,1,56,0,56,84
227.511,17,4,240,2,32,227510,32,120,2,32,227510,32,120
161.568,6,24,10290,13,579,72,1360,2871,11,1161,16140,2720,7419
0.071,17,2,368,1,37,0,37,65,1,275,0,275,303
1740.699,17,30,31170,30,1011,60024,1011,31170,0,0,0,0,0
3.268,6,5,280,2,0,3268,0,112,3,0,1517,0,168
28.526,6,49,13348,24,188,1240,721,2852,25,730,1145,2840,10496
1672.355,1,8,448,8,28,238907,28,448,0,0,0,0,0
1763.819,2,14,448,14,8,135678,8,448,0,0,0,0,0
280.203,6,28,7352,12,158,25473,267,1277,16,603,18679,1400,6075
8.391,6,32,8079,14,241,645,721,1771,18,507,483,2840,6308
78.788,6,33,8099,11,175,501,267,1499,22,336,3745,1917,6600
53.604,1,16,1664,0,0,0,0,0,16,76,3573,76,1664
1782.67,17,295,62718,295,184,6063,422,62718,0,0,0,0,0
273.85,6,21,9267,7,290,45641,517,953,14,757,21054,1408,8314
1793.833,17,66,2766,65,14,28028,14,2730,1,8,0,8,36
240.191,6,53,17964,28,802,8895,1402,15114,25,192,10007,580,2850
369.872,6,27,1767,18,177,21757,177,1181,9,110,8590,110,586
1741.781,6,91,6604,59,31,30030,31,3998,32,31,56186,31,2606
12.359,17,51,41935,21,419,617,1350,9395,30,1056,320,1350,32540
0.393,17,8,2758,8,316,56,355,2758,0,0,0,0,0
5.019,17,4,288,2,36,5004,36,128,2,52,5010,52,160
1793.288,6,356,22520,208,69,8663,69,12460,148,69,12198,69,10060
7.224,6,8,348,3,0,3612,0,128,5,0,1799,0,220
1.363,6,23,6596,13,350,113,1089,2276,10,979,150,1731,4320
1781.177,17,142,11360,71,48,25445,48,5396,71,56,25445,56,5964
11.027,6,20,5694,11,275,1102,275,998,9,1440,728,1440,4696
1783.321,6,102,8296,68,65,26616,65,4930,34,59,54037,59,3366
0.502,17,3,451,2,39,27,39,134,1,289,0,289,317
1787.4,6,106,8590,69,66,26285,66,5070,37,60,49647,60,3520
10.021,17,4,808,2,44,10011,44,144,2,304,10006,304,664
0.033,17,2,283,1,31,0,31,59,1,196,0,196,224
0.266,6,22,5040,10,137,29,267,1092,12,577,22,1400,3948
5.003,17,4,288,2,36,5002,36,128,2,52,4984,52,160
0.855,6,24,5755,13,158,70,370,1315,11,999,84,1731,4440
149.75,6,21,1392,9,46,18718,46,636,12,46,13601,46,756
1.435,6,47,19229,27,895,55,1360,13653,20,476,65,2715,5576
1794.543,1,230,12880,230,28,7836,28,12880,0,0,0,0,0
1538.141,6,585,130479,288,274,5358,1360,72912,297,397,5196,2720,57567
1777.785,17,142,11360,71,48,25396,48,5396,71,56,25396,56,5964
1787.59,6,104,8376,68,65,26680,65,4930,36,59,51070,59,3446
1.013,6,2,376,0,0,0,0,0,2,272,1013,272,376
240.146,6,45,9072,23,139,10915,346,2050,22,533,11435,1408,7022
0.0,6,1,71,1,31,0,31,71,0,0,0,0,0
0.019,17,2,656,1,300,0,300,328,1,300,0,300,328
40.968,17,4,304,2,48,40963,48,152,2,48,40963,48,152
1744.639,2,27,864,27,8,67101,8,864,0,0,0,0,0
14.061,17,4,352,2,48,14039,48,152,2,72,14047,72,200
1.669,6,13,2311,8,188,238,245,700,5,1407,350,1407,1611
1799.566,17,761,45937,761,32,2367,37,45937,0,0,0,0,0
8.55,6,12,945,6,222,1708,222,466,6,231,1708,231,479
107.537,6,25,12059,12,410,68,922,1754,13,1085,8950,1460,10305
52.497,1,4,224,4,28,17499,28,224,0,0,0,0,0
1770.135,6,213,16760,79,73,22692,374,8069,134,49,13309,143,8691
62.681,6,27,7177,13,155,5223,267,1306,14,530,4820,3417,5871
251.525,17,4,352,2,60,251524,60,176,2,60,251524,60,176
525.677,1,8,448,8,28,75096,28,448,0,0,0,0,0
103.805,17,4,352,2,60,103804,60,176,2,60,103804,60,176
1772.474,6,180,15480,120,69,14894,69,8940,60,69,30033,69,6540
196.152,17,12,4032,12,308,17832,308,4032,0,0,0,0,0
1772.954,6,181,15589,120,69,14898,69,8940,61,69,29542,69,6649
17.002,6,622,540124,379,1351,44,1368,521158,243,899,69,1473,18966
0.054,17,4,420,2,33,47,33,122,2,121,46,145,298
1772.447,6,180,15480,120,69,14894,69,8940,60,69,30034,69,6540
1.288,6,47,18835,26,934,51,1460,13219,21,433,55,1460,5616
1688.964,1,8,448,8,28,241280,28,448,0,0,0,0,0
0.011,17,3,474,2,36,8,36,128,1,318,0,318,346
317.052,6,68,18619,35,354,9325,1460,9580,33,350,9903,3089,9039
175.446,6,94,61834,54,1221,3310,1368,52893,40,841,1616,2519,8941
1740.56,17,28,29568,28,1028,64465,1028,29568,0,0,0,0,0
1787.915,6,364,23116,209,69,8595,69,12776,155,69,11609,69,10340
1796.781,17,447,39864,402,35,4480,288,25644,45,288,40019,288,14220
1789.444,6,271,28060,136,108,13255,721,16268,135,163,12730,1440,11792
0.578,6,22,5040,11,137,57,267,1132,11,692,50,1467,3908
1773.73,6,204,22330,130,75,13749,267,10057,74,132,24296,1460,12273
0.026,17,4,336,2,34,0,34,124,2,78,4,84,212
24.698,6,1484,1287134,939,1292,26,1368,1252334,545,776,45,1473,34800
1789.952,6,3111,2931828,1170,123,1531,347,76110,1941,1477,922,7090,2855718
842.211,2,8,256,8,8,120315,8,256,0,0,0,0,0
1786.694,6,106,8524,68,66,26667,66,4964,38,60,48286,60,3560
125.438,6,14,3145,7,92,20906,92,452,7,465,20868,1408,2693
7.889,6,10,3106,5,183,1912,267,571,5,1165,1912,1179,2535
30.582,17,8,704,4,48,10191,48,304,4,72,10190,72,400
1772.394,6,180,15480,120,69,14894,69,8940,60,69,30036,69,6540
0.545,17,2,136,1,32,0,32,60,1,48,0,48,76
280.039,6,28,7352,13,158,23336,267,1317,15,678,19999,4200,6035
7.829,6,7,427,3,131,3914,131,255,4,0,1915,0,172
31.803,6,7,308,1,0,0,0,44,6,0,6313,0,264
9.92,6,16,3871,9,275,1240,275,643,7,978,833,1420,3228
116.134,6,36,10792,18,559,6831,1460,4110,18,659,6803,1934,6682
37.684,17,44,6468,22,48,1794,48,1672,22,190,1794,308,4796
8.212,6,41,7365,21,218,410,314,3463,20,516,418,1179,3902
108.619,17,4,352,2,60,108617,60,176,2,60,108617,60,176
0.097,17,4,420,2,33,1,33,122,2,121,47,145,298
1787.951,6,354,22302,207,69,8679,69,12351,147,69,12203,69,9951
1796.711,6,367,25650,214,99,8435,469,15045,153,69,11819,69,10605
0.849,6,19,5908,11,281,84,544,1288,8,859,108,2642,4620
7.11,6,21,2906,10,152,790,267,862,11,320,682,1152,2044
675.323,6,44,3489,24,66,25900,66,1752,20,49,35535,60,1737
1798.186,17,142,11360,71,48,25688,48,5396,71,56,25688,56,5964
3.518,17,25,18978,12,779,319,1350,9693,13,686,277,1350,9285
5.026,17,3,208,2,36,5005,36,128,1,52,0,52,80
699.112,6,9,468,9,0,0,0,468,0,0,0,0,0
1771.652,6,99,9240,66,65,27256,65,5577,33,59,55361,59,3663
0.791,17,4,588,2,48,780,48,152,2,190,779,308,436
31.001,6,31,8912,14,158,2384,267,1357,17,687,1930,2036,7555
25.912,6,32,8841,14,340,1828,722,2606,18,612,1512,2760,6235
1.25,6,27,7901,15,278,89,824,2022,12,897,96,2720,5879
280.29,6,28,7352,13,158,23357,267,1317,15,678,20017,2800,6035
153.346,1,4,224,4,28,51115,28,224,0,0,0,0,0
3.931,17,5,295,5,31,982,31,295,0,0,0,0,0
242.582,17,4,352,2,60,242580,60,176,2,60,242581,60,176
0.183,6,47,21720,27,1039,7,1432,16687,20,467,9,1871,5033
1612.586,1,39,5376,39,109,42436,320,5376,0,0,0,0,0
11.02,6,20,4442,11,275,1102,275,998,9,768,782,1440,3444
783.999,2,8,256,8,8,111999,8,256,0,0,0,0,0
1792.722,17,144,11520,72,48,25249,48,5472,72,56,25249,56,6048
443.338,6,39,12051,22,481,21111,1360,4779,17,598,27698,2134,7272
75.682,6,14,580,6,0,5102,0,244,8,0,10809,0,336
5.286,6,537,518888,371,1339,13,1368,505592,166,776,30,1473,13296
1682.807,17,14,1036,7,30,280462,30,406,7,62,280460,62,630
300.773,6,36,8224,20,249,15830,619,1830,16,522,566,3488,6394
820.344,6,70,9992,42,97,20008,502,3542,28,221,30379,1420,6450
1797.415,17,449,39928,404,35,4460,288,25708,45,288,40018,288,14220
72.19,6,31,7544,13,155,6015,267,1306,18,423,4245,3417,6238
1785.193,6,367,25650,213,100,8420,469,14936,154,69,11665,69,10714
1793.932,1,57,4788,57,56,32034,56,4788,0,0,0,0,0
0.203,17,8,2750,8,315,29,354,2750,0,0,0,0,0
0.14,1,2,112,2,28,140,28,112,0,0,0,0,0
152.11,17,4,352,2,60,152109,60,176,2,60,152109,60,176
1740.498,17,28,29568,28,1028,64462,1028,29568,0,0,0,0,0
3.319,17,2,778,2,361,3319,361,778,0,0,0,0,0
47.235,17,44,8336,19,168,2622,1350,3728,25,156,1966,1350,4608
0.305,6,4,529,2,259,305,259,339,2,110,4,110,190
20.735,6,6,328,4,0,6911,0,216,2,0,20725,0,112
240.471,6,37,6536,19,168,13359,517,2020,18,595,14145,1402,4516
0.245,17,2,672,2,308,245,308,672,0,0,0,0,0
45.043,6,27,7177,13,155,3753,267,1306,14,530,3464,3417,5871
242.903,17,4,240,2,32,242902,32,120,2,32,242901,32,120
0.0,17,1,58,1,30,0,30,58,0,0,0,0,0
0.01,6,14,5639,8,134,1,134,474,6,2456,2,2920,5165
0.653,6,4,220,2,0,653,0,100,2,0,307,0,120
125.034,17,26,27712,26,1037,5001,1041,27712,0,0,0,0,0
1764.889,17,169,14402,156,30,11386,37,9097,13,380,141940,463,5305
11.832,6,29,4860,17,176,739,293,2626,12,437,1049,1179,2234
11.073,6,20,5855,10,267,1230,501,1205,10,606,1220,1420,4650
280.021,6,30,7432,13,158,23335,267,1317,17,543,17499,1400,6115
1795.28,6,362,22898,210,69,8589,69,12678,152,69,11889,69,10220
1782.222,6,190,18800,125,95,14372,965,10995,65,80,27843,453,7805
364.267,6,25,1651,17,177,22766,177,1117,8,110,10416,110,534
240.513,6,54,18144,28,814,8905,1418,15318,26,183,9617,580,2826
11.817,6,21,6825,12,275,1074,275,1038,9,1353,849,1440,5787
0.05,6,2,111,1,0,0,0,40,1,31,0,31,71
240.869,6,61,18433,33,800,7526,1402,15361,28,160,8920,580,3072
2.862,17,28,13587,13,734,238,1350,9907,15,217,113,1350,3680
1795.581,1,160,8960,160,28,11292,28,8960,0,0,0,0,0
58.811,6,11,1583,11,127,5881,127,1583,0,0,0,0,0
0.024,17,5,1757,5,323,6,354,1757,0,0,0,0,0
10.027,17,4,718,2,48,10017,48,152,2,255,10017,277,566
1741.33,6,87,6322,58,31,30549,31,3915,29,31,62189,31,2407
1793.463,1,168,9408,168,28,10739,28,9408,0,0,0,0,0
1796.811,1,278,15568,278,28,6486,28,15568,0,0,0,0,0
69.684,6,640,299859,332,831,210,1152,282732,308,436,226,1179,17127
1765.226,6,114,9450,72,55,24862,205,5624,42,41,43046,131,3826
1770.447,1,58,4872,58,56,31060,56,4872,0,0,0,0,0
280.281,6,30,7432,13,158,23356,267,1317,17,543,17512,1400,6115
67.746,6,24,14175,10,498,671,722,1401,14,1526,5195,2760,12774
0.411,6,2,138,1,0,0,0,40,1,46,0,46,98
1681.493,17,14,1036,7,30,280243,30,406,7,62,280243,62,630
1795.046,17,449,39928,404,35,4454,288,25708,45,288,40018,288,14220
102.685,6,21,9714,12,410,57,922,1742,9,1520,12818,4416,7972
1739.554,1,92,5152,92,28,19115,28,5152,0,0,0,0,0
1795.215,17,80,3354,79,14,23015,14,3318,1,8,0,8,36
1383.744,2,14,448,14,8,106441,8,448,0,0,0,0,0
36.573,6,29,9287,9,154,1072,267,832,20,477,1924,1420,8455
1752.321,6,101,7949,66,45,26958,205,4902,35,35,51531,98,3047
31.68,6,8,376,2,0,31680,0,88,6,0,6297,0,288
2.832,6,36,18336,19,768,157,1360,6181,17,1273,168,2720,12155
1788.74,17,87,3648,86,14,21044,14,3612,1,8,0,8,36
1683.091,17,18,1413,9,30,210380,37,529,9,70,210382,136,884
173.242,6,24,6248,9,272,107,516,1180,15,372,12367,1452,5068
1786.397,6,106,8388,68,64,26662,64,4896,38,58,48278,58,3492
1792.274,17,180,14040,180,50,10012,50,14040,0,0,0,0,0
1743.313,17,120,23428,120,167,14649,422,23428,0,0,0,0,0
0.114,17,7,2361,7,309,19,353,2361,0,0,0,0,0
0.546,6,6,324,4,0,182,0,216,2,0,271,0,108
0.064,17,2,184,1,32,0,32,60,1,96,0,96,124
0.0,17,1,1217,1,1189,0,1189,1217,0,0,0,0,0
0.06,17,2,283,1,31,0,31,59,1,196,0,196,224
39.4,6,58,18956,28,586,1459,1368,10857,30,432,1355,2460,8099
360.957,2,6,192,6,8,72191,8,192,0,0,0,0,0
0.863,6,24,9756,12,660,78,1440,3154,12,872,58,1440,6602
16.221,6,34,14527,15,168,1149,183,1351,19,1239,893,1460,13176
1799.718,17,5896,283008,2948,20,610,20,141504,2948,20,610,20,141504
1798.491,17,447,39580,403,35,4473,288,25676,44,288,40951,288,13904
1744.68,2,14,448,14,8,134206,8,448,0,0,0,0,0
0.01,17,2,426,1,30,0,30,58,1,340,0,340,368
0.428,6,10,968,5,256,104,256,460,5,304,104,304,508
1.691,6,13,2311,8,188,241,245,700,5,1407,360,1407,1611
0.331,6,28,10053,11,519,31,1448,3696,17,546,20,1448,6357
1792.985,17,44,14784,44,308,41697,308,14784,0,0,0,0,0
1771.643,6,101,9410,66,66,27256,66,5610,35,60,52104,60,3800
1.135,6,24,8016,12,164,87,267,1300,12,1014,87,2411,6716
1783.81,6,457,29240,239,100,7494,469,15976,218,34,8220,64,13264
1.405,6,50,20414,30,903,48,1360,14793,20,437,63,2715,5621
15.783,17,23,7409,10,393,1753,1350,4212,13,217,1281,1350,3197
300.86,6,39,9652,21,543,15043,1360,4130,18,399,510,1360,5522
0.44,6,12,1653,6,288,87,288,548,6,426,47,434,1105
1684.534,2,14,448,14,8,129579,8,448,0,0,0,0,0
373.855,6,26,1703,17,177,23365,177,1117,9,110,8949,110,586
84.499,17,4,352,2,60,84498,60,176,2,60,84498,60,176
366.379,2,4,128,4,8,122126,8,128,0,0,0,0,0
240.187,6,54,18085,28,813,8895,1418,15292,26,204,9607,580,2793
0.185,17,3,1164,3,360,92,360,1164,0,0,0,0,0
50.763,17,4,580,2,40,50701,40,136,2,194,50728,194,444
0.06,6,2,1460,1,0,0,0,40,1,1380,0,1380,1420
0.687,17,4,560,2,64,685,64,184,2,160,568,160,376
1.691,6,50,19370,27,897,65,1360,13674,23,433,69,1360,5696
25.109,6,3875,3664260,2533,1369,9,1408,3589812,1342,931,18,2816,74448
1.024,17,5,776,3,32,509,32,180,2,270,1018,294,596
0.149,17,2,1918,2,931,149,931,1918,0,0,0,0,0
1795.835,1,59,4956,0,0,0,0,0,59,56,30962,56,4956
5.013,17,22,10519,10,663,557,1350,6915,12,272,344,1350,3604
1790.081,6,419,39782,238,159,7553,485,21793,181,120,9944,453,17989
1744.678,2,26,832,26,8,69787,8,832,0,0,0,0,0
0.864,6,30,6118,14,156,66,267,1502,16,567,52,1420,4616
1750.672,17,12,498,11,14,175067,14,462,1,8,0,8,36
280.198,6,26,7272,12,158,25472,267,1277,14,775,21549,3445,5995
2.396,6,63,41408,39,712,63,1408,6373,24,2251,103,8448,35035
6.272,6,1592,1472047,1006,1385,6,1408,1436911,586,931,10,2816,35136
8.867,6,81,24765,39,560,233,1152,18928,42,461,210,1179,5837
3.807,6,3,127,1,0,0,0,40,2,7,0,7,87
0.032,17,2,212,1,46,0,46,74,1,110,0,110,138
0.13,6,2,375,1,295,0,295,335,1,0,0,0,40
1720.907,17,12,498,11,14,172090,14,462,1,8,0,8,36
1.317,6,10,1514,5,503,329,503,771,5,475,329,475,743
221.456,17,4,352,2,60,221454,60,176,2,60,221455,60,176
0.121,17,6,2078,6,318,24,354,2078,0,0,0,0,0
0.297,17,2,157,1,31,0,31,59,1,70,0,70,98
240.236,6,27,6775,13,183,20016,517,1783,14,472,18477,1368,4992
1.792,17,2,1430,2,687,1792,687,1430,0,0,0,0,0
47.826,17,8,2688,8,308,6832,308,2688,0,0,0,0,0
1.448,6,41,8443,21,321,72,1164,2822,20,400,66,1360,5621
32.014,6,9,396,2,0,3482,0,88,7,0,5321,0,308
5.445,17,4,1354,2,300,4452,300,656,2,321,4450,321,698
10.0,6,1971,1856408,1234,1425,7,1448,1813396,737,776,13,1448,43012
0.111,6,188,150438,85,137,1,334,5780,103,1393,1,2804,144658
0.266,6,25,7712,12,176,24,334,1339,13,948,17,1438,6373
1788.991,17,142,11360,71,48,25556,48,5396,71,56,25556,56,5964
13.349,17,3,968,3,294,6674,300,968,0,0,0,0,0
230.35,6,48,6477,24,126,10015,722,2632,24,185,10007,1408,3845
1785.956,6,102,8364,68,66,26656,66,4964,34,60,54117,60,3400
99.865,17,8,2688,8,308,14266,308,2688,0,0,0,0,0
1742.018,6,95,7203,63,38,28097,205,4476,32,33,56187,98,2727
378.902,1,6,558,6,65,75780,88,558,0,0,0,0,0
301.727,6,55,29410,28,567,11175,1130,4362,27,1125,1225,6864,25048
49.361,17,42,9174,19,215,2740,1350,4630,23,169,2242,1350,4544
2.257,17,3,507,2,39,987,39,134,1,345,0,345,373
1788.999,1,282,15792,282,28,6366,28,15792,0,0,0,0,0
280.25,6,28,7352,13,158,23354,267,1317,15,678,20017,2800,6035
280.654,6,30,7432,13,158,23387,267,1317,17,543,17535,1400,6115
1.862,17,20,5180,20,231,98,388,5180,0,0,0,0,0
281.59,17,5,1680,5,308,70397,308,1680,0,0,0,0,0
0.863,6,22,9989,13,653,71,1360,3166,9,1290,85,3595,6823
0.054,17,4,284,2,32,39,32,120,2,54,37,60,164
0.404,6,7,295,4,0,134,0,164,3,7,91,7,131
0.234,6,25,7216,12,155,21,267,1261,13,678,17,2045,5955
372.165,6,23,1538,16,180,24811,180,1056,7,110,10424,110,482
299.624,6,50,12179,25,576,12482,1360,4527,25,368,12475,2667,7652
9.542,6,1268,1098718,740,1402,12,1448,1066512,528,792,17,1448,32206
38.447,6,19,832,8,0,5492,0,348,11,0,2953,0,484
1769.018,6,99,9240,66,65,27215,65,5577,33,59,55278,59,3663
24.206,6,57,31182,33,810,756,1438,7429,24,1404,389,2876,23753
36.119,17,40,5880,20,48,1900,48,1520,20,190,1900,308,4360
87.104,6,11,1691,11,139,8710,139,1691,0,0,0,0,0
30.006,6,41,12112,21,303,1500,721,2971,20,925,1525,1440,9141
242.093,6,38,15940,19,1336,13448,1418,14358,19,293,13448,293,1582
2.236,17,3,1173,3,363,1118,363,1173,0,0,0,0,0
1745.865,6,97,7307,63,38,28159,205,4476,34,33,52896,98,2831
0.065,6,10,766,5,185,13,185,453,5,45,16,45,313
2.838,6,13,1640,7,279,473,279,918,6,191,379,272,722
1.873,6,10,1379,5,145,468,145,349,5,826,327,826,1030
12.192,6,1760,1634206,1140,1380,10,1432,1604383,620,427,19,1432,29823
61.87,6,76,51890,46,1211,1374,1448,43606,30,839,2124,2359,8284
1.289,6,42,11418,22,547,61,1360,5842,20,433,58,1360,5576
1786.328,6,150,19350,90,302,20070,302,13740,60,83,30276,83,5610
1.337,6,52,19696,28,914,49,1360,13960,24,433,50,1360,5736
1796.757,6,134,15843,77,86,23641,721,7665,57,267,13870,2007,8178
4.996,17,2,1364,2,654,4996,654,1364,0,0,0,0,0
53.209,6,27,7177,13,155,4434,267,1306,14,530,4092,3417,5871
608.009,6,28,1887,18,332,35765,332,1276,10,83,26688,83,611
1772.021,6,180,15480,120,69,14890,69,8940,60,69,30033,69,6540
0.827,6,20,9097,11,500,82,1194,1972,9,1125,75,2279,7125
0.824,6,37,8289,21,241,41,619,1850,16,482,45,4080,6439
12.722,6,16,1327,8,222,1816,222,768,8,231,1816,231,559
2.283,17,36,21403,17,845,142,1350,14857,19,316,94,1350,6546
0.111,17,2,410,1,46,0,46,74,1,308,0,308,336
300.147,6,53,18181,31,911,9998,1360,12225,22,361,14283,2667,5956
1786.243,6,104,8444,68,66,26660,66,4964,36,60,51032,60,3480
0.822,6,10,1687,7,100,137,100,384,3,1179,276,1179,1303
0.992,6,27,8420,15,222,58,540,1964,12,1192,75,3151,6456
3.072,6,15,3201,6,92,614,92,400,9,465,308,1408,2801
0.011,17,2,224,1,52,0,52,80,1,116,0,116,144
1798.887,6,356,22589,207,69,8732,69,12558,149,69,12066,69,10031
10.243,6,69,21702,36,574,292,1152,16955,33,489,311,1179,4747
1785.788,6,102,8296,68,65,26653,65,4930,34,59,54111,59,3366
0.443,6,53,23965,30,1039,15,1380,16880,23,558,18,1923,7085
32.596,17,3,228,3,48,16298,48,228,0,0,0,0,0
137.755,17,4,352,2,60,137754,60,176,2,60,137754,60,176
0.015,6,2,80,1,0,0,0,40,1,0,0,0,40
44.192,17,15,7808,8,655,6313,1350,5466,7,306,2520,1350,2342
6.171,6,39,7269,20,218,324,314,3423,19,513,328,1179,3846
66.114,6,210,88726,105,771,635,1152,79005,105,424,632,1179,9721
1783.322,17,83,3480,82,14,22016,14,3444,1,8,0,8,36
280.511,6,45,9214,28,106,10389,267,3154,17,447,17531,1997,6060
1740.543,17,29,6815,29,207,62162,207,6815,0,0,0,0,0
1788.438,6,356,22520,208,69,8639,69,12460,148,69,12165,69,10060
2.676,17,20,12947,8,414,381,1350,3536,12,756,240,1350,9411
0.013,17,2,399,1,39,0,39,67,1,304,0,304,332
1772.517,6,180,15480,120,69,14895,69,8940,60,69,30039,69,6540
539.999,6,5,200,5,0,0,0,200,0,0,0,0,0
64.248,6,23,6587,9,138,8031,267,923,14,637,4940,1997,5664
15.325,17,6,528,3,48,7659,48,228,3,72,7658,72,300
121.031,17,3,228,3,48,60515,48,228,0,0,0,0,0
137.139,6,54,10626,19,125,4752,267,1775,35,337,4029,1460,8851
1796.039,17,142,11360,71,48,25657,48,5396,71,56,25657,56,5964
0.334,17,17,10203,8,612,47,1350,5120,9,536,34,1350,5083
12.028,17,20,1680,10,45,1335,45,730,10,67,1335,73,950
7.052,17,16,9203,6,366,1410,1350,2366,10,655,620,1350,6837
1791.369,17,166,28279,166,142,10856,389,28279,0,0,0,0,0
629.31,2,5,160,5,8,157327,8,160,0,0,0,0,0
0.231,6,20,4960,10,137,25,267,1092,10,692,24,1467,3868
0.071,6,20,6651,10,484,7,804,1982,10,690,7,1700,4669
1786.485,6,104,8444,68,66,26663,66,4964,36,60,51039,60,3480
1.571,6,31,10871,16,454,104,1375,3397,15,1143,99,2382,7474
1798.309,6,355,22549,206,69,8667,69,12380,149,69,12150,69,10169
1.551,6,37,8248,19,320,86,1162,2752,18,476,79,2715,5496
1799.997,1,252,14112,252,28,7171,28,14112,0,0,0,0,0
280.461,6,30,7432,14,158,21573,267,1357,16,678,18694,3456,6075
0.009,17,2,279,1,36,0,36,64,1,187,0,187,215
2.043,6,58,14595,29,549,72,1429,5048,29,440,68,1986,9547
38.652,17,43,6132,22,48,1837,48,1672,21,184,1926,308,4460
1786.478,6,119,13744,77,82,23506,501,6063,42,157,43570,1420,7681
0.771,6,5,260,2,0,753,0,104,3,0,381,0,156
189.259,6,30,7432,13,158,15771,267,1317,17,543,11827,1400,6115
1772.249,6,180,15480,120,69,14892,69,8940,60,69,30034,69,6540
0.261,17,2,904,2,424,261,548,904,0,0,0,0,0
57.5,6,10,958,6,0,11500,0,320,4,414,11783,414,638
0.15,6,37,14566,22,884,7,1420,9745,15,467,10,1883,4821
0.053,17,4,350,2,34,0,34,124,2,85,44,91,226
0.016,6,2,99,1,0,0,0,40,1,7,0,7,59
8.278,6,12,528,5,0,1499,0,220,7,0,1334,0,308
348.972,6,147,68958,80,955,4415,1448,56738,67,261,5285,1448,12220
0.507,17,3,234,2,39,204,39,134,1,72,0,72,100
270.717,6,7,364,7,0,0,0,364,0,0,0,0,0
1791.622,17,178,13884,178,50,10122,50,13884,0,0,0,0,0
0.058,1,2,112,2,28,58,28,112,0,0,0,0,0
8.805,6,71,20326,36,501,251,1152,15499,35,489,251,1179,4827
1799.616,6,372,26853,215,104,8409,1189,15256,157,81,11534,485,11597
1792.326,17,87,3648,86,14,21086,14,3612,1,8,0,8,36
25.274,17,4,1344,4,308,8424,308,1344,0,0,0,0,0
6.012,17,6,507,3,34,3003,34,186,3,79,3003,79,321
8.2,1,9,756,9,56,1025,56,756,0,0,0,0,0
0.198,17,2,231,1,34,0,34,62,1,141,0,141,169
1775.501,17,140,11200,70,48,25731,48,5320,70,56,25731,56,5880
1776.522,6,102,8364,68,66,26515,66,4964,34,60,53828,60,3400
1799.985,17,449,39928,404,35,4466,288,25708,45,288,40019,288,14220
6.462,6,46,8465,23,227,293,314,4102,23,491,281,1179,4363
79.791,17,16,17875,16,1089,5319,1451,17875,0,0,0,0,0
1744.708,2,29,928,29,8,62311,8,928,0,0,0,0,0
1746.407,6,96,7286,63,38,28167,205,4476,33,33,54558,98,2810
0.052,17,2,279,1,36,0,36,64,1,187,0,187,215
1739.315,6,89,6426,58,31,30514,31,3915,31,31,57976,31,2511
240.56,2,2,64,2,8,240560,8,64,0,0,0,0,0
300.791,6,41,9957,23,571,13672,1360,4390,18,402,507,2667,5567
280.172,6,30,7432,14,158,21551,267,1357,16,603,18677,2036,6075
0.187,6,27,7296,13,155,15,267,1301,14,603,12,2800,5995
155.092,17,8,2688,8,308,22156,308,2688,0,0,0,0,0
0.008,6,10,1510,5,657,2,657,925,5,317,2,317,585
1772.627,6,180,15480,120,69,14896,69,8940,60,69,30036,69,6540
1785.908,6,357,22629,208,69,8627,69,12460,149,69,12066,69,10169
280.906,6,60,8723,28,158,10403,267,1917,32,552,9060,2600,6806
0.048,17,2,558,1,32,0,32,60,1,470,0,470,498
1795.391,17,142,11360,71,48,25648,48,5396,71,56,25648,56,5964
211.345,6,29,7392,13,158,17612,267,1317,16,603,14087,2036,6075
5.899,6,40,7325,21,218,294,314,3463,19,516,313,1179,3862
1776.94,6,185,16025,120,69,14932,69,8940,65,69,27757,69,7085
9.497,6,1871,1733811,1194,1374,7,1408,1693943,677,931,13,2816,39868
1799.208,17,449,39928,404,35,4464,288,25708,45,288,40021,288,14220
80.485,17,5,380,5,48,20121,48,380,0,0,0,0,0
1680.725,17,13,534,11,14,168054,14,462,2,8,1680547,8,72
0.313,17,8,2750,8,315,44,354,2750,0,0,0,0,0
1740.409,17,30,7050,30,207,60014,207,7050,0,0,0,0,0
300.956,6,45,13745,25,881,12539,1460,8098,20,371,461,1460,5647
345.305,17,8,480,4,32,115101,32,240,4,32,115101,32,240
1785.859,6,352,22360,204,69,8797,69,12300,148,69,12148,69,10060
0.018,6,11,1566,6,503,3,503,823,5,475,4,475,743
27.689,6,31,7677,12,155,2517,267,1266,19,376,1537,3417,6411
1773.853,6,180,15480,120,69,14906,69,8940,60,69,30054,69,6540
1790.664,6,387,34019,219,119,8214,1189,17151,168,133,10722,1420,16868
15.369,6,16,2209,9,242,1921,517,1191,7,323,2560,499,1018
1638.006,1,7,392,7,28,273001,28,392,0,0,0,0,0
1798.845,6,379,27165,210,98,8606,469,15023,169,69,10704,69,12142
1.351,6,12,1304,6,256,268,256,756,6,304,268,304,548
66.983,6,80,54917,50,1188,1367,1368,46597,30,844,2138,2519,8320
1788.651,17,87,3648,86,14,21042,14,3612,1,8,0,8,36
0.136,17,8,2758,8,316,19,355,2758,0,0,0,0,0
0.671,17,17,6137,8,395,95,1350,3388,9,277,79,1350,2749
240.21,6,53,18303,28,814,8896,1408,15310,25,210,10008,580,2993
45.985,17,4,352,2,60,45983,60,176,2,60,45983,60,176
1.202,6,11,1427,6,145,240,145,389,5,830,293,830,1038
399.994,6,46,26495,29,251,14285,1360,4455,17,1779,38,5440,22040
1655.008,1,8,448,8,28,236429,28,448,0,0,0,0,0
261.214,17,14,4689,14,306,20093,308,4689,0,0,0,0,0
57.755,6,26,10234,14,652,4442,1438,3345,12,1042,5239,1438,6889
1.197,17,3,1167,3,361,598,361,1167,0,0,0,0,0
86.715,6,800,386317,435,822,199,1152,366926,365,435,237,1179,19391
1781.419,6,354,22440,207,69,8647,69,12420,147,69,12201,69,10020
5.22,6,41,7349,21,218,261,314,3463,20,513,259,1179,3886
5.012,17,4,558,2,36,5002,36,128,2,187,5000,187,430
0.109,17,2,410,1,46,0,46,74,1,308,0,308,336
1744.724,2,29,928,29,8,62311,8,928,0,0,0,0,0
8.652,6,22,6546,7,154,1442,267,752,15,518,615,1420,5794
1773.507,6,204,22399,130,75,13748,267,10057,74,133,24291,2828,12342
1.504,6,36,11531,19,415,83,1460,3714,17,890,82,2382,7817
1.661,6,49,19304,29,891,59,1360,13683,20,437,76,2715,5621
11.19,6,94,29543,49,575,233,1152,23261,45,447,248,1179,6282
0.544,6,22,7345,13,334,45,663,2021,9,1209,62,1946,5324
1.057,17,3,215,2,33,1036,33,122,1,65,0,65,93
113.16,6,23,3838,15,99,8071,182,1248,8,437,16123,1343,2590
1794.418,1,69,5796,0,0,0,0,0,69,56,26388,56,5796
1745.463,6,90,6540,60,31,29584,31,4050,30,31,60179,31,2490
1.221,6,24,8004,12,164,94,267,1288,12,1014,94,2896,6716
1761.038,1,65,5460,65,56,27516,56,5460,0,0,0,0,0
1263.346,2,10,320,10,8,140371,8,320,0,0,0,0,0
126.016,6,13,2074,6,183,685,267,611,7,1179,20962,1179,1463
0.107,17,2,2756,2,1350,107,1350,2756,0,0,0,0,0
0.942,6,28,5893,14,123,72,267,1428,14,650,64,1380,4465
1757.805,1,21,2803,21,105,87890,320,2803,0,0,0,0,0
1786.641,6,102,8296,68,65,26666,65,4930,34,59,54137,59,3366
11.803,6,98,31654,50,581,240,1152,25252,48,447,245,1179,6402
0.007,6,2,149,1,69,0,69,109,1,0,0,0,40
0.066,1,2,112,2,28,66,28,112,0,0,0,0,0
241.469,17,4,240,2,32,241468,32,120,2,32,241468,32,120
1753.025,6,100,7897,65,45,27391,205,4850,35,35,51552,98,3047
2.148,6,10,1687,6,100,429,100,344,4,589,631,1152,1343
1772.994,6,181,15589,120,69,14899,69,8940,61,69,29544,69,6649
560.556,17,6,444,3,30,280272,30,174,3,62,280269,62,270
1771.665,6,270,33563,112,139,15959,1360,16355,158,134,11283,3302,17208
76.064,17,4,240,2,32,76063,32,120,2,32,76063,32,120
1787.443,6,102,8296,68,65,26678,65,4930,34,59,54161,59,3366
1700.648,1,8,448,8,28,242949,28,448,0,0,0,0,0
1789.28,17,83,3480,82,14,22089,14,3444,1,8,0,8,36
60.194,2,2,64,2,8,60194,8,64,0,0,0,0,0
1794.344,6,244,35804,152,302,11883,302,26032,92,83,19718,83,9772
16.439,6,103,29090,50,512,335,1152,21465,53,392,310,1152,7625
601.953,6,36,6579,19,250,33441,1314,2516,17,307,37620,1460,4063
0.0,17,2,744,2,344,0,355,744,0,0,0,0,0
66.11,6,30,20252,19,1070,3672,1408,11705,11,1593,6592,3310,8547
1699.422,17,12,498,11,14,169942,14,462,1,8,0,8,36
1.408,6,24,8004,12,164,110,267,1288,12,1014,110,2331,6716
1780.582,6,354,22440,207,69,8643,69,12420,147,69,12195,69,10020
0.066,17,2,2384,2,1164,66,1164,2384,0,0,0,0,0
66.776,6,24,6248,9,272,100,516,1180,15,372,4762,1452,5068
0.039,17,2,570,1,30,0,30,58,1,484,0,484,512
29.389,6,38,10079,19,745,496,1460,4517,19,399,1623,1460,5562
120.37,2,2,64,2,8,120370,8,64,0,0,0,0,0
740.857,17,10,821,5,31,185210,37,297,5,76,185210,136,524
1794.361,6,207,14367,103,69,17590,208,9246,104,31,17419,31,5121
28.09,6,37,8503,18,400,511,885,1989,19,441,1552,1360,6514
1769.924,6,123,11387,75,65,23917,65,6365,48,59,37655,59,5022
380.458,6,32,3213,18,324,22379,585,1609,14,282,29265,580,1604
0.317,17,2,152,1,48,0,48,76,1,48,0,48,76
410.776,6,40,7345,19,262,22818,517,1784,21,744,20536,1418,5561
10.663,6,1341,1216995,825,1396,12,1408,1185475,516,776,20,1408,31520
1781.825,6,357,22698,208,69,8607,69,12460,149,69,12039,69,10238
1799.865,6,221,19120,82,77,21851,339,8581,139,70,13042,1062,10539
1799.089,6,130,11898,70,26,26073,27,4136,60,208,30492,427,7762
2.868,6,118,70856,64,1284,45,1432,60437,54,578,48,2218,10419
3.051,6,3,180,3,0,0,0,180,0,0,0,0,0
1799.47,17,4202,201696,2102,20,856,20,100896,2100,20,856,20,100800
1799.195,6,129,8162,74,47,24644,208,5001,55,31,33315,31,3161
1786.079,6,173,27930,74,62,24466,517,5749,99,497,18224,1408,22181
1.023,17,8,704,4,37,338,37,260,4,83,338,89,444
1.316,6,50,18793,27,856,50,1360,13097,23,476,51,2715,5696
1795.758,6,373,26097,215,98,8391,469,15223,158,69,11437,69,10874
0.719,6,21,5000,11,137,71,267,1132,10,692,69,1467,3868
3.496,17,8,736,4,32,1059,32,240,4,96,1066,96,496
4.993,17,4,288,2,36,4984,36,128,2,52,4983,52,160
62.582,1,10,560,10,28,6953,28,560,0,0,0,0,0
131.076,6,30,7432,13,158,10923,267,1317,17,543,8190,1400,6115
30.142,1,2,120,2,32,30142,32,120,0,0,0,0,0
1049.151,6,190,21194,82,76,12405,615,7480,108,156,9803,4649,13714
0.643,17,3,705,3,207,321,207,705,0,0,0,0,0
1681.258,17,14,3843,7,30,280208,30,406,7,463,280209,463,3437
1783.565,17,83,3480,82,14,22019,14,3444,1,8,0,8,36
0.265,17,3,451,2,39,210,39,134,1,289,0,289,317
7.982,6,45,8425,23,227,362,314,4102,22,491,368,1179,4323
23.719,1,4,224,4,28,7906,28,224,0,0,0,0,0
7.334,6,30,8848,13,155,611,267,1306,17,527,457,3417,7542
1771.477,6,101,9344,66,65,27253,65,5577,35,59,52098,59,3767
1680.426,1,13,728,13,28,140035,28,728,0,0,0,0,0
2.283,6,9,424,5,0,570,0,232,4,0,667,0,192
207.444,6,72,15274,28,212,5185,1189,3468,44,346,4824,1420,11806
125.776,2,2,64,2,8,125776,8,64,0,0,0,0,0
126.339,2,2,64,2,8,126339,8,64,0,0,0,0,0
1770.501,1,59,4956,59,56,30525,56,4956,0,0,0,0,0
3.553,17,2,136,1,32,0,32,60,1,48,0,48,76
300.665,6,44,8578,23,245,13666,636,1982,21,478,585,1928,6596
1764.811,2,16,512,16,8,117654,8,512,0,0,0,0,0
11.585,6,58,15056,30,379,399,823,2490,28,497,339,1360,12566
0.942,6,25,8662,14,208,72,475,1426,11,969,76,1460,7236
1798.559,17,572,192192,572,308,3149,308,192192,0,0,0,0,0
955.039,1,12,672,12,28,86821,28,672,0,0,0,0,0
0.488,6,53,22420,29,1001,17,1380,17218,24,383,18,1380,5202
181.117,6,30,8872,14,158,13932,267,1357,16,763,12071,2800,7515
1.005,6,52,13869,24,551,43,1429,4840,28,438,36,1460,9029
8.745,6,30,8029,14,215,672,721,1854,16,614,570,2840,6175
42.526,6,47,10375,22,533,721,910,3107,25,329,1766,2128,7268
120.384,6,28,7352,13,158,10032,267,1317,15,678,8595,2800,6035
1787.907,6,386,26755,220,97,8163,469,15699,166,69,10835,69,11056
1791.844,17,87,3648,86,14,21080,14,3612,1,8,0,8,36
10.43,6,19,6516,5,154,2607,267,672,14,586,767,2086,5844
1.924,17,3,468,3,128,962,128,468,0,0,0,0,0
1784.604,17,368,79700,368,188,4862,406,79700,0,0,0,0,0
300.831,6,45,10240,23,433,13674,910,3154,22,364,737,2720,7086
111.689,6,22,10202,12,433,76,990,1823,10,1327,12393,3928,8379
1.522,6,52,23849,30,997,52,1460,18193,22,433,61,1460,5656
9.961,17,36,13855,17,548,620,1350,9807,19,185,551,1350,4048
0.558,6,29,7521,17,306,34,1088,2827,12,601,49,1452,4694
1794.707,6,369,25799,215,99,8386,469,15085,154,69,11728,69,10714
1771.012,6,99,9306,66,66,27246,66,5610,33,60,55341,60,3696
1789.608,17,142,11360,71,48,25565,48,5396,71,56,25565,56,5964
1791.997,6,365,25432,213,100,8452,469,14936,152,69,11867,69,10496
55.034,6,16,4735,9,290,6879,517,1057,7,1102,9168,1368,3678
1.716,6,53,19215,29,873,61,1360,13434,24,400,65,1360,5781
0.51,17,3,451,2,39,57,39,134,1,289,0,289,317
0.604,6,10,924,5,283,107,283,551,5,105,107,105,373
2.474,17,2,136,1,32,0,32,60,1,48,0,48,76
1647.637,1,7,392,7,28,274606,28,392,0,0,0,0,0
0.165,17,3,634,2,32,159,32,120,1,486,0,486,514
1795.781,6,373,23614,214,69,8430,69,13114,159,69,11365,69,10500
0.098,6,9,1002,5,213,24,213,417,4,421,29,421,585
1.338,6,49,19123,28,946,49,1460,13462,21,400,57,1460,5661
280.822,6,30,7432,13,158,23401,267,1317,17,543,17549,1400,6115
2.149,17,32,15791,14,332,162,1350,5043,18,569,124,1350,10748
2.753,6,1209,1738708,560,218,4,230,31759,649,2586,4,9814,1706949
1794.94,6,356,22520,208,69,8671,69,12460,148,69,12210,69,10060
0.571,6,4,232,1,0,0,0,52,3,0,285,0,180
44.52,6,43,8917,21,401,646,889,2160,22,366,2112,2720,6757
280.258,6,28,7352,12,158,25478,267,1277,16,603,18679,1400,6075
0.102,6,9,1339,5,145,25,145,349,4,826,22,826,990
1745.692,1,56,4704,0,0,0,0,0,56,56,31739,56,4704
0.055,17,2,257,1,48,0,48,76,1,153,0,153,181
1800.0,6,209,14444,77,46,23289,46,6082,132,46,13740,46,8362
0.999,6,49,17247,29,426,35,1360,9294,20,793,46,4649,7953
11.183,6,26,11333,13,275,931,275,1078,13,1215,850,2840,10255
16.329,17,16,5206,7,360,2715,1350,2716,9,248,2037,1350,2490
240.214,6,53,18072,28,802,8896,1402,15103,25,207,10008,580,2969
